Ticker;SimFinId;Currency;"Fiscal Year";"Fiscal Period";"Report Date";"Publish Date";"Shares (Basic)";"Shares (Diluted)";"Cash, Cash Equivalents & Short Term Investments";"Accounts & Notes Receivable";Inventories;"Total Current Assets";"Property, Plant & Equipment, Net";"Long Term Investments & Receivables";"Other Long Term Assets";"Total Noncurrent Assets";"Total Assets";"Payables & Accruals";"Short Term Debt";"Total Current Liabilities";"Long Term Debt";"Total Noncurrent Liabilities";"Total Liabilities";"Share Capital & Additional Paid-In Capital";"Treasury Stock";"Retained Earnings";"Total Equity";"Total Liabilities & Equity"
GOOG;18;USD;2016;Q4;2016-12-31;2017-02-03;689814000;748006000;86333000000;14137000000;268000000;105408000000;34234000000;5878000000;21977000000;62089000000;167497000000;15657000000;;16756000000;3935000000;11705000000;28461000000;36307000000;;105131000000;139036000000;167497000000
GOOG;18;USD;2015;Q4;2015-12-31;2016-02-11;687537000;747676000;73066000000;11556000000;491000000;90114000000;29016000000;5183000000;23148000000;57347000000;147461000000;12869000000;3225000000;19310000000;1995000000;7820000000;27130000000;32982000000;;89223000000;120331000000;147461000000
GOOG;18;USD;2014;Q4;2014-12-31;2015-10-29;678941000;742130000;64395000000;9383000000;;78656000000;23883000000;3079000000;23569000000;50531000000;129187000000;11240000000;2009000000;16779000000;3228000000;8548000000;25327000000;28767000000;;75066000000;103860000000;129187000000
GOOG;18;USD;2017;Q4;2017-12-31;2018-02-06;694605000;752153000;101871000000;18336000000;749000000;124308000000;42383000000;7813000000;22791000000;72987000000;197295000000;22751000000;;24183000000;3969000000;20610000000;44793000000;40247000000;;113247000000;152502000000;197295000000
GOOG;18;USD;2018;Q4;2018-12-31;2019-02-05;695239000;747600000;109140000000;20838000000;1107000000;135676000000;59719000000;13859000000;23538000000;97116000000;232792000000;32836000000;;34620000000;4012000000;20544000000;55164000000;45049000000;;134885000000;177628000000;232792000000
FOX;242;USD;2016;Q4;2016-06-30;2016-08-11;1889000000;1894000000;4424000000;6258000000;3291000000;14949000000;1692000000;4252000000;27300000000;33244000000;48193000000;3181000000;427000000;7068000000;19126000000;26244000000;33312000000;12230000000;;3575000000;14881000000;48193000000
FOX;242;USD;2015;Q4;2015-06-30;2015-08-13;2056000000;2060000000;8428000000;5912000000;2749000000;17348000000;1722000000;4923000000;26046000000;32691000000;50039000000;3717000000;244000000;7042000000;18795000000;24811000000;31853000000;13447000000;;5343000000;18186000000;50039000000
FOX;242;USD;2014;Q4;2014-06-30;2014-08-14;2223000000;2228000000;5415000000;6468000000;3092000000;15376000000;2931000000;3313000000;33173000000;39417000000;54793000000;4183000000;799000000;8856000000;18259000000;25036000000;33892000000;15063000000;;2389000000;20901000000;54793000000
FOX;242;USD;2013;Q4;2013-06-30;2013-08-19;2317000000;2318000000;6659000000;5459000000;2784000000;15567000000;2829000000;4141000000;28407000000;35377000000;50944000000;4434000000;137000000;8435000000;16321000000;22384000000;30819000000;15863000000;;1454000000;20125000000;50944000000
FOX;242;USD;2012;Q4;2012-06-30;2012-08-14;2413000000;2414000000;9626000000;6608000000;2595000000;19448000000;5814000000;5355000000;26046000000;37215000000;56663000000;5405000000;273000000;9617000000;15182000000;21861000000;31478000000;16163000000;;8521000000;25185000000;56663000000
FOX;242;USD;2011;Q4;2011-06-30;2011-08-15;2626000000;2647000000;12680000000;6330000000;2332000000;21784000000;6542000000;5217000000;28437000000;40196000000;61980000000;5773000000;32000000;9571000000;15463000000;21762000000;31333000000;17461000000;;12608000000;30647000000;61980000000
FOX;242;USD;2010;Q4;2010-06-30;2010-09-03;2620000000;2646000000;8709000000;6431000000;2392000000;18024000000;5980000000;3861000000;26519000000;36360000000;54384000000;5204000000;129000000;8862000000;13191000000;19981000000;28843000000;17434000000;;7679000000;25541000000;54384000000
FOX;242;USD;2009;Q4;2009-06-30;2009-11-05;2613000000;2605000000;6540000000;6287000000;2477000000;15836000000;6245000000;3239000000;27801000000;37285000000;53121000000;5279000000;2085000000;10639000000;12204000000;18850000000;29489000000;17380000000;;5844000000;23632000000;53121000000
FOX;242;USD;2017;Q4;2017-06-30;2017-08-14;1851000000;1854000000;6163000000;6477000000;3101000000;16286000000;1781000000;4445000000;28212000000;34438000000;50724000000;3451000000;457000000;7238000000;19456000000;26548000000;33786000000;12425000000;;5315000000;16938000000;50724000000
FOX;242;USD;2018;Q4;2018-06-30;2018-08-13;1850000000;1862000000;7622000000;7120000000;3669000000;19333000000;1956000000;4836000000;27706000000;34498000000;53831000000;3248000000;1054000000;8244000000;18469000000;24789000000;33033000000;12631000000;;8934000000;20798000000;53831000000
ATVI;243;USD;2016;Q4;2016-12-31;2017-02-28;744000000;764000000;3245000000;732000000;49000000;4830000000;258000000;;12364000000;12622000000;17452000000;1028000000;;2656000000;4887000000;5677000000;8333000000;10442000000;-5563000000;4869000000;9119000000;17452000000
ATVI;243;USD;2015;Q4;2015-12-31;2016-02-29;732000000;751000000;1823000000;679000000;128000000;3387000000;189000000;;11670000000;11859000000;15246000000;909000000;;2611000000;4074000000;4567000000;7178000000;10242000000;-5637000000;4096000000;8068000000;15246000000
ATVI;243;USD;2014;Q4;2014-12-31;2015-02-26;721000000;741000000;4858000000;659000000;123000000;6541000000;157000000;9000000;7935000000;8101000000;14642000000;917000000;;2714000000;4324000000;4695000000;7409000000;9924000000;-5762000000;3374000000;7233000000;14642000000
ATVI;243;USD;2013;Q4;2013-12-31;2014-03-03;743000000;759000000;4443000000;510000000;171000000;5920000000;138000000;9000000;7945000000;8092000000;14012000000;991000000;25000000;2405000000;4668000000;4985000000;7390000000;9682000000;-5814000000;2686000000;6622000000;14012000000
ATVI;243;USD;2012;Q4;2012-12-31;2013-02-22;1110000000;1116000000;4375000000;707000000;209000000;5787000000;141000000;8000000;8264000000;8413000000;14200000000;995000000;0;2652000000;0;231000000;2883000000;9450000000;0;1893000000;11317000000;14200000000
ATVI;243;USD;2011;Q4;2011-12-31;2012-02-28;1138000000;1144000000;3525000000;649000000;144000000;4873000000;163000000;16000000;8225000000;8404000000;13277000000;1084000000;;2556000000;;229000000;2785000000;9616000000;;948000000;10492000000;13277000000
ATVI;243;USD;2010;Q4;2010-12-31;2011-02-25;1196000000;1205000000;3508000000;673000000;112000000;4784000000;169000000;23000000;8471000000;8663000000;13447000000;1234000000;;2960000000;;284000000;3244000000;12353000000;-2194000000;57000000;10203000000;13447000000
ATVI;243;USD;2009;Q4;2009-12-31;2010-03-01;1264000000;1256000000;3245000000;739000000;241000000;4831000000;138000000;23000000;8750000000;8911000000;13742000000;1081000000;;2507000000;;479000000;2986000000;12376000000;-1235000000;-361000000;10756000000;13742000000
ATVI;243;USD;2008;Q4;2008-12-31;2009-08-07;1336000000;1336000000;3002000000;974000000;262000000;4723000000;149000000;78000000;9515000000;9742000000;14465000000;1161000000;;2084000000;;854000000;2938000000;12170000000;-126000000;-474000000;11527000000;14465000000
ATVI;243;USD;2017;Q4;2017-12-31;2018-02-27;758000000;773000000;4713000000;918000000;46000000;6520000000;294000000;;11854000000;12148000000;18668000000;1734000000;;3663000000;4390000000;5543000000;9206000000;10747000000;-5563000000;4916000000;9462000000;18668000000
ATVI;243;USD;2018;Q4;2018-12-31;2019-02-28;765000000;773000000;4225000000;1035000000;43000000;6106000000;282000000;;11447000000;11729000000;17835000000;1149000000;;2642000000;2671000000;3836000000;6478000000;10963000000;-5563000000;6558000000;11357000000;17835000000
BLK;914;USD;2016;Q4;2017-02-28;2017-02-28;163427476;166024182;6175000000;2350000000;;185406000000;559000000;2603000000;31609000000;34771000000;220177000000;2974000000;;158126000000;4915000000;32707000000;190833000000;19339000000;-3185000000;13660000000;29344000000;220177000000
BLK;914;USD;2015;Q4;2016-02-29;2015-11-06;165809150;168651055;6231000000;2237000000;;190655000000;581000000;2608000000;31417000000;34606000000;225261000000;3039000000;;159951000000;4930000000;36266000000;196217000000;19407000000;-2489000000;12033000000;29044000000;225261000000
BLK;914;USD;2014;Q4;2015-02-28;2014-11-07;167173934;170586322;6001000000;2120000000;;203062000000;467000000;5241000000;31022000000;36730000000;239792000000;2900000000;;170307000000;8311000000;41965000000;212272000000;19388000000;-1894000000;10145000000;27520000000;239792000000
BLK;914;USD;2013;Q4;2014-02-28;2013-11-08;168981316;173509385;4551000000;2247000000;;183699000000;525000000;2151000000;33498000000;36174000000;219873000000;2831000000;;164107000000;7308000000;29096000000;193203000000;19475000000;-1210000000;8230000000;26670000000;219873000000
BLK;914;USD;2012;Q4;2013-02-28;2012-11-08;171451852;175111618;4903000000;2250000000;;164942000000;557000000;1750000000;33202000000;35509000000;200451000000;2602000000;100000000;143724000000;8089000000;31110000000;174834000000;19421000000;-432000000;6473000000;25617000000;200451000000
BLK;914;USD;2011;Q4;2012-02-29;2011-11-09;178359265;181763844;3560000000;1960000000;;145489000000;537000000;1631000000;32239000000;34407000000;179896000000;2306000000;100000000;127352000000;6264000000;27182000000;154534000000;20276000000;-218000000;5118000000;25362000000;179896000000
BLK;914;USD;2010;Q4;2011-02-28;2010-11-08;191071951;193719557;3460000000;2095000000;;144546000000;428000000;1540000000;31945000000;33913000000;178459000000;2588000000;100000000;129950000000;4537000000;22175000000;152125000000;22503000000;-111000000;3798000000;26333000000;178458000000
BLK;914;USD;2009;Q4;2010-02-28;2009-11-06;152265133;156861755;4708000000;1718000000;;145682000000;443000000;1049000000;30950000000;32442000000;178124000000;2322000000;2234000000;130753000000;3434000000;22769000000;153522000000;22128000000;-3000000;2436000000;24601000000;178123000000
BLK;914;USD;2008;Q4;2009-02-28;2009-08-07;129890627;129510724;2032000000;901000000;;6000000000;260000000;1429000000;12235000000;13924000000;19924000000;1371000000;200000000;6422000000;942000000;942000000;7364000000;10474000000;-58000000;1982000000;12560000000;19924000000
BLK;914;USD;2017;Q4;2018-02-28;2018-02-28;161250624;164880550;7038000000;2699000000;;183864000000;592000000;3474000000;32311000000;36377000000;220241000000;3314000000;;158773000000;5014000000;29204000000;187977000000;19258000000;-3967000000;16939000000;32264000000;220241000000
BLK;914;USD;2018;Q4;2019-02-28;2019-02-28;158831980;161335813;6488000000;2657000000;;120085000000;643000000;4476000000;34369000000;39488000000;159573000000;3280000000;;99109000000;6269000000;26924000000;126033000000;19170000000;-5387000000;19282000000;33540000000;159573000000
ADBE;14099;USD;2016;Q4;2016-12-31;2017-01-20;495697000;503126000;4761300000;833033000;;5839774000;816264000;80439000;5960769000;6857472000;12697246000;866016000;;2811635000;1892200000;2460776000;5272411000;4616392000;-5132472000;8114517000;7424835000;12697246000
ADBE;14099;USD;2015;Q4;2015-12-31;2016-01-19;498382000;509739000;3988084000;672006000;;4821892000;787421000;80439000;6036720000;6904580000;11726472000;779356000;;2213556000;1907231000;2511336000;4724892000;4184944000;-4267715000;7253431000;7001580000;11726472000
ADBE;14099;USD;2014;Q4;2014-12-31;2015-01-20;498121000;511082000;3739491000;591800000;;4602328000;785123000;80439000;5317939000;6183501000;10785829000;776163000;603229000;2494435000;911086000;1515489000;4009924000;3778556000;-3918851000;6924294000;6775905000;10785829000
ADBE;14099;USD;2013;Q4;2013-12-31;2014-01-21;499381000;519560000;3173752000;599820000;;4045929000;659774000;207239000;5467356000;6334369000;10380298000;729257000;14676000;1525648000;1499297000;2130016000;3655664000;3392757000;-3643190000;6928964000;6724634000;10380298000
ADBE;14099;USD;2012;Q4;2012-12-31;2013-01-22;494907000;509372000;3538353000;617233000;;4397066000;664302000;207239000;4771622000;5643163000;10040229000;689785000;11217000;1271752000;1496938000;2103295000;3375047000;3038726000;-3407259000;7003003000;6665182000;10040229000
ADBE;14099;USD;2011;Q4;2011-12-31;2012-01-26;491519000;499318000;2911692000;634373000;;3771451000;527828000;207239000;4484665000;5219732000;8991183000;684235000;9212000;1250779000;1505096000;1957291000;3208070000;2753957000;-3529529000;6528735000;5783113000;8991183000
ADBE;14099;USD;2010;Q4;2010-12-31;2011-01-27;507149000;514213000;2468015000;554328000;;3216050000;448881000;207239000;4268978000;4925098000;8141148000;670422000;8799000;1068088000;1513662000;1880673000;2948761000;2458339000;-3264294000;5980914000;5192387000;8141148000
ADBE;14099;USD;2009;Q4;2009-12-31;2010-01-22;523542000;534788000;1904473000;410879000;;2473624000;388132000;207239000;4213242000;4808613000;7282237000;525184000;0;844553000;1000000000;1547116000;2391669000;2390122000;-2823914000;5299914000;4890568000;7282237000
ADBE;14099;USD;2008;Q4;2008-12-31;2009-06-26;531928000;539266000;2019202000;467234000;;2735103000;313037000;207239000;2566219000;3086495000;5821598000;482945000;;762599000;350000000;648645000;1411244000;2396880000;-2957154000;4913406000;4410354000;5821598000
ADBE;14099;USD;2017;Q4;2017-12-31;2018-01-22;492119000;502882000;5819774000;1217968000;;7247813000;936976000;0;6350767000;7287743000;14535556000;1121507000;;3527457000;1881421000;2548230000;6075687000;5082256000;-6084436000;9573870000;8459869000;14535556000
ADBE;14099;USD;2018;Q4;2018-12-31;2019-01-25;488256000;496821000;3228962000;1315578000;;4857039000;1075072000;;12836571000;13911643000;18768682000;1385152000;;4301126000;4124800000;5105442000;9406568000;5685398000;-7990751000;11815597000;9362114000;18768682000
MMM;22219;USD;2017;Q4;2017-12-31;2018-02-08;596200000;613300000;4129000000;4911000000;4034000000;14277000000;8866000000;;14844000000;23710000000;37987000000;3125000000;1853000000;7687000000;12096000000;18678000000;26365000000;5361000000;-25887000000;39115000000;11622000000;37987000000
MMM;22219;USD;2016;Q4;2016-12-31;2016-11-01;600100000;613800000;2678000000;4392000000;3385000000;11726000000;8516000000;;12664000000;21180000000;32906000000;2775000000;972000000;6219000000;10678000000;16344000000;22563000000;5070000000;-25434000000;37907000000;10343000000;32906000000
MMM;22219;USD;2015;Q4;2015-12-31;2015-10-29;614300000;625400000;1916000000;4154000000;3518000000;10986000000;8515000000;126000000;13256000000;21897000000;32883000000;2670000000;2044000000;7118000000;8753000000;14297000000;21415000000;4800000000;-23308000000;36296000000;11468000000;32883000000
MMM;22219;USD;2014;Q4;2014-12-31;2014-10-30;638000000;651000000;3336000000;4238000000;3706000000;12303000000;8489000000;117000000;10300000000;18906000000;31209000000;2974000000;106000000;5964000000;6705000000;12103000000;18067000000;4388000000;-19307000000;34317000000;13142000000;31209000000
MMM;22219;USD;2013;Q4;2013-12-31;2013-10-31;668500000;681400000;3337000000;4253000000;3864000000;12733000000;8652000000;1575000000;10590000000;20817000000;33550000000;2924000000;1683000000;7498000000;4326000000;8104000000;15602000000;4384000000;-15385000000;32416000000;17948000000;33550000000
MMM;22219;USD;2012;Q4;2012-12-31;2012-11-01;691500000;701400000;4531000000;4061000000;3837000000;13630000000;8378000000;1325000000;10543000000;20246000000;33876000000;2834000000;1085000000;6200000000;4916000000;9636000000;15836000000;4053000000;-12407000000;30679000000;18040000000;33876000000
MMM;22219;USD;2011;Q4;2011-12-31;2011-11-03;701400000;707600000;3680000000;3867000000;3416000000;12240000000;7666000000;1051000000;10659000000;19376000000;31616000000;2674000000;682000000;5441000000;4484000000;10313000000;15754000000;3776000000;-11679000000;28348000000;15862000000;31616000000
MMM;22219;USD;2010;Q4;2010-12-31;2010-11-05;714500000;727600000;4478000000;3615000000;3155000000;12215000000;7279000000;686000000;9976000000;17941000000;30156000000;2798000000;1269000000;6089000000;4183000000;8050000000;14139000000;3477000000;-10266000000;25995000000;16017000000;30156000000
MMM;22219;USD;2009;Q4;2009-12-31;2009-10-30;708900000;719800000;3784000000;3250000000;2639000000;10795000000;7000000000;928000000;8527000000;16455000000;27250000000;2385000000;613000000;4897000000;5097000000;9051000000;13948000000;3162000000;-10397000000;23753000000;13302000000;27250000000
MMM;22219;USD;2008;Q4;2008-12-31;2009-07-31;692900000;696700000;2222000000;3195000000;3013000000;9598000000;6886000000;463000000;8846000000;16195000000;25793000000;2295000000;1552000000;5839000000;5166000000;9650000000;15489000000;3015000000;-11676000000;22227000000;10304000000;25793000000
MMM;22219;USD;2018;Q4;2018-12-31;2019-02-07;580800000;592700000;3233000000;5020000000;4366000000;13709000000;8738000000;;14053000000;22791000000;36500000000;3258000000;1211000000;7244000000;13411000000;19408000000;26652000000;5652000000;-29626000000;40636000000;9848000000;36500000000
BRID;33021;USD;2018;Q4;2018-11-30;2019-01-18;9076328;;8179000;20293000;23413000;53216000;32638000;;15640000;48278000;101494000;12387000;;18367000;;17447000;35814000;17432000;;65948000;65680000;101494000
BRID;33021;USD;2017;Q4;2017-11-30;2018-01-12;18144251;;12109000;19148000;23016000;55823000;18571000;;23151000;41722000;97545000;10136000;;16244000;;25263000;41507000;17432000;;56902000;56038000;97545000
BRID;33021;USD;2016;Q4;2016-11-30;2017-01-13;9077424;;6985000;16582000;24081000;48585000;10362000;;28307000;38669000;87254000;8304000;;12222000;;36123000;48345000;17432000;;48073000;38909000;87254000
BRID;33021;USD;2015;Q4;2015-11-30;2016-01-15;9082968;;5842000;14619000;19977000;40757000;10235000;;24310000;34545000;75302000;11386000;;14211000;;25446000;39657000;17472000;;40303000;35645000;75302000
BRID;33021;USD;2014;Q4;2014-11-30;2015-01-16;9114372;;192000;10302000;21292000;32265000;12251000;;13660000;25911000;58176000;11809000;;14405000;;18521000;32926000;17755000;;24861000;25250000;58176000
BRID;33021;USD;2013;Q4;2013-11-30;2014-01-17;9139756;;8325000;12146000;18919000;40406000;11212000;;13146000;24358000;64764000;12446000;;15646000;;15663000;31309000;17939000;;29205000;33455000;64764000
BRID;33021;USD;2012;Q4;2012-11-30;2013-01-18;9167952;;9744000;11758000;17355000;40153000;9076000;;12321000;21397000;61550000;10876000;;14874000;;26532000;41406000;18148000;;26747000;20144000;61550000
BRID;33021;USD;2011;Q4;2011-11-30;2012-01-17;9180060;;9324000;9702000;16888000;37290000;7903000;;11773000;19676000;56966000;9836000;;13275000;;18853000;32128000;18469000;;23096000;24838000;56966000
BRID;33021;USD;2010;Q4;2010-11-30;2011-08-19;;;15686000;7609000;16307000;41487000;7892000;;11144000;19036000;60523000;8896000;;11651000;;12672000;24323000;19781000;;24471000;36200000;60523000
NWY;33184;USD;2017;Q4;2018-01-31;2018-04-17;63453000;65272000;90908000;12528000;84498000;206420000;77906000;;18630000;96536000;302956000;140794000;841000;141635000;10644000;74460000;216095000;183294000;-5085000;-90797000;86861000;302956000
NWY;33184;USD;2016;Q4;2017-01-31;2017-04-12;63227000;62752000;88369000;11837000;78044000;197964000;87070000;;16554000;103624000;301588000;137536000;841000;138377000;11485000;84042000;222419000;181465000;-4468000;-96472000;79169000;301588000
NWY;33184;USD;2015;Q4;2016-01-31;2016-04-14;63235000;63235000;61432000;8208000;87777000;177764000;88831000;;16865000;105696000;283460000;134888000;841000;135729000;12326000;53960000;189689000;178260000;-3397000;-79181000;93771000;283460000
NWY;33184;USD;2014;Q4;2015-01-31;2015-04-16;62932000;62932000;69293000;7406000;93791000;193800000;84374000;;23080000;107454000;301254000;139609000;866000;147135000;13258000;54760000;201895000;174674000;-3397000;-69112000;99359000;301254000
NWY;33184;USD;2013;Q4;2014-01-31;2014-04-15;62512000;65486000;69723000;7026000;83479000;182748000;83553000;;22452000;106005000;288753000;123829000;;130330000;;45208000;175538000;170570000;-3397000;-52227000;113215000;288753000
NWY;33184;USD;2012;Q4;2013-01-31;2013-04-16;61742000;64334000;60933000;8216000;80198000;172256000;97960000;;22464000;120424000;292680000;124446000;;131201000;;55227000;186428000;166966000;-3397000;-54621000;106252000;292680000
NWY;33184;USD;2011;Q4;2012-01-31;2012-04-09;61187000;61187000;50787000;7269000;81328000;161886000;115280000;;22625000;137905000;299791000;130507000;;137303000;;62383000;199686000;163002000;-3397000;-56721000;100105000;299791000
NWY;33184;USD;2010;Q4;2011-01-31;2011-09-08;59536000;59536000;77392000;9756000;82062000;191646000;144561000;;19003000;163564000;355210000;137943000;7500000;148805000;;72568000;221373000;157081000;-3397000;-17784000;133837000;355210000
NWY;33184;USD;2018;Q4;2019-01-31;2019-04-17;64084000;65715000;95542000;9879000;82803000;206963000;63791000;;18124000;81915000;288878000;146010000;;146010000;;56255000;202265000;185087000;-5085000;-92450000;86613000;288878000
AMSC;33387;USD;2016;Q4;2017-03-31;2017-05-25;13979000;13979000;26784000;7956000;17462000;55700000;43438000;;1106000;44544000;100244000;14490000;1481000;32217000;;7801000;40018000;1017657000;-1371000;-955557000;60226000;100244000
AMSC;33387;USD;2015;Q4;2016-03-31;2015-05-28;13467000;13467000;39330000;19264000;18512000;83341000;49778000;;2199000;51977000;135318000;23156000;2624000;41007000;1367000;10762000;51769000;1011954000;-881000;-928184000;83549000;135318000
AMSC;33387;USD;2014;Q4;2015-03-31;2014-06-05;9228000;9228000;43114000;7556000;20694000;83281000;64574000;;20654000;85228000;168509000;21764000;6240000;47822000;6380000;8428000;56250000;967179000;-370000;-856389000;112259000;168509000
AMSC;33387;USD;2013;Q4;2014-03-31;2013-06-14;6875500;6875500;39243000;18864000;33473000;120185000;74626000;;21943000;96569000;216754000;31578000;8768000;79757000;9248000;11879000;91636000;924450000;-313000;-800131000;125118000;216754000
AMSC;33387;USD;2012;Q4;2013-03-31;2011-09-23;5639000;5639000;51583000;18999000;29256000;143571000;90828000;;20657000;111485000;255056000;37582000;;86323000;;3854000;90177000;897123000;-271000;-734000000;164879000;255056000
AMSC;33387;USD;2011;Q4;2012-03-31;2011-09-23;5085000;5085000;239909000;15259000;25828000;319805000;96494000;;24910000;121404000;441209000;90273000;;145180000;;3174000;148354000;886211000;;-597173000;292855000;441209000
AMSC;33387;USD;2010;Q4;2011-03-31;2010-08-05;4962000;4814400;142063000;57290000;35858000;262994000;64315000;7342000;65533000;137190000;400184000;84319000;;104760000;;14459000;119219000;698865000;;-410889000;280965000;400184000
AMSC;33387;USD;2017;Q4;2018-03-31;2018-06-06;20081000;20081000;34084000;7365000;19780000;67176000;12513000;;8486000;20999000;88175000;12625000;;27325000;;8621000;35946000;1041324000;-1645000;-988333000;52229000;88175000
AMSC;33387;USD;2018;Q4;2019-03-31;2019-06-05;20441000;21292000;77483000;7855000;12119000;105470000;8972000;;4888000;13860000;119330000;15885000;;30082000;;8055000;38137000;1044838000;-2101000;-961539000;81193000;119330000
ACAT;33956;USD;2015;Q4;2016-03-31;2016-05-27;13031000;12871000;17730000;35760000;140007000;211818000;81487000;;11396000;92883000;304701000;96821000;;124030000;;13280000;137310000;6235000;;171340000;167391000;304701000
ACAT;33956;USD;2014;Q4;2015-03-31;2015-05-29;12945000;13138000;41262000;25067000;152443000;245964000;62868000;;6579000;69447000;315411000;93319000;;122089000;;12950000;135039000;2070000;;185444000;180372000;315411000
ACAT;33956;USD;2013;Q4;2014-03-31;2014-05-30;13086000;13298000;82532000;42003000;140652000;285296000;55931000;;1067000;56998000;342294000;93882000;;148541000;;8710000;157251000;129000;;187024000;185043000;342294000
ACAT;33956;USD;2012;Q4;2013-03-31;2013-06-14;13188000;13655000;112807000;30296000;96389000;259344000;45539000;;1262000;46801000;306145000;66599000;;127292000;;4381000;131673000;11077000;;167561000;174472000;306145000
ACAT;33956;USD;2011;Q4;2012-03-31;2012-06-08;12723000;14455000;62597000;28073000;98702000;212860000;41168000;;1388000;42556000;255416000;61210000;;114035000;;2909000;116944000;13364000;;127816000;138472000;255416000
ACAT;33956;USD;2010;Q4;2011-03-31;2011-08-09;18287000;19001000;125113000;23732000;61478000;232040000;39230000;;1636000;40866000;272906000;41666000;;87444000;;2426000;89870000;7463000;;177493000;183036000;272906000
APIC;34899;USD;2015;Q4;2015-07-31;2015-10-14;29492000;;89562000;21451000;;116819000;3144000;;18743000;21887000;138706000;11811000;2079000;49538000;1787000;9264000;58802000;276128000;;-196224000;79904000;138706000
APIC;34899;USD;2014;Q4;2014-07-31;2015-06-11;4193000;;51759000;16403000;;72695000;3474000;;19453000;22927000;95622000;10244000;2778000;36378000;2465000;9722000;46100000;195251000;;-145871000;49522000;95622000
LABL;35331;USD;2017;Q4;2018-03-31;2018-05-30;20407000;20557000;67708000;306542000;167950000;601183000;510002000;;1791791000;2301793000;2902976000;306363000;20864000;327227000;1577821000;1815376000;2142603000;403655000;-11528000;384671000;760373000;2902976000
LABL;35331;USD;2016;Q4;2017-03-31;2016-05-31;16942000;17088000;25229000;141211000;63995000;253746000;247261000;;590983000;838244000;1091990000;142233000;2093000;144326000;479408000;565844000;710170000;159453000;-11168000;316461000;381820000;1091990000
LABL;35331;USD;2015;Q4;2016-03-31;2015-06-12;16875000;17023000;27709000;134920000;61191000;248525000;221295000;;600246000;821541000;1070066000;135852000;1573000;137425000;504706000;590009000;727434000;151823000;-10556000;258848000;342632000;1070066000
LABL;35331;USD;2014;Q4;2015-03-31;2014-06-13;16970000;17235000;10020000;118906000;56296000;213424000;194589000;;556453000;751042000;964466000;113783000;42648000;156431000;435554000;509571000;666002000;133338000;-3760000;172052000;298464000;964466000
LABL;35331;USD;2013;Q4;2014-03-31;2013-06-14;16378000;16621000;15737000;102996000;48734000;190544000;178552000;;470454000;649006000;839550000;98491000;23946000;122437000;378910000;441498000;563935000;127145000;-1114000;147100000;275615000;839550000
LABL;35331;USD;2012;Q4;2013-03-31;2012-06-14;16187000;16398000;10014000;96179000;44176000;167102000;173137000;;469415000;642552000;809654000;107762000;24471000;132233000;377584000;424026000;556259000;124202000;-655000;120037000;253395000;809654000
LABL;35331;USD;2011;Q4;2012-03-31;2011-08-09;16083000;16305000;15152000;54564000;26275000;102628000;108173000;;201028000;309201000;411829000;59967000;12304000;72271000;115027000;147332000;219603000;74051000;-647000;103278000;192226000;411829000
LABL;35331;USD;2018;Q4;2019-03-31;2019-05-28;20480000;20225000;57762000;300945000;144235000;596819000;528077000;;1527576000;2055653000;2652472000;292638000;23059000;315697000;1514294000;1708072000;2023769000;408257000;-12079000;355973000;628703000;2652472000
ASNA;35533;USD;2018;Q4;2018-07-31;2018-09-24;196300000;196300000;238900000;;622900000;1110300000;1205300000;;1254900000;2460200000;3570500000;769000000;;890700000;1328700000;1881300000;2772000000;1090200000;;-278800000;798500000;3570500000
ASNA;35533;USD;2017;Q4;2017-07-31;2017-09-25;195000000;194100000;325600000;;639300000;1122300000;1437600000;;1311600000;2749200000;3871500000;771600000;44000000;937100000;1494100000;2113400000;3050500000;1070200000;;-238800000;821000000;3871500000
ASNA;35533;USD;2016;Q4;2016-07-31;2016-09-19;194200000;193200000;371800000;;649300000;1240000000;1630100000;;2636200000;4266300000;5506300000;849700000;54000000;1013700000;1594500000;2629300000;3643000000;1052200000;;828800000;1863300000;5506300000
ASNA;35533;USD;2015;Q4;2015-07-31;2015-09-16;163000000;156200000;240600000;;489300000;949900000;1170000000;;786300000;1956300000;2906200000;653600000;0;717700000;106500000;670400000;1388100000;671400000;;859300000;1518100000;2906200000
ASNA;35533;USD;2014;Q4;2014-07-31;2014-09-23;160700000;166700000;156900000;;553200000;923600000;1110600000;;1089600000;2200200000;3123800000;568400000;;631900000;172000000;754200000;1386100000;643800000;;1096100000;1737700000;3123800000
ASNA;35533;USD;2013;Q4;2013-07-31;2013-09-24;159000000;165700000;189400000;;540900000;942800000;824800000;;1104100000;1928900000;2871700000;553200000;600000;636500000;135000000;678800000;1315300000;594400000;;963200000;1556400000;2871700000
ASNA;35533;USD;2012;Q4;2012-07-31;2012-09-26;154200000;161600000;165700000;;533400000;1004600000;674200000;;1128300000;1802500000;2807100000;520100000;4200000;685600000;322400000;780600000;1466200000;530300000;;811900000;1340900000;2807100000
ASNA;35533;USD;2011;Q4;2011-07-31;2011-09-28;155100000;162500000;297600000;;365300000;760500000;489000000;138500000;451600000;1079100000;1839600000;349900000;;382200000;;299400000;681600000;473600000;;686800000;1158000000;1839600000
ASNA;35533;USD;2010;Q4;2010-07-31;2011-03-10;160000000;154600000;327100000;;320300000;716100000;478100000;15800000;444100000;938000000;1654100000;330300000;1400000;359200000;24600000;280200000;639400000;431100000;;589300000;1014700000;1654100000
ASNA;35533;USD;2019;Q4;2019-07-31;2019-10-10;198200000;193700000;328000000;;547700000;1155000000;847000000;42100000;655700000;1544800000;2699800000;669900000;;798200000;1338600000;1750600000;2548800000;1102600000;;-935900000;151000000;2699800000
ENS;35886;USD;2016;Q4;2017-03-31;2016-05-31;43533985;44158541;500329000;486646000;360694000;1418915000;348549000;;525565000;874114000;2293029000;449072000;18359000;467431000;587609000;717229000;1184660000;464636000;-439800000;1231444000;1108369000;2293029000
ENS;35886;USD;2017;Q4;2018-03-31;2018-05-30;41934186;42863244;522118000;546325000;414234000;1539587000;390260000;;557078000;947338000;2486925000;473189000;18341000;491530000;579535000;794284000;1285814000;477834000;-560991000;1320549000;1201111000;2486925000
ABAX;36105;USD;2016;Q4;2017-03-31;2016-05-31;22594000;22901000;129797000;35148000;35131000;212198000;26842000;22458000;9882000;59182000;271380000;26179000;;29172000;379000;5896000;35068000;127016000;;109303000;236312000;271380000
ABAX;36105;USD;2015;Q4;2016-03-31;2015-06-01;22540000;23065000;133124000;29015000;36179000;209861000;27316000;24181000;7706000;59203000;269064000;33004000;;41285000;480000;7585000;48870000;132559000;;87643000;220194000;269064000
ABAX;36105;USD;2014;Q4;2015-03-31;2014-05-30;22274000;22655000;102691000;27253000;26583000;165812000;24191000;18491000;8886000;51568000;217380000;14125000;;17259000;581000;6205000;23464000;124603000;;69318000;193916000;217380000
ABAX;36105;USD;2013;Q4;2014-03-31;2013-06-14;22079000;22660000;78264000;40005000;26786000;152963000;25330000;17000000;6470000;48800000;201763000;17662000;;20019000;682000;5550000;25569000;121019000;;55133000;176194000;201763000
ABAX;36105;USD;2012;Q4;2013-03-31;2012-06-14;21693000;22199000;67532000;30694000;19597000;127397000;24296000;23442000;6701000;54439000;181836000;14974000;;17431000;783000;4620000;22051000;110063000;;49697000;159785000;181836000
ABAX;36105;USD;2011;Q4;2012-03-31;2011-08-09;22534000;23119000;69452000;27880000;19814000;124064000;19637000;36237000;8322000;64196000;188260000;14538000;;16522000;746000;3090000;19612000;132042000;;36606000;168648000;188260000
ABAX;36105;USD;2017;Q4;2018-03-31;2018-05-30;23166000;24321000;166783000;48164000;44121000;264248000;35419000;19240000;22196000;76855000;341103000;40745000;;43880000;177000;6530000;50410000;147000000;;143870000;290693000;341103000
NGL;36205;USD;2016;Q4;2017-03-31;2016-05-31;;;12264000;800607000;561432000;1484207000;1790273000;187423000;2858476000;4836172000;6320379000;665939000;29590000;938598000;2963483000;3148017000;4086615000;2141884000;;;2233764000;6320379000
NGL;36205;USD;2015;Q4;2016-03-31;2016-05-31;;;28176000;521014000;367806000;1028480000;1649572000;219550000;2662553000;4531675000;5560155000;427499000;7907000;706017000;2912837000;3160073000;3866090000;1656515000;;;1694065000;5560155000
NGL;36205;USD;2014;Q4;2015-03-31;2015-06-01;;;41303000;1025763000;442025000;1647496000;1624016000;472673000;2911607000;5008296000;6655792000;858812000;4472000;1119867000;2727464000;2842493000;3962360000;2146551000;;;2693432000;6655792000
NGL;36205;USD;2013;Q4;2014-03-31;2014-05-30;;;10440000;877904000;310160000;1286299000;835848000;194821000;1830663000;2861332000;4147631000;796149000;7080000;974884000;1629834000;1640894000;2615778000;1526815000;;;1531853000;4147631000
NGL;36205;USD;2012;Q4;2013-03-31;2013-06-14;;;11561000;562757000;126895000;761987000;526437000;;1003194000;1529631000;2291618000;542955000;8626000;659559000;740436000;742641000;1402200000;883654000;;;889418000;2291618000
NGL;36205;USD;2011;Q4;2012-03-31;2012-06-15;;;7832000;84004000;94504000;198624000;231394000;;319501000;550895000;749519000;90831000;19534000;144801000;199177000;199389000;344190000;404870000;;;405329000;749519000
NGL;36205;USD;2017;Q4;2018-03-31;2018-05-30;;;22094000;1026764000;551303000;2251279000;1518607000;17236000;2364000000;3899843000;6151122000;854093000;646000;1086617000;2679740000;2895834000;3982451000;1801676000;;;2168671000;6151122000
EGHT;36662;USD;2017;Q4;2018-03-31;2018-05-30;92707000;92707000;152262000;16296000;;178598000;35732000;;62879000;98611000;277209000;53704000;;56263000;;2172000;58435000;425883000;;-201464000;218774000;277209000
EGHT;36662;USD;2016;Q4;2017-03-31;2017-05-30;91165000;87705000;174989000;14264000;;197354000;24061000;;112440000;136501000;333855000;41200000;;43344000;;1910000;45254000;412853000;;-114610000;288601000;333855000
EGHT;36662;USD;2015;Q4;2016-03-31;2016-05-31;88829000;88829000;162850000;11070000;520000;180518000;12375000;;120559000;132934000;313452000;32809000;;34734000;;3412000;38146000;389349000;;-109859000;275306000;313452000
EGHT;36662;USD;2014;Q4;2015-03-31;2015-05-29;89025000;91574000;177094000;6642000;704000;187142000;10248000;;98234000;108482000;295624000;20062000;;21830000;;1583000;23413000;379059000;;-104739000;272211000;295624000
EGHT;36662;USD;2013;Q4;2014-03-31;2014-05-27;88018000;91462000;106340000;5503000;811000;114868000;7711000;72021000;104603000;184335000;299203000;16264000;;18121000;;2904000;21025000;384413000;;-106665000;278178000;299203000
EGHT;36662;USD;2012;Q4;2013-03-31;2013-05-28;71971000;75144000;52269000;3880000;511000;57574000;6673000;0;88364000;95037000;152611000;12499000;;13735000;;1843000;15578000;246248000;;-109179000;137033000;152611000
EGHT;36662;USD;2011;Q4;2012-03-31;2012-05-24;70233000;73815000;24368000;2279000;581000;28156000;3820000;;98757000;102577000;130733000;11324000;;12215000;;68000;12283000;241626000;;-123118000;118450000;130733000
EGHT;36662;USD;2010;Q4;2011-03-31;2011-07-22;62246000;67167000;18401000;863000;2105000;22076000;2398000;;2110000;4508000;26584000;9849000;;10684000;;39000;10723000;208280000;;-192346000;15861000;26584000
EGHT;36662;USD;2018;Q4;2019-03-31;2019-05-21;95867000;95867000;346482000;20181000;;397391000;52835000;0;96132000;148967000;546358000;71369000;;74705000;216035000;222263000;296968000;507045000;;-250302000;249390000;546358000
CBRL;37621;USD;2016;Q4;2016-07-31;2016-09-26;23944610;24103220;150966000;19389000;152308000;355740000;1080189000;;61735000;1141924000;1497664000;288875000;;368817000;400000000;602404000;971221000;51702000;;488481000;526443000;1497664000
CBRL;37621;USD;2015;Q4;2015-07-31;2015-09-29;23958636;24095808;265455000;18050000;153058000;456824000;1052636000;;66748000;1119384000;1576208000;366112000;;445611000;400000000;592329000;1037940000;56306000;;485687000;538268000;1576208000
CBRL;37621;USD;2014;Q4;2014-07-31;2014-09-25;23820550;23989887;119361000;22704000;165426000;329649000;1043284000;;59315000;1102599000;1432248000;245559000;25000000;344438000;375000000;559169000;903607000;40207000;;493167000;528641000;1432248000
CBRL;37621;USD;2013;Q4;2013-07-31;2013-09-26;23786102;24053602;121718000;15942000;146687000;302194000;1026369000;;59743000;1086112000;1388306000;250817000;0;316067000;400000000;588213000;904280000;51965000;;438673000;484026000;1388306000
CBRL;37621;USD;2012;Q4;2012-07-31;2012-09-25;23298598;23644779;151962000;14609000;143267000;337308000;1022370000;;59314000;1081684000;1418992000;244176000;;319059000;525036000;717258000;1036317000;28910000;;374923000;382675000;1418992000
CBRL;37621;USD;2011;Q4;2011-07-31;2011-09-27;22874635;23423234;52274000;12279000;141547000;245915000;1009164000;;55805000;1064969000;1310884000;210455000;;267103000;550143000;775747000;1042850000;7309000;;298757000;268034000;1310884000
CBRL;37621;USD;2010;Q4;2010-07-31;2010-12-06;23239226;23982346;47700000;13530000;144079000;236259000;1004103000;;51705000;1055808000;1292067000;258175000;6765000;309548000;573744000;790902000;1100450000;6428000;;234038000;191617000;1292067000
CBRL;37621;USD;2017;Q4;2017-07-31;2017-09-22;24042716;24143936;161001000;18116000;156367000;358857000;1098097000;;64988000;1163085000;1521942000;118395000;;375828000;400000000;601607000;977435000;55900000;;492836000;544507000;1521942000
CBRL;37621;USD;2018;Q4;2018-07-31;2018-09-28;24004338;24074953;114656000;19496000;156253000;306752000;1149135000;;71468000;1220603000;1527355000;276496000;;364619000;400000000;580955000;945574000;44289000;;532807000;581781000;1527355000
JOY;39382;USD;2016;Q4;2016-10-31;2016-12-16;98228000;97164000;276709000;683958000;814821000;1892625000;656245000;;874430000;1530675000;3423300000;466165000;41611000;772121000;962291000;1269473000;2041594000;;;;1381706000;3423300000
JOY;39382;USD;2015;Q4;2015-10-31;2015-12-21;97529000;95829000;102885000;812073000;1007925000;2068442000;792032000;;851972000;1644004000;3712446000;553212000;26321000;899338000;1060643000;1393099000;2292437000;1362352000;-1650065000;1854794000;1420009000;3712446000
JOY;39382;USD;2014;Q4;2014-10-31;2014-12-19;98354000;99148000;270191000;1059709000;1101955000;2612006000;892440000;;2087903000;2980343000;5592349000;728817000;11739000;1163406000;1269541000;1592583000;2755989000;1330817000;-1600065000;3111888000;2836360000;5592349000
JOY;39382;USD;2013;Q4;2013-10-31;2013-12-13;105147000;106022000;405709000;1083663000;1139744000;2822444000;912642000;;2054496000;2967138000;5789582000;759914000;58669000;1348906000;1256927000;1582307000;2931213000;1306273000;-1330729000;3390459000;2858369000;5789582000
JOY;39382;USD;2012;Q4;2012-10-31;2012-12-18;106067000;106955000;263873000;1229083000;1415455000;3156077000;832862000;;2153564000;2986426000;6142503000;875695000;65316000;1767670000;1306625000;1797644000;3565314000;1270480000;-1116623000;2931981000;2577189000;6142503000
JOY;39382;USD;2011;Q4;2011-10-31;2011-12-22;105254000;106724000;288321000;884696000;1334134000;3564007000;539571000;380114000;942662000;1862347000;5426354000;741844000;35895000;1697244000;1356412000;1777315000;3474559000;1219761000;-1116623000;2244740000;1951795000;5426354000
JOY;39382;USD;2010;Q4;2010-10-31;2010-12-20;103532000;105423000;815581000;674135000;764945000;2361927000;378024000;0;531062000;909086000;3271013000;517342000;1550000;1023324000;396326000;905323000;1928647000;1129572000;-1116623000;1709059000;1342366000;3271013000
JOY;39382;USD;2009;Q4;2009-10-31;2009-12-22;-306890200;-308570584;471685000;580629000;769783000;1950027000;347058000;;711194000;1058252000;3008279000;469215000;19791000;926784000;523890000;1267756000;2194540000;1069332000;-1116623000;1333254000;813739000;3008279000
JOY;39382;USD;2008;Q4;2008-10-31;2009-09-09;105309000;106010000;201575000;632194000;805244000;1738129000;289001000;;617183000;906184000;2644313000;512209000;26460000;1140351000;540967000;971488000;2111839000;1030614000;-1102917000;950697000;532474000;2644313000
BOOT;39510;USD;2017;Q4;2018-03-31;2017-06-07;26181000;26594000;9016000;4389000;211472000;241127000;89208000;;257606000;346814000;587941000;129992000;;150998000;190503000;222337000;373335000;148130000;-194000;66670000;214606000;587941000
BOOT;39510;USD;2016;Q4;2017-03-31;2016-06-03;26330000;27817000;8035000;4354000;189096000;224303000;82711000;;258567000;341278000;565581000;113465000;1062000;147801000;199342000;237871000;385672000;142187000;-69000;37791000;179909000;565581000
BOOT;39510;USD;2015;Q4;2016-03-31;2015-05-29;25722000;27295000;1448000;3863000;129312000;145279000;30054000;;150795000;180849000;326128000;68697000;1596000;86493000;72045000;97213000;183706000;128696000;;13726000;142422000;326128000
BOOT;39510;USD;2014;Q4;2015-03-31;2014-12-09;18929000;18881000;1118000;2191000;102702000;114696000;21450000;;155717000;177167000;291863000;56792000;1000000;86416000;98500000;120872000;207288000;78836000;;1652000;84575000;291863000
BOOT;39510;USD;2018;Q4;2019-03-31;2019-05-24;28325000;28949000;16614000;8095000;240734000;277343000;98663000;;260069000;358732000;636075000;151943000;;151943000;181010000;219968000;371911000;159140000;-668000;105692000;264164000;636075000
SHOS;39593;USD;2016;Q4;2017-02-28;2016-04-01;22666000;22666000;18244000;11753000;434846000;487019000;49315000;;97499000;146814000;633833000;39762000;68300000;228654000;;2670000;231324000;;;;402509000;633833000
SHOS;39593;USD;2015;Q4;2016-02-29;2016-04-01;22666000;22666000;19746000;15456000;442743000;497295000;50708000;;97719000;148427000;645722000;14888000;84100000;221162000;;2274000;223436000;548115000;;-125829000;422286000;645722000
SHOS;39593;USD;2014;Q4;2015-02-28;2014-04-04;22737000;22751000;23475000;19252000;482107000;538050000;48973000;;260162000;309135000;847185000;24129000;99762000;252606000;95000;4354000;256960000;547249000;;42976000;590225000;847185000
SHOS;39593;USD;2013;Q4;2014-02-28;2013-04-02;23100000;23100000;20068000;10986000;428437000;473812000;53383000;;258608000;311991000;785803000;31830000;21463000;215995000;769000;3521000;219516000;556806000;;9481000;566287000;785803000
SHOS;39593;USD;2012;Q4;2013-02-28;2012-10-09;23100000;23100000;694000;9006000;393658000;405521000;59996000;;186321000;246317000;651838000;30889000;2061000;108185000;1937000;543653000;651838000;0;;0;0;651838000
SHOS;39593;USD;2017;Q4;2018-02-28;2018-04-19;22744000;22741000;10402000;14672000;336294000;368499000;36049000;;8140000;44189000;412688000;15741000;137900000;234865000;0;2284000;237149000;;;;175539000;412688000
SHOS;39593;USD;2018;Q4;2019-02-28;2019-05-03;22702000;22702000;12801000;10275000;179047000;328661000;13291000;;1819000;15110000;343771000;15160000;132057000;147217000;0;76598000;223815000;;;;119956000;343771000
PLAB;39856;USD;2017;Q4;2017-10-31;2017-12-20;68617000;69218000;308021000;105320000;23703000;449124000;535197000;;36473000;571670000;1020794000;77137000;4639000;81776000;57337000;73723000;155499000;548283000;;189390000;865295000;1020794000
PLAB;39856;USD;2016;Q4;2016-10-31;2017-01-06;68024000;74447000;314074000;92636000;22081000;441586000;506434000;;39968000;546402000;987988000;75889000;5428000;81317000;61860000;81197000;162514000;541774000;;176260000;825474000;987988000
PLAB;39856;USD;2015;Q4;2015-10-31;2016-01-07;66574000;89715000;205867000;110056000;24157000;360760000;547284000;;135332000;682616000;1043376000;127197000;65495000;192692000;67120000;88618000;281310000;527068000;;130060000;762066000;1043376000
PLAB;39856;USD;2014;Q4;2014-10-31;2015-01-06;63108000;64443000;192929000;94515000;22478000;336492000;550069000;;142622000;692691000;1029183000;128736000;10381000;139117000;131805000;150572000;289689000;520841000;;85435000;739494000;1029183000
PLAB;39856;USD;2013;Q4;2013-10-31;2014-01-03;61060000;57623000;215615000;73357000;18849000;318466000;422740000;;144723000;567463000;885929000;92769000;11818000;104587000;182203000;193511000;298098000;499472000;;59439000;587831000;885929000
PLAB;39856;USD;2012;Q4;2012-10-31;2013-01-09;60196000;91900000;218043000;75685000;17702000;319794000;380808000;;148632000;529440000;849234000;77732000;7781000;85513000;168956000;177720000;263233000;494013000;;41473000;586001000;849234000
PLAB;39856;USD;2011;Q4;2011-10-31;2012-01-13;59631000;34992000;189928000;85540000;22100000;305207000;368680000;;143967000;512647000;817854000;90318000;5583000;95901000;152577000;162197000;258098000;487271000;;13605000;559756000;817854000
PLAB;39856;USD;2010;Q4;2010-10-31;2011-09-07;53709000;66145000;98945000;82951000;15502000;205802000;369814000;;128263000;498077000;703879000;107762000;11467000;119229000;78852000;88707000;207936000;437363000;;-2624000;495943000;703879000
PLAB;39856;USD;2018;Q4;2018-10-31;2018-12-21;67894000;79464000;329277000;120515000;29180000;502731000;571781000;;35497000;607278000;1110009000;133623000;57453000;191076000;0;14364000;205440000;556303000;-23111000;231445000;904569000;1110009000
JVA;40037;USD;2017;Q4;2017-10-31;2018-01-29;5848161;5848161;2325650;13441802;16310572;33316013;2439338;94643;4150416;6684397;40000410;4431972;0;13050361;;1358588;14408949;16110569;-3504510;12345490;25591461;40000410
JVA;40037;USD;2016;Q4;2016-10-31;2017-01-27;5978924;5978924;3227981;13517892;14276290;32691440;2269863;95598;1966992;4332453;37023893;4063623;;11021998;;888354;11910352;16110569;-3249590;11878228;25113541;37023893
JVA;40037;USD;2015;Q4;2015-10-31;2016-01-26;6204034;6204034;3853816;10968237;13862818;31993822;1845000;96571;1339249;3280820;35274642;4021389;;10059345;;796924;10856269;15910565;-1494712;9665940;24418373;35274642
JVA;40037;USD;2014;Q4;2014-10-31;2015-01-23;6243743;5442743;3782639;15419860;15210153;35484335;1991094;97404;1379799;3468297;38952632;9024151;;12007533;;890346;12897879;15910565;-1267862;11079168;26054753;38952632
JVA;40037;USD;2013;Q4;2013-10-31;2014-01-24;6372309;6105309;4035669;12362792;9373018;28878246;2060350;98178;1362248;3520776;32399022;7244822;;9458044;;856616;10314660;15910565;-272133;6111633;22084362;32399022
JVA;40037;USD;2012;Q4;2012-10-31;2013-01-28;6372309;6901309;7568583;12633128;11303581;33124723;1791754;1931931;1399344;5123029;38247752;11790229;;13720118;;728010;14448128;15910565;-272133;7979247;23799624;38247752
JVA;40037;USD;2011;Q4;2011-10-31;2012-01-30;5782739;6840739;4244335;16021581;13475855;35680576;1661759;0;1436356;3098115;38778691;12379514;;16067181;;741028;16808209;15891065;-272133;6268326;21970482;38778691
JVA;40037;USD;2010;Q4;2010-10-31;2011-09-13;5491122;5479530;1672921;8852372;8190420;20894920;1560940;;1465279;3026219;23921139;7358816;;9665565;;763057;10428622;7587553;-295261;6151054;13492517;23921139
JVA;40037;USD;2018;Q4;2018-10-31;2019-01-29;5603344;5603344;4611384;9914297;15271106;30758854;2350208;89776;5635239;8075223;38834077;4835053;70255;11187368;;1656891;12844259;16110569;-4633560;13404767;25989818;38834077
PSTG;40474;USD;2016;Q4;2017-01-31;2017-03-29;201036000;201036000;546661000;168978000;23498000;780081000;81695000;;37969000;119664000;899745000;113668000;;273125000;;148190000;421315000;1281472000;;-802480000;478430000;899745000
PSTG;40474;USD;2015;Q4;2016-01-31;2016-03-25;188982000;188982000;604742000;126324000;20649000;788070000;52629000;;30084000;82713000;870783000;85258000;;184532000;;122897000;307429000;1118689000;;-555335000;563354000;870783000
PSTG;40474;USD;2014;Q4;2015-01-31;2015-12-11;31393000;31393000;192707000;59032000;21605000;293970000;39859000;;22461000;62320000;356290000;30924000;;69608000;;42572000;112180000;41753000;;-341583000;244110000;356290000
PSTG;40474;USD;2017;Q4;2018-01-31;2018-03-26;218186000;218186000;597346000;243001000;34497000;943484000;89142000;;91369000;180511000;1123995000;171147000;;362696000;0;186898000;549594000;1479905000;;-903587000;574401000;1123995000
PSTG;40474;USD;2018;Q4;2019-01-31;2019-03-26;239836000;239836000;1197472000;378729000;44687000;1701827000;125353000;;145845000;271198000;1973025000;243232000;;509816000;449828000;725429000;1235245000;1820067000;;-1081949000;737780000;1973025000
EXAS;41775;USD;2017;Q4;2017-12-31;2018-02-22;120092000;120092000;424715000;26419000;26027000;487216000;79986000;;31358000;111344000;598560000;65261000;182000;68124000;4269000;10018000;78142000;1381782000;;-860614000;520418000;598560000
EXAS;41775;USD;2016;Q4;2016-12-31;2017-02-21;109385000;109385000;311100000;8526000;6833000;333573000;38142000;;5325000;43467000;377040000;28816000;174000;30692000;4633000;11053000;41745000;1081534000;;-745821000;335295000;377040000
EXAS;41775;USD;2015;Q4;2015-12-31;2016-02-24;96515000;96515000;306879000;4933000;6677000;325864000;34096000;;4070000;38166000;364030000;25561000;166000;26723000;4789000;10451000;37174000;905899000;;-578610000;326856000;364030000
EXAS;41775;USD;2014;Q4;2014-12-31;2015-02-27;84952000;84952000;282756000;1376000;4017000;291677000;19947000;;1200000;21147000;312824000;16607000;360000;17521000;1000000;6319000;23840000;709906000;;-420807000;288984000;312824000
EXAS;41775;USD;2013;Q4;2013-12-31;2014-02-28;70878000;70878000;133259000;;;135458000;11169000;;;11169000;146627000;6567000;351000;7752000;1000000;3559000;11311000;455950000;;-320759000;135316000;146627000
EXAS;41775;USD;2012;Q4;2012-12-31;2013-03-01;63638000;63638000;108121000;;;108714000;3405000;;;3405000;112119000;6979000;333000;11455000;1000000;2069000;13524000;372762000;;-274245000;98595000;112119000
EXAS;41775;USD;2011;Q4;2011-12-31;2012-03-09;53665000;53665000;93361000;;;94395000;2558000;;;2558000;96953000;3834000;;7977000;1000000;5481000;13458000;305333000;;-221824000;83495000;96953000
EXAS;41775;USD;2010;Q4;2010-12-31;2011-08-05;46941000;46941000;95415000;;;95661000;854000;;;854000;96515000;3015000;;7158000;1000000;9603000;16761000;272902000;;-193149000;79754000;96515000
EXAS;41775;USD;2018;Q4;2018-12-31;2018-04-26;123012000;123012000;1124182000;44239000;39148000;1228067000;245259000;;50696000;295955000;1524022000;133378000;8000;136590000;688822000;706491000;843081000;1718126000;;-1035763000;680941000;1524022000
AXON;41996;USD;2017;Q4;2018-03-31;2018-06-11;107789711;107789711;154337000;;;158262000;2524000;;0;2524000;160786000;35811000;9753000;46575000;42925000;42925000;89500000;628111000;;-556951000;71286000;160786000
AXON;41996;USD;2016;Q4;2017-03-31;2017-06-13;99162632;99162632;212573000;;;219688000;142000;;2709000;2851000;222539000;43347000;0;46266000;51436000;51436000;97702000;459602000;;-335143000;124837000;222539000
AXON;41996;USD;2015;Q4;2016-03-31;2016-06-06;99252964;99252964;276251000;;;282086000;89000;;323000;412000;282498000;8941000;;15755000;0;0;15755000;420935000;;-154192000;266743000;282498000
AXON;41996;USD;2018;Q4;2019-03-31;2019-06-11;-293022531;-293022531;106999000;;;114584000;1278000;5871000;973000;8122000;122706000;22317000;21182000;43499000;22994000;22994000;66493000;741318000;;-686016000;56213000;122706000
SSI;42463;USD;2016;Q4;2017-02-28;2017-04-04;27162000;27098000;13803000;;409384000;464761000;284110000;;38118000;322228000;786989000;168670000;;168670000;163749000;238159000;406829000;410827000;-43286000;18267000;380160000;786989000
SSI;42463;USD;2015;Q4;2016-02-29;2016-03-30;28831000;28972000;16487000;;435996000;500762000;311717000;;35620000;347337000;848099000;153035000;2847000;155882000;162876000;262464000;418346000;406354000;-43068000;72820000;429753000;848099000
SSI;42463;USD;2014;Q4;2015-02-28;2015-04-01;31657000;31941000;17165000;;441452000;504061000;285450000;;35166000;320616000;824677000;203067000;1715000;204782000;45673000;143965000;348747000;395711000;-600000;87693000;475930000;824677000
SSI;42463;USD;2013;Q4;2014-02-28;2014-04-02;31214000;32011000;14762000;;434407000;489251000;282534000;;39052000;321586000;810837000;192902000;2354000;195256000;60871000;161137000;356393000;384607000;-967000;75420000;454444000;810837000
SSI;42463;USD;2012;Q4;2013-02-28;2013-04-03;32008000;33081000;17937000;;413928000;467332000;290701000;;36838000;327539000;794871000;207328000;744000;208072000;11585000;121929000;330001000;376935000;-701000;94771000;464870000;794871000
SSI;42463;USD;2011;Q4;2012-02-29;2012-03-28;30430000;31059000;18621000;;347944000;399999000;300717000;;34623000;335340000;735339000;172517000;13782000;186299000;35721000;136334000;322633000;349670000;-835000;68619000;412706000;735339000
SSI;42463;USD;2010;Q4;2011-02-28;2011-09-07;36630000;37086000;89349000;;325501000;445273000;317954000;;32857000;350811000;796084000;169683000;13490000;183173000;25002000;123402000;306575000;516648000;-320055000;295851000;489509000;796084000
SSI;42463;USD;2017;Q4;2018-02-28;2018-04-10;27635000;27635000;21250000;;439735000;512034000;252788000;;41584000;294372000;806406000;210433000;2985000;213418000;180350000;248874000;462292000;418986000;-43298000;-26397000;344114000;806406000
SSI;42463;USD;2018;Q4;2019-02-28;2019-04-05;28290000;28290000;15830000;;424555000;492903000;224803000;;26455000;251258000;744161000;172540000;4812000;177352000;250294000;312284000;489636000;423870000;-43579000;-119909000;254525000;744161000
CST;42704;USD;2016;Q4;2016-12-31;2017-02-28;75702000;76357000;137000000;195000000;250000000;627000000;2642000000;;1091000000;3733000000;4360000000;537000000;78000000;615000000;1427000000;1966000000;2581000000;630000000;-89000000;713000000;1779000000;4360000000
CST;42704;USD;2015;Q4;2015-12-31;2016-02-19;75454000;75804000;314000000;135000000;224000000;720000000;2224000000;;896000000;3120000000;3840000000;482000000;139000000;621000000;1290000000;1674000000;2295000000;628000000;-87000000;399000000;1545000000;3840000000
CST;42704;USD;2014;Q4;2014-12-31;2015-02-27;77374000;77639000;368000000;173000000;221000000;786000000;1957000000;;863000000;2820000000;3606000000;473000000;77000000;550000000;1204000000;1501000000;2051000000;487000000;-22000000;269000000;1553000000;3604000000
CST;42704;USD;2013;Q4;2013-12-31;2014-03-06;75397000;75464000;378000000;153000000;217000000;766000000;1326000000;;211000000;1537000000;2303000000;427000000;36000000;463000000;1006000000;1213000000;1676000000;405000000;0;87000000;625000000;2301000000
CST;42704;USD;2012;Q4;2012-12-31;2013-05-22;75397000;75397000;61000000;134000000;200000000;407000000;1276000000;;49000000;1325000000;1732000000;227000000;1000000;228000000;4000000;234000000;462000000;0;;0;1270000000;1732000000
TESS;42813;USD;2017;Q4;2018-03-31;2017-08-03;8391047;8634371;8540100;64778900;63984300;141167400;13830900;;18982200;32813100;173980500;63946400;26500;63972900;29800;1991300;65964200;59104400;-57437600;106349500;108016300;173980500
TESS;42813;USD;2016;Q4;2017-03-31;2017-06-07;8329224;8385168;8540100;64778900;63984300;141167400;18089100;;14724000;32813100;173980500;63946400;26500;63972900;29800;1991300;65964200;59104400;-57437600;106349500;108016300;173980500
TESS;42813;USD;2015;Q4;2016-03-31;2016-06-06;8197000;8059000;16882800;58315700;53903900;135019500;19895400;;14501100;34396500;169416000;52244800;251100;52495900;1706500;4392800;56888700;58211400;-57245200;111561100;112527300;169416000
TESS;42813;USD;2014;Q4;2015-03-31;2015-06-02;7954000;7998000;7524000;59572100;72363600;150328600;21111800;;14800200;35912000;186240600;67857000;250700;68107700;1957500;4990800;73098500;56613700;-56307900;112836300;113142100;186240600
TESS;42813;USD;2013;Q4;2014-03-31;2014-05-29;8160000;8373000;11467900;67495700;61955700;150168900;22765400;;14026000;36791400;186960300;61828300;250200;62078500;2208200;10053700;72132200;54081900;-50084600;110830800;114828100;186960300
TESS;42813;USD;2012;Q4;2013-03-31;2012-06-01;7967000;8178000;4468000;82177600;60913600;157268800;23202000;;13829200;37031200;194300000;80467400;249700;80717100;2458300;10780300;91497400;50573100;-48438300;100667800;102802600;194300000
TESS;42813;USD;2011;Q4;2012-03-31;2011-08-05;7680000;8131000;18211600;88748200;53360300;165763400;22905700;;13828600;36734300;202497700;99734400;249200;99983600;2708000;8862200;108845800;45223900;-46276400;94704400;93651900;202497700
TESS;42813;USD;2010;Q4;2011-03-31;2011-08-05;;;8178200;65708700;45709800;126270100;21148100;;13742400;34890500;161160600;74073200;359100;74432300;2959100;7848200;82280500;40752200;-44388400;82540900;78880100;161160600
TESS;42813;USD;2018;Q4;2019-03-31;2019-06-11;8459926;8587513;30300;93966200;71845400;171404700;15003500;;20087600;35091100;206495800;82390600;;96768700;;939900;97708600;62766200;-57614100;103635100;108787200;206495800
COVS;43077;USD;2016;Q4;2017-03-31;2016-06-06;;40436000;39681000;12836000;;56287000;7847000;;37911000;45758000;102045000;8509000;;24461000;;6275000;30736000;161997000;;-90527000;71309000;102045000
THO;43246;USD;2016;Q4;2016-07-31;2016-09-26;52475609;52653709;209902000;392539000;403869000;1016858000;344267000;;964339000;1308606000;2325464000;289305000;;651652000;369975000;408590000;1060242000;230740000;-331499000;1365981000;1265222000;2325464000
THO;43246;USD;2015;Q4;2015-07-31;2015-09-21;52570141;52714563;183478000;269694000;246115000;775841000;234045000;;493362000;727407000;1503248000;173587000;;378335000;11945000;59726000;438061000;221770000;-329015000;1172432000;1065187000;1503248000
THO;43246;USD;2014;Q4;2014-07-31;2014-09-25;53295810;53408893;289336000;279793000;216354000;844049000;169862000;;394807000;564669000;1408718000;183087000;;370715000;23689000;60306000;431021000;214722000;-267453000;1030428000;977697000;1408718000
THO;43246;USD;2013;Q4;2013-07-31;2013-09-26;53068454;53195746;236601000;246379000;153036000;830704000;143809000;;353755000;497564000;1328268000;156390000;;361672000;41219000;73982000;435654000;205043000;-266147000;953740000;892614000;1328268000
THO;43246;USD;2012;Q4;2012-07-31;2012-09-26;52923434;52989281;218642000;232085000;186083000;684886000;164394000;;393774000;558168000;1243054000;159268000;;311090000;44516000;81137000;392227000;198426000;-266104000;918565000;850827000;1243054000
THO;43246;USD;2011;Q4;2011-07-31;2011-09-28;55821822;55914582;215435000;169493000;184498000;623767000;168214000;;406089000;574303000;1198070000;133531000;;278598000;43024000;83198000;361796000;196297000;-189104000;829148000;836274000;1198070000
THO;43246;USD;2010;Q4;2010-07-31;2010-11-30;51512307;51612706;247751000;165399000;142680000;601770000;139180000;5327000;217796000;362303000;964073000;137032000;;256764000;35686000;50031000;306795000;101502000;-189104000;745204000;657278000;964073000
THO;43246;USD;2017;Q4;2017-07-31;2017-09-27;52582658;52813761;223258000;484844000;460488000;1180167000;425238000;;952526000;1377764000;2557931000;379812000;;781046000;155263000;200345000;981391000;241785000;-336071000;1670826000;1576540000;2557931000
THO;43246;USD;2018;Q4;2018-07-31;2018-09-20;52694673;52880396;275249000;487235000;537909000;1311674000;522054000;48463000;896474000;1466991000;2778665000;306319000;;769330000;12446000;71594000;840924000;258481000;-343728000;2022988000;1937741000;2778665000
THO;43246;USD;2019;Q4;2019-07-31;2019-09-30;55025718;55173387;425615000;542822000;827988000;2037357000;1092471000;46181000;2484437000;3623089000;5660446000;613314000;61464000;1448325000;1896052000;2116893000;3565218000;422901000;-348146000;2066674000;2095228000;5660446000
MLAB;43619;USD;2016;Q4;2017-03-31;2016-06-06;3633000;3845000;5820000;14319000;13873000;35785000;26002000;;109946000;135948000;171733000;10031000;1125000;16567000;53675000;57345000;73912000;25925000;;73656000;97821000;171733000
MLAB;43619;USD;2015;Q4;2016-03-31;2016-06-06;3543000;3650000;5695000;15313000;14017000;37186000;16628000;;106934000;123562000;160748000;13188000;3000000;23971000;42250000;52099000;76070000;21001000;;64828000;84678000;160748000
MLAB;43619;USD;2014;Q4;2015-03-31;2015-06-03;3540000;3662000;2034000;12145000;12420000;29622000;9598000;;78100000;87698000;117320000;9123000;3000000;14657000;23250000;29184000;43841000;17751000;;55962000;73479000;117320000
MLAB;43619;USD;2013;Q4;2014-03-31;2014-06-04;3382000;3751000;5575000;9278000;7771000;26566000;7680000;;63283000;70963000;97529000;8329000;0;10215000;16500000;22981000;33196000;15772000;;48561000;64333000;97529000
MLAB;43619;USD;2012;Q4;2013-03-31;2013-06-06;3298000;3483000;4006000;8474000;5576000;19455000;7406000;;39058000;46464000;65919000;4662000;;4662000;4000000;8504000;13166000;11203000;;41550000;52753000;65919000
MLAB;43619;USD;2011;Q4;2012-03-31;2012-06-29;3247000;3342000;7191000;6486000;4438000;19161000;7266000;;24269000;31535000;50696000;4262000;;4262000;;2519000;6781000;8170000;;35745000;43915000;50696000
MLAB;43619;USD;2010;Q4;2011-03-31;2011-08-15;3247000;3342000;3546000;7017000;5714000;17318000;7308000;;25934000;33242000;50560000;4331000;5600000;9931000;1500000;4212000;14143000;5068000;;31349000;36417000;50560000
MLAB;43619;USD;2017;Q4;2018-03-31;2018-06-05;3799000;3441000;5469000;14302000;9228000;32115000;23593000;;108393000;131986000;164101000;11035000;1625000;17290000;44635000;47450000;64740000;30516000;;68281000;99361000;164101000
MLAB;43619;USD;2018;Q4;2019-03-31;2019-06-03;3835000;4035000;10185000;12516000;6772000;33623000;22225000;;100919000;123144000;156767000;10222000;2125000;16357000;20613000;29099000;45456000;39823000;;73303000;111311000;156767000
VRNT;44422;USD;2016;Q4;2017-01-31;2016-03-30;62272000;66132000;408087000;256419000;18312000;754112000;68904000;;1532719000;1601623000;2355735000;274518000;;442430000;735983000;845141000;1287571000;1388018000;-10251000;-201436000;1068164000;2355735000
VRNT;44422;USD;2015;Q4;2016-01-31;2015-03-27;60845000;63828000;320823000;262092000;17505000;710192000;62490000;;1567770000;1630260000;2340452000;294498000;23000;477888000;726235000;857661000;1335549000;1321516000;-10251000;-219074000;1004903000;2340452000
VRNT;44422;USD;2014;Q4;2015-01-31;2014-03-31;53547000;55959000;410667000;194312000;10693000;694391000;40145000;;1038371000;1078516000;1772907000;244330000;6555000;413483000;635830000;726306000;1139789000;924717000;-8013000;-250005000;633118000;1772907000
VRNT;44422;USD;2013;Q4;2014-01-31;2013-03-28;40478000;41365000;223566000;168415000;15014000;501653000;38161000;;1024455000;1062616000;1564269000;224327000;5867000;394210000;570822000;654841000;1049051000;580802000;-8013000;-303762000;515218000;1564269000
VRNT;44422;USD;2012;Q4;2013-01-31;2012-04-02;38920000;41964000;150662000;154753000;14414000;400690000;28289000;;1070616000;1098905000;1499595000;217332000;6228000;383148000;591151000;686610000;1069758000;554391000;-7466000;-357764000;429837000;1499595000
VRNT;44422;USD;2011;Q4;2012-01-31;2011-09-08;36821000;39141000;169906000;150769000;16987000;401944000;23176000;;951007000;974183000;1376127000;199511000;;344202000;583234000;668696000;1012898000;519872000;-6639000;-394757000;363229000;1376127000
VRNT;44422;USD;2017;Q4;2018-01-31;2018-03-29;65427000;65427000;344508000;296324000;19871000;782192000;89089000;;1709339000;1798428000;2580620000;309404000;;505511000;768484000;942773000;1448284000;1519789000;-57425000;-238312000;1132336000;2580620000
VRNT;44422;USD;2018;Q4;2019-01-31;2019-03-28;65908000;69012000;402304000;375663000;24952000;1006346000;100134000;;1760547000;1860681000;2867027000;284445000;;661821000;777785000;944402000;1606223000;1586333000;-57598000;-134274000;1260804000;2867027000
GME;44534;USD;2017;Q4;2018-01-31;2018-04-02;101400000;101600000;864400000;182700000;1366700000;2538700000;433200000;;2069700000;2502900000;5041600000;1915600000;;1915600000;817900000;911500000;2827100000;22200000;;2180100000;2214500000;5041600000
GME;44534;USD;2018;Q4;2019-01-31;2019-04-02;102300000;102100000;1624400000;134200000;1250500000;3127700000;321300000;;595300000;916600000;4044300000;1831900000;349200000;2181100000;471600000;527000000;2708100000;27800000;;1362700000;1336200000;4044300000
PLAY;44636;USD;2017;Q4;2018-01-31;2018-04-03;40539848;41728149;18795000;;27560000;102696000;726455000;;367879000;1094334000;1197030000;192825000;15000000;207825000;351249000;567559000;775384000;320915000;-147331000;248311000;421646000;1197030000
PLAY;44636;USD;2016;Q4;2017-01-31;2017-03-28;42215286;43430581;20083000;;21860000;78050000;606865000;;367818000;974683000;1052733000;170297000;7500000;177797000;256628000;435484000;613281000;310655000;-14817000;144337000;439452000;1052733000
PLAY;44636;USD;2015;Q4;2016-01-31;2016-03-29;41546756;43113949;25495000;;19529000;110080000;523891000;;369730000;893621000;1003701000;149147000;7500000;156647000;329916000;500716000;657363000;281244000;;66064000;346338000;1003701000
PLAY;44636;USD;2014;Q4;2015-01-31;2015-04-07;39969229;46281817;70876000;;18457000;142909000;436048000;;371361000;807409000;950318000;125769000;;125769000;429020000;565852000;691621000;254087000;-1189000;6445000;258697000;950318000
PLAY;44636;USD;2013;Q4;2014-01-31;2014-12-17;33192285;35831344;38080000;;15354000;99344000;388093000;;374321000;762414000;861758000;111544000;1500000;113044000;484177000;598266000;711310000;152995000;-1189000;-1191000;150448000;861758000
PLAY;44636;USD;2018;Q4;2019-01-31;2019-04-02;38245610;39152151;21585000;;27315000;91093000;805337000;;376757000;1182094000;1273187000;229390000;15000000;244390000;378469000;640960000;885350000;331687000;-297129000;353962000;387837000;1273187000
SMRT;45048;USD;2016;Q4;2017-01-31;2016-04-11;44903000;47329000;11830000;;293608000;324024000;162954000;;29247000;192201000;516225000;177140000;10000000;187140000;180150000;252768000;439908000;43259000;;33337000;76317000;516225000
SMRT;45048;USD;2015;Q4;2016-01-31;2016-04-11;43900000;45979000;65314000;;285623000;370277000;148782000;;30768000;179550000;549827000;199137000;;199137000;;65752000;264889000;35324000;;250046000;284938000;549827000
SMRT;45048;USD;2014;Q4;2015-01-31;2014-04-15;43365000;44219000;66854000;;261517000;357171000;139673000;;27414000;167087000;524258000;196213000;;196213000;;63644000;259857000;29191000;;235471000;264401000;524258000
SMRT;45048;USD;2013;Q4;2014-01-31;2013-05-03;42690000;43277000;67233000;;243345000;333433000;131570000;;26706000;158276000;491709000;197081000;;197081000;;60594000;257675000;17929000;;216574000;234034000;491709000
SMRT;45048;USD;2012;Q4;2013-01-31;2012-04-12;86541149;87176814;94053000;;218832000;347024000;109990000;;22569000;132559000;479583000;174126000;;174126000;;55786000;229912000;15704000;;235386000;249671000;479583000
SMRT;45048;USD;2011;Q4;2012-01-31;2011-09-07;170992200;174237473;80171000;;232295000;340434000;79964000;;16046000;96010000;436444000;168132000;;168132000;;21061000;189193000;21570000;;225225000;247251000;436444000
SMRT;45048;USD;2017;Q4;2018-01-31;2016-12-01;48209000;46693000;10400000;;270237000;307257000;151128000;;24973000;176101000;483358000;197841000;13738000;211579000;142387000;223461000;435040000;56482000;;-7918000;48318000;483358000
SMRT;45048;USD;2018;Q4;2019-01-31;2019-03-28;46802000;46753000;9049000;;255884000;293259000;123838000;;24108000;147946000;441205000;167296000;;167296000;153253000;226858000;394154000;60651000;;-13853000;47051000;441205000
ZUMZ;45730;USD;2016;Q4;2017-02-28;2016-03-14;26069000;26165000;78826000;12538000;106924000;211363000;129651000;;85669000;215320000;426683000;42309000;;73597000;;46035000;119632000;140984000;;182555000;307051000;426683000
ZUMZ;45730;USD;2015;Q4;2016-02-29;2015-03-17;28990000;29735000;75554000;12840000;98299000;198897000;137233000;;78565000;215798000;414695000;38451000;;69142000;;48596000;117738000;135013000;;177191000;296957000;414695000
ZUMZ;45730;USD;2014;Q4;2015-02-28;2014-03-18;29789000;30152000;117155000;10294000;87182000;229846000;127343000;;86214000;213557000;443403000;33620000;;61374000;;46375000;107749000;114983000;;215961000;335654000;443403000
ZUMZ;45730;USD;2013;Q4;2014-02-28;2013-03-19;30310000;30815000;103172000;9467000;77598000;203314000;115474000;;90310000;205784000;409098000;34066000;;57199000;;48478000;105677000;108360000;;189051000;303421000;409098000
ZUMZ;45730;USD;2012;Q4;2013-02-28;2012-03-13;30645000;31189000;172798000;6284000;65037000;253503000;89478000;;19176000;108654000;362157000;36640000;;55576000;;34304000;89880000;99412000;;172730000;272277000;362157000
ZUMZ;45730;USD;2011;Q4;2012-02-29;2011-09-01;30160000;31088000;128801000;6129000;56303000;200861000;78248000;2766000;19756000;100770000;301631000;28059000;;45461000;;29435000;74896000;91373000;;135379000;226735000;301631000
ZUMZ;45730;USD;2017;Q4;2018-02-28;2018-03-19;24107000;24811000;121905000;17027000;125826000;279163000;128852000;;91495000;220347000;499510000;64307000;943000;99247000;;44348000;143595000;146523000;;209357000;355915000;499510000
ZUMZ;45730;USD;2018;Q4;2019-02-28;2019-03-18;24984000;25568000;165334000;17776000;129268000;327175000;120503000;;86512000;207015000;534190000;62125000;;93108000;;40626000;133734000;153066000;;256614000;400456000;534190000
A;45846;USD;2018;Q4;2018-10-31;2018-12-20;319000000;327000000;2247000000;776000000;638000000;3848000000;822000000;68000000;3803000000;4693000000;8541000000;340000000;0;1171000000;1799000000;2799000000;3970000000;5311000000;;-336000000;4571000000;8541000000
A;45846;USD;2017;Q4;2017-10-31;2017-12-21;324000000;327000000;2678000000;724000000;575000000;4169000000;757000000;138000000;3362000000;4257000000;8426000000;305000000;210000000;1263000000;1801000000;2328000000;3591000000;5303000000;;-126000000;4835000000;8426000000
A;45846;USD;2016;Q4;2016-10-31;2016-12-20;324000000;328000000;2289000000;631000000;533000000;3635000000;639000000;135000000;3385000000;4159000000;7794000000;257000000;0;945000000;1904000000;2603000000;3548000000;9165000000;-10508000000;6089000000;4246000000;7794000000
A;45846;USD;2015;Q4;2015-10-31;2015-12-21;330000000;331000000;2003000000;606000000;541000000;3686000000;604000000;86000000;3103000000;3793000000;7479000000;279000000;;976000000;1655000000;2333000000;3309000000;9051000000;-10074000000;5581000000;4170000000;7479000000
A;45846;USD;2014;Q4;2014-10-31;2014-12-22;332000000;339000000;2218000000;626000000;574000000;5509000000;631000000;96000000;4579000000;5306000000;10815000000;302000000;;1692000000;1663000000;3819000000;5511000000;8973000000;-9807000000;6469000000;5304000000;10815000000
A;45846;USD;2013;Q4;2013-10-31;2013-12-19;-77338000;-79512000;2675000000;899000000;1066000000;4983000000;1134000000;139000000;4430000000;5703000000;10686000000;432000000;;1602000000;2699000000;3795000000;5397000000;8729000000;-9607000000;6073000000;5289000000;10686000000
A;45846;USD;2012;Q4;2012-10-31;2012-12-20;-67512000;-68482000;2351000000;923000000;1014000000;4629000000;1164000000;109000000;4634000000;5907000000;10536000000;461000000;250000000;1893000000;2112000000;3458000000;5351000000;8495000000;-8707000000;5505000000;5185000000;10536000000
A;45846;USD;2011;Q4;2011-10-31;2011-12-16;483708000;493494000;3527000000;860000000;898000000;5569000000;1006000000;117000000;2365000000;3488000000;9057000000;472000000;253000000;1837000000;1932000000;2904000000;4741000000;8271000000;-8535000000;4456000000;4316000000;9057000000
A;45846;USD;2010;Q4;2010-10-31;2010-12-20;480912000;497688000;2649000000;869000000;716000000;6169000000;980000000;142000000;2405000000;3527000000;9696000000;499000000;1501000000;3083000000;2190000000;3377000000;6460000000;7910000000;-8038000000;3444000000;3236000000;9696000000
A;45846;USD;2009;Q4;2009-10-31;2009-12-21;479514000;479514000;2493000000;595000000;552000000;3961000000;845000000;163000000;2643000000;3651000000;7612000000;307000000;1000000;1123000000;2904000000;3975000000;5098000000;7558000000;-7627000000;2760000000;2514000000;7612000000
A;45846;USD;2008;Q4;2008-10-31;2009-10-05;499086000;501882000;1429000000;770000000;646000000;3182000000;824000000;206000000;2795000000;3825000000;7007000000;436000000;;1330000000;2125000000;3118000000;4448000000;7416000000;-7470000000;2791000000;2559000000;7007000000
LAYN;45965;USD;2016;Q4;2017-01-31;2016-04-13;19791000;20015000;65569000;91810000;19540000;286294000;113497000;57364000;31502000;202363000;488657000;130856000;;155014000;158986000;204937000;359951000;365817000;;-216584000;128706000;488657000
LAYN;45965;USD;2015;Q4;2016-01-31;2015-04-14;19633000;19633000;21661000;101080000;29092000;284528000;135529000;61828000;60057000;257414000;541942000;141263000;142000;179696000;128566000;180587000;360283000;370249000;;-171807000;181659000;541942000
LAYN;45965;USD;2014;Q4;2015-01-31;2014-05-01;19654000;19654000;30909000;88217000;31481000;316857000;191393000;67293000;71075000;329761000;646618000;129433000;128000;195527000;107118000;160388000;355915000;367660000;;-61656000;290703000;646618000
LAYN;45965;USD;2013;Q4;2014-01-31;2013-04-16;19508000;18879000;27242000;145890000;49913000;381823000;266540000;78290000;85573000;430403000;812226000;209086000;12789000;256744000;96539000;140411000;397155000;352246000;;66983000;415071000;812226000
LAYN;45965;USD;2012;Q4;2013-01-31;2012-04-27;19463000;18875000;41916000;162043000;35392000;392789000;277357000;88297000;47393000;413047000;805836000;213878000;7450000;256385000;52716000;97570000;353955000;351254000;;103634000;451881000;805836000
LAYN;45965;USD;2011;Q4;2012-01-31;2011-09-07;19420000;19716000;44985000;142816000;29542000;344146000;259856000;69152000;143498000;472506000;816652000;187644000;9667000;250837000;;61891000;312728000;347502000;;159709000;503924000;816652000
LAYN;45965;USD;2017;Q4;2018-01-31;2016-12-08;20078000;19896000;32041000;59558000;20020000;168521000;120604000;53325000;27739000;201668000;370189000;42330000;67293000;173230000;98769000;139406000;312636000;372248000;;-296131000;57553000;370189000
PVH;46764;USD;2016;Q4;2017-02-28;2017-03-24;78800000;79700000;730100000;616000000;1317900000;2879600000;759900000;;7428400000;8188300000;11067900000;1515000000;19100000;1564800000;3197300000;4696600000;6261400000;2950100000;-532800000;3098000000;4806500000;11067900000
PVH;46764;USD;2015;Q4;2016-02-29;2016-03-25;81900000;82400000;556400000;657200000;1322300000;2804500000;744600000;;7124700000;7869300000;10673800000;1332400000;162500000;1527200000;3031700000;4594300000;6121500000;2906000000;-210700000;2561200000;4552300000;10673800000
PVH;46764;USD;2014;Q4;2015-02-28;2015-04-01;82700000;83500000;479300000;705700000;1257300000;2785800000;725700000;;7313400000;8039100000;10824900000;1289100000;107800000;1428100000;3438700000;5032500000;6460600000;2851800000;-72300000;2001300000;4364300000;10824900000
PVH;46764;USD;2013;Q4;2014-02-28;2013-06-13;82000000;86300000;593200000;730300000;1281000000;2998600000;712100000;;7864900000;8577000000;11575600000;1427100000;91800000;1552400000;3878200000;5682400000;7234800000;2779300000;-61200000;1574800000;4340800000;11575600000
PVH;46764;USD;2012;Q4;2013-02-28;2013-04-03;72072000;74410000;892209000;418251000;878415000;2437006000;561335000;;4733346000;5294681000;7731687000;1023361000;98847000;1162447000;2211642000;3316671000;4479118000;1697017000;-30003000;1445673000;3252569000;7731687000
PVH;46764;USD;2011;Q4;2012-02-29;2012-03-28;67480000;73268000;233197000;467628000;809009000;1739235000;458891000;;4554235000;5013126000;6752361000;922504000;82991000;1043871000;1832925000;2993041000;4036912000;1446220000;-16019000;1022818000;2715449000;6752361000
PVH;46764;USD;2010;Q4;2011-02-28;2011-03-30;66683000;80686000;498718000;433900000;710868000;1835289000;404577000;;4544484000;4949061000;6784350000;875152000;4868000;931255000;2364002000;3410551000;4341806000;1368882000;-10749000;840072000;2442544000;6784350000
PVH;46764;USD;2009;Q4;2010-02-28;2010-10-06;;;480882000;188844000;263788000;994883000;167474000;;1177322000;1344796000;2339679000;323907000;0;362881000;399584000;808245000;1171126000;653483000;-200764000;796282000;1168553000;2339679000
PVH;46764;USD;2017;Q4;2018-02-28;2018-03-30;77100000;78200000;493900000;658500000;1591300000;3030800000;899800000;;7955100000;8854900000;11885700000;1812900000;19500000;1871600000;3061300000;4475700000;6347300000;3026100000;-793400000;3625200000;5538400000;11885700000
PVH;46764;USD;2018;Q4;2019-02-28;2019-03-29;75500000;76000000;452000000;777800000;1732400000;3238600000;984500000;;7640600000;8625100000;11863700000;1815800000;12800000;1893900000;2819400000;4141800000;6035700000;3102700000;-1117100000;4350100000;5828000000;11863700000
URBN;46954;USD;2016;Q4;2017-01-31;2016-03-31;118374299;118411337;326337000;75723000;330223000;834361000;863137000;36600000;99203000;998940000;1833301000;329231000;;329231000;150000000;366843000;696074000;12000;;1160666000;1137227000;1833301000
URBN;46954;USD;2015;Q4;2016-01-31;2015-04-01;131811008;132738828;258804000;70458000;358237000;809117000;889232000;104448000;85944000;1079624000;1888741000;353740000;;353740000;;207032000;560772000;13000;;1343383000;1327969000;1888741000
URBN;46954;USD;2014;Q4;2015-01-31;2014-04-01;147325883;149226290;523871000;55161000;311207000;994980000;806909000;366422000;52903000;1226234000;2221214000;331830000;;331830000;;195214000;527044000;97699000;;1597439000;1694170000;2221214000
URBN;46954;USD;2013;Q4;2014-01-31;2013-04-01;145947997;148384469;473813000;39519000;282411000;872284000;733416000;149585000;41926000;924927000;1797211000;250195000;;250195000;;192428000;442623000;48291000;;1315079000;1354588000;1797211000
URBN;46954;USD;2012;Q4;2013-01-31;2012-04-02;143943233;145293008;235127000;36673000;250073000;596992000;684979000;126913000;74824000;886716000;1483708000;233466000;;233466000;;183974000;417440000;15000;;1077765000;1066268000;1483708000
URBN;46954;USD;2011;Q4;2012-01-31;2011-04-01;164125078;167613530;456677000;36502000;229561000;803977000;586346000;351988000;52010000;990344000;1794321000;211024000;;211024000;;171749000;382773000;27620000;;1394190000;1411548000;1794321000
URBN;46954;USD;2010;Q4;2011-01-31;2010-09-08;168504159;172426507;501536000;38405000;186130000;806213000;539961000;243445000;46474000;829880000;1636093000;188549000;;188549000;;150769000;339318000;184637000;;1121232000;1296775000;1636093000
URBN;46954;USD;2017;Q4;2018-01-31;2016-12-12;96281415;97107845;447345000;76962000;351395000;978757000;813768000;58688000;101567000;974023000;1952780000;360214000;;360214000;;291663000;651877000;695000;;1310859000;1300903000;1952780000
URBN;46954;USD;2018;Q4;2019-01-31;2019-04-01;107113568;108383632;637492000;80461000;370507000;1202756000;796029000;57292000;104438000;957759000;2160515000;386644000;;386644000;;284773000;671417000;11000;;1516190000;1489098000;2160515000
HPE;47023;USD;2017;Q4;2017-10-31;2017-12-15;-65771967;-33109240;9579000000;3073000000;2315000000;21444000000;6269000000;2535000000;31158000000;39962000000;61406000000;6501000000;3850000000;18924000000;10182000000;18977000000;37901000000;33599000000;;-7238000000;23505000000;61406000000
HPE;47023;USD;2016;Q4;2016-10-31;2016-12-15;-2030119052;2945593926;12987000000;3151000000;1720000000;28917000000;6375000000;2648000000;41689000000;50712000000;79629000000;5106000000;3525000000;22529000000;12168000000;25582000000;48111000000;35265000000;;2782000000;31518000000;79629000000
HPE;47023;USD;2015;Q4;2015-10-31;2015-12-17;-2095655566;3155501905;9842000000;8538000000;2198000000;29964000000;9886000000;0;40066000000;49952000000;79916000000;6304000000;691000000;21993000000;15103000000;62555000000;84548000000;0;;0;-4632000000;79916000000
HPE;47023;USD;2014;Q4;2014-10-31;2015-12-17;;;2319000000;8423000000;1884000000;22031000000;8520000000;;34520000000;43040000000;65071000000;5595000000;894000000;19760000000;485000000;47163000000;66923000000;;;0;-1852000000;65071000000
HPE;47023;USD;2018;Q4;2018-10-31;2018-12-12;1460000000;1480000000;4880000000;3263000000;2447000000;17272000000;6138000000;2398000000;29685000000;38221000000;55493000000;6470000000;2005000000;17198000000;10136000000;17021000000;34219000000;30356000000;;-5899000000;21274000000;55493000000
BOX;47121;USD;2016;Q4;2017-01-31;2017-03-24;129893000;129893000;177391000;120113000;;322101000;117176000;;54397000;171573000;493674000;54786000;13748000;297941000;61697000;121001000;418942000;960157000;-1177000;-884128000;74732000;493674000
BOX;47121;USD;2015;Q4;2016-01-31;2016-03-30;123386000;123386000;193120000;99542000;;319994000;120492000;;57002000;177494000;497488000;77419000;4698000;250466000;47316000;109121000;359587000;871503000;-1177000;-732341000;137901000;497488000
BOX;47121;USD;2014;Q4;2015-01-31;2015-06-12;20108000;20108000;330436000;54174000;;406229000;58446000;;27991000;86437000;492666000;54834000;625000;166053000;41238000;58484000;224537000;798755000;-1177000;-529393000;268129000;492666000
BOX;47121;USD;2017;Q4;2018-01-31;2018-03-22;136642000;136642000;208076000;162133000;;399189000;123977000;;30400000;154377000;553566000;80941000;18844000;393967000;66980000;144631000;538598000;1054945000;-1177000;-1039088000;14968000;553566000
BOX;47121;USD;2018;Q4;2019-01-31;2019-03-20;143796000;143796000;217518000;175130000;;428554000;137703000;;83904000;221607000;650161000;81293000;;463200000;40000000;155556000;618756000;1166457000;-1177000;-1133898000;31405000;650161000
FL;47224;USD;2017;Q4;2018-02-28;2018-03-29;120100000;120600000;849000000;;1278000000;2551000000;866000000;;544000000;1410000000;3961000000;258000000;;616000000;125000000;826000000;1442000000;842000000;-63000000;2019000000;2519000000;3961000000
FL;47224;USD;2016;Q4;2017-02-28;2017-03-23;132200000;133100000;1046000000;;1307000000;2633000000;765000000;;442000000;1207000000;3840000000;249000000;;612000000;127000000;518000000;1130000000;;;;2710000000;3840000000
FL;47224;USD;2015;Q4;2016-02-29;2016-03-24;137400000;138900000;1021000000;;1285000000;2606000000;661000000;;508000000;1169000000;3775000000;279000000;1000000;700000000;129000000;522000000;1222000000;;;2919000000;2553000000;3775000000
FL;47224;USD;2014;Q4;2015-02-28;2015-03-30;142100000;144300000;967000000;;1250000000;2456000000;620000000;;501000000;1121000000;3577000000;301000000;2000000;696000000;132000000;385000000;1081000000;;;;2496000000;3577000000
FL;47224;USD;2013;Q4;2014-02-28;2014-03-31;146000000;148400000;867000000;;1220000000;2350000000;590000000;;547000000;1137000000;3487000000;263000000;3000000;626000000;136000000;365000000;991000000;;;;2496000000;3487000000
FL;47224;USD;2012;Q4;2013-02-28;2013-04-01;150600000;153900000;928000000;;1167000000;2363000000;490000000;;514000000;1004000000;3367000000;298000000;0;636000000;133000000;354000000;990000000;;;;2377000000;3367000000
FL;47224;USD;2011;Q4;2012-02-29;2012-03-26;151600000;153100000;851000000;;1069000000;2079000000;427000000;;544000000;971000000;3050000000;240000000;;548000000;135000000;392000000;940000000;;;;2110000000;3050000000
FL;47224;USD;2010;Q4;2011-02-28;2011-03-28;154800000;156400000;696000000;;1059000000;1934000000;386000000;;576000000;962000000;2896000000;223000000;;489000000;137000000;382000000;871000000;;;;2025000000;2896000000
FL;47224;USD;2009;Q4;2010-02-28;2010-09-08;156300000;156900000;589000000;;1037000000;1772000000;387000000;;657000000;1044000000;2816000000;215000000;;433000000;138000000;435000000;868000000;;;;1948000000;2816000000
FL;47224;USD;2018;Q4;2019-02-28;2019-04-02;112600000;113200000;891000000;;1269000000;2518000000;836000000;;466000000;1302000000;3820000000;387000000;;764000000;124000000;550000000;1314000000;809000000;-37000000;2104000000;2506000000;3820000000
DVMT;47385;USD;2017;Q4;2018-01-31;2018-03-29;200000000;200000000;16129000000;11721000000;2678000000;40328000000;5390000000;4163000000;74312000000;83865000000;124193000000;26360000000;7873000000;45839000000;43998000000;60869000000;106708000000;19889000000;-1440000000;-6860000000;17485000000;124193000000
DVMT;47385;USD;2016;Q4;2017-01-31;2017-03-31;-164000000;-164000000;11449000000;9420000000;2538000000;30773000000;5653000000;3802000000;77978000000;87433000000;118206000000;21541000000;6329000000;38135000000;43061000000;61062000000;99197000000;20199000000;-752000000;-5609000000;19009000000;118206000000
DVMT;47385;USD;2015;Q4;2016-01-31;2016-06-10;;;6322000000;4887000000;1619000000;23573000000;1649000000;114000000;19786000000;21549000000;45122000000;17098000000;2981000000;25310000000;10650000000;18346000000;43656000000;5727000000;0;-3937000000;1466000000;45122000000
KKD;47513;USD;2016;Q4;2017-01-31;2016-03-31;64406000;65735000;50785000;28088000;16312000;99142000;127709000;;116024000;243733000;342875000;49393000;;49719000;;37016000;86735000;266724000;;-10584000;256140000;342875000
KKD;47513;USD;2015;Q4;2016-01-31;2015-04-02;66503000;68591000;50971000;27799000;18194000;104602000;115758000;;132353000;248111000;352713000;49625000;;49958000;;34969000;84927000;310768000;;-42982000;267786000;352713000
KKD;47513;USD;2014;Q4;2015-01-31;2014-04-03;67222000;71043000;55748000;25268000;16750000;127487000;92823000;;118236000;211059000;338546000;46064000;;46408000;;27045000;73453000;338135000;;-73042000;265093000;338546000
KKD;47513;USD;2013;Q4;2014-01-31;2013-04-19;66805000;69461000;66332000;25627000;12358000;134784000;78024000;;129130000;207154000;341938000;44528000;;46676000;;48830000;95506000;354068000;;-107298000;246432000;341938000
KKD;47513;USD;2012;Q4;2013-01-31;2012-03-30;69541000;71566000;44319000;25467000;12646000;97240000;75466000;;162242000;237708000;334948000;39294000;;41518000;;44304000;85822000;377539000;;-128077000;249126000;334948000
KKD;47513;USD;2011;Q4;2012-01-31;2011-09-01;;;21970000;20261000;14635000;63422000;71163000;;35341000;106504000;169926000;38333000;;40846000;;52652000;93498000;370808000;;-294346000;76428000;169926000
CMTL;48404;USD;2017;Q4;2017-07-31;2017-09-27;23470000;23623000;41844000;124962000;60603000;241044000;32847000;;558172000;591019000;832063000;100637000;17803000;144211000;177999000;207702000;351913000;536863000;-441849000;385136000;480150000;832063000
CMTL;48404;USD;2016;Q4;2016-07-31;2016-10-06;19336000;19294000;66805000;150967000;71354000;303639000;38667000;;578890000;617557000;921196000;139822000;14659000;184146000;243990000;266649000;450795000;528634000;-441849000;383616000;470401000;921196000
CMTL;48404;USD;2015;Q4;2015-07-31;2015-09-28;16152000;16272000;150953000;69255000;62068000;300756000;15370000;;157751000;173121000;473877000;50017000;0;64337000;0;8131000;72468000;430200000;-441849000;413058000;401409000;473877000
CMTL;48404;USD;2014;Q4;2014-07-31;2014-10-09;16148000;16675000;154500000;54887000;61332000;290844000;18536000;;164472000;183008000;473852000;53578000;;66188000;;10739000;76927000;424342000;-436860000;409443000;396925000;473852000
CMTL;48404;USD;2013;Q4;2013-07-31;2013-10-03;16442000;34584000;356642000;49915000;65482000;489651000;20333000;;171831000;192164000;681815000;54342000;200000000;269091000;;8662000;277753000;366795000;-366131000;403398000;404062000;681815000
CMTL;48404;USD;2012;Q4;2012-07-31;2012-09-26;17783000;23851000;367894000;56242000;72361000;516876000;22832000;;180070000;202902000;719778000;68139000;0;82655000;200000000;207722000;290377000;364351000;-339177000;404227000;429401000;719778000
CMTL;48404;USD;2011;Q4;2011-07-31;2011-09-27;25463000;31360000;558804000;70801000;74661000;723065000;26638000;;187806000;214444000;937509000;85046000;;96057000;200000000;212272000;308329000;357874000;-121803000;393109000;629180000;937509000
CMTL;48404;USD;2010;Q4;2010-07-31;2010-12-08;28317000;34073000;607594000;135840000;73562000;840819000;33727000;;192016000;225743000;1066562000;141439000;;154219000;200000000;210711000;364930000;350368000;-185000;351449000;701632000;1066562000
CMTL;48404;USD;2018;Q4;2018-07-31;2018-09-26;23853000;24358000;43484000;147439000;75076000;279793000;28987000;;536377000;565364000;845157000;111817000;19047000;165316000;148852000;174157000;339473000;542339000;-441849000;405194000;505684000;845157000
CAL;49132;USD;2016;Q4;2017-02-28;2017-03-28;41826000;42004000;55332000;153121000;585764000;843745000;219196000;;412332000;631528000;1475273000;417595000;;527595000;197003000;333192000;860787000;121967000;;521584000;614486000;1475273000
CAL;49132;USD;2015;Q4;2016-02-29;2016-03-29;42837000;43253000;118151000;153664000;546745000;875065000;179010000;;249248000;428258000;1303323000;335306000;;390299000;196544000;310552000;700851000;139318000;;468030000;602472000;1303323000
CAL;49132;USD;2014;Q4;2015-02-28;2015-04-01;42179000;42376000;67403000;136646000;543103000;790148000;149743000;;274436000;424179000;1214327000;310946000;;369539000;196712000;303166000;672705000;139394000;;398804000;541622000;1214327000
CAL;49132;USD;2013;Q4;2014-02-28;2014-04-01;41559000;41914000;82546000;129217000;547531000;792549000;143560000;;213294000;356854000;1149403000;316555000;;386855000;199010000;285186000;672041000;131832000;;328191000;477362000;1149403000
CAL;49132;USD;2012;Q4;2013-02-28;2013-04-02;40782000;40722000;68223000;111392000;503688000;775142000;144856000;;253975000;398831000;1173973000;301470000;;471823000;198823000;276249000;748072000;122022000;;302223000;425901000;1173973000
CAL;49132;USD;2011;Q4;2012-02-29;2012-03-27;40097000;40657000;47682000;154022000;561797000;815138000;131471000;;280867000;412338000;1227476000;278066000;;524580000;198633000;289180000;813760000;116289000;;286743000;413716000;1227476000
CAL;49132;USD;2010;Q4;2011-02-28;2011-09-07;;;126548000;113937000;524250000;808281000;135632000;;204130000;339762000;1148043000;249377000;;511905000;150000000;220229000;732134000;134709000;;274230000;415909000;1148043000
CAL;49132;USD;2017;Q4;2018-02-28;2018-04-04;41801000;41995000;64047000;152613000;569379000;846789000;212799000;;429827000;642626000;1489415000;430159000;;430159000;197472000;340294000;770453000;;;;718962000;1489415000
CAL;49132;USD;2018;Q4;2019-02-28;2019-04-03;41151000;40803000;30200000;191722000;683171000;976447000;230784000;;631337000;862121000;1838568000;518336000;;853336000;197932000;349797000;1203133000;146308000;;519346000;635435000;1838568000
CSWI;49347;USD;2016;Q4;2017-03-31;2017-06-14;15848000;15921000;23146000;59831000;43665000;146283000;56812000;;194994000;251806000;398089000;31991000;561000;37736000;72646000;87915000;125651000;38858000;-1011000;245026000;272438000;398089000
CSWI;49347;USD;2015;Q4;2016-03-31;2016-06-08;15671000;15624000;25987000;52637000;51634000;155521000;64357000;;172382000;236739000;392260000;31002000;561000;31563000;89121000;102687000;134250000;31753000;0;233955000;258010000;392260000
CSWI;49347;USD;2014;Q4;2015-03-31;2015-11-16;15583000;15624000;20448000;48941000;47175000;132296000;56837000;;97388000;154225000;286521000;24961000;13561000;38522000;13143000;43398000;81920000;7822000;-2712000;208784000;204601000;286521000
CSWI;49347;USD;2018;Q4;2019-03-31;2018-08-01;15072000;15193000;10983000;65555000;46335000;130110000;53437000;;155332000;208769000;338879000;41311000;561000;45339000;19319000;25931000;71270000;43771000;-10754000;243402000;267609000;338879000
CSWI;49347;USD;2017;Q4;2018-03-31;2018-05-30;15291000;15122000;11706000;63383000;42974000;127567000;54473000;;158776000;213249000;340816000;40327000;561000;44854000;23459000;30197000;75051000;42842000;-3252000;233650000;265765000;340816000
BIG;49609;USD;2016;Q4;2017-01-31;2016-03-29;49093000;49806000;54144000;;849982000;994432000;559924000;;86014000;645938000;1640370000;637787000;;678448000;62300000;241452000;919900000;589299000;-2063091000;2210239000;720470000;1640370000
BIG;49609;USD;2015;Q4;2016-01-31;2016-03-29;52889000;54133000;52261000;;851669000;999275000;550555000;;86061000;636616000;1635891000;549005000;;587829000;62100000;258512000;846341000;575629000;-1878523000;2107100000;789550000;1635891000
BIG;49609;USD;2014;Q4;2015-01-31;2014-04-01;57512000;58604000;68629000;;914965000;1121061000;569682000;;48856000;618538000;1739599000;539840000;;577447000;77000000;260725000;838172000;563622000;-1670041000;2021357000;901427000;1739599000
BIG;49609;USD;2013;Q4;2014-01-31;2013-04-02;57067000;57986000;60581000;;918023000;1090630000;593562000;;69434000;662996000;1753626000;589704000;;629634000;171200000;365850000;995484000;553020000;-1677610000;1896062000;758142000;1753626000
BIG;49609;USD;2012;Q4;2013-01-31;2012-03-26;64138000;65430000;68547000;;825195000;1006656000;572767000;;61887000;634654000;1641310000;546546000;;584820000;65900000;233257000;818077000;543335000;-1423524000;1718941000;823233000;1641310000
BIG;49609;USD;2011;Q4;2012-01-31;2011-03-30;155355068;157539615;177539000;;762146000;1051719000;524906000;;42974000;567880000;1619599000;500638000;;541931000;0;130875000;672806000;524516000;-1079130000;1511877000;946793000;1619599000
BIG;49609;USD;2010;Q4;2011-01-31;2010-09-08;81772000;83248000;283733000;;731337000;1122966000;491256000;;55271000;546527000;1669493000;498164000;;542520000;;125561000;668081000;516236000;-791042000;1289353000;1001412000;1669493000
BIG;49609;USD;2017;Q4;2018-01-31;2018-04-03;34239000;34372000;51176000;;872790000;1021973000;565977000;;63776000;629753000;1651726000;551091000;;589608000;215406000;392531000;982139000;623725000;-2422396000;2468258000;669587000;1651726000
BIG;49609;USD;2018;Q4;2019-01-31;2019-04-02;40041000;40328000;46034000;;969561000;1128003000;822338000;;73006000;895344000;2023347000;599677000;;638560000;518577000;691746000;1330306000;623860000;-2506086000;2575267000;693041000;2023347000
CIEN;49697;USD;2017;Q4;2017-10-31;2017-12-22;143099000;200107000;919646000;622183000;267143000;2006311000;308465000;49783000;1587152000;1945400000;3951711000;583032000;352293000;1037743000;583688000;777626000;1815369000;6811612000;;-4664253000;2136342000;3951711000
CIEN;49697;USD;2016;Q4;2016-10-31;2016-12-21;139742000;157903000;1052863000;576235000;211251000;2013192000;288406000;90172000;481805000;860383000;2873575000;546295000;236241000;891545000;1017441000;1215689000;2107234000;6716876000;;-5926206000;766341000;2873575000
CIEN;49697;USD;2015;Q4;2015-10-31;2015-03-12;133923000;111381000;926078000;550792000;191162000;1864210000;191973000;95105000;543763000;830841000;2695051000;538423000;2500000;667034000;1271639000;1407141000;2074175000;6641792000;;-5998790000;620876000;2695051000
CIEN;49697;USD;2014;Q4;2014-10-31;2014-12-19;106944000;92371000;726925000;518981000;254660000;1693190000;126632000;50057000;202753000;379442000;2072632000;486385000;190063000;781136000;1274791000;1361111000;2142247000;5955510000;;-6010457000;-69615000;2072632000
CIEN;49697;USD;2013;Q4;2013-10-31;2013-12-20;103570000;103570000;471466000;488578000;249103000;1395802000;119729000;15031000;272208000;406968000;1802770000;526505000;0;615055000;1212019000;1270392000;1885447000;5894917000;;-5969820000;-82677000;1802770000
CIEN;49697;USD;2012;Q4;2012-10-31;2012-12-21;100787000;100787000;692501000;345496000;260098000;1415690000;123580000;0;341873000;465453000;1881143000;389244000;216210000;684970000;1225806000;1285145000;1970115000;5798771000;;-5884389000;-88972000;1881143000
CIEN;49697;USD;2011;Q4;2011-10-31;2011-12-22;97247000;97247000;541896000;417509000;230076000;1332838000;122558000;50264000;445758000;618580000;1951418000;354120000;0;453493000;1442364000;1484052000;1937545000;5754210000;;-5740368000;13873000;1951418000
CIEN;49697;USD;2010;Q4;2010-10-31;2010-12-22;94571000;94571000;688687000;343582000;261619000;1441568000;120294000;0;556231000;676525000;2118093000;394611000;;469945000;1442705000;1488855000;1958800000;5703078000;;-5544847000;159293000;2118093000
CIEN;49697;USD;2009;Q4;2009-10-31;2010-09-08;91758000;91758000;1048888000;118251000;88086000;1305762000;61868000;8031000;128722000;198621000;1504383000;158264000;;198829000;798000000;849716000;1048545000;5665948000;;-5211333000;455838000;1504383000
CIEN;49697;USD;2018;Q4;2018-10-31;2018-12-21;143655000;123059000;894404000;786502000;262751000;2142602000;292067000;58970000;1262884000;1613921000;3756523000;680657000;7000000;963003000;686450000;864186000;1827189000;6882766000;;-4947652000;1929334000;3756523000
VRA;49797;USD;2016;Q4;2017-01-31;2016-03-29;37924000;38133000;97681000;31294000;113590000;253642000;113711000;;13326000;127037000;380679000;66552000;;66552000;;28872000;95424000;85436000;-44147000;244009000;285255000;380679000
VRA;49797;USD;2015;Q4;2016-01-31;2015-03-31;40284000;40368000;112292000;31374000;98403000;267697000;109003000;;584000;109587000;377284000;63049000;;63049000;;29764000;92813000;80992000;-12957000;216451000;284471000;377284000
VRA;49797;USD;2014;Q4;2015-01-31;2014-04-02;40608000;40693000;59215000;29174000;136923000;248358000;84940000;;1085000;86025000;334383000;54847000;;54847000;;24389000;79236000;78153000;0;178002000;255147000;334383000
VRA;49797;USD;2013;Q4;2014-01-31;2013-04-03;40563000;40595000;9603000;34811000;131562000;198340000;77211000;;1768000;78979000;277319000;52641000;58000;52699000;15037000;30365000;83064000;75675000;;119190000;194255000;277319000
VRA;49797;USD;2012;Q4;2013-01-31;2012-03-27;40507330;40554831;4922000;38097000;106967000;166339000;52312000;;862000;53174000;219513000;60016000;89000;60105000;25095000;35401000;95506000;73590000;;50320000;124007000;219513000
VRA;49797;USD;2011;Q4;2012-01-31;2011-09-13;40288608;40306532;13953000;34300000;96717000;160467000;42984000;;2588000;45572000;206039000;68465000;83000;68548000;66934000;73169000;141717000;71923000;;-7601000;64322000;206039000
VRA;49797;USD;2017;Q4;2018-01-31;2018-04-03;32566000;32585000;122901000;15566000;87838000;247408000;86463000;15515000;1283000;103261000;350669000;40274000;;40274000;;25112000;65386000;91192000;-76578000;270783000;285283000;350669000
VRA;49797;USD;2018;Q4;2019-01-31;2019-04-02;34597000;35105000;132874000;15604000;91581000;252468000;77951000;23735000;7994000;109680000;362148000;43556000;;43556000;;23889000;67445000;95572000;-92839000;291994000;294703000;362148000
NMBL;50051;USD;2016;Q4;2017-01-31;2017-03-24;88186000;88186000;184814000;64336000;21944000;280043000;51258000;;1719000;52977000;333020000;61922000;;145767000;;80223000;225990000;586190000;;-478322000;107030000;333020000
NMBL;50051;USD;2015;Q4;2016-01-31;2016-03-31;81258000;81258000;211160000;50432000;15994000;283591000;47404000;;754000;48158000;331749000;43655000;;107168000;;68973000;176141000;476346000;;-320007000;155608000;331749000
NMBL;50051;USD;2014;Q4;2015-01-31;2015-04-02;74556000;74556000;208394000;35271000;11981000;260620000;36716000;;4238000;40954000;301574000;40927000;;83236000;;49766000;133002000;368760000;;-199938000;168572000;301574000
NMBL;50051;USD;2013;Q4;2014-01-31;2014-06-12;45500000;45500000;208486000;17676000;5412000;234750000;20209000;;4112000;24321000;259071000;18930000;;38963000;;28422000;67385000;292753000;;-101092000;191686000;259071000
AMBA;50129;USD;2016;Q4;2017-01-31;2016-03-25;32105629;33747103;405394000;38596000;20145000;468535000;4988000;;38748000;43736000;512271000;46971000;;54396000;;3241000;57637000;212291000;;242413000;454634000;512271000
AMBA;50129;USD;2015;Q4;2016-01-31;2015-03-30;30566177;33066488;307893000;39408000;18167000;369645000;3448000;;37522000;40970000;410615000;38740000;;48817000;;12342000;61159000;176321000;;173142000;349456000;410615000
AMBA;50129;USD;2014;Q4;2015-01-31;2014-04-04;28420751;31420284;143394000;18837000;10452000;177236000;3018000;;3053000;6071000;183307000;20571000;;25402000;;1544000;26946000;110298000;;46063000;156361000;183307000
AMBA;50129;USD;2013;Q4;2014-01-31;2013-04-04;26853962;28506216;100494000;20153000;8918000;133148000;2536000;;2919000;5455000;138603000;21379000;;24830000;;1441000;26271000;91923000;;20409000;112332000;138603000
AMBA;50129;USD;2012;Q4;2013-01-31;2012-12-17;8009158;9482360;58944000;9485000;6786000;77819000;1686000;;2234000;3920000;81739000;14942000;;22944000;;52346000;75290000;4228000;;2221000;6449000;81739000
AMBA;50129;USD;2017;Q4;2018-01-31;2018-03-30;34785006;35847505;434591000;31294000;23383000;493283000;6449000;;46917000;53366000;546649000;52929000;;53236000;;11226000;64462000;221201000;;261265000;482187000;546649000
AMBA;50129;USD;2018;Q4;2019-01-31;2019-03-29;32128581;32128581;358908000;26212000;18252000;409589000;6728000;;50536000;57264000;466853000;38494000;;39023000;;8341000;47364000;188531000;;230861000;419489000;466853000
DLTH;50213;USD;2016;Q4;2016-12-31;2016-04-08;;;24042000;45000;70368000;101246000;52432000;;2289000;54721000;155967000;34377000;742000;35119000;3384000;7060000;42179000;86446000;;24733000;113788000;155967000
DLTH;50213;USD;2015;Q4;2015-12-31;2016-04-08;29555000;31683000;37873000;20000;55303000;98390000;21529000;;701000;22230000;120620000;23968000;722000;24690000;4301000;5444000;30134000;85389000;;3443000;90486000;120620000
DLTH;50213;USD;2017;Q4;2017-12-31;2016-12-09;;;2865000;52000;89548000;101826000;109705000;6323000;5248000;121276000;223102000;50212000;84000;50296000;28002000;33457000;83753000;88043000;-57000;48084000;139349000;223102000
DLTH;50213;USD;2018;Q4;2018-12-31;2019-04-19;;;731000;28000;97685000;118198000;167109000;6295000;3703000;177107000;295305000;52111000;500000;52611000;44825000;82584000;135195000;89849000;-92000;70592000;160110000;295305000
ENZ;50379;USD;2018;Q4;2018-07-31;2018-10-15;93985927;93985927;60041000;13147000;7278000;83200000;7636000;;10824000;18460000;101660000;19570000;;20186000;;353000;20539000;331242000;;-252221000;81121000;101660000
ENZ;50379;USD;2017;Q4;2017-07-31;2017-09-27;46469000;46469000;64167000;15180000;7047000;89084000;7901000;;10680000;18581000;107665000;17070000;;17810000;;983000;18793000;328759000;;-241900000;88872000;107665000
ENZ;50379;USD;2016;Q4;2016-07-31;2016-10-13;46266000;47496000;67777000;14592000;6971000;91397000;8214000;;12210000;20424000;111821000;18068000;1557000;20568000;;1699000;22267000;326751000;;-239396000;89554000;111821000
ENZ;50379;USD;2015;Q4;2015-07-31;2015-10-13;46059000;46059000;18109000;12109000;7396000;46486000;7948000;;13960000;21908000;68394000;20059000;3013000;23958000;;1830000;25788000;325427000;;-284682000;42606000;68394000
ENZ;50379;USD;2014;Q4;2014-07-31;2014-10-09;44057000;44057000;17455000;12470000;8690000;40736000;7730000;;15945000;23675000;64411000;21162000;3013000;24965000;;2496000;27461000;317603000;;-282397000;36950000;64411000
ENZ;50379;USD;2013;Q4;2013-07-31;2012-10-15;40284000;40284000;9007000;12288000;8805000;32556000;8617000;;17785000;26402000;58958000;20257000;3264000;23852000;;974000;24826000;304694000;;-272420000;34132000;58958000
ENZ;50379;USD;2012;Q4;2012-07-31;2012-10-15;116289787;116289787;15076000;14135000;8800000;40368000;9116000;;19639000;28755000;69123000;18838000;;18956000;;1066000;20022000;304753000;-3074000;-254183000;49101000;69123000
ENZ;50379;USD;2011;Q4;2011-07-31;2011-12-12;38591000;38591000;24161000;15245000;9260000;51399000;10335000;;47740000;58075000;109474000;16046000;;17729000;;3030000;20759000;306223000;-6387000;-214914000;88715000;109474000
ENZ;50379;USD;2019;Q4;2019-07-31;2019-10-15;94705814;95102814;60146000;10738000;7842000;81453000;14254000;;10933000;25187000;106640000;15618000;;16009000;4179000;4603000;20612000;333180000;;-249732000;86028000;106640000
MIK;50465;USD;2016;Q4;2017-01-31;2017-03-07;202201000;203583000;298813000;23215000;1127777000;1542805000;413164000;;191671000;604835000;2147640000;993099000;31125000;1024224000;2723187000;2821842000;3846066000;246077000;;-1930279000;-1698426000;2147640000
MIK;50465;USD;2015;Q4;2016-01-31;2016-03-17;207484000;209401000;409391000;9484000;1002607000;1507723000;378507000;;145057000;523564000;2031287000;887960000;24900000;912860000;2744942000;2842522000;3755382000;606399000;;-2308438000;-1724095000;2031287000
MIK;50465;USD;2014;Q4;2015-01-31;2015-03-19;609286952;620825220;378295000;;958171000;1423778000;386372000;;150958000;537330000;1961108000;864732000;24900000;889632000;3089781000;3183001000;4072633000;571630000;;-2671350000;-2111525000;1961108000
MIK;50465;USD;2013;Q4;2014-01-31;2014-08-29;174188000;177512000;239000000;;901000000;1276000000;358000000;;177000000;535000000;1811000000;809000000;16000000;826000000;3678000000;3767000000;4593000000;106000000;;-2888000000;-2782000000;1811000000
MIK;50465;USD;2017;Q4;2018-01-31;2018-03-22;180560000;181947000;425896000;26207000;1123288000;1676982000;420020000;;203213000;623233000;2300215000;933045000;24900000;957945000;2701764000;2851765000;3809710000;33946000;;-1539781000;-1509495000;2300215000
MIK;50465;USD;2018;Q4;2019-01-31;2019-03-19;157594000;158075000;245887000;57328000;1108715000;1515524000;439077000;;173735000;612812000;2128336000;907653000;;907653000;2705900000;2846878000;3754531000;16548000;;-1628185000;-1626195000;2128336000
DCI;50564;USD;2016;Q4;2016-07-31;2016-09-23;133733166;135243732;243200000;452400000;234100000;958700000;469800000;;360100000;829900000;1788600000;241800000;216700000;458500000;351800000;558700000;1017200000;758200000;-707000000;905100000;771400000;1788600000
DCI;50564;USD;2015;Q4;2015-07-31;2015-11-10;136219252;137547493;217400000;460000000;265000000;970600000;470600000;;368300000;838900000;1809500000;288600000;189100000;477700000;389200000;553100000;1030800000;758200000;-654500000;815200000;778700000;1809500000
DCI;50564;USD;2014;Q4;2014-07-31;2014-09-26;142786221;144842397;423619000;474157000;253351000;1179013000;451665000;;311733000;763398000;1942411000;342392000;187041000;529433000;243726000;410495000;939928000;758216000;-431959000;702435000;1002483000;1942411000
DCI;50564;USD;2013;Q4;2013-07-31;2013-09-27;147858032;150073370;323888000;430766000;234820000;1015938000;419280000;;308338000;727618000;1743556000;293941000;107854000;401795000;102774000;256574000;658369000;758216000;-189608000;532307000;1085187000;1743556000
DCI;50564;USD;2012;Q4;2012-07-31;2012-09-28;149989479;152682181;318151000;438796000;256116000;1038221000;384909000;;306952000;691861000;1730082000;328974000;97493000;426467000;203483000;393601000;820068000;758216000;-138050000;366788000;910014000;1730082000
DCI;50564;USD;2011;Q4;2011-07-31;2011-09-23;153421090;156455650;273494000;445700000;271476000;1020475000;391502000;;314116000;705618000;1726093000;366900000;61000000;427900000;205748000;363482000;791382000;443216000;-498810000;925542000;934711000;1726093000
DCI;50564;USD;2010;Q4;2010-07-31;2010-12-08;154775834;157573912;232000000;358917000;203631000;816602000;365892000;;317012000;682904000;1499506000;280085000;55536000;335621000;256192000;417252000;752873000;443216000;-422670000;744247000;746633000;1499506000
DCI;50564;USD;2017;Q4;2017-07-31;2017-09-22;131600000;133300000;308400000;497700000;293500000;1099600000;484600000;;395500000;880100000;1979700000;194000000;73900000;267900000;537300000;857300000;1125200000;758200000;-808000000;1041200000;854500000;1979700000
DCI;50564;USD;2018;Q4;2018-07-31;2018-10-01;129700000;133600000;204700000;534600000;334100000;1073400000;509300000;;393900000;903200000;1976600000;339300000;43500000;382800000;499600000;736000000;1118800000;758200000;-898800000;1122100000;857800000;1976600000
DCI;50564;USD;2019;Q4;2019-07-31;2019-09-27;127900000;130200000;177800000;529500000;332800000;1122600000;588900000;;431100000;1020000000;2142600000;357500000;52300000;409800000;584400000;830100000;1239900000;758200000;-981200000;;902700000;2142600000
ARRY;50863;USD;2018;Q4;2018-06-30;2018-08-14;210342000;210342000;412487000;32084000;;451543000;7128000;919000;774000;8821000;460364000;64475000;18399000;95931000;93376000;144690000;240621000;1286211000;;-1066007000;219743000;460364000
ARRY;50863;USD;2017;Q4;2017-06-30;2017-08-11;170581000;170581000;234323000;31279000;;270177000;8132000;732000;104000;8968000;279145000;51771000;0;69551000;133905000;197867000;267418000;930464000;;-918661000;11727000;279145000
ARRY;50863;USD;2016;Q4;2016-06-30;2016-08-19;143469000;143469000;109942000;39302000;;155301000;6680000;596000;6323000;13599000;168900000;38988000;;52434000;113655000;154398000;206832000;763468000;;-801407000;-37932000;168900000
ARRY;50863;USD;2015;Q4;2015-06-30;2015-08-21;141306000;134862000;178326000;6307000;;191047000;5050000;496000;1614000;7160000;198207000;32193000;;42424000;107280000;113130000;155554000;751215000;;-708567000;42653000;198207000
ARRY;50863;USD;2014;Q4;2014-06-30;2014-08-15;126711000;126711000;110998000;5429000;;121676000;8157000;640000;6152000;14949000;136625000;26646000;;52733000;101524000;109613000;162346000;692213000;;-717936000;-25721000;136625000
ARRY;50863;USD;2013;Q4;2013-06-30;2013-08-12;116502000;116502000;108241000;9595000;;121309000;10049000;465000;4165000;14679000;135988000;21588000;;50577000;99021000;107320000;157897000;610772000;;-632679000;-21909000;135988000
ARRY;50863;USD;2012;Q4;2012-06-30;2012-08-16;90630000;90630000;89177000;1075000;;93107000;12059000;473000;2434000;14966000;108073000;20780000;150000;75936000;92106000;117943000;193879000;476878000;;-570737000;-85806000;108073000
ARRY;50863;USD;2011;Q4;2011-06-30;2011-11-03;221623171;221623171;64085000;;;70562000;15698000;623000;2491000;18812000;89374000;18451000;150000;69808000;91390000;150424000;220232000;386295000;;-547156000;-130858000;89374000
EXPR;50957;USD;2016;Q4;2017-02-28;2017-03-24;78414000;78742000;207373000;15787000;241424000;514133000;451286000;;219770000;671056000;1185189000;252969000;;282397000;;267105000;549502000;186018000;-237243000;690715000;635687000;1185189000
EXPR;50957;USD;2015;Q4;2016-02-29;2016-03-30;82560000;83336000;186903000;22130000;255350000;513419000;444397000;;220828000;665225000;1178644000;276508000;;307403000;;253288000;560691000;170426000;-181106000;633298000;617953000;1178644000
EXPR;50957;USD;2014;Q4;2015-02-28;2015-03-27;84210000;84747000;346159000;23272000;241063000;654236000;407607000;;216307000;623914000;1278150000;258884000;;287459000;199527000;434352000;721811000;150693000;-108082000;516785000;556339000;1278150000
EXPR;50957;USD;2013;Q4;2014-02-28;2014-04-01;83839000;84607000;311884000;17384000;212510000;583461000;376122000;;223087000;599209000;1182670000;270771000;;299207000;199170000;408894000;708101000;131410000;-104573000;448460000;474569000;1182670000
EXPR;50957;USD;2012;Q4;2013-02-28;2013-04-02;84942000;85319000;256297000;11024000;215082000;515862000;278369000;;224968000;503337000;1019199000;284925000;;312776000;198843000;335261000;648037000;105905000;-66644000;331921000;371162000;1019199000
EXPR;50957;USD;2011;Q4;2012-02-29;2012-03-23;88665000;89070000;152362000;9027000;213075000;416157000;227306000;;222857000;450163000;866320000;267647000;;295331000;198539000;289842000;585173000;88603000;-103000;192654000;281147000;866320000
EXPR;50957;USD;2010;Q4;2011-02-28;2011-09-02;88420000;88681000;187762000;9908000;185209000;427293000;211319000;;224137000;435456000;862749000;271768000;;296835000;366157000;435752000;732587000;78205000;0;51957000;130162000;862749000
EXPR;50957;USD;2017;Q4;2018-02-28;2018-04-04;78331000;79358000;236222000;12084000;260728000;564132000;405013000;;217779000;622792000;1186924000;256152000;;297392000;;241218000;538610000;200025000;-256106000;704395000;648314000;1186924000
EXPR;50957;USD;2018;Q4;2019-02-28;2019-03-19;68195000;68685000;171670000;17369000;267766000;512028000;364279000;;210320000;574599000;1086627000;234226000;;274692000;;226757000;501449000;212917000;-341603000;713864000;585178000;1086627000
SPLK;51255;USD;2016;Q4;2017-01-31;2016-03-30;127447000;127447000;1009039000;181665000;;1217269000;134995000;1500000;183075000;319570000;1536839000;150645000;;497766000;;179659000;677425000;1528779000;;-665595000;859414000;1536839000
SPLK;51255;USD;2015;Q4;2016-01-31;2015-03-31;122467000;122467000;850164000;128413000;;999833000;50374000;165082000;32502000;247958000;1247791000;96765000;;346648000;;87822000;434470000;1200981000;;-386823000;813321000;1247791000
SPLK;51255;USD;2017;Q4;2018-01-31;2016-12-09;136428000;160252000;1165150000;396413000;;1684035000;160880000;5375000;289155000;455410000;2139445000;241036000;;730949000;;277175000;1008124000;2087036000;;-955871000;1131321000;2139445000
SPLK;51255;USD;2018;Q4;2019-01-31;2019-03-27;147859000;147859000;2757385000;469658000;;3378463000;158276000;110588000;852916000;1121780000;4500243000;372120000;;1045138000;1634474000;1934648000;2979786000;2755007000;;-1232044000;1520457000;4500243000
KMG;51451;USD;2017;Q4;2017-07-31;2017-10-16;11890000;12396000;20708000;51168000;46482000;133143000;105435000;;553853000;659288000;792431000;42026000;3167000;52906000;523102000;565809000;618715000;42654000;;140774000;173716000;792431000
KMG;51451;USD;2016;Q4;2016-07-31;2016-10-14;11733000;11934000;12428000;33324000;37401000;95348000;79739000;;61941000;141680000;237028000;37670000;;43669000;35800000;50170000;93839000;36672000;;118564000;143189000;237028000
KMG;51451;USD;2015;Q4;2015-07-31;2015-11-27;11685000;11842000;7517000;36887000;42082000;96845000;80589000;;64925000;145514000;242359000;45582000;;50434000;53000000;68504000;118938000;31793000;;101295000;123421000;242359000
KMG;51451;USD;2014;Q4;2014-07-31;2014-10-28;11638000;11564000;19252000;40176000;45268000;111653000;92450000;;46755000;139205000;250858000;53676000;;58251000;60000000;72401000;130652000;29002000;;90559000;120206000;250858000
KMG;51451;USD;2013;Q4;2013-07-31;2013-10-30;11519000;11590000;13949000;41935000;53387000;118836000;96688000;;46491000;143179000;262015000;43854000;;45843000;85000000;98932000;144775000;26804000;;92940000;117240000;262015000
KMG;51451;USD;2012;Q4;2012-07-31;2012-11-09;11388000;11546000;1633000;28933000;40661000;75661000;68026000;;24003000;92029000;167690000;26450000;;28677000;24000000;32246000;60923000;26136000;;84970000;106767000;167690000
KMG;51451;USD;2011;Q4;2011-07-31;2011-12-12;11316000;11502000;1826000;36410000;41770000;86006000;71826000;;27546000;99372000;185378000;31672000;8000000;40782000;41279000;48066000;88848000;25369000;;72394000;96530000;185378000
KMG;51451;USD;2018;Q4;2018-07-31;2018-10-01;15422000;15909000;24436000;61895000;54218000;155299000;117101000;;546034000;663135000;818434000;51529000;;59255000;306119000;343112000;402367000;222526000;;203862000;416067000;818434000
Fred;51800;USD;2017;Q4;2018-02-28;2018-05-04;37126;37126;6573000;37720000;279175000;384926000;115466000;41717000;55456000;212639000;597565000;197190000;65000;223827000;167100000;192690000;416517000;123950000;-4975000;61514000;181048000;597565000
Fred;51800;USD;2016;Q4;2017-02-28;2017-04-13;36861;36841;5830000;40055000;327232000;435206000;130288000;54682000;79231000;264201000;699407000;193124000;60000;212048000;128388000;150163000;362211000;118090000;0;218640000;337196000;699407000
Fred;51800;USD;2015;Q4;2016-02-29;2016-04-14;36419;36416;5917000;53171000;340730000;451361000;138993000;;140158000;279151000;730512000;240731000;621000;241352000;52527000;84949000;326301000;109596000;;294140000;404211000;730512000
Fred;51800;USD;2014;Q4;2015-02-28;2015-04-16;-36534074;-36762074;6440000;41370000;315678000;419958000;143985000;;82532000;226517000;646475000;188849000;4331000;193180000;2259000;37659000;230839000;104653000;;310413000;415636000;646475000
Fred;51800;USD;2013;Q4;2014-02-28;2014-04-17;-36433847;-36547528;6725000;35161000;361993000;456232000;153363000;;58191000;211554000;667786000;172161000;1640000;198247000;3578000;17991000;216238000;102524000;;348321000;451548000;667786000
Fred;51800;USD;2012;Q4;2013-02-28;2013-04-18;72829557;73076417;8129000;35438000;353266000;443240000;158394000;;45014000;203408000;646648000;159325000;1263000;184822000;12241000;30554000;215376000;99342000;;331136000;431272000;646648000
Fred;51800;USD;2011;Q4;2012-02-29;2012-04-12;36803000;36910000;27130000;31883000;331882000;435306000;161112000;;35564000;196676000;631982000;151762000;658000;176298000;6640000;32072000;208370000;105384000;;317364000;423612000;631982000
Fred;51800;USD;2010;Q4;2011-02-28;2011-09-08;39145000;39241000;49182000;28146000;313384000;429813000;139931000;;25784000;165715000;595528000;126373000;201000;147716000;3969000;23924000;171640000;131367000;;291649000;423888000;595528000
Fred;51800;USD;2018;Q4;2019-02-28;2019-05-03;35906;35906;5353000;22970000;246517000;315326000;66346000;4839000;22513000;93698000;409024000;155459000;58641000;214100000;14446000;29461000;243561000;127182000;-10823000;48547000;165465000;409026000
GCO;51883;USD;2016;Q4;2017-02-28;2017-03-29;19382000;19492000;48301000;43525000;563677000;716973000;330611000;;393415000;724026000;1440999000;296881000;9175000;309386000;73730000;209092000;518478000;258031000;-17857000;731111000;922521000;1440999000
GCO;51883;USD;2015;Q4;2016-02-29;2016-03-30;21598000;21692000;133288000;47265000;529758000;800086000;323328000;;417776000;741104000;1541190000;298046000;14182000;323617000;97583000;260790000;584407000;246327000;-17857000;768222000;956783000;1541190000
GCO;51883;USD;2014;Q4;2015-02-28;2015-04-01;23561000;23758000;112867000;55263000;598145000;847658000;305752000;;429677000;735429000;1583087000;382259000;13152000;405916000;16003000;178394000;584310000;233403000;-17857000;820563000;998777000;1583087000
GCO;51883;USD;2013;Q4;2014-02-28;2014-04-03;23290000;23601000;59447000;52646000;567261000;756875000;280037000;;402372000;682409000;1439284000;291522000;6793000;305578000;26937000;215583000;521161000;214976000;-17857000;734533000;918123000;1439284000
GCO;51883;USD;2012;Q4;2013-02-28;2013-04-03;23466000;24400000;59795000;48214000;505344000;682271000;241669000;;402132000;643801000;1326072000;262331000;5675000;275198000;45007000;227087000;502285000;194845000;-17857000;669189000;823787000;1326072000
GCO;51883;USD;2011;Q4;2012-02-29;2012-04-26;23243000;23085000;53790000;43713000;435113000;595312000;227689000;;406760000;634449000;1229761000;286299000;8773000;303322000;31931000;197459000;500781000;174237000;-17857000;598360000;728980000;1229761000
GCO;51883;USD;2010;Q4;2011-02-28;2011-09-19;;;55934000;44512000;359736000;513055000;198691000;;249336000;448027000;961082000;223914000;0;234363000;0;99898000;334261000;156073000;-17857000;505224000;626821000;961082000
GCO;51883;USD;2017;Q4;2018-02-28;2018-04-04;19266000;19162000;39937000;43292000;542625000;693088000;382629000;;239636000;622265000;1315353000;251400000;1766000;255068000;86619000;229581000;484649000;271269000;-17857000;603902000;830704000;1315353000
GCO;51883;USD;2018;Q4;2019-02-28;2019-04-03;19322000;19623000;167355000;132390000;366667000;731046000;277375000;;172660000;450035000;1181081000;266684000;8992000;276229000;56751000;167301000;443530000;283729000;-17857000;508555000;737551000;1181081000
CPST;51961;USD;2016;Q4;2017-03-31;2017-06-13;3586600;3268000;14191000;17003000;14538000;54319000;2115000;;1837000;3952000;58271000;20304000;302000;37189000;26000;184000;37373000;874736000;-1639000;-852199000;20898000;58271000
CPST;51961;USD;2015;Q4;2016-03-31;2016-06-09;2171800;2171800;11704000;13575000;16126000;49043000;3537000;;3312000;6849000;55892000;16706000;361000;30894000;74000;258000;31152000;853312000;-1617000;-826955000;24740000;55892000
CPST;51961;USD;2014;Q4;2015-03-31;2015-06-15;1649330;;32221000;13120000;23097000;71501000;3523000;;3903000;7426000;78927000;27562000;407000;43973000;89000;250000;44223000;837982000;-1514000;-801764000;34704000;78927000
CPST;51961;USD;2013;Q4;2014-03-31;2014-06-12;1550615;;27859000;28019000;18102000;76197000;2891000;;5030000;7921000;84118000;33425000;444000;49754000;201000;271000;50025000;805654000;-1330000;-770231000;34093000;84118000
CPST;51961;USD;2012;Q4;2013-03-31;2013-06-13;1522830;;38817000;17941000;18513000;77859000;3543000;;5936000;9479000;87338000;28141000;361000;45077000;233000;375000;45452000;797073000;-1212000;-753975000;41886000;87338000
CPST;51961;USD;2011;Q4;2012-03-31;2012-06-14;1414790;;49952000;18576000;18881000;90383000;4833000;;4576000;9409000;99792000;26271000;363000;40851000;70000;324000;41175000;791201000;-1172000;-731412000;58617000;99792000
CPST;51961;USD;2010;Q4;2011-03-31;2011-08-09;1251020;;33456000;19329000;19267000;74421000;5939000;;6659000;12598000;87019000;22928000;214000;52147000;83000;392000;52539000;748222000;-1094000;-712648000;34480000;87019000
CPST;51961;USD;2017;Q4;2018-03-31;2018-06-07;7457400;7457400;14408000;15968000;15633000;53812000;2859000;;1702000;4561000;58373000;16773000;192000;32088000;130000;526000;32614000;889642000;-1658000;-862225000;25759000;58373000
CPST;51961;USD;2018;Q4;2019-03-31;2019-06-11;7160700;7160700;29727000;16222000;20343000;70110000;5291000;;4562000;9853000;79963000;20889000;31000;28087000;27311000;28722000;56809000;903810000;-1772000;-878884000;23154000;79963000
UNFI;52168;USD;2018;Q4;2018-07-31;2018-09-24;50430000;50899000;23315000;579702000;1135775000;1788914000;571146000;;604412000;1175558000;2964472000;686783000;12441000;699224000;31487000;419293000;1118517000;484133000;-24231000;1400232000;1845955000;2964472000
UNFI;52168;USD;2017;Q4;2017-07-31;2017-09-26;50617000;50945000;15414000;525636000;1031690000;1662670000;602090000;;621803000;1223893000;2886563000;691859000;12128000;703987000;149863000;500655000;1204642000;460517000;0;1235367000;1681921000;2886563000
UNFI;52168;USD;2016;Q4;2016-07-31;2016-09-28;50382000;50516000;18593000;489708000;1021663000;1611190000;616605000;;624360000;1240965000;2852155000;607868000;11854000;619722000;161739000;712929000;1332651000;436671000;;1105212000;1519504000;2852155000
UNFI;52168;USD;2015;Q4;2015-07-31;2015-09-30;50091000;50330000;17380000;474494000;975194000;1546377000;572452000;;422165000;994617000;2540994000;516327000;11613000;527940000;172949000;631966000;1159906000;421085000;;979446000;1381088000;2540994000
UNFI;52168;USD;2014;Q4;2014-07-31;2014-10-01;49719000;50013000;16116000;441528000;834722000;1369948000;483960000;;434983000;918943000;2288891000;514507000;990000;515497000;32510000;530030000;1045527000;403373000;;845157000;1243364000;2288891000
UNFI;52168;USD;2013;Q4;2013-07-31;2013-10-01;49084000;49302000;11111000;339590000;702161000;1115218000;338594000;;276096000;614690000;1729908000;397248000;1019000;398267000;33091000;232495000;630762000;380602000;;719675000;1099146000;1729908000
UNFI;52168;USD;2012;Q4;2012-07-31;2012-09-26;47330000;47666000;16122000;305177000;578555000;946861000;278455000;;268630000;547085000;1493946000;333811000;350000;334161000;635000;181069000;515230000;365088000;;611821000;978716000;1493946000
UNFI;52168;USD;2011;Q4;2011-07-31;2011-09-28;43620000;44145000;16867000;257116000;514506000;844492000;285151000;;271345000;556496000;1400988000;300974000;47447000;348421000;986000;182900000;531321000;345521000;-708000;520534000;869667000;1400988000
UNFI;52168;USD;2010;Q4;2010-07-31;2010-12-09;43485000;43638000;13802000;217097000;439702000;712954000;279255000;;258590000;537845000;1250799000;274272000;5033000;279305000;48433000;341047000;620352000;189162000;-708000;443861000;630447000;1250799000
CMD;52478;USD;2017;Q4;2017-07-31;2017-09-28;41495754;41570838;36584000;110656000;98724000;257371000;88338000;4707000;435957000;529002000;786373000;81497000;;106779000;126000000;155662000;262441000;179221000;-52979000;407590000;523932000;786373000
CMD;52478;USD;2016;Q4;2016-07-31;2016-09-29;41368980;41423569;28367000;93332000;91486000;222742000;74604000;5149000;392037000;471790000;694532000;76162000;;96335000;116000000;143827000;240162000;170181000;-46069000;342053000;454370000;694532000
CMD;52478;USD;2015;Q4;2015-07-31;2015-09-29;41211002;41254661;31720000;69805000;72078000;188361000;62541000;5342000;327787000;395670000;584031000;52301000;;70624000;78500000;106774000;177398000;160641000;-42337000;287105000;406633000;584031000
CMD;52478;USD;2014;Q4;2014-07-31;2014-09-29;40855276;40974597;31781000;62225000;59737000;163909000;52718000;4919000;314599000;372236000;536145000;50397000;;66499000;80500000;104400000;170899000;150612000;-38224000;243306000;365246000;536145000
CMD;52478;USD;2013;Q4;2013-07-31;2013-09-30;40461112;40680179;34076000;52753000;54167000;150660000;46465000;2999000;287547000;337011000;487671000;37771000;10000000;59151000;85000000;107388000;166539000;139371000;-32978000;203762000;321132000;487671000
CMD;52478;USD;2012;Q4;2012-07-31;2012-10-15;39841847;40268397;30186000;47977000;46755000;133892000;43022000;2932000;254966000;300920000;434812000;37027000;10000000;55141000;80000000;103735000;158876000;130338000;-30116000;167539000;275936000;434812000
CMD;52478;USD;2011;Q4;2011-07-31;2011-12-12;;;18410000;46121000;40064000;111324000;34459000;1699000;173961000;210119000;321443000;36693000;;43411000;24000000;43717000;87128000;112651000;-26344000;138725000;234315000;321443000
CMD;52478;USD;2018;Q4;2018-07-31;2018-09-27;41590066;41668562;94097000;118642000;107592000;338243000;111417000;5749000;508299000;625465000;963708000;96169000;10000000;134783000;187302000;220058000;354841000;188836000;-60053000;491540000;608867000;963708000
HQY;52958;USD;2016;Q4;2017-01-31;2016-03-31;59456000;60453000;180359000;17001000;592000;200819000;5170000;;73147000;78317000;279136000;15703000;;15703000;;1493000;17196000;232120000;;29985000;261940000;279136000
HQY;52958;USD;2015;Q4;2016-01-31;2015-03-31;57730000;59487000;123775000;14308000;620000;143048000;3506000;;73241000;76747000;219795000;12106000;;12106000;;4232000;16338000;199946000;;3609000;203457000;219795000
HQY;52958;USD;2014;Q4;2015-01-31;2014-09-12;55544000;64455000;13917000;5705000;391000;23756000;1992000;;29342000;31334000;55090000;9429000;;9429000;;13987000;23416000;1000;;-23170000;31674000;55090000
HQY;52958;USD;2017;Q4;2018-01-31;2016-12-08;60761000;62383000;240269000;21602000;215000;265396000;7836000;;95927000;103763000;369159000;20490000;;20490000;;2395000;22885000;261243000;;85300000;346274000;369159000
HQY;52958;USD;2018;Q4;2019-01-31;2019-03-28;62206000;63467000;361475000;25668000;;396354000;8223000;709000;104730000;113662000;510016000;29053000;;29053000;;3884000;32937000;305229000;;171850000;477079000;510016000
PURE;53064;USD;2017;Q4;2017-07-31;2017-10-26;62849033;62849033;1640000;297000;273000;2459000;548000;;822000;1370000;3829000;675000;;2528000;;11000;2539000;110772000;;-109482000;1290000;3829000
PURE;53064;USD;2016;Q4;2016-07-31;2016-10-27;64178648;54315790;5194000;263000;350000;6142000;440000;;980000;1420000;7562000;695000;;2536000;;3000;2539000;108242000;;-103219000;5023000;7562000
PURE;53064;USD;2015;Q4;2015-07-31;2015-10-28;41278322;41278322;1321000;189000;207000;1979000;90000;;1192000;1282000;3261000;806000;;869000;;9000;878000;91231000;;-88848000;2383000;3261000
PURE;53064;USD;2014;Q4;2014-07-31;2014-10-28;28874126;28874126;86000;47000;249000;478000;36000;;1345000;1381000;1859000;1497000;;1829000;;13000;1842000;81238000;;-81221000;17000;1859000
PURE;53064;USD;2013;Q4;2013-07-31;2013-10-24;12389577;12389577;32000;18000;365000;486000;146000;;1430000;1576000;2062000;1734000;368000;2153000;;900000;3053000;69180000;;-70171000;-991000;2062000
PURE;53064;USD;2012;Q4;2012-07-31;2012-10-29;6282240;6282240;877000;373000;654000;2251000;257000;;1950000;2207000;4458000;2290000;0;3637000;;3000;3640000;63318000;;-62500000;818000;4458000
PURE;53064;USD;2011;Q4;2011-07-31;2011-12-22;4363283;4363283;1794000;50000;861000;2805000;426000;;1917000;2343000;5148000;935000;;935000;;6000;941000;57817000;;-53610000;4207000;5148000
PURE;53064;USD;2018;Q4;2018-07-31;2018-10-25;68093624;68093624;851000;275000;197000;1456000;461000;;658000;1119000;2575000;778000;503000;1281000;;13000;1294000;118205000;;-116924000;1281000;2575000
ONVO;53151;USD;2016;Q4;2017-03-31;2016-06-09;92453950;92453950;62751000;647000;550000;65092000;3840000;;248000;4088000;69180000;5272000;;6011000;;807000;6818000;261690000;;-199317000;62362000;69180000
ONVO;53151;USD;2015;Q4;2016-03-31;2015-06-09;80933971;80933971;62091000;259000;334000;63652000;3711000;;213000;3924000;67576000;3237000;;4490000;;905000;5395000;223051000;;-160870000;62181000;67576000
ONVO;53151;USD;2014;Q4;2015-03-31;2014-06-10;77812321;77812321;48167000;;63000;49161000;857000;;167800;1024800;50185800;1148000;10000;1893000;;9000;1902000;140497000;;-92213000;48284000;50186000
ONVO;53151;USD;2013;Q4;2014-03-31;2013-05-24;;;15628000;101000;88000;16144000;1045000;;186000;1231000;17375000;1421000;10000;8382000;;24000;8406000;75334000;;-66365000;8969000;17375000
ONVO;53151;USD;2012;Q4;2013-03-31;2013-03-15;172480578957;172480578957;14817000;162000;360000;15866000;714000;;169000;883000;16749000;1406000;10000;22035000;;17000;22052000;44942000;;-50245000;-5303000;16749000
ONVO;53151;USD;2011;Q4;2012-03-31;2011-10-31;91668162363;91668162363;340000;;292000;1031000;278000;;100000;378000;1409000;1120000;704000;3244000;;0;3244000;4857000;;-6692000;-1835000;1409000
ONVO;53151;USD;2017;Q4;2018-03-31;2018-05-31;110643183;110643183;43726000;1028000;842000;46760000;2788000;;279000;3067000;49827000;3805000;;4658000;;583000;5241000;278706000;;-234120000;44586000;49827000
ONVO;53151;USD;2018;Q4;2019-03-31;2019-06-03;119811365;119811365;36477000;558000;490000;38574000;1832000;;217000;2049000;40623000;3177000;;3737000;;588000;4325000;297053000;;-260755000;36298000;40623000
SPPI;53529;USD;2016;Q4;2016-12-31;2017-03-14;77820618;77820618;158469000;39782000;8715000;216650000;449000;;211669000;212118000;428768000;61464000;;65513000;97043000;127229000;192742000;640246000;;-402641000;236026000;428768000
SPPI;53529;USD;2015;Q4;2015-12-31;2016-03-14;63327260;63327260;139986000;30384000;4176000;190625000;918000;;227506000;228424000;419049000;64727000;;76343000;99377000;129849000;206192000;552176000;;-334123000;212857000;419049000
SPPI;53529;USD;2014;Q4;2014-12-31;2015-03-13;66011074;66011074;133248000;70758000;9200000;222469000;1405000;;266159000;267564000;490033000;93438000;;109439000;96298000;126040000;235479000;538619000;;-283338000;254554000;490033000
SPPI;53529;USD;2013;Q4;2013-12-31;2014-03-12;62854595;62854595;159777000;49483000;13519000;235190000;1535000;;262430000;263965000;499155000;86709000;;89984000;91480000;127565000;217549000;518208000;;-237619000;281606000;499155000
SPPI;53529;USD;2012;Q4;2012-12-31;2013-12-06;58215874;64763905;143008000;92169000;14478000;264873000;2548000;;237534000;240082000;504955000;110087000;;123243000;75000000;93031000;216274000;463770000;;-175485000;288681000;504955000
SPPI;53529;USD;2011;Q4;2011-12-31;2012-03-02;55726449;58574193;161262000;51703000;10762000;225801000;2681000;9283000;43015000;54979000;280780000;56559000;;78537000;9000;14336000;92873000;452820000;-2926000;-261883000;187907000;280780000
SPPI;53529;USD;2010;Q4;2010-12-31;2011-08-04;50572681;50572681;95674000;21051000;4234000;121865000;3158000;8569000;30039000;41766000;163631000;42017000;;63322000;40000;25833000;89155000;384808000;0;-310400000;74476000;163631000
SPPI;53529;USD;2017;Q4;2017-12-31;2018-03-07;99899932;99899932;227571000;32260000;5715000;277746000;589000;;209104000;209693000;487439000;67378000;;71525000;38224000;64575000;136100000;837447000;;-502107000;351339000;487439000
SPPI;53529;USD;2018;Q4;2018-12-31;2019-02-28;105710437;95690346;203988000;29873000;;250688000;385000;;139813000;140198000;390886000;79313000;;86474000;;21150000;107624000;886850000;;-599886000;283262000;390886000
SYUT;53873;USD;2016;Q4;2016-12-31;2016-06-13;56714000;56714000;102667000;29911000;98360000;361997000;302726000;;152374000;455100000;817097000;79583000;190679000;345197000;322827000;335100000;680297000;134699000;;-14810000;136800000;817097000
SYUT;53873;USD;2015;Q4;2015-12-31;2015-06-12;57301000;57301000;102667000;29911000;98360000;361997000;302726000;;152374000;455100000;817097000;79583000;190679000;345197000;322827000;335100000;680297000;134699000;;-14810000;136800000;817097000
SYUT;53873;USD;2014;Q4;2014-12-31;2014-06-16;57301000;57301000;90915000;17763000;83986000;285256000;156790000;;108637000;265427000;550683000;39616000;207422000;310266000;168431000;179161000;489427000;135446000;;-104579000;61256000;550683000
SYUT;53873;USD;2013;Q4;2013-12-31;2013-06-13;57301000;57301000;79050000;30183000;87707000;286455000;140950000;;48739000;189689000;476144000;48717000;210112000;326461000;110012000;120476000;446937000;135446000;;-135508000;29207000;476144000
SYUT;53873;USD;2012;Q4;2012-12-31;2012-06-14;57301000;57301000;64793000;38753000;75499000;257143000;145100000;;45670000;190770000;447913000;70927000;127445000;246578000;97471000;104243000;350821000;135446000;;-71620000;97092000;447913000
SYUT;53873;USD;2011;Q4;2011-12-31;2011-08-12;57265000;57028000;48741000;46021000;67372000;247989000;115907000;;34808000;150715000;398704000;52923000;162412000;248468000;68262000;74310000;322778000;135446000;;-88357000;75926000;398704000
RAX;53986;USD;2015;Q4;2015-12-31;2016-06-13;133200000;134700000;484700000;174400000;;718400000;1148000000;;147800000;1295800000;2014200000;205600000;1700000;236900000;656900000;809200000;1046100000;834600000;;169700000;968100000;2014200000
RAX;53986;USD;2014;Q4;2014-12-31;2015-03-02;141900000;145200000;213500000;156500000;;412400000;1057700000;;146000000;1203700000;1616100000;215800000;40100000;276800000;118900000;270100000;546900000;696100000;;393800000;1069200000;1616100000
RAX;53986;USD;2013;Q4;2013-12-31;2014-03-03;139933000;143102000;259733000;123898000;;438968000;890776000;;162053000;1052829000;1491797000;195894000;39746000;258508000;25172000;177877000;436385000;636801000;;423147000;1055412000;1491797000
RAX;53986;USD;2012;Q4;2012-12-31;2013-03-01;137075000;142836000;292061000;92834000;;425245000;724985000;;145321000;870306000;1295551000;175128000;63046000;255439000;62326000;196465000;451904000;515326000;;336410000;843647000;1295551000
RAX;53986;USD;2011;Q4;2011-12-31;2012-02-17;131475000;139699000;159856000;68709000;;263365000;627490000;;135627000;763117000;1026482000;156004000;66910000;237749000;72216000;189310000;427059000;383163000;;230992000;599423000;1026482000
RAX;53986;USD;2010;Q4;2010-12-31;2011-02-22;126503000;135178000;104941000;47734000;;185445000;495228000;;80904000;576132000;761577000;111645000;61675000;189142000;70052000;133572000;322714000;296698000;;154581000;438863000;761577000
RAX;53986;USD;2009;Q4;2009-12-31;2010-08-24;481920636;509302453;125425000;38732000;;191669000;432971000;;44005000;476976000;668645000;89773000;51308000;158194000;116078000;161024000;319218000;251461000;;108223000;349427000;668645000
VIRC;54439;USD;2016;Q4;2017-01-31;2016-04-26;14974000;15148000;815000;9929000;34603000;46688000;34820000;;7774000;42594000;89282000;22115000;579000;22694000;6028000;33275000;55969000;116783000;;-69140000;33313000;89282000
VIRC;54439;USD;2015;Q4;2016-01-31;2015-04-24;14757000;15302000;470000;10614000;26678000;38815000;35221000;;7775000;42996000;81811000;18039000;3366000;21405000;6153000;37833000;59238000;116497000;;-73690000;22573000;81811000
VIRC;54439;USD;2014;Q4;2015-01-31;2014-04-28;14822000;14602000;1051000;8468000;27780000;39639000;36305000;;7400000;43705000;83344000;20408000;2248000;22656000;6000000;33083000;55739000;116125000;;-74540000;27605000;83344000
VIRC;54439;USD;2013;Q4;2014-01-31;2013-04-22;14442000;14228000;853000;8760000;25317000;36962000;36882000;;8319000;45201000;82163000;19811000;4053000;24436000;0;30707000;55143000;115816000;;-72810000;27020000;82163000
VIRC;54439;USD;2012;Q4;2013-01-31;2012-04-25;14217000;14217000;2897000;12743000;27791000;45808000;39208000;;9209000;48417000;94225000;20492000;5497000;27210000;6011000;36119000;63329000;115204000;;-68980000;30896000;94225000
VIRC;54439;USD;2011;Q4;2012-01-31;2011-09-14;14151000;14151000;1528000;10462000;35371000;49515000;42061000;;9012000;51073000;100588000;18607000;12000;20017000;6519000;30169000;50186000;114609000;;-54465000;50402000;100588000
VIRC;54439;USD;2017;Q4;2018-01-31;2018-04-27;15841000;15565000;534000;11385000;42057000;55713000;42442000;;18468000;60910000;116623000;23042000;4681000;27723000;12000000;30188000;57911000;117619000;;-49648000;58712000;116623000
VIRC;54439;USD;2018;Q4;2019-01-31;2019-05-01;15489000;15350000;738000;13253000;47289000;63111000;41920000;;18082000;60002000;123113000;26621000;5504000;32125000;15910000;33961000;66086000;118261000;;-52192000;57027000;123113000
SAIC;54785;USD;2017;Q4;2018-01-31;2016-12-08;39300000;39900000;144000000;674000000;;950000000;61000000;;1062000000;1123000000;2073000000;654000000;41000000;695000000;983000000;1051000000;1746000000;0;;323000000;327000000;2073000000
SAIC;54785;USD;2016;Q4;2017-01-31;2016-03-29;45400000;47000000;210000000;539000000;71000000;901000000;60000000;;1081000000;1141000000;2042000000;598000000;25000000;623000000;1022000000;1070000000;1693000000;91000000;;260000000;349000000;2042000000
SAIC;54785;USD;2015;Q4;2016-01-31;2015-03-31;45500000;47500000;195000000;635000000;68000000;952000000;71000000;;1099000000;1170000000;2122000000;631000000;57000000;688000000;1013000000;1054000000;1742000000;215000000;;174000000;380000000;2122000000
SAIC;54785;USD;2014;Q4;2015-01-31;2014-04-09;48600000;49700000;254000000;621000000;59000000;994000000;60000000;;393000000;453000000;1447000000;536000000;13000000;564000000;489000000;506000000;1070000000;349000000;;30000000;377000000;1447000000
SAIC;54785;USD;2013;Q4;2014-01-31;2013-10-15;47400000;48800000;1000000;691000000;;809000000;29000000;;407000000;436000000;1245000000;620000000;2000000;638000000;1000000;607000000;1245000000;0;;;0;1245000000
SAIC;54785;USD;2018;Q4;2019-01-31;2019-03-29;46200000;46600000;237000000;1050000000;;1433000000;103000000;;3027000000;3130000000;4563000000;873000000;24000000;897000000;2065000000;2167000000;3064000000;1132000000;;367000000;1499000000;4563000000
ADT;54871;USD;2015;Q4;2015-09-30;2015-11-12;168000000;169000000;78000000;102000000;76000000;399000000;283000000;;10044000000;10327000000;10726000000;190000000;5000000;658000000;5389000000;7149000000;7807000000;2376000000;;633000000;2919000000;10726000000
ADT;54871;USD;2014;Q4;2014-09-30;2014-11-12;176000000;176000000;66000000;101000000;76000000;409000000;265000000;;9875000000;10140000000;10549000000;208000000;4000000;708000000;5096000000;6713000000;7421000000;2645000000;;445000000;3128000000;10549000000
ADT;54871;USD;2013;Q4;2013-09-30;2013-11-20;212000000;212000000;138000000;86000000;66000000;580000000;235000000;;9098000000;9333000000;9913000000;246000000;3000000;758000000;3373000000;4833000000;5591000000;3959000000;;283000000;4322000000;9913000000
ADT;54871;USD;2012;Q4;2012-09-30;2013-01-31;232000000;236000000;234000000;78000000;42000000;440000000;217000000;;8603000000;8820000000;9260000000;144000000;2000000;572000000;2525000000;3531000000;4103000000;5064000000;;0;5157000000;9260000000
MGCD;55248;USD;2016;Q4;2016-10-31;2017-01-30;4333000;4310000;7265000;8286000;4916000;21053000;2632000;;6993000;9625000;30678000;3824000;0;9381000;;4374000;13755000;25293000;;-8129000;16923000;30678000
MGCD;55248;USD;2015;Q4;2015-10-31;2016-01-29;4270000;4276000;6553000;7416000;6759000;21716000;2894000;;10978000;13872000;35588000;4110000;785000;10357000;2158000;5304000;15661000;24545000;;-4355000;19927000;35588000
MGCD;55248;USD;2014;Q4;2014-10-31;2015-01-29;4199000;4125000;5675000;7068000;5548000;20716000;3469000;;8199000;11668000;32384000;4577000;786000;10831000;2947000;6108000;16939000;23890000;;-8331000;15445000;32384000
MGCD;55248;USD;2013;Q4;2013-10-31;2014-01-28;4092000;4212000;10574000;8048000;3499000;23223000;779000;;2189000;2968000;26191000;2776000;;7812000;;2535000;10347000;23019000;;-7175000;15844000;26191000
MGCD;55248;USD;2012;Q4;2012-10-31;2013-01-29;3888000;3888000;9665000;5710000;3721000;19793000;578000;;1577000;2155000;21948000;2627000;;6303000;;895000;7198000;21434000;;-6684000;14750000;21948000
MGCD;55248;USD;2011;Q4;2011-10-31;2012-01-27;3768000;4005000;9184000;5958000;3688000;19127000;440000;;1205000;1645000;20772000;2243000;;5636000;;817000;6453000;21000000;;-6683000;14319000;20772000
MGCD;55248;USD;2010;Q4;2010-10-31;2011-09-14;4053000;4053000;9664000;5221000;3697000;18852000;528000;722000;1279000;2529000;21381000;2359000;;6171000;;873000;7044000;20861000;;-6531000;14337000;21381000
EEI;55609;USD;2017;Q4;2017-07-31;2017-11-14;4297067;4297067;14841000;35107000;;53360000;4428000;;2989000;7417000;60777000;17056000;963000;20869000;66000;100000;20969000;17652000;-1037000;23509000;39808000;60777000
EEI;55609;USD;2016;Q4;2016-07-31;2016-11-15;4289636;4289636;11660000;34319000;;48999000;6094000;;4419000;10513000;59512000;16909000;552000;20758000;217000;849000;21607000;16650000;-1172000;22237000;37905000;59512000
EEI;55609;USD;2015;Q4;2015-07-31;2015-10-29;4286898;4286898;10137000;42866000;;54631000;7114000;;6744000;13858000;68489000;23029000;1223000;26870000;395000;1134000;28004000;16619000;-1224000;23246000;40485000;68489000
EEI;55609;USD;2014;Q4;2014-07-31;2014-10-29;4294169;4294169;8296520;44431305;;59792806;7941455;;3974061;11915516;71708322;21759988;1993203;28756604;421769;1159887;29916491;17168277;-1223899;21916575;41791831;71708322
EEI;55609;USD;2013;Q4;2013-07-31;2013-11-14;4249703;4249703;10908524;47134007;;68491155;10122801;;3067728;13190529;81681684;21037121;6728349;34203200;251614;839194;35042394;20060811;-1798233;25365853;46639290;81681684
EEI;55609;USD;2012;Q4;2012-07-31;2013-03-12;4244920;4244920;11872352;61568443;;82545793;12112078;;2854284;14966362;97512155;22954918;12797795;44034632;102635;719982;44754614;19795930;-1897032;29534783;52757541;97512155
EEI;55609;USD;2011;Q4;2011-07-31;2012-01-04;;;10021301;63750870;;80975954;9961304;;3330384;13291688;94267642;29579640;1689920;38997285;448391;1312524;40309809;20026967;-2317515;30797763;53957833;94267642
EEI;55609;USD;2018;Q4;2018-07-31;2019-05-31;4313484;4313484;14993000;25615000;;43590000;3870000;2058000;3311000;9239000;52829000;13083000;54000;16328000;54000;54000;16382000;17602000;-907000;20973000;36447000;52829000
LXRX;56235;USD;2016;Q4;2016-12-31;2017-03-06;104055000;104055000;346504000;7492000;0;357874000;19390000;;98361000;117751000;475625000;84991000;16280000;164643000;85167000;153581000;318224000;1411327000;-3368000;-1250363000;157401000;475625000
LXRX;56235;USD;2015;Q4;2015-12-31;2016-03-11;103624000;103624000;521352000;911000;;532400000;21227000;;98333000;119560000;651960000;44482000;1976000;122957000;100960000;243153000;366110000;1397750000;-2747000;-1108934000;285850000;651960000
LXRX;56235;USD;2014;Q4;2014-12-31;2015-03-12;84906000;84906000;339339000;1035000;;368987000;1080000;;101309000;102389000;471376000;23184000;20167000;44969000;87500000;142389000;187358000;1390723000;-2390000;-1104252000;284018000;471376000
LXRX;56235;USD;2013;Q4;2013-12-31;2014-03-07;73294903;73294903;129128000;790000;;134554000;41362000;;98244000;139606000;274160000;17389000;1710000;19294000;20167000;84703000;103997000;1175622000;-1503000;-1003958000;170163000;274160000
LXRX;56235;USD;2012;Q4;2012-12-31;2013-03-11;72567621;72567621;223208000;1378000;;230935000;42634000;;98209000;140843000;371778000;16583000;1574000;18285000;21877000;86815000;105100000;1167117000;-630000;-899832000;266678000;371778000
LXRX;56235;USD;2011;Q4;2011-12-31;2012-03-08;50039436;50039436;281692000;350000;;285790000;46417000;;98305000;144722000;430512000;19828000;1443000;21390000;23451000;111554000;132944000;1087513000;-345000;-789621000;297568000;430512000
LXRX;56235;USD;2010;Q4;2010-12-31;2011-08-09;;;211111000;744000;;214738000;53427000;;98719000;152146000;366884000;9423000;1138000;10775000;27345000;109085000;119860000;920662000;-237000;-673406000;247024000;366884000
LXRX;56235;USD;2017;Q4;2017-12-31;2018-03-01;105605000;105605000;310788000;4825000;1948000;321995000;17687000;;96857000;114544000;436539000;69934000;14094000;124127000;231576000;260310000;384437000;1435632000;-1904000;-1381404000;52102000;436539000
LXRX;56235;USD;2018;Q4;2018-12-31;2019-03-15;105923000;105923000;160052000;5924000;4680000;173324000;15865000;;94947000;110812000;284136000;32241000;1115000;36751000;243887000;273790000;310541000;1448060000;-2876000;-1471577000;-26405000;284136000
TSLA;56317;USD;2018;Q4;2018-12-31;2019-02-19;172064000;164761000;3685618000;949022000;3113446000;8306308000;11330077000;421548000;9681681000;21433306000;29739614000;5498704000;2567699000;9992136000;9959636000;13989838000;23981974000;10249293000;;-5317832000;5757640000;29739614000
TSLA;56317;USD;2017;Q4;2017-12-31;2018-02-23;168397000;168397000;3367914000;515381000;2263537000;6570520000;10027522000;456652000;11600678000;22084852000;28655372000;4121616000;896549000;7674670000;9816123000;15746114000;23420784000;9178193000;;-4974299000;5234588000;28655372000
TSLA;56317;USD;2016;Q4;2016-12-31;2017-03-01;155198000;147254000;3393216000;499142000;2067454000;6259796000;5982957000;506302000;9915021000;16404280000;22664076000;3070369000;1150147000;5827005000;6345323000;11298985000;17125990000;7773888000;;-2997237000;5538086000;22664076000
TSLA;56317;USD;2015;Q4;2015-12-31;2016-02-24;131166000;131166000;1196908000;168965000;1277838000;2782006000;3403334000;;1882599000;5285933000;8067939000;1338946000;627927000;2811035000;2068378000;4173200000;6984235000;3409583000;;-2322323000;1083704000;8067939000
TSLA;56317;USD;2014;Q4;2014-12-31;2015-02-26;125521790;125521790;1905713000;226604000;953675000;3180073000;1829267000;;821327000;2650594000;5830667000;1046829000;611099000;2107166000;1876981000;2811791000;4918957000;2345392000;;-1433660000;911710000;5830667000
TSLA;56317;USD;2013;Q4;2013-12-31;2014-02-26;122837418;122837418;845889000;49109000;340355000;1265939000;738494000;;412497000;1150991000;2416930000;412221000;20759000;688015000;586119000;1061795000;1749810000;1806740000;;-1139620000;667120000;2416930000
TSLA;56317;USD;2012;Q4;2012-12-31;2013-03-07;;;201890000;26842000;268504000;524768000;552229000;;37193000;589422000;1114190000;343180000;65171000;549073000;401495000;440417000;989490000;1190306000;;-1065606000;124700000;1114190000
TSLA;56317;USD;2011;Q4;2011-12-31;2012-02-27;;;280327000;9539000;50082000;372838000;298414000;;42196000;340610000;713448000;88250000;11813000;194169000;268335000;295234000;489403000;893440000;;-669392000;224045000;713448000
TSLA;56317;USD;2010;Q4;2010-12-31;2011-08-12;;;99558000;6710000;45182000;235886000;114636000;;35560000;150196000;386082000;49896000;775000;86061000;71828000;92973000;179034000;622030000;;-414982000;207048000;386082000
NATI;56422;USD;2017;Q4;2017-12-31;2018-02-22;130905000;132706000;412052000;248825000;184592000;894090000;249715000;;422629000;672344000;1566434000;148617000;;269255000;;169158000;438413000;831289000;;313241000;1128021000;1566434000
NATI;56422;USD;2016;Q4;2016-12-31;2017-02-16;129120000;130136000;358400000;228686000;193608000;834647000;260456000;;401461000;661917000;1496564000;144498000;;260075000;25000000;122270000;382345000;772638000;;376202000;1114219000;1496564000
NATI;56422;USD;2015;Q4;2015-12-31;2016-02-19;127331000;128430000;332918000;216244000;185197000;799740000;257853000;;396263000;654116000;1453856000;127932000;;240215000;37000000;131920000;372135000;718980000;;400831000;1081721000;1453856000
NATI;56422;USD;2014;Q4;2014-12-31;2015-02-19;127782000;129056000;471193000;202329000;173052000;947820000;264086000;;243585000;507671000;1455491000;141693000;;247657000;;90338000;337995000;664167000;;464993000;1117496000;1455491000
NATI;56422;USD;2013;Q4;2013-12-31;2014-02-20;125517000;127041000;393412000;180680000;172109000;828595000;260568000;;254388000;514956000;1343551000;129238000;;225355000;;95112000;320467000;605587000;;414947000;1023084000;1343551000
NATI;56422;USD;2012;Q4;2012-12-31;2013-02-19;122781000;124103000;335162000;187060000;169990000;767700000;249721000;;267348000;517069000;1284769000;154242000;;244956000;;100685000;345641000;534074000;;404210000;939128000;1284769000
NATI;56422;USD;2011;Q4;2011-12-31;2012-02-07;120607000;122174000;366112000;157056000;131995000;719549000;190148000;;244597000;434745000;1154294000;132846000;;212905000;;89378000;302283000;473037000;;382474000;852011000;1154294000
NATI;56422;USD;2010;Q4;2010-12-31;2011-02-18;117660000;119855000;350662000;127214000;117765000;650718000;160410000;;148554000;308964000;959682000;94662000;;166312000;;48825000;215137000;408892000;;336363000;744545000;959682000
NATI;56422;USD;2009;Q4;2009-12-31;2010-08-06;116383500;117867000;288661000;103957000;86515000;532178000;153265000;;127586000;280851000;813029000;61177000;;118419000;;40190000;158609000;337220000;;303655000;654420000;813029000
NATI;56422;USD;2018;Q4;2018-12-31;2019-02-21;132587000;134221000;530782000;242955000;194146000;1022220000;245201000;;403814000;649015000;1671235000;155696000;;282984000;;149893000;432877000;898871000;;356418000;1238358000;1671235000
CLC;57096;USD;2016;Q4;2016-12-31;2017-01-27;48591862;48926036;134878000;229762000;237627000;625346000;294602000;;819144000;1113746000;1739092000;186110000;17700000;203810000;267753000;393769000;597579000;48567000;;1214922000;1141513000;1739092000
CLC;57096;USD;2015;Q4;2015-12-31;2016-01-22;49359490;49609086;101529000;258280000;274825000;664795000;301019000;;852642000;1153661000;1818456000;195912000;7788000;203700000;397368000;504291000;707991000;49111000;;1148510000;1110465000;1818456000
WY;57524;USD;2017;Q4;2017-12-31;2018-02-16;755510000;758563000;824000000;396000000;383000000;1715000000;14797000000;;1547000000;16344000000;18059000000;894000000;271000000;1165000000;6232000000;7995000000;9160000000;9383000000;;1078000000;8899000000;18059000000
WY;57524;USD;2016;Q4;2016-12-31;2017-02-24;749509000;752987000;676000000;390000000;358000000;1622000000;16074000000;56000000;1491000000;17621000000;19243000000;925000000;281000000;1206000000;6840000000;8857000000;10063000000;9218000000;;1421000000;9180000000;19243000000
WY;57524;USD;2015;Q4;2015-12-31;2016-02-17;511131000;514157000;1011000000;276000000;325000000;3639000000;7929000000;0;1152000000;9081000000;12720000000;631000000;4000000;1325000000;5298000000;6526000000;7851000000;4718000000;;1349000000;4869000000;12720000000
WY;57524;USD;2014;Q4;2014-12-31;2015-02-13;523931000;528506000;1580000000;525000000;595000000;2805000000;9284000000;188000000;988000000;10460000000;13265000000;918000000;;918000000;5402000000;7043000000;7961000000;5175000000;;1508000000;5304000000;13265000000
WY;57524;USD;2013;Q4;2013-12-31;2014-02-18;584399000;589404000;830000000;518000000;542000000;2326000000;9381000000;190000000;2680000000;12251000000;14577000000;972000000;2000000;1128000000;5402000000;6651000000;7779000000;7173000000;;294000000;6798000000;14577000000
WY;57524;USD;2012;Q4;2012-12-31;2013-02-19;542132000;547168000;898000000;523000000;531000000;2407000000;7854000000;213000000;2118000000;10185000000;12592000000;1035000000;570000000;1605000000;4393000000;6874000000;8479000000;5409000000;;219000000;4113000000;12592000000
WY;57524;USD;2018;Q4;2018-12-31;2019-02-15;748594000;749924000;334000000;337000000;389000000;1602000000;14664000000;;983000000;15647000000;17249000000;712000000;500000000;1939000000;5419000000;6264000000;8203000000;9105000000;;1093000000;9046000000;17249000000
ENG;58098;USD;2015;Q4;2015-12-31;2016-03-03;28090000;-83889908;7806000;24097000;;37424000;2145000;;12631000;14776000;52200000;6268000;;11870000;318000;318000;12188000;37213000;;2799000;40012000;52200000
ENG;58098;USD;2014;Q4;2014-12-31;2015-03-12;28238000;28116000;6213000;30026000;;42848000;2074000;;6734000;8808000;51656000;9492000;;22408000;216000;216000;22624000;39131000;-2362000;-7737000;29032000;51656000
ENG;58098;USD;2013;Q4;2013-12-31;2014-03-14;26999000;26889000;3955000;26846000;;36553000;2655000;;6593000;9248000;45801000;11946000;;22978000;340000;340000;23318000;38683000;-2362000;-13768000;22483000;45801000
ENG;58098;USD;2012;Q4;2012-12-31;2013-04-15;53735187;53735187;738000;52470000;;66691000;2997000;;8999000;11996000;78687000;19356000;26829000;53388000;;0;53388000;38510000;-2362000;-10779000;25299000;78687000
ENG;58098;USD;2011;Q4;2011-12-31;2012-04-12;27133000;27133000;26000;54020000;;77732000;3260000;;23187000;26447000;104179000;19573000;16602000;45679000;;0;45679000;38109000;-2362000;22822000;58500000;104179000
ENG;58098;USD;2010;Q4;2010-12-31;2011-08-04;;;49000;52465000;;75170000;4416000;;30738000;35154000;110324000;19669000;21163000;44970000;252000;252000;45222000;37636000;-2362000;29920000;65102000;110324000
ENG;58098;USD;2016;Q4;2016-12-31;2017-03-10;-83370388;-83370388;15687000;10455000;;29816000;1194000;;13426000;14620000;44436000;4975000;;7616000;14000;14000;7630000;36349000;;457000;36806000;44436000
ENG;58098;USD;2017;Q4;2017-12-31;2018-03-15;54799812;54799812;9648000;9114000;;25029000;1027000;;3196000;4223000;29252000;5781000;;8182000;1000;1000;8183000;36870000;;-15801000;21069000;29252000
ENG;58098;USD;2018;Q4;2018-12-31;2019-03-28;54993486;54993486;6060000;10211000;;20542000;677000;;1087000;1764000;22306000;5473000;;6817000;0;0;6817000;36961000;;-21472000;15489000;22306000
AZO;58197;USD;2015;Q4;2015-12-31;2015-10-26;30562000;31222000;175309000;247872000;3421635000;3970294000;3505632000;;626423000;4132055000;8102349000;4712873000;;4712873000;4624876000;5090866000;9803739000;938676000;-971810000;-1418738000;-1701390000;8102349000
AZO;58197;USD;2016;Q4;2016-12-31;2016-10-24;29079000;29631000;189734000;287680000;3631916000;4239573000;3733254000;;626960000;4360214000;8599787000;4690320000;;4690320000;4924119000;5697005000;10387325000;1054950000;-932773000;-1602186000;-1787538000;8599787000
AZO;58197;USD;2017;Q4;2017-12-31;2017-10-25;27805000;28212000;293270000;280733000;3882086000;4611255000;4031018000;;617508000;4648526000;9259781000;5137412000;;5137412000;5081238000;5550746000;10688158000;1086958000;-618391000;-1642387000;-1428377000;9259781000
AZO;58197;USD;2018;Q4;2018-12-31;2018-10-24;25961000;26389000;217824000;258136000;3943670000;4635869000;4218400000;;492711000;4711111000;9346980000;5313885000;;5313885000;5005930000;5553450000;10867335000;1155701000;-1231427000;-1208824000;-1520355000;9346980000
TPB;58275;USD;2015;Q4;2015-12-31;2016-06-15;7198536;9530060;4835000;3940000;44339000;63952000;5603000;;172908000;178511000;242463000;19469000;1650000;21137000;290772000;302938000;324075000;12700000;;-90800000;-81612000;242463000
DELL;59180;USD;2013;Q4;2014-01-31;2013-03-12;3147590000;3169310000;12777000000;6629000000;1382000000;27968000000;2126000000;2565000000;14881000000;19572000000;47540000000;11579000000;3843000000;23439000000;5242000000;13400000000;36839000000;12554000000;-32145000000;30330000000;10701000000;47540000000
DELL;59180;USD;2012;Q4;2013-01-31;2012-03-13;3209130000;3239900000;14818000000;6476000000;1404000000;29448000000;2124000000;3404000000;9557000000;15085000000;44533000000;11656000000;2867000000;22001000000;6387000000;13615000000;35616000000;12187000000;-31445000000;28236000000;8917000000;44533000000
DELL;59180;USD;2011;Q4;2012-01-31;2011-03-15;3482440000;3507780000;14365000000;6493000000;1301000000;29021000000;1953000000;704000000;6921000000;9578000000;38599000000;11293000000;851000000;19483000000;5146000000;11350000000;30833000000;11797000000;-28704000000;24744000000;7766000000;38599000000
DELL;59180;USD;2010;Q4;2011-01-31;2010-03-18;3540360000;3565700000;11008000000;5837000000;1051000000;24245000000;2181000000;781000000;6445000000;9407000000;33652000000;11373000000;663000000;18960000000;3417000000;9051000000;28011000000;11472000000;-27904000000;22110000000;5641000000;33652000000
DELL;59180;USD;2009;Q4;2010-01-31;2009-09-11;3513210000;3529500000;9092000000;4731000000;867000000;20151000000;2277000000;454000000;3618000000;6349000000;26500000000;8309000000;113000000;14859000000;1898000000;7370000000;22229000000;11189000000;-27904000000;20677000000;4271000000;26500000000
MSFT;59265;USD;2018;Q4;2018-06-30;2018-08-03;7684000000;7873000000;133768000000;26481000000;2662000000;169662000000;29460000000;1862000000;57864000000;89186000000;258848000000;16841000000;3998000000;58488000000;72242000000;117642000000;176130000000;71223000000;;13682000000;82718000000;258848000000
MSFT;59265;USD;2017;Q4;2017-06-30;2017-04-27;7715000000;7809000000;132981000000;22431000000;2181000000;162696000000;23734000000;6023000000;57859000000;87616000000;250312000000;13927000000;10121000000;55745000000;76073000000;106856000000;162601000000;69315000000;;17769000000;87711000000;250312000000
MSFT;59265;USD;2016;Q4;2016-06-30;2016-07-28;7845000000;7932000000;113240000000;18277000000;2251000000;139660000000;18356000000;10431000000;25021000000;53808000000;193468000000;12742000000;12904000000;59357000000;40557000000;62114000000;121471000000;68178000000;;2282000000;71997000000;193468000000
MSFT;59265;USD;2015;Q4;2015-06-30;2015-07-31;8064000000;8131000000;96526000000;17908000000;2902000000;122797000000;14731000000;12053000000;24891000000;51675000000;174472000000;12293000000;7484000000;49647000000;27808000000;44742000000;94389000000;68465000000;;9096000000;80083000000;174472000000
MSFT;59265;USD;2014;Q4;2014-06-30;2014-07-31;8247000000;8400000000;85709000000;19544000000;2660000000;114246000000;13011000000;14597000000;30530000000;58138000000;172384000000;13011000000;2000000000;45625000000;20645000000;36975000000;82600000000;68366000000;;17710000000;89784000000;172384000000
MSFT;59265;USD;2013;Q4;2013-06-30;2013-07-30;8347000000;8513000000;77022000000;17486000000;1938000000;101466000000;9991000000;10844000000;20130000000;40965000000;142431000000;9537000000;2999000000;37417000000;12601000000;26070000000;63487000000;67306000000;;9895000000;78944000000;142431000000
MSFT;59265;USD;2012;Q4;2012-06-30;2012-07-26;8389000000;8571000000;63040000000;15780000000;1137000000;85084000000;8269000000;9776000000;18142000000;36187000000;121271000000;8839000000;1231000000;32688000000;10713000000;22220000000;54908000000;65797000000;;-856000000;66363000000;121271000000
MSFT;59265;USD;2011;Q4;2011-06-30;2011-07-28;8429000000;8597000000;52772000000;14987000000;1372000000;74918000000;8162000000;10865000000;14759000000;33786000000;108704000000;8352000000;0;28774000000;11921000000;22847000000;51621000000;63415000000;;-6332000000;57083000000;108704000000
MSFT;59265;USD;2010;Q4;2010-06-30;2010-07-30;8715000000;8898000000;36788000000;13014000000;740000000;55676000000;7630000000;7754000000;15053000000;30437000000;86113000000;8382000000;1000000000;26147000000;4939000000;13791000000;39938000000;62856000000;;-16681000000;46175000000;86113000000
MSFT;59265;USD;2009;Q4;2009-06-30;2009-10-23;8902000000;8983000000;31447000000;11192000000;717000000;49280000000;7535000000;4933000000;16140000000;28608000000;77888000000;7205000000;2000000000;27034000000;3746000000;11296000000;38330000000;62382000000;;-22824000000;39558000000;77888000000
MSFT;59265;USD;2019;Q4;2019-06-30;2019-08-01;7655000000;7734000000;133819000000;29524000000;2063000000;175552000000;36477000000;2649000000;71878000000;111004000000;286556000000;21877000000;5516000000;69420000000;66662000000;114806000000;184226000000;78520000000;;24150000000;102330000000;286556000000
ITI;59550;USD;2017;Q4;2018-03-31;2018-02-07;33093000;31712000;15471000;12866000;2921000;39896000;2333000;;20657000;22990000;62886000;17594000;;22494000;;871000;23365000;143040000;;-103519000;39521000;62886000
ITI;59550;USD;2016;Q4;2017-03-31;2017-06-13;32322000;32322000;18201000;14299000;2250000;43314000;2064000;;16967000;19031000;62345000;16530000;;20579000;;1542000;22121000;140217000;;-99993000;40224000;62345000
ITI;59550;USD;2015;Q4;2016-03-31;2016-06-20;32045000;32045000;16029000;13241000;3153000;39178000;2139000;;18703000;20842000;60020000;12633000;;14927000;;1631000;16558000;138629000;;-95167000;43462000;60020000
ITI;59550;USD;2014;Q4;2015-03-31;2015-06-18;32570000;32570000;21961000;11206000;3062000;44513000;1990000;;24129000;26119000;70632000;12106000;;13655000;;1009000;14664000;138814000;;-82846000;55968000;70632000
ITI;59550;USD;2013;Q4;2014-03-31;2014-09-04;32777000;32911000;20414000;12349000;2546000;43826000;1546000;;25235000;26781000;70607000;11527000;;12918000;;199000;13117000;139266000;;-81776000;57490000;70607000
ITI;59550;USD;2012;Q4;2013-03-31;2013-06-07;32992000;33160000;18678000;10946000;2465000;42109000;1862000;;25540000;27402000;69511000;10764000;;12722000;;908000;13630000;139066000;;-83185000;55881000;69511000
ITI;59550;USD;2011;Q4;2012-03-31;2012-06-11;34026000;34190000;18701000;11081000;2454000;40925000;1948000;;26867000;28815000;69740000;10384000;634000;12560000;;1708000;14268000;141036000;;-85564000;55472000;69740000
ITI;59550;USD;2010;Q4;2011-03-31;2011-08-05;34347000;33933000;11818000;9419000;2392000;31058000;2461000;;37049000;39510000;70568000;9689000;2324000;13348000;640000;3924000;17272000;141374000;;-88078000;53296000;70568000
ITI;59550;USD;2018;Q4;2019-03-31;2019-06-06;33324000;33324000;9006000;16929000;2916000;36705000;1965000;;19285000;21250000;57955000;18347000;;23230000;;670000;23900000;145598000;;-111543000;34055000;57955000
BV;59824;USD;2016;Q4;2016-04-30;2017-06-16;83712000;83712000;91183000;43713000;;142515000;28358000;;151082000;179440000;321955000;4310000;;126568000;;9082000;135650000;455763000;0;-267776000;186305000;321955000
BV;59824;USD;2015;Q4;2015-04-30;2016-06-20;81488000;81488000;94645000;39597000;;142657000;31649000;;153976000;185625000;328282000;6110000;;92012000;42000000;51736000;143748000;437247000;0;-251835000;184534000;328282000
BV;59824;USD;2014;Q4;2014-04-30;2015-06-25;79636000;79636000;106771000;49532000;;169280000;19054000;;154627000;173681000;342961000;3539000;;91336000;57000000;60242000;151578000;418517000;0;-226496000;191383000;342961000
BV;59824;USD;2013;Q4;2013-04-30;2014-06-26;77114000;77114000;72634000;39099000;;154294000;17005000;;155971000;172976000;327270000;3346000;;115989000;;4819000;120808000;398209000;0;-192075000;206462000;327270000
BV;59824;USD;2012;Q4;2012-04-30;2013-07-03;73107000;73107000;95335000;27582000;;182139000;14461000;;145343000;159804000;341943000;6362000;;94010000;;6584000;100594000;370404000;0;-128909000;241349000;341943000
BV;59824;USD;2011;Q4;2011-04-30;2012-09-10;47761000;47761000;125201000;17977000;;147551000;8868000;;448000;9316000;156867000;2523000;;57400000;;5869000;63269000;158775000;0;-65157000;93598000;156867000
BBBY;60362;USD;2017;Q4;2018-03-31;2018-05-02;137335000;137814000;724179000;;2730874000;3971078000;1909289000;19517000;1140922000;3069728000;7040806000;1830604000;;2165685000;1492078000;1986493000;4152178000;2061393000;-10467972000;11343503000;2888628000;7040806000
BBBY;60362;USD;2016;Q4;2017-03-31;2017-04-25;144835000;145982000;488329000;;2905660000;3591901000;1837129000;89592000;1304033000;3230754000;6822655000;1663202000;;2032501000;1491603000;2070877000;4103378000;1978176000;-10215539000;11003890000;2719277000;6822655000
BBBY;60362;USD;2015;Q4;2016-03-31;2016-04-26;157227000;158716000;601770000;;2848119000;3825962000;1725043000;71289000;867783000;2664115000;6490077000;1510403000;;1867225000;1491137000;2063312000;3930537000;1888190000;-9668517000;10394865000;2559540000;6490077000
BBBY;60362;USD;2014;Q4;2015-03-31;2015-04-28;175763000;178134000;985566000;;2731881000;4083603000;1676700000;97160000;901530000;2675390000;6758993000;1559915000;;1942681000;1500000000;2073122000;4015803000;1800059000;-8567932000;9553376000;2743190000;6758993000
BBBY;60362;USD;2013;Q4;2014-03-31;2014-04-29;205551000;208105000;855847000;;2578956000;3788987000;1579804000;87393000;899849000;2567046000;6356033000;1490622000;;1835136000;;579610000;2414746000;1676567000;-6317335000;8595902000;3941287000;6356033000
BBBY;60362;USD;2012;Q4;2013-03-31;2013-04-30;219406000;222240000;1014904000;;2466214000;3867485000;1466667000;77325000;868475000;2412467000;6279952000;1306459000;;1635210000;;565012000;2200222000;1543778000;-5033340000;7573612000;4079730000;6279952000
BBBY;60362;USD;2011;Q4;2012-03-31;2012-04-24;233965000;237504000;1759555000;;2071890000;4142939000;1198255000;95785000;287567000;1581607000;5724546000;1081238000;;1339130000;;462888000;1802018000;1420643000;-4032060000;6535824000;3922528000;5724546000
BBBY;60362;USD;2010;Q4;2011-03-31;2011-04-26;248542000;252814000;1789195000;;1968907000;4073838000;1116297000;121446000;334612000;1572355000;5646193000;1016397000;;1322440000;;392094000;1714534000;1194376000;-2814104000;5546287000;3931659000;5646193000
BBBY;60362;USD;2009;Q4;2010-03-31;2010-04-27;258190000;261883000;1527576000;;1759703000;3563345000;1119292000;132860000;336633000;1588785000;5152130000;892893000;;1149554000;;349672000;1499226000;1023721000;-2126499000;4754954000;3652904000;5152130000
BBBY;60362;USD;2008;Q4;2009-03-31;2009-10-07;256131000;258061000;670209000;;1642339000;2562799000;1148435000;221134000;336475000;1706044000;4268843000;762242000;;952968000;;315421000;1268389000;881715000;-2031642000;4154921000;3000454000;4268843000
BBBY;60362;USD;2018;Q4;2019-03-31;2019-04-30;131960000;130894000;994770000;;2618922000;3909972000;1853091000;20010000;787468000;2660569000;6570541000;1717812000;;2077632000;1487934000;1932578000;4010210000;2122099000;-10616045000;11112887000;2560331000;6570541000
TRNS;60740;USD;2016;Q4;2017-03-31;2016-06-20;7018000;6878000;842000;22049000;10278000;35589000;15568000;;40940000;56508000;92097000;18327000;1429000;19756000;25883000;28940000;48696000;16518000;;27297000;43401000;92097000
TRNS;60740;USD;2015;Q4;2016-03-31;2016-06-20;6911000;7096000;641000;17080000;6520000;26218000;12313000;;38176000;50489000;76707000;15829000;0;15829000;19073000;21967000;37796000;16455000;;22814000;38911000;76707000
TRNS;60740;USD;2014;Q4;2015-03-31;2015-06-25;6821000;7074000;65000;16899000;6750000;27142000;9397000;;25610000;35007000;62149000;11933000;;11933000;12168000;15898000;27831000;15707000;;18754000;34318000;62149000
TRNS;60740;USD;2013;Q4;2014-03-31;2014-06-26;6632000;7026000;23000;15663000;6181000;24135000;7089000;;22650000;29739000;53874000;13857000;;13857000;7593000;9934000;23791000;14745000;;14771000;30083000;53874000
TRNS;60740;USD;2012;Q4;2013-03-31;2013-06-26;7413000;7558000;406000;15411000;6803000;24731000;6885000;;23431000;30316000;55047000;13327000;;13327000;8017000;10070000;23397000;14328000;;16841000;31650000;55047000
TRNS;60740;USD;2011;Q4;2012-03-31;2012-06-20;7332000;7676000;32000;13800000;6396000;22137000;5306000;;17534000;22840000;44977000;13053000;;13053000;3365000;4546000;17599000;14730000;-2194000;14394000;27378000;44977000
TRNS;60740;USD;2010;Q4;2011-03-31;2011-08-05;7258000;7463000;32000;12064000;7571000;21124000;5253000;;14983000;20236000;41360000;12028000;;12028000;5253000;6003000;18031000;13946000;-2194000;11092000;23329000;41360000
TRNS;60740;USD;2017;Q4;2018-03-31;2018-06-08;7144000;7407000;577000;24684000;12651000;40513000;17091000;;39218000;56309000;96822000;19007000;2143000;21150000;20707000;24324000;45474000;18543000;;33086000;51348000;96822000
TRNS;60740;USD;2018;Q4;2019-03-31;2019-06-07;7204000;7584000;788000;27469000;14304000;45006000;19653000;;40571000;60224000;105230000;20250000;1899000;22149000;19103000;23451000;45600000;20072000;;40169000;59630000;105230000
MU;60906;USD;2017;Q4;2017-08-31;2017-10-26;1111000000;1188000000;5428000000;3759000000;3123000000;12457000000;19431000000;617000000;2831000000;22879000000;35336000000;3664000000;1262000000;5334000000;9893000000;10532000000;15866000000;8399000000;-67000000;10260000000;19470000000;35336000000
MU;60906;USD;2016;Q4;2016-08-31;2016-10-28;1037000000;987000000;4398000000;2068000000;2889000000;9495000000;14686000000;1778000000;1581000000;18045000000;27540000000;3879000000;756000000;4835000000;9154000000;9777000000;14612000000;7845000000;-1029000000;5299000000;12928000000;27540000000
MU;60906;USD;2015;Q4;2015-08-31;2015-10-27;1063000000;1125000000;3521000000;2507000000;2340000000;8596000000;10554000000;3492000000;1501000000;15547000000;24143000000;2611000000;1089000000;3905000000;6301000000;6999000000;10904000000;7582000000;-881000000;5588000000;13239000000;24143000000
MU;60906;USD;2014;Q4;2014-08-31;2014-10-27;1067000000;1205000000;4534000000;2906000000;2455000000;10245000000;8682000000;1790000000;1699000000;12171000000;22416000000;2864000000;1618000000;4791000000;4961000000;6063000000;10854000000;7975000000;0;2729000000;11562000000;22416000000
MU;60906;USD;2013;Q4;2013-08-31;2013-10-28;1034000000;1151000000;3101000000;2329000000;2649000000;8911000000;7626000000;895000000;1686000000;10207000000;19118000000;2115000000;1585000000;4125000000;4452000000;4987000000;9112000000;9291000000;;-212000000;10006000000;19118000000
MU;60906;USD;2012;Q4;2012-08-31;2012-10-29;1012500000;1012500000;2559000000;1289000000;1812000000;5758000000;7103000000;763000000;704000000;8570000000;14328000000;1641000000;224000000;2243000000;3038000000;3668000000;5911000000;9022000000;;-1402000000;8417000000;14328000000
MU;60906;USD;2011;Q4;2011-08-31;2011-10-25;992100000;919700000;2160000000;1497000000;2080000000;5832000000;7555000000;535000000;830000000;8920000000;14752000000;1830000000;140000000;2480000000;1861000000;2420000000;4900000000;8708000000;;-370000000;9852000000;14752000000
MU;60906;USD;2010;Q4;2010-08-31;2011-01-11;970700000;1147400000;2913000000;1531000000;1770000000;6668000000;6601000000;582000000;842000000;8025000000;14693000000;1509000000;712000000;2702000000;1648000000;2175000000;4877000000;8545000000;;-536000000;9816000000;14693000000
MU;60906;USD;2009;Q4;2009-08-31;2010-01-12;;;1485000000;798000000;987000000;3344000000;7089000000;315000000;711000000;8115000000;11459000000;1037000000;424000000;1892000000;2379000000;2628000000;4520000000;7342000000;;-2385000000;6939000000;11459000000
MU;60906;USD;2018;Q4;2018-08-31;2018-10-15;1159000000;1218000000;6802000000;5478000000;3595000000;16039000000;23672000000;473000000;3192000000;27337000000;43376000000;4611000000;859000000;5754000000;3780000000;4361000000;10115000000;8318000000;-429000000;24395000000;33261000000;43376000000
MU;60906;USD;2019;Q4;2019-08-31;2019-10-17;1104000000;1128000000;7955000000;3195000000;5118000000;16503000000;28240000000;1164000000;2980000000;32384000000;48887000000;4626000000;1310000000;6390000000;4541000000;5629000000;12019000000;8332000000;-3221000000;30761000000;36868000000;48887000000
ABBV;61199;USD;2017;Q4;2017-12-31;2018-02-16;1595000000;1606000000;9789000000;5088000000;1605000000;21223000000;2803000000;2090000000;44670000000;49563000000;70786000000;10226000000;6415000000;16641000000;30953000000;49048000000;65689000000;14288000000;-11923000000;5459000000;5097000000;70786000000
ABBV;61199;USD;2016;Q4;2016-12-31;2016-11-07;1616000000;1627000000;6423000000;4758000000;1444000000;16187000000;2604000000;1783000000;45525000000;49912000000;66099000000;9379000000;402000000;9781000000;36440000000;51682000000;61463000000;13696000000;-10852000000;4378000000;4636000000;66099000000
ABBV;61199;USD;2015;Q4;2015-12-31;2016-02-19;1633000000;1643000000;8407000000;4730000000;1719000000;16314000000;2565000000;145000000;34026000000;36736000000;53050000000;8463000000;2431000000;10894000000;29240000000;38211000000;49105000000;13097000000;-8839000000;2248000000;3945000000;53050000000
ABBV;61199;USD;2014;Q4;2014-12-31;2015-02-20;1596000000;1613000000;8374000000;3735000000;1124000000;16081000000;2485000000;92000000;8855000000;11432000000;27513000000;6954000000;4439000000;11393000000;10538000000;14378000000;25771000000;4210000000;-972000000;535000000;1742000000;27513000000
ABBV;61199;USD;2013;Q4;2013-12-31;2014-02-21;1589000000;1597000000;9895000000;3854000000;1150000000;17848000000;2298000000;118000000;8934000000;11350000000;29198000000;6448000000;431000000;6879000000;14292000000;17827000000;24706000000;3687000000;-320000000;1567000000;4492000000;29198000000
ABBV;61199;USD;2012;Q4;2012-12-31;2013-05-08;1577000000;1577000000;7976000000;4298000000;1091000000;15354000000;2247000000;119000000;9288000000;11654000000;27008000000;5734000000;1042000000;6776000000;14630000000;20582000000;27358000000;;;;-350000000;27008000000
ABBV;61199;USD;2018;Q4;2018-12-31;2019-02-27;1494000000;1501000000;8061000000;5384000000;1605000000;16945000000;2883000000;1420000000;38104000000;42407000000;59352000000;11931000000;5308000000;17239000000;35002000000;50559000000;67798000000;14774000000;-24108000000;3368000000;-8446000000;59352000000
ACN;61372;USD;2016;Q4;2016-08-31;2016-10-28;622478450;665251942;4908484000;4072180000;;11976222000;956542000;198633000;7477607000;8632782000;20609004000;6042894000;2773000;8878924000;24457000;3540704000;12419628000;2924801000;-2591907000;7879960000;8189376000;20609004000
ACN;61372;USD;2015;Q4;2015-08-31;2015-10-30;624534949;675704226;4363214000;3840920000;;10700074000;801884000;45027000;6655662000;7502573000;18202647000;5675109000;1848000;8491006000;25587000;3064070000;11555076000;4516886000;-11472400000;13470008000;6647571000;18202647000
ACN;61372;USD;2014;Q4;2014-08-31;2014-10-24;631111687;686696634;4923907000;3859567000;;11904442000;793444000;66783000;5165783000;6026010000;17930452000;5160680000;330000;8158079000;26403000;3487036000;11645115000;3347468000;-9423202000;11758131000;6285337000;17930452000
ACN;61372;USD;2013;Q4;2013-08-31;2013-10-29;642342474;704955284;5634410000;3333126000;;11844178000;779675000;43631000;4199565000;5022871000;16867049000;4997492000;0;8160990000;25600000;3278230000;11439220000;2394011000;-7326079000;10069844000;5427829000;16867049000
ACN;61372;USD;2012;Q4;2012-08-31;2012-10-30;636030499;719066901;6642787000;3080877000;;12587931000;779494000;28180000;3269810000;4077484000;16665415000;4903834000;11000;8109205000;22000;3931782000;12040987000;1341650000;-5285625000;7904242000;4624428000;16665415000
ACN;61372;USD;2011;Q4;2011-08-31;2011-10-21;647594709;739147732;5706007000;3236059000;;11471183000;785231000;40365000;3434731000;4260327000;15731510000;4795045000;4419000;7906589000;0;3474049000;11380638000;525111000;-3577574000;6281517000;4350872000;15731510000
ACN;61372;USD;2010;Q4;2010-08-31;2010-10-26;-16567097704;-20043083500;4841279000;2534598000;;9563625000;659569000;41023000;2571036000;3271628000;12835253000;4079848000;143000;6567604000;1445000;2992926000;9560530000;137957000;-2524137000;4634329000;3274723000;12835253000
ACN;61372;USD;2009;Q4;2009-08-31;2009-12-18;6256744160;7781415650;4549566000;2251341000;;8990514000;701144000;29011000;2535065000;3265220000;12255734000;3633821000;594000;6238959000;361000;2630569000;8869528000;17000;-1755446000;3947129000;3386206000;12255734000
ACN;61372;USD;2017;Q4;2017-08-31;2017-10-26;617410484;658250278;4129871000;4569214000;;12097289000;1140598000;211610000;9240393000;10592601000;22689890000;6677305000;2907000;9824279000;22163000;3155411000;12979690000;3516470000;-1649090000;7081855000;9710200000;22689890000
ACN;61372;USD;2018;Q4;2018-08-31;2018-10-24;640899432;653794361;5064552000;4996454000;;13585559000;1264020000;215532000;9383972000;10863524000;24449083000;6415859000;5337000;10151751000;19676000;3572744000;13724495000;4870836000;-2116948000;7952413000;10724588000;24449083000
ACN;61372;USD;2019;Q4;2019-08-31;2019-10-29;637043985;650199626;6130166000;;;15450601000;1391166000;240313000;12707800000;14339279000;29789880000;6915200000;6411000;11061896000;16247000;3900293000;14962189000;5804520000;-1388376000;10421538000;14827691000;29789880000
AGN;61474;USD;2016;Q4;2016-12-31;2017-02-24;356500000;356500000;13225500000;2531000000;718000000;17857900000;1611300000;282100000;109235000000;111128400000;128986300000;5076800000;2797900000;7874700000;29970800000;44911100000;52785800000;53958900000;;18342500000;76200500000;128986300000
AGN;61474;USD;2015;Q4;2015-12-31;2016-02-26;395500000;395500000;1105300000;2125400000;757500000;8579100000;1531300000;408700000;125064200000;127004200000;135583300000;4202300000;2396500000;8292000000;40133900000;50702000000;58994000000;68508300000;;3647500000;76589300000;135583300000
AGN;61474;USD;2014;Q4;2014-12-31;2015-02-18;266500000;264600000;251000000;1112300000;984600000;7110600000;283400000;153300000;45210700000;45647400000;52758000000;3064000000;693400000;5247500000;14837700000;19175000000;24422500000;28994700000;;-198200000;28335500000;52758000000
AGN;61474;USD;2013;Q4;2013-12-31;2014-02-25;174300000;172400000;331500000;1404900000;1786300000;4434700000;1616800000;137500000;16536900000;18291200000;22725900000;2439800000;534600000;3294900000;8517400000;9893900000;13188800000;8012600000;-3300000;1432300000;9537100000;22725900000
AGN;61474;USD;2012;Q4;2012-12-31;2014-02-25;;;328000000;1330900000;1546500000;3838300000;1485000000;91200000;8700300000;10276500000;14114800000;2536000000;176200000;2749300000;6257100000;7509100000;10258400000;1957100000;-342800000;2182700000;3856400000;14114800000
AGN;61474;USD;2017;Q4;2017-12-31;2018-02-16;331400000;331400000;6449300000;2899000000;904500000;11376700000;1785400000;267900000;104911900000;106965200000;118341900000;5616300000;4231800000;9848100000;25843500000;34656700000;44504800000;54013500000;;12957200000;73837100000;118341900000
AGN;61474;USD;2018;Q4;2018-12-31;2019-02-15;335300000;335300000;1907300000;2868100000;846900000;6475400000;1787000000;1970600000;91554600000;95312200000;101787600000;4859600000;868300000;5727900000;22929400000;30928700000;36656600000;56510000000;;7258900000;65131000000;101787600000
GOOG_old;61595;USD;2015;Q4;2015-12-31;2016-02-11;687537000;800522000;73066000000;11556000000;;90114000000;29016000000;5183000000;23148000000;57347000000;147461000000;12567000000;3225000000;19310000000;1995000000;7820000000;27130000000;32982000000;;89223000000;120331000000;147461000000
GOOG_old;61595;USD;2014;Q4;2014-12-31;2015-02-09;678941000;688490000;64395000000;9383000000;;78656000000;23883000000;3079000000;23569000000;50531000000;129187000000;11144000000;2009000000;16779000000;3228000000;8548000000;25327000000;28767000000;;75066000000;103860000000;129187000000
GOOG_old;61595;USD;2013;Q4;2013-12-31;2014-02-12;669668000;682002000;58717000000;8882000000;;72886000000;16524000000;1976000000;19534000000;38034000000;110920000000;10439000000;3009000000;15908000000;2236000000;7703000000;23611000000;25922000000;;61262000000;87309000000;110920000000
GOOG_old;61595;USD;2012;Q4;2012-12-31;2013-01-29;658992000;669954000;48088000000;7885000000;505000000;60454000000;11854000000;1469000000;20021000000;33344000000;93798000000;8980000000;2549000000;14337000000;2988000000;7746000000;22083000000;22835000000;;48342000000;71715000000;93798000000
GOOG_old;61595;USD;2011;Q4;2011-12-31;2012-01-26;324202000;396939000;44626000000;5427000000;35000000;52758000000;9603000000;790000000;9423000000;19816000000;72574000000;4944000000;1218000000;8913000000;2986000000;5516000000;14429000000;20264000000;;37605000000;58145000000;72574000000
GOOG_old;61595;USD;2010;Q4;2010-12-31;2011-02-11;319946000;396909000;34975000000;4252000000;;41562000000;7759000000;523000000;8007000000;16289000000;57851000000;3739000000;3465000000;9996000000;0;1614000000;11610000000;18235000000;;27868000000;46241000000;57851000000
GOOG_old;61595;USD;2009;Q4;2009-12-31;2010-02-12;317235000;396647000;24485000000;3178000000;;29167000000;4845000000;129000000;6356000000;11330000000;40497000000;2462000000;0;2747000000;;1746000000;4493000000;15817000000;;20082000000;36004000000;40497000000
GOOG_old;61595;USD;2008;Q4;2008-12-31;2009-08-04;;;15845771000;2642192000;;20178182000;5233843000;85160000;6270390000;11589393000;31767575000;2002457000;;2302090000;;1226623000;3528713000;14450654000;;13561630000;28238863000;31767576000
AYI;61705;USD;2016;Q4;2016-08-31;2016-10-27;43700000;44000000;413200000;572800000;295200000;1322900000;267800000;;1357300000;1625100000;2948000000;672300000;200000;672500000;362200000;615700000;1288200000;856900000;-418600000;1360900000;1659800000;2948000000
AYI;61705;USD;2015;Q4;2015-08-31;2015-10-27;43100000;43400000;756800000;411700000;224800000;1413400000;174600000;;819000000;993600000;2407000000;520900000;0;520900000;359300000;526100000;1047000000;797600000;-420200000;1093000000;1360000000;2407000000
AYI;61705;USD;2014;Q4;2014-08-31;2014-10-29;43000000;42900000;552500000;373400000;212000000;1186400000;152500000;;827500000;980000000;2166400000;470500000;;470500000;358700000;532400000;1002900000;762000000;-420200000;893600000;1163500000;2166400000
AYI;61705;USD;2013;Q4;2013-08-31;2013-10-29;42700000;42600000;359100000;318300000;203000000;913500000;147900000;;842400000;990300000;1903800000;386200000;;386200000;360600000;524100000;910300000;736000000;-420200000;740300000;993500000;1903800000
AYI;61705;USD;2012;Q4;2012-08-31;2012-10-26;41400000;42000000;284500000;263800000;194100000;779000000;139200000;;818700000;957900000;1736900000;364800000;;364800000;360100000;538100000;902900000;703600000;-420200000;635300000;834000000;1736900000
AYI;61705;USD;2011;Q4;2011-08-31;2011-10-28;42000000;42300000;170200000;262600000;165900000;630500000;143200000;;823700000;966900000;1597400000;331400000;;331400000;360700000;509000000;840400000;680800000;-411000000;541000000;757000000;1597400000
AYI;61705;USD;2010;Q4;2010-08-31;2011-01-10;42500000;43300000;191000000;255100000;149000000;626300000;138400000;;738900000;877300000;1503600000;321300000;;321300000;360900000;487900000;809200000;662400000;-355700000;459000000;694400000;1503600000
AYI;61705;USD;2017;Q4;2017-08-31;2017-10-26;41700000;41900000;311100000;573300000;328600000;1245600000;287700000;;1366300000;1654000000;2899600000;600500000;400000;600900000;364400000;633100000;1234000000;881500000;-776100000;1659900000;1665600000;2899600000
AYI;61705;USD;2018;Q4;2018-08-31;2018-10-25;39900000;39900000;129100000;637900000;411800000;1211100000;286700000;;1491000000;1777700000;2988800000;682300000;400000;682700000;364300000;589300000;1272000000;906800000;-1074400000;1999200000;1716800000;2988800000
AYI;61705;USD;2019;Q4;2019-08-31;2019-10-29;39600000;39700000;461000000;561000000;340800000;1441800000;277300000;;1453300000;1730600000;3172400000;587000000;9100000;596100000;354300000;657400000;1253500000;930500000;-1156000000;2295800000;1918900000;3172400000
AES;62329;USD;2017;Q4;2017-12-31;2018-02-27;661000000;656000000;1373000000;1463000000;562000000;6398000000;20296000000;;6418000000;26714000000;33112000000;2831000000;2164000000;6028000000;17801000000;21402000000;27430000000;8509000000;-1892000000;-2276000000;5682000000;33112000000
AES;62329;USD;2016;Q4;2016-12-31;2017-02-27;661000000;664000000;1774000000;1421000000;622000000;6416000000;20415000000;;9293000000;29708000000;36124000000;2571000000;1052000000;5277000000;18402000000;24365000000;29642000000;8600000000;-1904000000;-1146000000;6482000000;36124000000
AES;62329;USD;2015;Q4;2015-12-31;2016-02-24;672000000;673000000;1726000000;2302000000;671000000;6842000000;22022000000;;7606000000;29628000000;36470000000;4093000000;2172000000;6926000000;17909000000;22835000000;29761000000;8726000000;-1837000000;143000000;6709000000;36470000000
AES;62329;USD;2014;Q4;2014-12-31;2015-02-26;710000000;704000000;2248000000;2709000000;702000000;7826000000;25151000000;;5989000000;31140000000;38966000000;4864000000;2133000000;6997000000;18725000000;24566000000;31563000000;8417000000;-1371000000;512000000;7403000000;38966000000
AES;62329;USD;2013;Q4;2013-12-31;2014-02-26;738000000;745000000;2310000000;2363000000;684000000;7739000000;25112000000;;7560000000;32672000000;40411000000;4636000000;2180000000;7653000000;18869000000;25029000000;32682000000;8451000000;-1089000000;-150000000;7729000000;40411000000
AES;62329;USD;2012;Q4;2012-12-31;2013-02-27;743000000;720000000;2593000000;2539000000;719000000;8465000000;24635000000;;8730000000;33365000000;41830000000;5179000000;2505000000;8319000000;18216000000;25919000000;34238000000;8533000000;-780000000;-264000000;7592000000;41830000000
AES;62329;USD;2011;Q4;2011-12-31;2012-02-27;765000000;775000000;3051000000;2522000000;775000000;9229000000;25001000000;;11116000000;36117000000;45346000000;5724000000;2428000000;8438000000;19592000000;27101000000;35539000000;8515000000;-489000000;678000000;9807000000;45346000000
AES;62329;USD;2010;Q4;2010-12-31;2011-02-28;792000000;796000000;4243000000;2256000000;552000000;9446000000;23429000000;;7636000000;31065000000;40511000000;4738000000;2996000000;8065000000;15792000000;21973000000;30038000000;8452000000;-216000000;620000000;10473000000;40511000000
AES;62329;USD;2009;Q4;2009-12-31;2010-02-26;670000000;673000000;3430000000;2118000000;560000000;8787000000;23796000000;;6952000000;30748000000;39535000000;4462000000;1932000000;6621000000;17605000000;23974000000;30595000000;6875000000;-126000000;650000000;8940000000;39535000000
AES;62329;USD;2008;Q4;2008-12-31;2009-08-07;;;2263000000;2064000000;547000000;7316000000;20879000000;;6611000000;27490000000;34806000000;3917000000;1071000000;5182000000;16619000000;22537000000;27719000000;6839000000;-144000000;-8000000;7087000000;34806000000
AES;62329;USD;2018;Q4;2018-12-31;2019-02-27;664000000;668000000;1479000000;1595000000;577000000;5015000000;21396000000;;6110000000;27506000000;32521000000;2732000000;1659000000;4399000000;17636000000;21639000000;26038000000;8162000000;-1878000000;-1005000000;6483000000;32521000000
AMG;62475;USD;2016;Q4;2016-12-31;2017-02-24;55100000;58400000;430800000;383300000;;814100000;110100000;3638200000;4186700000;7935000000;8749100000;729300000;939400000;2478900000;1170200000;1170200000;3649100000;1074100000;-386000000;3054400000;5100000000;8749100000
AMG;62475;USD;2015;Q4;2015-12-31;2016-02-25;53600000;56500000;563800000;391200000;;955000000;114100000;2286300000;4414000000;6814400000;7769400000;729400000;937100000;2445500000;942300000;942300000;3387800000;695500000;-421900000;2581600000;4381600000;7769400000
AMG;62475;USD;2014;Q4;2014-12-31;2015-02-23;55300000;63000000;550600000;425900000;;976500000;95400000;2123300000;4502900000;6721600000;7698100000;808300000;736800000;2251300000;1158100000;1158100000;3409400000;672800000;-240900000;2163300000;4288700000;7698100000
AMG;62475;USD;2013;Q4;2013-12-31;2014-02-27;53400000;61100000;469600000;418400000;;888000000;92300000;1445500000;3893000000;5430800000;6318800000;514700000;340000000;1488600000;1043700000;1043700000;2532300000;480400000;-131400000;1711200000;3786500000;6318800000
AMG;62475;USD;2012;Q4;2012-12-31;2013-02-22;52100000;53400000;430400000;311000000;;741400000;81500000;1315600000;4048600000;5445700000;6187100000;363300000;340000000;1377600000;1290600000;1290600000;2668200000;869000000;-214600000;1350700000;3518900000;6187100000
AMG;62475;USD;2011;Q4;2011-12-31;2012-02-23;51400000;52500000;449500000;214900000;;776000000;69100000;716200000;3657600000;4442900000;5218900000;343600000;;1069300000;1198200000;1198200000;2267500000;928000000;-288700000;1176700000;2951400000;5218900000
AMG;62475;USD;2010;Q4;2010-12-31;2011-03-01;51400000;52700000;313300000;236400000;;654900000;67700000;794900000;3762300000;4624900000;5279800000;252800000;;1106200000;1392000000;1392000000;2498200000;981000000;-293300000;1011800000;2781600000;5279800000
AMG;62475;USD;2009;Q4;2009-12-31;2010-08-09;-123181857000;-128332574000;353296000;140118000;;528892000;62402000;715022000;2084590000;2862014000;3390906000;117227000;;575852000;964334000;1333333000;1909185000;612549000;-421954000;873137000;1481721000;3390906000
AMG;62475;USD;2017;Q4;2017-12-31;2018-02-23;55200000;58200000;439500000;433800000;;873300000;111000000;3547500000;4170300000;7828800000;8702100000;807200000;741300000;2198300000;1113400000;1113400000;3311700000;809200000;-663700000;3698500000;5390400000;8702100000
AMG;62475;USD;2018;Q4;2018-12-31;2019-02-22;52700000;48600000;565500000;400600000;;966100000;104300000;3111400000;4037300000;7253000000;8219100000;746600000;742500000;2163400000;1087100000;1087100000;3250500000;836200000;-1146600000;3876800000;4968600000;8219100000
AMZN;62747;USD;2016;Q4;2016-12-31;2017-02-10;478000000;487000000;25981000000;8339000000;11461000000;45781000000;29114000000;;8507000000;37621000000;83402000000;39048000000;;43816000000;7694000000;20301000000;64117000000;17191000000;-1837000000;4916000000;19285000000;83402000000
AMZN;62747;USD;2015;Q4;2015-12-31;2016-01-29;468000000;489000000;19808000000;5654000000;10243000000;35705000000;21838000000;;7204000000;29042000000;64747000000;30769000000;;33887000000;8227000000;17476000000;51363000000;13399000000;-1837000000;2545000000;13384000000;64747000000
AMZN;62747;USD;2014;Q4;2014-12-31;2015-01-30;464000000;456000000;17416000000;5612000000;8299000000;31327000000;16967000000;;6211000000;23178000000;54505000000;26266000000;;28089000000;8265000000;15675000000;43764000000;11140000000;-1837000000;1949000000;10741000000;54505000000
AMZN;62747;USD;2013;Q4;2013-12-31;2014-01-31;460000000;484000000;12447000000;4767000000;7411000000;24625000000;10949000000;;4585000000;15534000000;40159000000;21821000000;;22980000000;3191000000;7433000000;30413000000;9578000000;-1837000000;2190000000;9746000000;40159000000
AMZN;62747;USD;2012;Q4;2012-12-31;2013-01-30;456000000;442000000;11448000000;3817000000;6031000000;21296000000;7060000000;;4199000000;11259000000;32555000000;18210000000;;19002000000;3084000000;5361000000;24363000000;8352000000;-1837000000;1916000000;8192000000;32555000000
AMZN;62747;USD;2011;Q4;2011-12-31;2012-02-01;456000000;474000000;9576000000;2571000000;4992000000;17490000000;4417000000;;3371000000;7788000000;25278000000;14896000000;;14896000000;255000000;2625000000;17521000000;6995000000;-877000000;1955000000;7757000000;25278000000
AMZN;62747;USD;2010;Q4;2010-12-31;2011-01-28;448000000;459000000;8762000000;1587000000;3202000000;13747000000;2414000000;;2636000000;5050000000;18797000000;10372000000;;10372000000;;1561000000;11933000000;6330000000;-600000000;1324000000;6864000000;18797000000
AMZN;62747;USD;2009;Q4;2009-12-31;2009-07-24;440000000;450000000;6366000000;988000000;2171000000;9797000000;1290000000;;2726000000;4016000000;13813000000;7364000000;;7364000000;;1192000000;8556000000;5741000000;-600000000;172000000;5257000000;13813000000
AMZN;62747;USD;2008;Q4;2008-12-31;2009-07-24;429000000;435000000;3727000000;827000000;1399000000;6157000000;854000000;;1303000000;2157000000;8314000000;4746000000;;4746000000;409000000;896000000;5642000000;4125000000;-600000000;-730000000;2672000000;8314000000
AMZN;62747;USD;2017;Q4;2017-12-31;2018-02-02;483000000;496000000;30986000000;13164000000;16047000000;60197000000;48866000000;;22247000000;71113000000;131310000000;52786000000;;57883000000;24743000000;45718000000;103601000000;21394000000;-1837000000;8636000000;27709000000;131310000000
AMZN;62747;USD;2018;Q4;2018-12-31;2019-02-01;490000000;501000000;41250000000;16677000000;17174000000;75101000000;61797000000;;25750000000;87547000000;162648000000;61855000000;;68391000000;23495000000;50708000000;119099000000;26796000000;-1837000000;19625000000;43549000000;162648000000
SITE;62823;USD;2016;Q4;2017-01-31;2017-03-15;39576340;38131199;16300000;169000000;289600000;490000000;69800000;;182800000;252600000;742600000;178200000;7300000;185500000;379200000;408300000;593800000;219700000;;-69700000;148800000;742600000
SITE;62823;USD;2015;Q4;2016-01-31;2016-06-22;14253204;13732120;20100000;136800000;265900000;442200000;66200000;;160300000;226500000;668700000;140200000;4600000;144800000;184200000;219300000;364100000;113200000;;-24200000;304600000;668700000
SITE;62823;USD;2017;Q4;2018-01-31;2018-02-28;39877921;46456060;16700000;219900000;338300000;601900000;75500000;;233300000;308800000;910700000;197400000;8400000;205800000;466900000;492100000;697900000;228200000;;-15100000;212800000;910700000
SITE;62823;USD;2018;Q4;2019-01-31;2019-02-27;40869878;45072307;17300000;285300000;411700000;765400000;88400000;;314700000;403100000;1168500000;272700000;9700000;282400000;563200000;584300000;866700000;242500000;;60100000;301800000;1168500000
LZB;63005;USD;2017;Q4;2017-04-30;2018-06-19;46929000;47640000;134515000;154055000;184841000;518218000;180882000;;193867000;374749000;892967000;62403000;223000;181347000;199000;86404000;267751000;345736000;;291644000;625216000;892967000
LZB;63005;USD;2016;Q4;2016-04-30;2017-06-20;48680000;49391000;141860000;150846000;175114000;517422000;169132000;;202301000;371433000;888855000;51282000;219000;198676000;296000;89074000;287750000;338104000;;284698000;601105000;888855000
LZB;63005;USD;2015;Q4;2015-04-30;2016-06-21;49662000;50439000;112358000;146545000;175589000;481972000;171590000;;146467000;318057000;800029000;44661000;290000;157427000;513000;85390000;242817000;328670000;;252472000;557212000;800029000
LZB;63005;USD;2014;Q4;2014-04-30;2015-06-16;51022000;51895000;98302000;158548000;156789000;476451000;174036000;;124117000;298153000;774604000;46168000;397000;154891000;433000;86613000;241504000;320779000;;235506000;533100000;774604000
LZB;63005;USD;2013;Q4;2013-04-30;2014-06-17;52148000;55778000;149661000;152614000;147009000;522673000;127535000;;121087000;248622000;771295000;56177000;7497000;167382000;277000;74195000;241577000;314882000;;238384000;529718000;771295000
LZB;63005;USD;2012;Q4;2012-04-30;2013-06-18;52424000;55031000;131085000;160005000;146343000;500880000;118060000;;101431000;219491000;720371000;50542000;513000;150163000;7576000;78240000;228403000;294280000;;226044000;491968000;720371000
LZB;63005;USD;2011;Q4;2011-04-30;2012-06-19;51968000;52615000;152370000;167232000;143787000;500000000;114366000;;71373000;185739000;685739000;56630000;1829000;149759000;7931000;88165000;237924000;283576000;;189609000;447815000;685739000
LZB;63005;USD;2010;Q4;2010-04-30;2011-08-24;51891000;52847000;115262000;161299000;138444000;432223000;120603000;;40629000;161232000;593455000;49537000;5120000;132104000;29937000;97211000;229315000;274248000;;105872000;364140000;593455000
LZB;63005;USD;2018;Q4;2018-04-30;2019-06-18;46888000;47821000;129819000;143288000;196899000;541118000;200523000;;318149000;518672000;1059790000;65365000;180000;238636000;19000;124178000;362814000;360123000;;325847000;696976000;1059790000
Fuel;63100;USD;2016;Q4;2016-12-31;2017-03-16;46306000;46306000;84024000;125755000;;215426000;49561000;;37714000;87275000;302701000;116487000;79515000;198858000;6721000;16692000;215550000;473102000;;-385026000;87151000;302701000
Fuel;63100;USD;2015;Q4;2015-12-31;2016-03-14;43164000;43164000;78560000;124998000;;209442000;82781000;;54831000;137612000;347054000;112026000;54322000;168464000;29472000;44690000;213154000;453382000;;-319331000;133900000;347054000
Fuel;63100;USD;2014;Q4;2014-12-31;2015-03-16;41569000;41569000;107056000;135400000;;258685000;89441000;;191139000;280580000;539265000;109343000;51187000;161123000;35676000;65376000;226499000;421672000;;-108786000;312766000;539265000
Fuel;63100;USD;2013;Q4;2013-12-31;2014-02-28;32699000;32699000;113873000;90502000;;210501000;25794000;;1213000;27007000;237508000;61494000;7446000;69858000;19980000;24483000;94341000;187657000;;-44475000;143167000;237508000
Fuel;63100;USD;2012;Q4;2012-12-31;2013-11-13;8183000;8183000;14896000;47333000;;63444000;10939000;;806000;11745000;75189000;23668000;1988000;25843000;4978000;8483000;34326000;3873000;;-23543000;40863000;75189000
BREW;63411;USD;2015;Q4;2015-12-31;2016-03-02;19177000;19228000;911000;18926000;18300000;42481000;116867000;;30986000;147853000;190334000;24577000;507000;31643000;18991000;39953000;71596000;139630000;;-20540000;118738000;190334000
BREW;63411;USD;2014;Q4;2014-12-31;2015-03-04;19095000;19338000;981000;11741000;18971000;37776000;110350000;;30475000;140825000;178601000;20417000;1157000;29726000;13720000;33458000;63184000;138487000;;-22758000;115417000;178601000
BREW;63411;USD;2013;Q4;2013-12-31;2014-03-06;18945000;19225000;2726000;11370000;16639000;35483000;104193000;;30610000;134803000;170286000;20739000;710000;29701000;11050000;29353000;59054000;137067000;;-25835000;111232000;170286000
BREW;63411;USD;2012;Q4;2012-12-31;2013-03-12;18874000;18940000;5013000;10512000;11749000;32333000;102852000;;30479000;133331000;165664000;18588000;642000;27126000;12440000;30343000;57469000;136124000;;-27794000;108195000;165664000
BREW;63411;USD;2011;Q4;2011-12-31;2012-03-14;18845000;18916000;795000;13326000;9446000;27277000;100725000;;30906000;131631000;158908000;16954000;596000;24950000;13188000;29449000;54399000;135185000;;-30320000;104509000;158908000
BREW;63411;USD;2010;Q4;2010-12-31;2011-08-15;70040721;70220541;164000;10514000;8729000;23572000;98778000;5240000;30676000;134694000;158266000;19256000;2460000;28007000;24675000;36063000;64070000;134695000;;-39971000;94196000;158266000
BREW;63411;USD;2016;Q4;2016-12-31;2017-03-16;19261000;19146000;442000;24008000;19091000;46036000;121970000;;32399000;154369000;200405000;25151000;1317000;32954000;27946000;47790000;80744000;140783000;;-20860000;119661000;200405000
BREW;63411;USD;2017;Q4;2017-12-31;2018-03-07;19301000;19695000;579000;27784000;13844000;69488000;106283000;;33866000;140149000;209637000;25968000;699000;31483000;32599000;47363000;78846000;142292000;;-11337000;130791000;209637000
BREW;63411;USD;2018;Q4;2018-12-31;2019-03-06;19382000;19678000;1200000;29998000;17216000;51535000;113189000;;71323000;184512000;236047000;26805000;919000;37862000;46573000;61750000;99612000;144110000;;-7589000;136435000;236047000
ABT;63877;USD;2017;Q4;2017-12-31;2018-02-16;1748363000;1757766000;9610000000;5249000000;3601000000;20147000000;7607000000;883000000;47613000000;56103000000;76250000000;8198000000;714000000;8912000000;27210000000;36240000000;45152000000;23206000000;-10225000000;23978000000;31098000000;76250000000
ABT;63877;USD;2016;Q4;2016-12-31;2016-11-03;1479798000;1491469000;18775000000;3248000000;2434000000;26776000000;5705000000;2947000000;17238000000;25890000000;52666000000;5090000000;1325000000;6660000000;20681000000;25289000000;31949000000;13027000000;-10791000000;25565000000;20717000000;52666000000
ABT;63877;USD;2015;Q4;2015-12-31;2016-02-19;1489769000;1499081000;6125000000;3418000000;2599000000;14155000000;5730000000;4041000000;17321000000;27092000000;41247000000;5683000000;3130000000;9186000000;5871000000;10735000000;19921000000;12734000000;-10622000000;25757000000;21326000000;41247000000
ABT;63877;USD;2014;Q4;2014-12-31;2015-02-27;1515999000;1523483000;4460000000;3586000000;2643000000;13556000000;5935000000;229000000;21487000000;27651000000;41207000000;5350000000;4437000000;10467000000;3393000000;9101000000;19568000000;12383000000;-8678000000;22874000000;21639000000;41207000000
ABT;63877;USD;2013;Q4;2013-12-31;2014-02-21;1550948000;1566607000;8098000000;3986000000;2693000000;19247000000;5905000000;119000000;17682000000;23706000000;42953000000;5948000000;3173000000;9507000000;3388000000;8179000000;17686000000;12048000000;-6844000000;21979000000;25267000000;42953000000
ABT;63877;USD;2012;Q4;2012-12-31;2013-02-15;1577209000;1595709000;15174000000;7613000000;3793000000;31323000000;8063000000;274000000;27575000000;35912000000;67235000000;10889000000;2391000000;13280000000;18085000000;27142000000;40422000000;11755000000;-5591000000;24151000000;26813000000;67235000000
ABT;63877;USD;2011;Q4;2011-12-31;2012-02-21;-3499336556;-3513215210;8097359000;7683920000;3284249000;23768774000;7873955000;378225000;28255939000;36508119000;60276893000;12105473000;3374755000;15480228000;12039822000;20270520000;35750748000;9817134000;-3687478000;20907362000;24526145000;60276893000
ABT;63877;USD;2010;Q4;2010-12-31;2011-02-18;-3480175541;-3503200619;5451450000;7184034000;3188734000;22317529000;7970956000;302049000;29983318000;38256323000;60573852000;10867668000;6394766000;17262434000;12523517000;20546287000;37808721000;8744703000;-3916823000;19215768000;22765131000;60573852000
ABT;63877;USD;2009;Q4;2009-12-31;2010-02-19;3230991450;3253586262;9932048000;6541941000;3264877000;23313891000;7619489000;1132866000;20515377000;29267732000;52581623000;7859869000;5189620000;13049489000;11266294000;16344738000;29394227000;8257873000;-3310347000;17342694000;23187396000;52581623000
ABT;63877;USD;2008;Q4;2008-12-31;2009-08-07;3231770941;3259592927;5079625000;5465660000;2775849000;17042559000;7219166000;1073736000;17083743000;25376645000;42419204000;7943951000;2731975000;11591908000;8713327000;13308605000;24900513000;7444411000;-2626404000;13825383000;17518691000;42419204000
ABT;63877;USD;2007;Q4;2007-12-31;2009-08-07;;;2820827000;4946876000;2951442000;14042733000;7518149000;1125262000;17027780000;25671191000;39713924000;6377363000;2725915000;9103278000;9487789000;12786701000;21889979000;6104102000;-1213134000;10805809000;17823945000;39713924000
ABT;63877;USD;2018;Q4;2018-12-31;2019-02-22;1761167000;1774092000;4086000000;5182000000;3796000000;14632000000;7563000000;897000000;44081000000;52541000000;67173000000;8805000000;207000000;9012000000;19359000000;27439000000;36451000000;23512000000;-9962000000;24560000000;30722000000;67173000000
MEI;64377;USD;2016;Q4;2016-04-30;2017-06-22;37239111;37461609;294000000;165300000;57900000;530300000;90600000;;83100000;173700000;704000000;124400000;0;124400000;27000000;38500000;162900000;151300000;-11500000;427000000;541100000;704000000
MEI;64377;USD;2015;Q4;2015-04-30;2015-06-25;37296474;37499580;227800000;175500000;66200000;496200000;93000000;;66700000;159700000;655900000;115800000;;115800000;57000000;70000000;185800000;131400000;-11500000;358600000;470100000;655900000
MEI;64377;USD;2014;Q4;2014-04-30;2014-06-26;38796509;39287283;168100000;170400000;70900000;438300000;93300000;;74200000;167500000;605800000;130600000;;130600000;5000000;16200000;146800000;122100000;-11500000;356500000;459000000;605800000
MEI;64377;USD;2013;Q4;2013-04-30;2013-08-29;39675977;39000312;65800000;119800000;59900000;258600000;98400000;;77900000;176300000;434900000;90400000;;90400000;43500000;54900000;145300000;100700000;-11400000;184400000;289600000;434900000
MEI;64377;USD;2012;Q4;2012-04-30;2013-06-20;;;65811000;119816000;59929000;258654000;98358000;;77927000;176285000;434939000;90471000;;90471000;43500000;54884000;145355000;100700000;-11377000;184368000;289584000;434939000
MEI;64377;USD;2011;Q4;2011-04-30;2012-06-28;;;86797000;98359000;43561000;240433000;77152000;;86063000;163215000;403648000;91877000;;91877000;48000000;56214000;148091000;96840000;-11377000;154008000;255557000;403648000
MEI;64377;USD;2010;Q4;2010-04-30;2011-09-01;37264728;39365758;57445000;88036000;38557000;195961000;61511000;;77272000;138783000;334744000;63487000;;63487000;0;10113000;73600000;91269000;-11377000;155989000;261144000;334744000
MEI;64377;USD;2017;Q4;2017-04-30;2018-06-21;37301397;37645322;246100000;202600000;84100000;550000000;162200000;;203700000;365900000;915900000;152600000;4400000;157000000;53400000;128900000;285900000;155600000;-11500000;472000000;630000000;915900000
MEI;64377;USD;2018;Q4;2018-04-30;2019-06-20;37459648;37712766;83200000;219300000;116700000;453500000;191900000;;586300000;778200000;1231700000;165200000;15700000;180900000;276900000;361100000;542000000;169600000;-11500000;545200000;689700000;1231700000
CYAN;65022;USD;2016;Q4;2017-03-31;2016-06-23;5597000;5426000;1407000;2135000;7972000;12079000;16712000;;213000;16925000;29004000;4679000;1234000;6032000;6365000;6365000;12397000;31691000;;-15084000;16607000;29004000
CYAN;65022;USD;2015;Q4;2016-03-31;2015-07-15;5554000;5133000;1240000;2983000;7856000;12655000;17796000;;696000;18492000;31147000;5430000;574000;6121000;7124000;7198000;13319000;31697000;;-13869000;17828000;31147000
CYAN;65022;USD;2017;Q4;2018-03-31;2018-06-15;5693000;5803000;1329000;2664000;9034000;13617000;15734000;;356000;16090000;29707000;4419000;1155000;5707000;5893000;5893000;11600000;32166000;;-14059000;18107000;29707000
CYAN;65022;USD;2018;Q4;2019-03-31;2019-07-01;5849000;5823000;840000;1982000;11274000;14592000;14752000;;282000;15034000;29626000;5914000;2948000;9488000;5172000;5229000;14717000;32564000;;-17655000;14909000;29626000
HLI;65213;USD;2016;Q4;2017-03-31;2017-06-13;61596994;66461906;300314000;60718000;;621999000;30416000;;733292000;763708000;1385707000;415619000;;624056000;;31196000;655252000;854823000;-193572000;87407000;730455000;1385707000
HLI;65213;USD;2015;Q4;2016-03-31;2016-06-23;59355817;65336387;166169000;58100000;;310181000;21701000;;739002000;760703000;1070884000;365078000;;380041000;;37288000;417329000;637397000;0;28623000;653555000;1070884000
HLI;65213;USD;2014;Q4;2015-03-31;2015-11-13;57372619;60306903;88662000;57488000;;516618000;16489000;12666000;684075000;713230000;1229848000;348235000;;362507000;;41453000;403960000;670241000;;170929000;825888000;1229848000
HLI;65213;USD;2017;Q4;2018-03-31;2018-05-25;62962736;65895294;416042000;77259000;;641395000;32146000;;745300000;777446000;1418841000;440501000;;543848000;;22180000;566028000;753145000;-93500000;207124000;852813000;1418841000
HLI;65213;USD;2018;Q4;2019-03-31;2019-05-24;61637626;65425716;411004000;70830000;;565579000;31034000;;829299000;860333000;1425912000;476181000;;526525000;;8058000;534583000;645155000;0;276468000;891329000;1425912000
WSCI;65297;USD;2016;Q4;2016-08-31;2016-11-04;2919500;2924849;3739324;3823545;3047512;10896632;11460818;;3625136;15085954;25982586;2257385;1557801;3815186;6785432;8188167;12003353;4140434;;9838799;13979233;25982586
WSCI;65297;USD;2015;Q4;2015-08-31;2015-11-04;2915747;2958235;4149645;2985256;5951706;13746575;12900900;;2379147;15280047;29026622;3391082;1527688;4918770;8342926;10233120;15151890;3975421;;9899311;13874732;29026622
WSCI;65297;USD;2014;Q4;2014-08-31;2014-10-24;2904341;2975724;3233436;5963498;3767027;13304489;13303514;;2383157;15686671;28991160;3722929;1615041;5337970;8555243;10538915;15876885;3771339;;9367580;13114275;28991160
WSCI;65297;USD;2013;Q4;2013-08-31;2013-10-24;2889687;2943034;1906218;5318285;3279506;10932771;15298713;;2387168;17685881;28618652;3067974;1921708;4989682;10168597;11491040;16480722;3604577;;8607227;12137930;28618652
WSCI;65297;USD;2012;Q4;2012-08-31;2012-11-13;2856300;2916086;2911961;5198987;2920390;11390813;9314826;;2368452;11683278;23074091;3596990;1377295;4974285;5462854;6433106;11407391;3597576;;8339381;11666700;23074091
WSCI;65297;USD;2011;Q4;2011-08-31;2012-01-06;2835424;2897468;2920078;3292227;2016325;8710308;7078061;;2368452;9446513;18156821;2438232;989191;3427423;3935712;4243773;7671196;3438631;;7322100;10485625;18156821
WSCI;65297;USD;2017;Q4;2017-08-31;2017-11-03;2959837;2959837;5846933;2739087;3131679;11796108;10320808;;2368452;12689260;24485368;3253821;1438057;4691878;5441848;6356916;11048794;4488572;;9024502;13436574;24485368
ALK;65470;USD;2015;Q4;2015-12-31;2016-02-11;125828000;126798000;1328000000;212000000;51000000;1663000000;4802000000;;65000000;4867000000;6530000000;1022000000;114000000;1805000000;569000000;2314000000;4119000000;74000000;-250000000;2890000000;2411000000;6530000000
ALK;65470;USD;2014;Q4;2014-12-31;2015-02-11;132307000;133513000;1217000000;259000000;58000000;1639000000;4299000000;;126000000;4425000000;6064000000;923000000;117000000;1671000000;686000000;2266000000;3937000000;297000000;-4000000;2144000000;2127000000;6064000000
ALK;65470;USD;2013;Q4;2013-12-31;2014-02-13;138715256;140982180;1330000000;152000000;60000000;1762000000;3893000000;;183000000;4076000000;5838000000;899000000;117000000;1580000000;754000000;2229000000;3809000000;607000000;-2000000;1607000000;2029000000;5838000000
ALK;65470;USD;2012;Q4;2012-12-31;2013-02-14;139362000;140788000;1252000000;130000000;58000000;1737000000;3609000000;;159000000;3768000000;5505000000;806000000;161000000;1501000000;871000000;2583000000;4084000000;730000000;0;1127000000;1421000000;5505000000
ALK;65470;USD;2011;Q4;2011-12-31;2012-02-21;142226000;146582000;1141000000;136000000;44000000;1596000000;3373000000;;198000000;3571000000;5167000000;813000000;208000000;1510000000;1099000000;2483000000;3993000000;878000000;-125000000;811000000;1174000000;5167000000
ALK;65470;USD;2010;Q4;2010-12-31;2011-02-23;286891860;295675856;1208200000;120100000;45100000;1662000000;3148400000;;206200000;3354600000;5016600000;781100000;221200000;1424700000;1313000000;2486500000;3911200000;852500000;-46000000;566100000;1105400000;5016600000
ALK;65470;USD;2009;Q4;2009-12-31;2010-08-05;141268000;142960000;1192100000;111800000;45800000;1634300000;3167900000;;194000000;3361900000;4996200000;747200000;156000000;1269500000;1699200000;2854600000;4124100000;802800000;-5700000;315000000;872100000;4996200000
ALK;65470;USD;2016;Q4;2016-12-31;2017-02-28;123279000;124407000;1580000000;302000000;47000000;2050000000;5666000000;;2246000000;7912000000;9962000000;1367000000;319000000;2535000000;2645000000;4496000000;7031000000;111000000;-443000000;3568000000;2931000000;9962000000
ALK;65470;USD;2017;Q4;2017-12-31;2018-02-15;122309000;122565000;1621000000;341000000;57000000;2146000000;6284000000;;2310000000;8594000000;10740000000;1456000000;307000000;2700000000;2262000000;4319000000;7019000000;165000000;-518000000;4454000000;3721000000;10740000000
ALK;65470;USD;2018;Q4;2018-12-31;2019-02-15;123273000;124370000;1236000000;366000000;60000000;1787000000;6781000000;;2344000000;9125000000;10912000000;963000000;486000000;2942000000;1617000000;4219000000;7161000000;233000000;-568000000;4534000000;3751000000;10912000000
ADI;65917;USD;2016;Q4;2016-10-31;2016-11-22;307853000;311631000;4055793000;477609000;376555000;4974863000;636116000;21937000;2337362000;2995415000;7970278000;431396000;0;782934000;1732177000;2021726000;2804660000;453633000;;4785799000;5165618000;7970278000
ADI;65917;USD;2015;Q4;2015-10-31;2015-11-24;312829000;316570000;3028928000;466527000;412314000;4079548000;644110000;17482000;2317637000;2979229000;7058777000;438904000;374594000;1113585000;495341000;872233000;1985818000;686495000;;4437315000;5072959000;7058777000
ADI;65917;USD;2014;Q4;2014-10-31;2014-12-10;312816000;316868000;2866468000;396605000;367927000;3811886000;622422000;13397000;2411985000;3047804000;6859690000;430621000;0;709056000;872789000;1392737000;2101793000;694927000;;4231496000;4757897000;6859690000
ADI;65917;USD;2013;Q4;2013-10-31;2013-11-26;311007000;317214000;4682912000;325144000;283337000;5472425000;508171000;3816000;397338000;909325000;6381750000;323084000;;570512000;872241000;1071662000;1642174000;763721000;;4056401000;4739576000;6381750000
ADI;65917;USD;2012;Q4;2012-10-31;2012-11-27;300681000;307953000;3900378000;339881000;313723000;4696185000;500867000;1816000;421479000;924162000;5620347000;272038000;14500000;525079000;807098000;929909000;1454988000;440884000;;3788869000;4165359000;5620347000
ADI;65917;USD;2011;Q4;2011-10-31;2011-11-22;298911000;305733000;3592462000;348416000;295081000;4386348000;478839000;2951000;409497000;891287000;5277635000;277256000;14500000;525005000;871876000;957217000;1482222000;339248000;;3482334000;3795413000;5277635000
ADI;65917;USD;2010;Q4;2010-10-31;2010-11-22;298227000;306710000;2687768000;387169000;277478000;3478999000;472665000;1317000;375850000;849832000;4328831000;400619000;0;643467000;400635000;485647000;1129114000;336746000;;2896566000;3199717000;4328831000
ADI;65917;USD;2009;Q4;2009-10-31;2009-11-24;291739000;294014000;1815973000;301036000;253161000;2490636000;476516000;1485000;400770000;878771000;3369407000;235972000;;386613000;379626000;453645000;840258000;104951000;;2434446000;2529149000;3369407000
ADI;65917;USD;2008;Q4;2008-10-31;2009-08-18;290846000;293819000;1309686000;315290000;314629000;2089577000;567439000;955000;433021000;1001415000;3090992000;374304000;;569058000;0;101671000;670729000;48533000;;2419908000;2420263000;3090992000
ADI;65917;USD;2017;Q4;2017-10-31;2017-11-22;368067000;372047000;1047838000;688953000;550816000;2351338000;1107304000;24838000;17657814000;18789956000;21141294000;822360000;300000000;1596332000;7551084000;9383422000;10979754000;5311960000;;4910939000;10161540000;21141294000
ADI;65917;USD;2018;Q4;2018-10-31;2018-11-27;370928000;374970000;816591000;639717000;586760000;2112126000;1154328000;28730000;17154595000;18337653000;20449779000;851721000;67000000;1406138000;6265674000;8055101000;9461239000;5343916000;;5703064000;10988540000;20449779000
AEP;66050;USD;2017;Q4;2017-12-31;2018-02-23;491915088;492812293;376300000;1891000000;953200000;4253100000;50261500000;;10214500000;60476000000;64729100000;2299800000;3392300000;8271300000;19419600000;38132300000;46403600000;9728100000;;8626700000;18325500000;64729100000
AEP;66050;USD;2016;Q4;2016-12-31;2017-02-28;491713899;491874323;349200000;1916700000;967300000;6033900000;45639300000;;11794500000;57433800000;63467700000;1915700000;4591000000;9498000000;17378400000;36549600000;46047600000;9660900000;;7892400000;17420100000;63467700000
AEP;66050;USD;2015;Q4;2015-12-31;2016-02-24;490907691;491076761;563200000;1640500000;1339400000;4072400000;46133200000;;11477500000;57610700000;61683100000;1644900000;2631800000;7108500000;17740900000;36669700000;43778200000;9620500000;;8398300000;17904900000;61683100000
AEP;66050;USD;2014;Q4;2014-12-31;2015-02-20;489300431;489819319;548100000;1835200000;1316600000;4478100000;43635100000;;11431400000;55066500000;59544600000;1496500000;3846400000;7966600000;16012000000;34753500000;42720100000;9516700000;;7406600000;16824500000;59544600000
AEP;66050;USD;2013;Q4;2013-12-31;2014-02-25;487428779;487797268;471000000;1860000000;1423000000;4310000000;40997000000;;11107000000;52104000000;56414000000;1511000000;2306000000;6112000000;16828000000;34216000000;40328000000;9434000000;;6766000000;16086000000;56414000000
AEP;66050;USD;2012;Q4;2012-12-31;2013-02-26;485422203;485866360;603000000;1871000000;1519000000;4589000000;38763000000;;11015000000;49778000000;54367000000;1438000000;3152000000;6823000000;15586000000;32307000000;39130000000;9338000000;;6236000000;15237000000;54367000000
AEP;66050;USD;2011;Q4;2011-12-31;2012-02-28;483105630;483475306;515000000;1834000000;1292000000;4182000000;36971000000;;11070000000;48041000000;52223000000;1374000000;3083000000;6611000000;15083000000;30947000000;37558000000;9244000000;;5890000000;14665000000;52223000000
AEP;66050;USD;2010;Q4;2010-12-31;2011-02-25;480434776;480634146;710000000;1923000000;1448000000;5016000000;35674000000;;9765000000;45439000000;50455000000;1342000000;2655000000;6518000000;15502000000;30255000000;36773000000;9161000000;;4842000000;13682000000;50455000000
AEP;66050;USD;2009;Q4;2009-12-31;2010-02-26;478715346;479213253;853000000;1050000000;1661000000;4756000000;34344000000;;9248000000;43592000000;48348000000;1445000000;1867000000;5327000000;15757000000;29820000000;35147000000;9063000000;;4451000000;13201000000;48348000000
AEP;66050;USD;2008;Q4;2008-12-31;2009-08-04;403728405;405786230;738000000;1066000000;1173000000;3775000000;32987000000;;8393000000;41380000000;45155000000;1567000000;2423000000;6297000000;15536000000;28087000000;34384000000;7298000000;;3847000000;10771000000;45155000000
AEP;66050;USD;2018;Q4;2018-12-31;2019-02-21;493130998;494465265;393200000;1926500000;921100000;4113900000;55099100000;;9589800000;64688900000;68802800000;2106000000;3608500000;8648800000;21648200000;40985800000;49634600000;9823500000;;9325300000;19168200000;68802800000
AVB;66223;USD;2017;Q4;2017-12-31;2018-02-23;137730341;138255305;99774000;;;234592000;1374664000;16342893000;462672000;18180229000;18414821000;504283000;1476706000;7919130000;;101589000;8020719000;10236856000;;188609000;10394102000;18414821000
AVB;66223;USD;2016;Q4;2016-12-31;2016-11-04;137010598;137520717;247065000;;;362048000;1987401000;15045593000;472229000;17505223000;17867271000;460073000;2567578000;7592759000;;95330000;7688089000;10107027000;;94899000;10179182000;17867271000
AVB;66223;USD;2015;Q4;2015-12-31;2016-02-26;136731941;137401036;430584000;;;535405000;2094783000;13847526000;453591000;16395900000;16931305000;431262000;2611274000;6987565000;;93217000;7080782000;10069902000;;-197989000;9850523000;16931305000
AVB;66223;USD;2014;Q4;2014-12-31;2015-02-19;131871688;133166135;539077000;;;634702000;1776554000;13159186000;570136000;15505876000;16140578000;397324000;3514174000;6990947000;;90461000;7081408000;9356005000;;-267085000;9059170000;16140578000
AVB;66223;USD;2013;Q4;2013-12-31;2014-03-03;129354196;130140746;308027000;;;406591000;2141631000;12142578000;637343000;14921552000;15328143000;378813000;3539642000;6623648000;;87448000;6711096000;8990017000;;-345254000;8617047000;15328143000
AVB;66223;USD;2012;Q4;2012-12-31;2013-02-22;102457572;102907435;2758366000;;;2808316000;1457445000;6557675000;336642000;8351762000;11160078000;327722000;1905235000;4242153000;;70105000;4312258000;7087551000;;-142329000;6847820000;11160078000
AVB;66223;USD;2011;Q4;2011-12-31;2012-02-27;124242747;125298577;640450000;;;713850000;1095343000;6329687000;343510000;7768540000;8482390000;330473000;1969986000;4003257000;;70178000;4073435000;4653409000;;-171648000;4408955000;8482390000
AVB;66223;USD;2010;Q4;2010-12-31;2011-02-23;113104167;114240254;326454000;;;499792000;597683000;6357962000;366051000;7321696000;7821488000;207607000;2152944000;4426221000;;65414000;4491635000;3594536000;;-282743000;3329853000;7821488000
AVB;66223;USD;2009;Q4;2009-12-31;2010-03-01;;;129337000;;;340013000;892580000;5940907000;284105000;7117592000;7457605000;305737000;2316843000;4332966000;;68715000;4401681000;3201182000;;-149988000;3055924000;7457605000
AVB;66223;USD;2008;Q4;2008-12-31;2009-08-10;;;94643000;;;287324000;1347479000;5302264000;237286000;6887029000;7174353000;426489000;1527757000;4176710000;;71294000;4248004000;2941270000;;-22223000;2926349000;7174353000
AVB;66223;USD;2018;Q4;2018-12-31;2019-02-22;137925719;138465720;123475000;;;249680000;1908052000;15822878000;399590000;18130520000;18380200000;501891000;1134270000;7639287000;;105063000;7744350000;10307973000;;350777000;10635850000;18380200000
AVY;66346;USD;2016;Q4;2016-12-31;2017-02-23;88800000;90400000;195100000;1001000000;519100000;1904800000;915200000;;1576400000;2491600000;4396400000;1425200000;579100000;2004300000;805700000;1466600000;3470900000;976100000;-1772000000;2473300000;925500000;4396400000
AVY;66346;USD;2015;Q4;2015-12-31;2016-02-24;90700000;93000000;158800000;964700000;478700000;1775400000;847900000;;1510400000;2358300000;4133700000;1318700000;95300000;1459100000;1071500000;1708900000;3168000000;958100000;-1587000000;2277600000;965700000;4133700000
AVY;66346;USD;2014;Q4;2014-12-31;2015-02-25;90900000;92900000;207200000;958100000;491800000;1921300000;875300000;;1560300000;2435600000;4356900000;1328600000;204300000;1593000000;1067900000;1716200000;3309200000;948000000;-1471300000;2116500000;1047700000;4356900000
AVY;66346;USD;2013;Q4;2013-12-31;2014-02-26;96300000;98500000;351600000;1016500000;494100000;2091800000;922500000;;1596300000;2518800000;4610600000;1427900000;76900000;1554100000;1087900000;1564300000;3118400000;936400000;-1172200000;2009100000;1492200000;4610600000
AVY;66346;USD;2012;Q4;2012-12-31;2013-02-27;100200000;101300000;235400000;972800000;473300000;2411700000;1015500000;;1678100000;2693600000;5105300000;1328700000;520200000;2074500000;842700000;1449900000;3524400000;925900000;-977800000;1910800000;1580900000;5105300000
AVY;66346;USD;2011;Q4;2011-12-31;2012-02-27;106100000;106700000;178000000;877100000;475100000;2218800000;1079400000;;1674500000;2753900000;4972700000;1183700000;227100000;1647100000;1080000000;1667100000;3314200000;902700000;-791500000;1810500000;1658500000;4972700000
AVY;66346;USD;2010;Q4;2010-12-31;2011-02-28;106400000;106900000;127500000;996100000;519900000;1951900000;1262900000;;1884600000;3147500000;5099400000;1397600000;381000000;1831800000;1080800000;1621900000;3453700000;818900000;-758200000;1727900000;1645700000;5099400000
AVY;66346;USD;2009;Q4;2009-12-31;2010-08-11;105100000;105100000;138100000;918600000;477300000;1733200000;1354700000;;1914900000;3269600000;5002800000;1291300000;535600000;1867700000;1216500000;1772500000;3640200000;603900000;-595800000;1499700000;1362600000;5002800000
AVY;66346;USD;2017;Q4;2017-12-31;2018-02-21;88000000;90600000;224400000;1180300000;609600000;2237900000;1097900000;;1801100000;2899000000;5136900000;1706400000;265400000;1971800000;1489600000;2118900000;4090700000;986700000;-1856700000;2596700000;1046200000;5136900000
AVY;66346;USD;2018;Q4;2018-12-31;2019-02-27;86000000;87300000;232000000;1189700000;651400000;2298000000;1137400000;;1742100000;2879500000;5177500000;1799400000;194600000;1994000000;1893700000;2228400000;4222400000;996100000;-2223900000;2864900000;955100000;5177500000
AN;66437;USD;2018;Q4;2018-12-31;2019-02-22;90400000;90500000;48600000;976200000;3650500000;4884000000;3155300000;;2625800000;5781100000;10665100000;4303900000;674300000;5658100000;1926200000;2291000000;7949100000;21800000;-544100000;3238300000;2716000000;10665100000
AN;66437;USD;2017;Q4;2017-12-31;2018-02-15;91600000;92000000;69200000;1111000000;3365600000;4797500000;2962700000;;2511300000;5474000000;10271500000;4116700000;744500000;5635700000;1959200000;2266500000;7902200000;5000000;-467900000;2832200000;2369300000;10271500000
AN;66437;USD;2016;Q4;2016-12-31;2017-02-09;100900000;101600000;64800000;1032900000;3520100000;4714800000;2843200000;;2502000000;5345200000;10060000000;4152900000;1109500000;5829200000;1611100000;1920500000;7749700000;19400000;-842400000;3133300000;2310300000;10060000000
AN;66437;USD;2015;Q4;2015-12-31;2016-02-11;111000000;111800000;74100000;908200000;3612000000;4709700000;2667400000;;2171100000;4838500000;9548200000;4027000000;611200000;5167400000;1745300000;2031500000;7198900000;6400000;-359900000;2702800000;2349300000;9548200000
AN;66437;USD;2014;Q4;2014-12-31;2015-02-11;113600000;115000000;75400000;817800000;2899000000;3999200000;2422000000;;1978500000;4400500000;8399700000;3361900000;25000000;3882000000;2103400000;2445600000;6327600000;63400000;-1747900000;3756600000;2072100000;8399700000
AN;66437;USD;2013;Q4;2013-12-31;2014-02-13;121300000;123400000;69200000;740900000;2827200000;3830000000;2235300000;;1848800000;4084100000;7914100000;3292000000;30100000;3751800000;1809800000;2100600000;5852400000;44400000;-1320600000;3337900000;2061700000;7914100000
AN;66437;USD;2012;Q4;2012-12-31;2013-02-15;122000000;123800000;69700000;698400000;2396900000;3361100000;2095100000;;1746800000;3841900000;7203000000;2757400000;29800000;3201700000;2066300000;2312800000;5514500000;28200000;-1302700000;2963000000;1688500000;7203000000
AN;66437;USD;2011;Q4;2011-12-31;2012-02-13;138300000;140400000;86600000;587400000;1809200000;2676200000;1950700000;;1571900000;3522600000;6198800000;2101200000;12600000;2462600000;1634400000;1841600000;4304200000;21200000;-773200000;2646600000;1894600000;6198800000
AN;66437;USD;2010;Q4;2010-12-31;2011-02-15;147500000;149900000;95100000;462000000;1867000000;2628800000;1838000000;;1507400000;3345400000;5974200000;2030400000;8100000;2399400000;1340600000;1495900000;3895300000;3600000;-289900000;2365200000;2078900000;5974200000
AN;66437;USD;2009;Q4;2009-12-31;2010-08-09;173200000;174000000;173500000;406400000;1392800000;2268400000;1713600000;;1425300000;3138900000;5407300000;1526300000;7600000;1863400000;1105000000;1240700000;3104100000;482100000;-399900000;2221000000;2303200000;5407300000
T;66790;USD;2018;Q4;2018-12-31;2019-02-20;7316000000;7350000000;5204000000;26472000000;;51427000000;131473000000;6245000000;342719000000;480437000000;531864000000;47038000000;10255000000;64420000000;166250000000;273560000000;337980000000;133146000000;-12059000000;58753000000;193884000000;531864000000
T;66790;USD;2017;Q4;2017-12-31;2018-02-20;6163000000;6180000000;50498000000;16522000000;;79146000000;125222000000;1560000000;238169000000;364951000000;444097000000;37540000000;38374000000;81389000000;125972000000;220701000000;302090000000;96058000000;-12714000000;50500000000;142007000000;444097000000
T;66790;USD;2016;Q4;2016-12-31;2017-02-17;6158000000;6182000000;5788000000;16794000000;;38369000000;124899000000;1674000000;238879000000;365452000000;403821000000;34146000000;9832000000;50576000000;113681000000;229135000000;279711000000;96099000000;-12659000000;34734000000;124110000000;403821000000
T;66790;USD;2015;Q4;2015-12-31;2016-02-18;6181000000;6202000000;5121000000;16532000000;;35992000000;124450000000;1606000000;240624000000;366680000000;402672000000;33322000000;7636000000;47816000000;118515000000;231216000000;279032000000;96258000000;-12592000000;33671000000;123640000000;402672000000
T;66790;USD;2014;Q4;2014-12-31;2015-02-20;5196000000;5212000000;8603000000;14527000000;;33606000000;112898000000;250000000;150080000000;263228000000;296834000000;26030000000;6056000000;37282000000;75778000000;169282000000;206564000000;97603000000;-47029000000;31081000000;90270000000;296834000000
T;66790;USD;2013;Q4;2013-12-31;2014-02-21;5263000000;5282000000;3339000000;12918000000;;23196000000;110968000000;3860000000;139763000000;254591000000;277787000000;23511000000;5498000000;34995000000;69290000000;151310000000;186305000000;97586000000;-45619000000;31141000000;91482000000;277787000000
T;66790;USD;2012;Q4;2012-12-31;2013-02-22;5660000000;5676000000;4868000000;12657000000;;22706000000;109767000000;4581000000;135261000000;249609000000;272315000000;23050000000;3486000000;31787000000;66358000000;147833000000;179620000000;97533000000;-32888000000;22481000000;92695000000;272315000000
T;66790;USD;2011;Q4;2011-12-31;2012-02-24;5919000000;5948000000;3045000000;13231000000;;22985000000;107087000000;3718000000;136652000000;247457000000;270442000000;22564000000;3453000000;30892000000;61300000000;133753000000;164645000000;97651000000;-20750000000;25453000000;105797000000;270442000000
T;66790;USD;2010;Q4;2010-12-31;2011-03-01;5929000000;5942000000;1437000000;13610000000;;20854000000;103196000000;4515000000;140826000000;248537000000;269391000000;22597000000;7196000000;34854000000;58971000000;122587000000;157441000000;98226000000;-21083000000;31792000000;111950000000;269391000000
T;66790;USD;2009;Q4;2009-12-31;2010-02-25;;23695982234;3741000000;14845000000;;25187000000;99519000000;2921000000;140685000000;243125000000;268312000000;23739000000;7361000000;36951000000;64720000000;129372000000;166323000000;98202000000;-21260000000;21944000000;101989000000;268312000000
T;66790;USD;2008;Q4;2008-12-31;2009-08-05;;;1792000000;16047000000;;22556000000;99088000000;2332000000;141269000000;242689000000;265245000000;22448000000;14119000000;42290000000;60872000000;126205000000;168495000000;98223000000;-21410000000;36591000000;96750000000;265245000000
ADM;66997;USD;2016;Q4;2016-12-31;2017-02-17;580000000;584000000;915000000;1905000000;8831000000;21045000000;9758000000;4684000000;4282000000;18724000000;39769000000;8764000000;427000000;13173000000;6504000000;9391000000;22564000000;2327000000;;17444000000;17205000000;39769000000
ADM;66997;USD;2015;Q4;2015-12-31;2016-02-19;600000000;603000000;1348000000;1738000000;8243000000;21829000000;9853000000;4340000000;4135000000;18328000000;40157000000;9294000000;98000000;13505000000;5779000000;8737000000;22242000000;3180000000;;16865000000;17915000000;40157000000
ADM;66997;USD;2014;Q4;2014-12-31;2015-02-20;646000000;649000000;1614000000;2704000000;9374000000;26028000000;9851000000;4377000000;3741000000;17969000000;43997000000;10200000000;132000000;15602000000;5528000000;8765000000;24367000000;5115000000;;15701000000;19630000000;43997000000
ADM;66997;USD;2013;Q4;2013-12-31;2014-02-26;661000000;663000000;3554000000;3224000000;11441000000;28530000000;10137000000;4046000000;1039000000;15222000000;43752000000;9345000000;1523000000;15658000000;5347000000;7900000000;23558000000;6136000000;;14077000000;20194000000;43752000000
ADM;66997;USD;2012;Q4;2012-12-31;2013-02-28;660000000;662000000;2290000000;3450000000;13836000000;29762000000;10123000000;3887000000;1364000000;15374000000;45136000000;9388000000;3084000000;16993000000;6456000000;9012000000;26005000000;6134000000;;13236000000;19131000000;45136000000
ADM;66997;USD;2011;Q4;2011-12-31;2011-08-25;651000000;650000000;1354000000;4808000000;12055000000;27504000000;9500000000;3906000000;1283000000;14689000000;42193000000;2581000000;2053000000;13218000000;8266000000;10137000000;23355000000;6636000000;;11996000000;18838000000;42193000000
ADM;66997;USD;2010;Q4;2010-12-31;2010-08-30;644000000;642000000;1440000000;6122000000;7871000000;18394000000;8712000000;3477000000;1225000000;13414000000;31808000000;5538000000;718000000;8833000000;6830000000;8344000000;17177000000;5151000000;;10357000000;14631000000;31808000000
ADM;66997;USD;2009;Q4;2009-12-31;2009-11-06;644000000;644000000;1555000000;7311000000;7782000000;19408000000;7950000000;3085000000;1139000000;12174000000;31582000000;5786000000;404000000;8885000000;7592000000;9044000000;17929000000;5204000000;;8778000000;13653000000;31582000000
ADM;66997;USD;2017;Q4;2017-12-31;2018-02-16;563000000;566000000;804000000;1947000000;9173000000;19925000000;10138000000;5180000000;4720000000;20038000000;39963000000;8867000000;870000000;12570000000;6623000000;9018000000;21588000000;2398000000;;17552000000;18375000000;39963000000
ADM;66997;USD;2018;Q4;2018-12-31;2019-02-19;564000000;568000000;2003000000;2233000000;8813000000;20588000000;9953000000;5324000000;4968000000;20245000000;40833000000;8173000000;690000000;11776000000;7698000000;10012000000;21788000000;2560000000;;18527000000;19045000000;40833000000
AMAT;67102;USD;2016;Q4;2016-10-31;2016-12-15;1086000000;1098000000;3749000000;2279000000;2050000000;8353000000;937000000;929000000;4351000000;6217000000;14570000000;2256000000;;3632000000;3125000000;3721000000;7353000000;6820000000;-14740000000;15252000000;7217000000;14570000000
AMAT;67102;USD;2015;Q4;2015-10-31;2015-12-09;1181000000;1192000000;4965000000;1739000000;1833000000;9261000000;892000000;946000000;4209000000;6047000000;15308000000;1833000000;1200000000;3798000000;3342000000;3897000000;7695000000;6586000000;-12848000000;13967000000;7613000000;15308000000
AMAT;67102;USD;2014;Q4;2014-10-31;2014-12-17;1220000000;1237000000;3162000000;1670000000;1567000000;6967000000;861000000;935000000;4411000000;6207000000;13174000000;1883000000;0;2823000000;1947000000;2483000000;5306000000;6396000000;-11524000000;13072000000;7868000000;13174000000
AMAT;67102;USD;2013;Q4;2013-10-31;2013-12-04;1204000000;1241000000;1891000000;1633000000;1413000000;5642000000;850000000;1005000000;4546000000;6401000000;12043000000;1649000000;;2443000000;1946000000;2512000000;4955000000;6163000000;-11524000000;12487000000;7088000000;12043000000
AMAT;67102;USD;2012;Q4;2012-10-31;2012-12-05;1219000000;1229000000;1937000000;1220000000;1272000000;5102000000;910000000;1055000000;5035000000;7000000000;12102000000;1510000000;;2265000000;1946000000;2602000000;4867000000;5875000000;-11279000000;12700000000;7235000000;12102000000
AMAT;67102;USD;2011;Q4;2011-10-31;2011-12-06;1314000000;1322000000;6243000000;1532000000;1701000000;10355000000;866000000;931000000;1709000000;3506000000;13861000000;1678000000;;2794000000;1947000000;2267000000;5061000000;5629000000;-9864000000;13029000000;8800000000;13861000000
AMAT;67102;USD;2010;Q4;2010-10-31;2010-12-10;1333000000;1345000000;2585000000;1831000000;1547000000;6765000000;963000000;1307000000;1908000000;4178000000;10943000000;2040000000;1000000;2888000000;204000000;519000000;3407000000;5419000000;-9396000000;11511000000;7536000000;10943000000
AMAT;67102;USD;2009;Q4;2009-10-31;2009-12-11;1337770000;1337770000;2214730000;1041495000;1627457000;5688947000;1090433000;1052165000;1742698000;3885296000;9574243000;1073937000;1240000;1939457000;200654000;540178000;2479635000;5208846000;-9046562000;10934004000;7094608000;9574243000
AMAT;67102;USD;2008;Q4;2008-10-31;2009-09-01;1338228000;1371060000;2100668000;1691027000;1987017000;6664157000;1094200000;1446589000;1801372000;4342161000;11006318000;1718749000;1068000;2945552000;201576000;511808000;3457360000;5109202000;-9134962000;11601288000;7548958000;11006318000
AMAT;67102;USD;2017;Q4;2017-10-31;2017-12-15;1065000000;1077000000;7276000000;2338000000;2930000000;12918000000;1066000000;1143000000;4292000000;6501000000;19419000000;2450000000;;4115000000;5304000000;5955000000;10070000000;7067000000;-15912000000;18258000000;9349000000;19419000000
AMAT;67102;USD;2018;Q4;2018-10-31;2018-12-13;973000000;988000000;4030000000;2565000000;3722000000;10747000000;1407000000;1568000000;4051000000;7026000000;17773000000;3975000000;;5322000000;5309000000;5612000000;10934000000;7284000000;-21194000000;20874000000;6839000000;17773000000
AIV;67201;USD;2015;Q4;2015-12-31;2016-02-29;155724000;156041000;50789000;;;137745000;5529461000;;451475000;5980936000;6118681000;353604000;;417709000;3849141000;3849141000;4266850000;4066222000;;;1851831000;6118681000
AIV;67201;USD;2014;Q4;2014-12-31;2015-02-27;145754000;146238000;28971000;;;120416000;5472779000;;503833000;5976612000;6097028000;320996000;;431847000;4135139000;4135139000;4566986000;3697607000;;;1530042000;6097028000
AON;67471;USD;2016;Q4;2016-12-31;2017-02-23;265200000;268100000;716000000;2106000000;;13146000000;550000000;0;12919000000;13469000000;26615000000;10563000000;336000000;12495000000;5869000000;8588000000;21083000000;;;;5532000000;26615000000
AON;67471;USD;2015;Q4;2015-12-31;2016-02-22;273600000;277600000;740000000;2564000000;;13565000000;765000000;0;12553000000;13318000000;26883000000;11704000000;562000000;13085000000;5138000000;7739000000;20824000000;;;;6059000000;26883000000
AON;67471;USD;2014;Q4;2014-12-31;2015-02-24;287700000;293500000;768000000;2815000000;;15823000000;765000000;0;13184000000;13949000000;29772000000;13443000000;783000000;15014000000;4799000000;8127000000;23141000000;;;;6631000000;29772000000
AON;67471;USD;2013;Q4;2013-12-31;2014-02-18;306000000;311600000;1000000000;2896000000;;16330000000;791000000;132000000;12998000000;13921000000;30251000000;13802000000;703000000;15411000000;3686000000;6645000000;22056000000;;;;8195000000;30251000000
AON;67471;USD;2012;Q4;2012-12-31;2013-02-22;322300000;327200000;637000000;3101000000;;16382000000;820000000;165000000;13119000000;14104000000;30486000000;14067000000;452000000;15350000000;3713000000;7331000000;22681000000;;;;7805000000;30486000000
AON;67471;USD;2011;Q4;2011-12-31;2012-02-24;332300000;338600000;1057000000;3183000000;;15505000000;783000000;239000000;13025000000;14047000000;29552000000;12670000000;337000000;13760000000;4155000000;7672000000;21432000000;4407000000;-2553000000;8594000000;8120000000;29552000000
AON;67471;USD;2010;Q4;2010-12-31;2011-02-25;340600000;344200000;1131000000;2701000000;;14519000000;781000000;312000000;13370000000;14463000000;28982000000;11873000000;492000000;12949000000;4014000000;7727000000;20676000000;4386000000;-2079000000;7861000000;8306000000;28982000000
AON;67471;USD;2009;Q4;2009-12-31;2010-02-26;286400000;291200000;639000000;2052000000;;13989000000;461000000;319000000;8189000000;8969000000;22958000000;12370000000;10000000;12640000000;1998000000;4887000000;17527000000;3578000000;-3859000000;7335000000;5431000000;22958000000
AON;67471;USD;2008;Q4;2008-12-31;2009-08-07;280500000;291300000;1266000000;1990000000;;14526000000;451000000;332000000;7631000000;8414000000;22940000000;12238000000;105000000;12803000000;1872000000;4722000000;17525000000;3582000000;-3626000000;6816000000;5415000000;22940000000
AON;67471;USD;2017;Q4;2017-12-31;2018-02-20;251200000;256100000;1285000000;2478000000;;13677000000;564000000;;11847000000;12411000000;26088000000;11586000000;299000000;12755000000;5667000000;8685000000;21440000000;5777000000;;2302000000;4648000000;26088000000
AON;67471;USD;2018;Q4;2018-12-31;2019-02-19;242300000;244800000;828000000;2760000000;;14372000000;588000000;;11462000000;12050000000;26422000000;12109000000;251000000;13296000000;5993000000;8907000000;22203000000;5967000000;;2093000000;4219000000;26422000000
AME;67669;USD;2015;Q4;2015-12-31;2016-02-25;237220000;238688000;381005000;603295000;514451000;1618827000;484548000;177481000;4379594000;5041623000;6660450000;639097000;384924000;1024021000;1553116000;2381803000;3405824000;570894000;-885430000;3974793000;3254626000;6660450000
AME;67669;USD;2014;Q4;2014-12-31;2015-02-24;243989000;246133000;377615000;585462000;495896000;1578604000;448446000;154322000;4239591000;4842359000;6420963000;649943000;286201000;936144000;1427825000;2245258000;3181402000;494339000;-457807000;3469923000;3239561000;6420963000
AME;67669;USD;2013;Q4;2013-12-31;2014-02-26;244660000;246815000;295203000;536701000;452848000;1369129000;402790000;223694000;3882289000;4508773000;5877902000;601230000;273315000;874545000;1141750000;1867236000;2741781000;451281000;-215936000;2966015000;3136121000;5877902000
AME;67669;USD;2012;Q4;2012-12-31;2013-02-21;242556000;245287000;157984000;507850000;428935000;1164743000;383483000;123864000;3517966000;4025313000;5190056000;559315000;320654000;879969000;1133121000;1774936000;2654905000;390436000;-211374000;2507419000;2535151000;5190056000
AME;67669;USD;2011;Q4;2011-12-31;2012-02-23;239945000;242272000;170392000;438245000;380471000;1059119000;325329000;145848000;2789194000;3260371000;4319490000;488367000;140508000;628875000;1123416000;1637810000;2266685000;318226000;-209773000;2101615000;2052805000;4319490000
AME;67669;USD;2010;Q4;2010-12-31;2011-02-24;238725000;242182500;168853000;399913000;335253000;974492000;318126000;191096000;2335201000;2844423000;3818915000;453707000;97152000;550859000;1071360000;1492852000;2043711000;264971000;-153551000;1755742000;1775204000;3818915000
AME;67669;USD;2009;Q4;2009-12-31;2010-02-25;241114500;243846000;251350000;331383000;311542000;969430000;310053000;167370000;1799179000;2276602000;3246032000;338481000;85801000;424282000;955880000;1254726000;1679008000;225167000;-83333000;1500471000;1567024000;3246032000
AME;67669;USD;2008;Q4;2008-12-31;2009-08-05;239305500;240555750;91210000;406012000;349509000;954586000;307908000;111211000;1681837000;2100956000;3055542000;429075000;18438000;447513000;1093243000;1320257000;1767770000;204102000;-92033000;1320470000;1287772000;3055542000
AME;67669;USD;2016;Q4;2016-12-31;2017-02-23;230210000;231193000;717259000;592326000;492104000;1928190000;473230000;146283000;4552971000;5172484000;7100674000;645520000;278921000;924441000;2062644000;2919720000;3844161000;606758000;-1211539000;4403683000;3256513000;7100674000
AME;67669;USD;2017;Q4;2017-12-31;2018-02-22;230771000;232535000;646300000;668176000;540504000;1934655000;493296000;239129000;5128984000;5861409000;7796064000;830540000;308123000;1138663000;1866166000;2629768000;3768431000;663525000;-1209135000;5002419000;4027633000;7796064000
AME;67669;USD;2018;Q4;2018-12-31;2019-02-21;229610000;231336000;353975000;732839000;624744000;1836144000;554130000;256210000;6015804000;6826144000;8662288000;762599000;358876000;1258704000;2273837000;3161662000;4420366000;709383000;-1570184000;5653811000;4241922000;8662288000
AMP;67872;USD;2017;Q4;2017-12-31;2018-02-23;150800000;153800000;40676000000;5785000000;;56955000000;;;90515000000;90515000000;147470000000;136173000000;200000000;136373000000;5099000000;5099000000;141472000000;8088000000;-13648000000;11329000000;5998000000;147470000000
AMP;67872;USD;2016;Q4;2016-12-31;2017-02-23;160300000;162500000;40574000000;5310000000;;56280000000;;;83541000000;83541000000;139821000000;128093000000;200000000;128293000000;5236000000;5236000000;133529000000;7768000000;-12027000000;10351000000;6292000000;139821000000
AMP;67872;USD;2015;Q4;2015-12-31;2016-02-25;176300000;178600000;43573000000;5274000000;;62041000000;;;83298000000;83298000000;145339000000;126537000000;200000000;126737000000;10223000000;10223000000;136960000000;7614000000;-10338000000;9662000000;8379000000;145339000000
AMP;67872;USD;2014;Q4;2014-12-31;2015-02-24;187900000;191000000;44758000000;5027000000;;62940000000;;;85870000000;85870000000;148810000000;129376000000;200000000;129576000000;9929000000;9929000000;139505000000;7348000000;-8589000000;8703000000;9305000000;148810000000
AMP;67872;USD;2013;Q4;2013-12-31;2014-02-27;198200000;202400000;43788000000;4610000000;;60993000000;;;83583000000;83583000000;144576000000;126388000000;500000000;126888000000;8456000000;8456000000;135344000000;6932000000;-6961000000;7626000000;9232000000;144576000000
AMP;67872;USD;2012;Q4;2012-12-31;2013-02-27;210800000;214800000;44197000000;4315000000;;59794000000;;;74935000000;74935000000;134729000000;117132000000;501000000;117633000000;7384000000;7384000000;125017000000;6506000000;-5325000000;6717000000;9712000000;134729000000
AMP;67872;USD;2011;Q4;2011-12-31;2012-02-24;230500000;234500000;47993000000;4440000000;;63734000000;;;68573000000;68573000000;132307000000;114538000000;504000000;115042000000;7571000000;7571000000;122613000000;6240000000;-4034000000;6031000000;9694000000;132307000000
AMP;67872;USD;2010;Q4;2010-12-31;2011-02-28;252400000;259000000;45509000000;4909000000;;61070000000;;;70144000000;70144000000;131214000000;111601000000;397000000;112077000000;7852000000;7852000000;119929000000;6032000000;-2620000000;6748000000;11285000000;131214000000
AMP;67872;USD;2009;Q4;2009-12-31;2010-02-24;259000000;263400000;40252000000;4484000000;;54189000000;;;59581000000;59581000000;113770000000;101649000000;;101649000000;2249000000;2249000000;103898000000;5751000000;-2023000000;5276000000;9872000000;113770000000
AMP;67872;USD;2008;Q4;2008-12-31;2009-08-05;218400000;220400000;33750000000;3887000000;;48948000000;;;46629000000;46629000000;95577000000;87083000000;;87083000000;2027000000;2027000000;89110000000;4691000000;-2012000000;4592000000;6467000000;95577000000
AMT;68339;USD;2016;Q4;2016-12-31;2017-02-27;426087000;430315000;791187000;308369000;;1689870000;10517258000;;18672022000;29189280000;30879150000;1147076000;238806000;1631269000;18294659000;21180461000;22811730000;10047858000;-207740000;-1076965000;8067420000;30879150000
AMT;68339;USD;2015;Q4;2015-12-31;2016-02-26;423988000;428501000;320686000;227354000;;996468000;9866424000;;16041380000;25907804000;26904272000;938826000;50202000;1200029000;17068807000;18991425000;20191454000;9694876000;-207740000;-998535000;6712818000;26904272000
AMT;68339;USD;2014;Q4;2014-12-31;2015-02-24;396571000;401239000;319794000;199074000;;957867000;7590112000;;12715586000;20305698000;21263565000;798331000;897386000;1929536000;13642955000;15280677000;17210213000;5792781000;-207740000;-837320000;4053352000;21263565000
AMT;68339;USD;2013;Q4;2013-12-31;2014-02-26;394742000;399119000;312188000;151165000;;986087000;7177728000;;12119850000;19297578000;20283665000;700452000;70132000;932663000;14408146000;15760962000;16693625000;5134592000;-207740000;-1081467000;3590040000;20283665000
AMT;68339;USD;2012;Q4;2012-12-31;2013-02-27;395216000;400397000;374636000;143562000;;836267000;5765856000;;7487306000;13253162000;14089429000;448000000;60031000;632178000;8693345000;9773070000;10405248000;5016083000;-62728000;-1196907000;3684181000;14089429000
AMT;68339;USD;2011;Q4;2011-12-31;2012-02-29;393294000;403448000;352461000;100610000;;775155000;4981722000;;6485518000;11467240000;12242395000;587198000;101816000;781497000;7134492000;8050756000;8832253000;4907736000;0;-1477899000;3410142000;12242395000
AMT;68339;USD;2010;Q4;2010-12-31;2011-02-28;398927000;401729000;930391000;81479000;;1408229000;3683474000;;5278381000;8961855000;10370084000;330430000;74896000;539461000;5512492000;6326065000;6865526000;8581953000;-3381966000;-1736596000;3504558000;10370084000
AMT;68339;USD;2009;Q4;2009-12-31;2010-03-01;401587000;404982000;257069000;67949000;;655096000;3169623000;;4695212000;7864835000;8519931000;208676000;70521000;391244000;4141060000;4810562000;5201806000;8398440000;-2961177000;-2109532000;3318125000;8519931000
AMT;68339;USD;2008;Q4;2008-12-31;2009-08-06;395227000;408319000;145105000;51313000;;473680000;3022636000;;4715349000;7737985000;8211665000;180620000;1837000;302645000;4331309000;4914541000;5217186000;8113909000;-2746429000;-2356127000;2994479000;8211665000
AMT;68339;USD;2017;Q4;2017-12-31;2018-02-28;428866000;433235000;803100000;513600000;;2038100000;11101000000;;20075200000;31176200000;33214300000;1468500000;774800000;2512100000;19430300000;22747900000;25260000000;10251900000;-974000000;-1058100000;7954300000;33214300000
AMT;68339;USD;2018;Q4;2018-12-31;2019-02-27;440914000;444837000;1208700000;459000000;;2385100000;11247100000;;19378200000;30625300000;33010400000;1631000000;2754800000;4689900000;18405100000;21416100000;26106000000;10385300000;-1206800000;-1199500000;6904400000;33010400000
AAL;68568;USD;2016;Q4;2016-12-31;2017-02-22;514572000;518358000;6359000000;1594000000;1094000000;10324000000;31159000000;;9791000000;40950000000;51274000000;5316000000;1855000000;13872000000;22489000000;33617000000;47489000000;7228000000;;1640000000;3785000000;51274000000
AAL;68568;USD;2015;Q4;2015-12-31;2016-02-24;626561000;644140000;6254000000;1425000000;863000000;9985000000;27510000000;;10920000000;38430000000;48415000000;5102000000;2231000000;13605000000;18330000000;29175000000;42780000000;11597000000;;-1230000000;5635000000;48415000000
AAL;68568;USD;2014;Q4;2014-12-31;2015-02-25;706186000;724766000;7303000000;1771000000;1004000000;11750000000;23084000000;;8391000000;31475000000;43225000000;4668000000;1677000000;13404000000;16043000000;27800000000;41204000000;15142000000;;-8562000000;2021000000;43225000000
AAL;68568;USD;2017;Q4;2017-12-31;2018-02-21;477164000;479381000;5066000000;1752000000;1359000000;9146000000;34156000000;;9483000000;43639000000;52785000000;5641000000;2554000000;15358000000;22511000000;38207000000;53565000000;5719000000;;-1345000000;-780000000;52785000000
AAL;68568;USD;2018;Q4;2018-12-31;2019-02-25;460588000;461917000;4760000000;1706000000;1522000000;8637000000;34098000000;;17845000000;51943000000;60580000000;5542000000;3294000000;18096000000;21179000000;42653000000;60749000000;4969000000;;136000000;-169000000;60580000000
AEE;68703;USD;2017;Q4;2017-12-31;2018-02-28;242600000;244800000;10000000;515000000;522000000;1612000000;21466000000;;2867000000;24333000000;25945000000;1001000000;1325000000;2940000000;7094000000;15679000000;18619000000;5542000000;;1660000000;7326000000;25945000000
AEE;68703;USD;2016;Q4;2016-12-31;2016-11-04;242600000;244600000;9000000;500000000;527000000;1593000000;20113000000;;2993000000;23106000000;24699000000;898000000;1239000000;2674000000;6595000000;14780000000;17454000000;5558000000;;1568000000;7245000000;24699000000
AEE;68703;USD;2015;Q4;2015-12-31;2016-02-26;242600000;243000000;292000000;486000000;538000000;1917000000;18799000000;;2924000000;21723000000;23640000000;866000000;696000000;2093000000;6880000000;14459000000;16552000000;5618000000;;1331000000;7088000000;23640000000
AEE;68703;USD;2014;Q4;2014-12-31;2015-03-02;242600000;244700000;5000000;504000000;524000000;1694000000;17424000000;;3171000000;20595000000;22289000000;796000000;834000000;2249000000;6085000000;13185000000;15434000000;5619000000;;1103000000;6855000000;22289000000
AEE;68703;USD;2013;Q4;2013-12-31;2013-05-10;242600000;244800000;30000000;600000000;526000000;1972000000;16205000000;;2865000000;19070000000;21042000000;892000000;902000000;2461000000;5504000000;11895000000;14356000000;5634000000;;907000000;6686000000;21042000000
AEE;68703;USD;2012;Q4;2012-12-31;2013-03-01;238600000;;184000000;425000000;570000000;3596000000;15348000000;;3286000000;18634000000;22230000000;622000000;355000000;2686000000;5802000000;12777000000;15463000000;5618000000;;1006000000;6767000000;22230000000
AEE;68703;USD;2011;Q4;2011-12-31;2012-02-28;242500000;;255000000;542000000;712000000;2295000000;18127000000;;3223000000;21350000000;23645000000;794000000;327000000;1785000000;6677000000;13792000000;15577000000;5600000000;;2369000000;8068000000;23645000000
AEE;68703;USD;2010;Q4;2010-12-31;2011-02-24;239900000;;545000000;727000000;707000000;2890000000;17853000000;;2768000000;20621000000;23511000000;758000000;424000000;1888000000;7313000000;13739000000;15627000000;5522000000;;2225000000;7884000000;23511000000
AEE;68703;USD;2009;Q4;2009-12-31;2010-02-26;237100000;;622000000;742000000;782000000;2842000000;17610000000;;3250000000;20860000000;23702000000;804000000;224000000;1711000000;7941000000;13931000000;15642000000;5414000000;;2455000000;8060000000;23702000000
AEE;68703;USD;2008;Q4;2008-12-31;2009-08-10;211900000;;92000000;831000000;842000000;2608000000;16567000000;;3496000000;20063000000;22671000000;920000000;1554000000;3077000000;6554000000;12415000000;15492000000;4782000000;;2181000000;7179000000;22671000000
AEE;68703;USD;2018;Q4;2018-12-31;2019-02-26;244500000;246700000;16000000;542000000;483000000;1533000000;22810000000;;2872000000;25682000000;27215000000;910000000;1177000000;2687000000;7859000000;16755000000;19442000000;5629000000;;2024000000;7773000000;27215000000
ADS;68960;USD;2016;Q4;2016-12-31;2017-02-27;57500000;58000000;1859200000;16393100000;271300000;19589300000;586000000;;5338800000;5924800000;25514100000;915100000;2453500000;9229500000;10103300000;14626400000;23855900000;3047200000;-4733100000;3494800000;1658200000;25514100000
ADS;68960;USD;2015;Q4;2015-12-31;2016-02-25;61096000;61504000;1168000000;13764400000;228000000;16250400000;576700000;;5522800000;6099500000;22349900000;1008900000;1418700000;6403100000;10081400000;13769400000;20172500000;2982200000;-3927400000;3092500000;2177400000;22349900000
ADS;68960;USD;2014;Q4;2014-12-31;2015-02-27;60583000;61170000;1077152000;11417003000;;13814776000;559628000;;5889573000;6449201000;20263977000;913128000;1266914000;6305483000;8134248000;11326548000;17632031000;2906680000;-2975795000;2540948000;2631946000;20263977000
ADS;68960;USD;2013;Q4;2013-12-31;2014-02-28;49165000;65950000;969822000;8464535000;;10400842000;299188000;;2544227000;2843415000;13244257000;472326000;1389489000;4512498000;6002708000;7875998000;12388496000;1513735000;-2689177000;2049430000;855761000;13244257000
ADS;68960;USD;2012;Q4;2012-12-31;2013-02-28;49785000;65954000;893352000;7337784000;;9132143000;253028000;;2614968000;2867996000;12000139000;490095000;2277323000;5032777000;4708486000;6438875000;11471652000;1455180000;-2458092000;1553260000;528487000;12000139000
ADS;68960;USD;2011;Q4;2011-12-31;2012-02-27;49912000;59080000;216213000;5498585000;;6606967000;195397000;;2177885000;2373282000;8980249000;356433000;1714032000;3855171000;3729729000;4949112000;8804283000;1388714000;-2320696000;1131004000;175966000;8980249000
ADS;68960;USD;2010;Q4;2010-12-31;2011-02-28;104311559;110745581;139114000;5099299000;;6129535000;170627000;;1971990000;2142617000;8272152000;290434000;1999506000;3862188000;3530408000;4386870000;8249058000;1321695000;-2079819000;815718000;23094000;8272152000
ADS;68960;USD;2009;Q4;2009-12-31;2010-08-09;52222000;56947000;213378000;841510000;;2359505000;165012000;;2701150000;2866162000;5225667000;231903000;51963000;2130012000;1730389000;2822879000;4952891000;1236580000;-1931102000;1033039000;272776000;5225667000
ADS;68960;USD;2017;Q4;2017-12-31;2018-02-27;55400000;55500000;4190000000;18316800000;234100000;24705600000;613900000;;5365300000;5979200000;30684800000;1094000000;1471200000;10146700000;13415700000;18682800000;28829500000;3100900000;-5272500000;4167100000;1855300000;30684800000
ADS;68960;USD;2018;Q4;2018-12-31;2019-02-26;54200000;54300000;3863100000;17740600000;251900000;24711700000;595100000;;5080900000;5676000000;30387700000;979300000;2862100000;11484000000;10527500000;16571600000;28055600000;3173500000;-5715700000;5012400000;2332100000;30387700000
ALLE;69109;USD;2018;Q4;2018-12-31;2019-02-19;94800000;95600000;283800000;324900000;280300000;916200000;276700000;;1617300000;1894000000;2810200000;370000000;35300000;425500000;1409500000;1730700000;2156200000;900000;;650100000;654000000;2810200000
ALLE;69109;USD;2017;Q4;2017-12-31;2018-02-20;94900000;96200000;466200000;296600000;239800000;1020500000;252200000;;1269300000;1521500000;2542000000;322900000;35000000;376100000;1442300000;1760400000;2136500000;10100000;;391500000;405500000;2542000000
ALLE;69109;USD;2016;Q4;2016-12-31;2017-02-17;95500000;97000000;312400000;260000000;220600000;817400000;226600000;;1203400000;1430000000;2247400000;297700000;48200000;348600000;1415600000;1782400000;2131000000;1000000;;112300000;116400000;2247400000
ALLE;69109;USD;2015;Q4;2015-12-31;2016-02-26;96000000;98100000;199700000;303400000;204100000;724600000;224800000;;1313600000;1538400000;2263000000;300000000;65600000;374700000;1457500000;1858600000;2233300000;25400000;;200000;29700000;2263000000
ALLE;69109;USD;2014;Q4;2014-12-31;2015-02-27;95900000;97200000;290500000;230400000;169300000;969000000;207200000;;839700000;1046900000;2015900000;377900000;49600000;461000000;1215000000;1536400000;1997400000;1000000;;-5800000;18500000;2015900000
ALLE;69109;USD;2013;Q4;2013-12-31;2014-04-30;96000000;96400000;227400000;260000000;187500000;908700000;200200000;;891700000;1091900000;2000600000;322900000;71900000;418700000;1272000000;1616900000;2035600000;29500000;;-95600000;-35000000;2000600000
AKAM;69211;USD;2017;Q4;2017-12-31;2018-03-01;169428000;170729000;711936000;461457000;;1346246000;862535000;567592000;1872543000;3302670000;4648916000;364021000;0;456694000;662913000;829753000;1286447000;4075061000;0;-690662000;3362469000;4648916000
AKAM;69211;USD;2016;Q4;2016-12-31;2016-11-08;173337000;175284000;837018000;368596000;;1309917000;801017000;779311000;1482901000;3063229000;4373146000;314897000;;374588000;640087000;774188000;1148776000;4241321000;;-960729000;3224370000;4373146000
AKAM;69211;USD;2015;Q4;2015-12-31;2016-02-29;177790000;179733000;749561000;380399000;;1253188000;753180000;774674000;1400642000;2928496000;4181684000;278148000;;332440000;618047000;728366000;1060806000;4439192000;;-1276861000;3120878000;4181684000
AKAM;69211;USD;2014;Q4;2014-12-31;2015-03-02;178144000;180910000;758292000;329578000;;1262555000;601591000;869992000;1267408000;2738991000;4001546000;282098000;;334011000;604851000;722200000;1056211000;4561213000;;-1598267000;2945335000;4001546000
AKAM;69211;USD;2013;Q4;2013-12-31;2014-03-03;178759000;182260000;673896000;271988000;;1029714000;450287000;573026000;904658000;1927971000;2957685000;224095000;;263166000;0;65088000;328254000;4563737000;;-1932215000;2629431000;2957685000
AKAM;69211;USD;2012;Q4;2012-12-31;2013-03-01;177478000;181784000;437581000;218777000;;728384000;345091000;657659000;869493000;1872243000;2600627000;176378000;;202944000;;51929000;254873000;5197558000;-624462000;-2225702000;2345754000;2600627000
AKAM;69211;USD;2011;Q4;2011-12-31;2012-02-29;178918000;182958000;849226000;210936000;;1122020000;293043000;380729000;549709000;1223481000;2345501000;123618000;;148392000;;40859000;189251000;5070194000;-482994000;-2429691000;2156250000;2345501000
AKAM;69211;USD;2010;Q4;2010-12-31;2011-03-01;183361000;191837000;606871000;175366000;;858467000;255929000;636531000;601749000;1494209000;2352676000;121036000;;145151000;;29920000;175071000;4972202000;-158261000;-2630595000;2177605000;2352676000
AKAM;69211;USD;2009;Q4;2009-12-31;2010-03-01;170934000;188620000;566741000;154269000;;761173000;182404000;494743000;649190000;1326337000;2087510000;92563000;199755000;327293000;;21495000;348788000;4617520000;-66301000;-2801815000;1738722000;2087510000
AKAM;69211;USD;2008;Q4;2008-12-31;2009-09-04;168843000;182215000;330631000;139612000;;501909000;174483000;440996000;763563000;1379042000;1880951000;87297000;0;100456000;199855000;211725000;312181000;4540848000;0;-2947728000;1568770000;1880951000
AKAM;69211;USD;2018;Q4;2018-12-31;2019-02-28;162958000;164541000;1892105000;479889000;;2535354000;910618000;209066000;1806732000;2926416000;5461770000;427393000;686552000;1210709000;874080000;1059201000;2269910000;3671662000;0;-430890000;3191860000;5461770000
IBM;69543;USD;2016;Q4;2016-12-31;2017-02-28;948590120;952656388;8527000000;9182000000;1553000000;43889000000;10830000000;4585000000;58166000000;73581000000;117470000000;6209000000;7513000000;36274000000;34655000000;62802000000;99076000000;53935000000;-159050000000;152759000000;18392000000;117468000000
IBM;69543;USD;2015;Q4;2015-12-31;2016-02-23;969478092;972801068;8194000000;8333000000;1551000000;42504000000;10727000000;5187000000;52077000000;67991000000;110495000000;6028000000;6461000000;34270000000;33428000000;61802000000;96072000000;53262000000;-155518000000;146124000000;14423000000;110495000000
IBM;69543;USD;2014;Q4;2014-12-31;2015-02-24;990490336;995401920;8476000000;9090000000;2103000000;47377000000;10771000000;5520000000;53604000000;69895000000;117272000000;6864000000;5731000000;39581000000;34991000000;65676000000;105257000000;52666000000;-150715000000;137793000000;12015000000;117272000000
IBM;69543;USD;2013;Q4;2013-12-31;2014-02-25;1072446416;1079968624;11066000000;10465000000;2310000000;51351000000;13821000000;4639000000;56412000000;74872000000;126223000000;7461000000;6862000000;40154000000;32856000000;63140000000;103294000000;51594000000;-137242000000;130042000000;22929000000;126223000000
IBM;69543;USD;2012;Q4;2012-12-31;2013-02-26;1124734084;1136397268;11129000000;10667000000;2287000000;49433000000;13996000000;5021000000;50764000000;69781000000;119214000000;7952000000;9181000000;43625000000;24088000000;56604000000;100229000000;50110000000;-123131000000;117641000000;18985000000;119214000000
IBM;69543;USD;2011;Q4;2011-12-31;2012-02-28;1172204024;1188771940;11922000000;11179000000;2595000000;50928000000;13883000000;4895000000;46727000000;65505000000;116433000000;8517000000;8463000000;42124000000;22857000000;54074000000;96198000000;48129000000;-110963000000;104857000000;20235000000;116433000000
IBM;69543;USD;2010;Q4;2010-12-31;2011-02-22;1240156808;1258321552;11651000000;10834000000;2450000000;48116000000;14096000000;5778000000;45460000000;65334000000;113450000000;7804000000;6778000000;40562000000;21846000000;49716000000;90278000000;45418000000;-96161000000;92532000000;23172000000;113450000000
IBM;69543;USD;2009;Q4;2009-12-31;2010-02-23;1318329640;1340811016;13974000000;10736000000;2494000000;48937000000;14165000000;5379000000;40543000000;60087000000;109024000000;7436000000;4168000000;36003000000;21932000000;50266000000;86269000000;41810000000;-81243000000;80900000000;22755000000;109024000000
IBM;69543;USD;2008;Q4;2008-12-31;2009-07-28;1347368276;1353588792;12907000000;10906000000;2701000000;49004000000;14305000000;5058000000;41158000000;60521000000;109525000000;7014000000;11236000000;42435000000;22689000000;53504000000;95939000000;39129000000;-74171000000;70353000000;13585000000;109524000000
IBM;69543;USD;2017;Q4;2017-12-31;2018-02-27;924575739;928915071;12580000000;8928000000;1583000000;49735000000;11116000000;4919000000;59585000000;75620000000;125355000000;6451000000;6987000000;37363000000;39837000000;70268000000;107631000000;54566000000;-163507000000;153126000000;17724000000;125355000000
IBM;69543;USD;2018;Q4;2018-12-31;2019-02-26;901294784;905242185;11997000000;7432000000;1682000000;49145000000;10792000000;2386000000;61058000000;74236000000;123381000000;6558000000;10207000000;38227000000;35605000000;68226000000;106453000000;55151000000;-168071000000;159206000000;16930000000;123383000000
SLNM;69772;USD;2016;Q4;2017-03-31;2016-06-24;76245000;149300000;189000;1348000;;1664000;69000;;301000;370000;2034000;1257000;1000000;10248000;;69000;10317000;116268000;;-124551000;-8283000;2034000
SLNM;69772;USD;2015;Q4;2016-03-31;2015-06-19;76245000;76245000;229000;874000;;1244000;60000;;301000;361000;1605000;1331000;1000000;8157000;;73000;8230000;115966000;;-122591000;-6625000;1605000
SLNM;69772;USD;2014;Q4;2015-03-31;2014-06-27;76273000;76273000;119000;1475000;;1883000;54000;;96000;150000;2033000;1210000;1000000;5001000;;2000;5003000;115681000;;-118651000;-2970000;2033000
SLNM;69772;USD;2013;Q4;2014-03-31;2013-06-26;11923000;11923000;96000;720000;;1134000;58000;;107000;165000;1299000;1128000;1000000;11314000;;12000;11326000;106438000;;-116465000;-10027000;1299000
SLNM;69772;USD;2012;Q4;2013-03-31;2012-06-29;3283000;3283000;130000;783000;;1107000;92000;;358000;450000;1557000;1847000;4106000;14223000;;123000;14346000;99740000;;-112529000;-12789000;1557000
SLNM;69772;USD;2011;Q4;2012-03-31;2011-08-12;;;386000;728000;;1187000;127000;;322000;449000;1636000;1237000;2733000;9258000;1156000;1380000;10638000;99429000;;-108431000;-9002000;1636000
GAS;70028;USD;2016;Q4;2016-12-31;2017-02-22;986000000;995000000;1975000000;1583000000;1462000000;9722000000;68564000000;1819000000;29592000000;99975000000;109697000000;5395000000;4828000000;12917000000;42629000000;69886000000;82803000000;14613000000;-31000000;10356000000;26894000000;109697000000
BXP;70579;USD;2016;Q4;2016-12-31;2017-02-28;153818000;153995000;356914000;92548000;;512636000;15925028000;23814000;2390165000;18339007000;18851643000;672765000;9796133000;10919719000;0;0;10919719000;6334962000;-2722000;-693694000;7931924000;18851643000
BXP;70579;USD;2015;Q4;2015-12-31;2016-02-29;153609000;153902000;723718000;97865000;;895373000;15555641000;20380000;1880092000;17456113000;18351486000;792415000;9188543000;10464559000;;0;10464559000;6307223000;-2722000;-780952000;7886927000;18351486000
BXP;70579;USD;2014;Q4;2014-12-31;2015-03-02;153128000;153552000;1763079000;46595000;;2296995000;15688744000;19459000;1881569000;17589772000;19886767000;1289267000;10086984000;11878506000;;104692000;11983198000;6271788000;-2722000;-762464000;7903569000;19886767000
BXP;70579;USD;2013;Q4;2013-12-31;2014-02-28;152813000;152950000;2365137000;59464000;;2481802000;15817194000;16641000;1860627000;17694462000;20176264000;867235000;10776628000;12236845000;744880000;844489000;13081334000;5663983000;-2722000;-108552000;7094930000;20176264000
BXP;70579;USD;2012;Q4;2012-12-31;2013-02-28;151024000;151421000;1041978000;69555000;;1166714000;11959168000;12172000;2324267000;14295607000;15462321000;382051000;7742013000;8448677000;1170356000;1267914000;9716591000;5223589000;-2722000;-109985000;5745730000;15462321000
BXP;70579;USD;2011;Q4;2011-12-31;2012-02-28;147807000;148051000;1823208000;79838000;;1943378000;10746486000;9548000;2083554000;12839588000;14782966000;316145000;6988453000;7598113000;1715685000;1715685000;9313798000;4937938000;-2722000;-53080000;5469168000;14782966000
BXP;70579;USD;2010;Q4;2010-12-31;2011-02-25;140121000;140612000;478948000;60813000;;847792000;10441117000;8732000;2050622000;12500471000;13348263000;304950000;6064184000;6606601000;1721817000;1721817000;8328418000;4418564000;-2722000;-24763000;5019845000;13348263000
BXP;70579;USD;2009;Q4;2009-12-31;2010-02-25;139036000;139735000;1448933000;93240000;;1564040000;9065881000;9946000;1708836000;10784663000;12348703000;376683000;4815690000;5319911000;1904081000;1904081000;7223992000;4375068000;-2722000;95433000;5124711000;12348703000
BXP;70579;USD;2008;Q4;2008-12-31;2009-08-06;120796000;121488000;241510000;68743000;;332223000;8856422000;11590000;1717241000;10585253000;10917476000;336085000;4133017000;4742852000;1859867000;1859867000;6602719000;3561053000;-2722000;154953000;4314757000;10917476000
BXP;70579;USD;2017;Q4;2017-12-31;2018-02-28;154368000;154532000;434767000;92186000;;597555000;16507008000;29161000;2238509000;18774678000;19372233000;554186000;10226611000;11269777000;0;0;11269777000;6379451000;-2722000;-712343000;8102456000;19372233000
BXP;70579;USD;2018;Q4;2018-12-31;2019-02-28;154468000;154774000;543359000;86626000;;725817000;16752119000;28198000;2750340000;19530657000;20256474000;531026000;10509269000;11040295000;498488000;1002214000;12042509000;6409168000;-2722000;-675534000;8213968000;20256477000
BWA;70746;USD;2015;Q4;2015-12-31;2016-02-11;221670000;222898000;577700000;1665000000;723600000;3135200000;2448100000;460900000;2781500000;5690500000;8825700000;1915800000;441400000;2357200000;2108900000;2837000000;5194200000;1112200000;-1158400000;4210100000;3631500000;8825700000
BWA;70746;USD;2014;Q4;2014-12-31;2015-02-12;226415000;228031000;797800000;1443500000;505700000;2970800000;2093900000;403300000;1760000000;4257200000;7228000000;1544500000;623700000;2168200000;716300000;1368900000;3537100000;1114900000;-832200000;3717100000;3690900000;7228000000
BWA;70746;USD;2013;Q4;2013-12-31;2014-02-13;226894000;229540000;939500000;1248500000;458100000;2798500000;1939400000;405100000;1774000000;4118500000;6917000000;1422300000;201600000;1623900000;1021000000;1660700000;3284600000;1124400000;-727200000;3177400000;3632400000;6917000000
BWA;70746;USD;2012;Q4;2012-12-31;2013-02-14;231500000;235588000;715700000;1147300000;447600000;2472800000;1788000000;382700000;1757300000;3928000000;6400800000;1359700000;243400000;1603100000;823800000;1651600000;3254700000;1161900000;-569200000;2611200000;3146100000;6400800000
BWA;70746;USD;2011;Q4;2011-12-31;2012-02-14;217484000;255132000;359600000;1183000000;454300000;2137800000;1664300000;345300000;1811200000;3820800000;5958600000;1327600000;577800000;1905400000;751300000;1600200000;3505600000;1135500000;-707100000;2110300000;2453000000;5958600000
BWA;70746;USD;2010;Q4;2010-12-31;2011-02-10;224252000;263510000;449900000;1023900000;430600000;2059900000;1542600000;307900000;1644600000;3495100000;5555000000;1263800000;128500000;1392300000;1051900000;1852900000;3245200000;1101600000;-349500000;1560200000;2309800000;5555000000
BWA;70746;USD;2009;Q4;2009-12-31;2010-02-11;233532000;235336000;357400000;732000000;314300000;1551800000;1490300000;257400000;1511900000;3259600000;4811400000;977100000;69100000;1046200000;773200000;1542500000;2588700000;1035300000;-57900000;1193400000;2222700000;4811400000
BWA;70746;USD;2008;Q4;2008-12-31;2009-10-28;231066000;219816000;103400000;607100000;451200000;1308200000;1586200000;266500000;1483100000;3335800000;4644000000;929300000;320700000;1250000000;459600000;1356500000;2606500000;978800000;-87400000;1200500000;2037500000;4644000000
BWA;70746;USD;2016;Q4;2016-12-31;2017-02-09;211501000;212746000;443700000;1689300000;641200000;2911600000;2501800000;502200000;2919100000;5923100000;8834700000;1915900000;175900000;2091800000;2043600000;3441000000;5532800000;1106800000;-1381600000;4215200000;3301900000;8834700000
BWA;70746;USD;2017;Q4;2017-12-31;2018-02-08;209745000;211465000;545300000;2018900000;766300000;3475900000;2863800000;547400000;2900500000;6311700000;9787600000;2311100000;84600000;2425200000;2103700000;3536500000;5961700000;1121200000;-1445400000;4531000000;3825900000;9787600000
BWA;70746;USD;2018;Q4;2018-12-31;2019-02-19;207272000;208623000;739400000;1987400000;780800000;3757600000;2903800000;591700000;2842200000;6337700000;10095300000;2203200000;172600000;2398900000;1940700000;3351600000;5750500000;1148300000;-1584800000;5336100000;4344800000;10095300000
BA;70844;USD;2016;Q4;2016-12-31;2017-02-08;624600000;639300000;10029000000;8832000000;43199000000;62488000000;12807000000;1317000000;13385000000;27509000000;89997000000;25881000000;384000000;50134000000;9568000000;38986000000;89120000000;9823000000;-36097000000;40714000000;877000000;89997000000
BA;70844;USD;2015;Q4;2015-12-31;2016-02-10;673800000;681300000;12052000000;8713000000;47257000000;68234000000;12076000000;1284000000;12814000000;26174000000;94408000000;24814000000;1234000000;50412000000;8730000000;37599000000;88011000000;9895000000;-29568000000;38756000000;6397000000;94408000000
BA;70844;USD;2014;Q4;2014-12-31;2015-02-12;716700000;724900000;13092000000;7729000000;46756000000;67767000000;11007000000;1154000000;12993000000;25154000000;92921000000;24129000000;929000000;48233000000;8141000000;35898000000;84131000000;9686000000;-23298000000;36180000000;8790000000;92921000000
BA;70844;USD;2013;Q4;2013-12-31;2014-02-14;757200000;766600000;15258000000;6546000000;42912000000;65074000000;10224000000;1204000000;16161000000;27589000000;92663000000;23629000000;1563000000;51486000000;8072000000;26180000000;77666000000;9476000000;-17671000000;32964000000;14997000000;92663000000
BA;70844;USD;2012;Q4;2012-12-31;2013-02-11;764100000;766300000;13558000000;5608000000;37751000000;57309000000;9660000000;1180000000;20747000000;31587000000;88896000000;22389000000;1436000000;44982000000;8973000000;37947000000;82929000000;9183000000;-15937000000;30037000000;5967000000;88896000000
BA;70844;USD;2011;Q4;2011-12-31;2012-02-09;750000000;746900000;11272000000;5793000000;32240000000;49810000000;9313000000;1043000000;19820000000;30176000000;79986000000;20645000000;2353000000;41274000000;10018000000;35104000000;76378000000;9094000000;-16603000000;27524000000;3608000000;79986000000
BA;70844;USD;2010;Q4;2010-12-31;2011-02-09;741300000;737200000;10517000000;5422000000;24317000000;40572000000;8931000000;1111000000;17951000000;27993000000;68565000000;21517000000;948000000;35395000000;11473000000;30308000000;65703000000;8927000000;-17187000000;24784000000;2862000000;68565000000
BA;70844;USD;2009;Q4;2009-12-31;2010-02-08;722800000;737500000;11223000000;5785000000;16933000000;35275000000;8784000000;1030000000;16964000000;26778000000;62053000000;19918000000;707000000;32883000000;12217000000;26945000000;59828000000;7170000000;-15911000000;22746000000;2225000000;62053000000
BA;70844;USD;2008;Q4;2008-12-31;2009-07-22;;713400000;3279000000;5602000000;15612000000;25964000000;8762000000;1328000000;17725000000;27815000000;53779000000;17435000000;560000000;30773000000;6952000000;24148000000;54921000000;7314000000;-17758000000;22675000000;-1142000000;53779000000
BA;70844;USD;2017;Q4;2017-12-31;2018-02-12;597600000;605100000;9992000000;10516000000;44344000000;65161000000;12672000000;1260000000;13240000000;27172000000;92333000000;27494000000;1335000000;56269000000;9782000000;35652000000;91921000000;11865000000;-43454000000;45320000000;412000000;92333000000
BA;70844;USD;2018;Q4;2018-12-31;2019-02-08;571400000;560300000;8564000000;3879000000;62567000000;87830000000;12645000000;1087000000;15797000000;29529000000;117359000000;27724000000;3190000000;81590000000;10657000000;35359000000;116949000000;11829000000;-52348000000;55941000000;410000000;117359000000
BIIB;71079;USD;2017;Q4;2017-12-31;2018-02-01;211500000;212100000;3689000000;1787000000;902700000;7873300000;3182400000;3057300000;9539600000;15779300000;23652600000;395500000;3200000;3368200000;5935000000;7686300000;11054500000;97900000;-2977100000;15810400000;12598100000;23652600000
BIIB;71079;USD;2016;Q4;2016-12-31;2016-10-26;216700000;217100000;4895100000;1441600000;1001600000;8732200000;2501800000;2829400000;8813400000;14144600000;22876800000;279800000;4700000;3419900000;6512700000;7328300000;10748200000;100000;-2611700000;15071600000;12128600000;22876800000
BIIB;71079;USD;2015;Q4;2015-12-31;2016-02-03;220300000;220900000;3428500000;1227000000;893400000;6700300000;2187600000;2760400000;7856500000;12804500000;19504800000;267400000;4800000;2577700000;6521500000;7552200000;10129900000;100000;-2611700000;12208400000;9374900000;19504800000
BIIB;71079;USD;2014;Q4;2014-12-31;2015-02-04;235900000;236600000;1845400000;1292400000;804000000;4535000000;1765700000;1470700000;6543300000;9779700000;14314700000;229200000;3100000;2218100000;580300000;1282600000;3500700000;4196300000;-2611700000;9283900000;10814000000;14314700000
BIIB;71079;USD;2013;Q4;2013-12-31;2014-02-06;236209000;237804000;1222729000;824406000;659003000;3184934000;1750710000;625772000;6301919000;8678401000;11863335000;219913000;3494000;1758279000;592433000;1484218000;3242497000;4023779000;-1724927000;6349135000;8620838000;11863335000
BIIB;71079;USD;2012;Q4;2012-12-31;2013-02-05;236536000;238385000;1705710000;686848000;447373000;3244337000;1742226000;2036658000;3106897000;6885781000;10130118000;203999000;453379000;1657389000;687396000;1508934000;3166323000;3854652000;-1324618000;4486794000;6963795000;10130118000
BIIB;71079;USD;2011;Q4;2011-12-31;2012-02-03;242786000;245249000;1690657000;584603000;326843000;2975427000;1571387000;1416737000;3086053000;6074177000;9049604000;186448000;3292000;912889000;1060808000;1709728000;2622617000;4185176000;-839903000;3106761000;6426987000;9049604000
BIIB;71079;USD;2010;Q4;2010-12-31;2011-02-04;239504000;242794000;1207744000;605329000;289066000;2540420000;1641634000;743101000;3167338000;5552073000;8092493000;162529000;137153000;1050122000;1066379000;1592928000;2643050000;3895227000;-349592000;1872481000;5449443000;8092493000
BIIB;71079;USD;2009;Q4;2009-12-31;2010-02-09;284189000;286764000;1263724000;551208000;293950000;2480595000;1637083000;1194080000;3240096000;6071259000;8551854000;118534000;19762000;714942000;1080207000;1575030000;2289972000;5782064000;-679920000;1068890000;6261882000;8551854000
BIIB;71079;USD;2008;Q4;2008-12-31;2009-10-21;291489000;293391000;1341971000;446665000;263602000;2458000000;1594754000;891406000;3534831000;6020991000;8478991000;107417000;27667000;923222000;1085431000;1721817000;2645039000;6074106000;-527097000;270180000;5833952000;8478991000
BIIB;71079;USD;2018;Q4;2018-12-31;2019-02-06;199700000;200300000;3538000000;1958500000;929900000;7640900000;3601200000;1375900000;12670900000;17648000000;25288900000;370500000;0;3295200000;5936500000;8962100000;12257300000;100000;-2977100000;16257000000;13031600000;25288900000
BBY;71192;USD;2017;Q4;2018-02-28;2016-12-02;241000000;258800000;3133000000;1049000000;5209000000;9829000000;2421000000;;799000000;3220000000;13049000000;6435000000;544000000;7817000000;811000000;1620000000;9437000000;28000000;;3270000000;3612000000;13049000000
BBY;71192;USD;2016;Q4;2017-02-28;2015-12-04;339300000;342300000;3921000000;1347000000;4864000000;10516000000;2293000000;;1047000000;3340000000;13856000000;6233000000;44000000;7122000000;1321000000;2025000000;9147000000;31000000;;4399000000;4709000000;13856000000
BBY;71192;USD;2015;Q4;2016-02-29;2014-12-05;351200000;357800000;3281000000;1162000000;5051000000;9886000000;2346000000;;1287000000;3633000000;13519000000;5764000000;395000000;6925000000;1339000000;2216000000;9141000000;32000000;-55000000;4130000000;4378000000;13519000000
BBY;71192;USD;2014;Q4;2015-02-28;2013-12-09;346200000;356100000;2901000000;1308000000;5376000000;10485000000;2598000000;;930000000;3528000000;14013000000;6586000000;45000000;7436000000;1612000000;2588000000;10024000000;335000000;;3159000000;3989000000;14013000000
BBY;71192;USD;2013;Q4;2014-02-28;2012-12-05;336800000;335800000;1826000000;2704000000;6571000000;12047000000;3270000000;;1470000000;4740000000;16787000000;8788000000;1143000000;10810000000;1153000000;2262000000;13072000000;88000000;;2861000000;3715000000;16787000000
BBY;71192;USD;2012;Q4;2013-02-28;2012-01-03;359500000;369300000;1199000000;2288000000;5731000000;10297000000;3471000000;140000000;2097000000;5708000000;16005000000;7876000000;523000000;8855000000;1685000000;2784000000;11639000000;34000000;;3621000000;4366000000;16005000000
BBY;71192;USD;2011;Q4;2012-02-29;2011-01-05;393500000;402900000;1125000000;2348000000;5897000000;10473000000;3823000000;328000000;3225000000;7376000000;17849000000;7191000000;998000000;8663000000;711000000;1894000000;10557000000;57000000;;6372000000;7292000000;17849000000
BBY;71192;USD;2010;Q4;2011-02-28;2010-01-07;418400000;428700000;1916000000;2020000000;5486000000;10566000000;4070000000;324000000;3342000000;7736000000;18302000000;7817000000;698000000;8978000000;1104000000;2360000000;11338000000;483000000;;5797000000;6964000000;18302000000
BBY;71192;USD;2009;Q4;2010-02-28;2009-10-08;413700000;423500000;509000000;1868000000;4753000000;8192000000;4174000000;395000000;3065000000;7634000000;15826000000;7119000000;837000000;8435000000;1126000000;2235000000;10670000000;246000000;;4714000000;5156000000;15826000000
BBY;71192;USD;2018;Q4;2019-02-28;2019-03-28;269700000;274300000;1980000000;1015000000;5409000000;8870000000;2510000000;;1521000000;4031000000;12901000000;6721000000;56000000;7513000000;1332000000;2082000000;9595000000;27000000;;2985000000;3306000000;12901000000
BRKA;71306;USD;2017;Q4;2017-12-31;2018-02-26;4050505;;115954000000;42326000000;16187000000;174467000000;158219000000;203014000000;166395000000;527628000000;702095000000;35903000000;;78840000000;102587000000;271301000000;350141000000;35702000000;-1763000000;255786000000;351954000000;702095000000
BRKA;71306;USD;2016;Q4;2016-12-31;2016-11-04;8216655;;86370000000;40397000000;15727000000;142494000000;152773000000;173612000000;151975000000;478360000000;620854000000;35042000000;;60014000000;101644000000;275412000000;335426000000;35689000000;-1763000000;210846000000;285428000000;620854000000
BRKA;71306;USD;2015;Q4;2015-12-31;2015-11-06;8224749;;71730000000;36075000000;11916000000;119721000000;145166000000;158328000000;129042000000;432536000000;552257000000;31271000000;;31271000000;84289000000;262359000000;293630000000;35628000000;-1763000000;187703000000;258627000000;552257000000
BRKA;71306;USD;2014;Q4;2014-12-31;2014-11-07;1642837;;63269000000;34418000000;10236000000;107923000000;137244000000;166549000000;114151000000;417944000000;525867000000;30556000000;;30556000000;79890000000;252284000000;282840000000;35581000000;-1763000000;163620000000;243027000000;525867000000
BRKA;71306;USD;2013;Q4;2013-12-31;2013-11-01;1643893;;48186000000;33106000000;9860000000;91152000000;123805000000;163706000000;106268000000;393779000000;484931000000;37835000000;;37835000000;72224000000;222611000000;260446000000;35480000000;-1363000000;143748000000;224485000000;484931000000
BRKA;71306;USD;2012;Q4;2012-12-31;2012-11-02;1650537;;46992000000;34562000000;9675000000;91229000000;106872000000;140287000000;89064000000;336223000000;427452000000;35361000000;;35361000000;62736000000;200503000000;235864000000;37238000000;-1363000000;124272000000;191588000000;427452000000
BRKA;71306;USD;2011;Q4;2011-12-31;2011-11-04;-1648407700778;;37299000000;32946000000;8975000000;79220000000;100391000000;125172000000;87864000000;313427000000;392647000000;32706000000;;32706000000;60384000000;190980000000;223686000000;37815000000;-67000000;109448000000;168961000000;392647000000
BRKA;71306;USD;2010;Q4;2010-12-31;2010-11-05;-3294763056523;;38227000000;36143000000;7101000000;81471000000;93126000000;117711000000;79921000000;290758000000;372229000000;29361000000;;29361000000;58574000000;179934000000;209295000000;37541000000;;99194000000;162934000000;372229000000
BRKA;71306;USD;2009;Q4;2009-12-31;2009-11-06;6204691347066;;30558000000;28781000000;6147000000;65486000000;46656000000;126293000000;58684000000;231633000000;297119000000;22362000000;;22362000000;37909000000;138972000000;161334000000;27082000000;;86227000000;135785000000;297119000000
BRKA;71306;USD;2008;Q4;2008-12-31;2009-11-06;6195835353387;;25539000000;28867000000;7500000000;61906000000;45157000000;102240000000;58096000000;205493000000;267399000000;23818000000;;23818000000;36882000000;129874000000;153692000000;27141000000;;78172000000;113707000000;267399000000
BRKA;71306;USD;2018;Q4;2018-12-31;2019-02-25;4948912;;111867000000;47844000000;19069000000;182446000000;166706000000;209980000000;148662000000;525348000000;707794000000;37186000000;;83613000000;97490000000;271681000000;355294000000;35715000000;-3109000000;321112000000;352500000000;707794000000
BDX;71373;USD;2016;Q4;2016-09-30;2016-11-23;213567000;219940000;1568000000;1618000000;1719000000;6366000000;3901000000;;15319000000;19220000000;25586000000;3210000000;1001000000;4400000000;10550000000;13553000000;17953000000;5048000000;-8212000000;12727000000;7634000000;25587000000
BDX;71373;USD;2015;Q4;2015-09-30;2015-11-25;211044000;218170000;1444000000;1618000000;1959000000;5659000000;4060000000;;16758000000;20818000000;26477000000;2930000000;1452000000;4382000000;11370000000;14933000000;19315000000;4828000000;-8239000000;12314000000;7165000000;26480000000
BDX;71373;USD;2014;Q4;2014-09-30;2014-11-26;192330000;198233000;2745000000;1187000000;1495000000;6130000000;3605000000;;2712000000;6317000000;12447000000;2031000000;203000000;2234000000;3768000000;5160000000;7394000000;2550000000;-8601000000;12105000000;5053000000;12447000000
BDX;71373;USD;2013;Q4;2013-09-30;2013-11-27;194713000;200340000;2608000000;1240000000;1402000000;5873000000;3476000000;;2801000000;6277000000;12150000000;1923000000;207000000;2130000000;3763000000;4976000000;7106000000;2420000000;-8204000000;11342000000;5042000000;12148000000
BDX;71373;USD;2012;Q4;2012-09-30;2012-11-21;199099000;203997000;2181000000;1250000000;1241000000;5323000000;3304000000;;2735000000;6039000000;11362000000;1573000000;405000000;1978000000;3761000000;5247000000;7225000000;2272000000;-7769000000;10435000000;4136000000;11361000000
BDX;71373;USD;2011;Q4;2011-09-30;2011-11-23;216757000;223171000;1563313000;1228637000;1244972000;4668331000;3211197000;;2550900000;5762097000;10430428000;1588296000;234932000;1823228000;2484665000;3779025000;5602253000;2144697000;-6280106000;9633584000;4828175000;10430428000
BDX;71373;USD;2010;Q4;2010-09-30;2010-11-24;231385000;238397000;1744195000;1205377000;1145337000;4505250000;3100492000;;2044952000;5145444000;9650694000;1468915000;202758000;1671673000;1495357000;2544441000;4216114000;1974594000;-4806333000;8724228000;5434580000;9650694000
BDX;71373;USD;2009;Q4;2009-09-30;2009-11-25;239147000;245943000;1945805000;1168662000;1156762000;4646954000;2966629000;;1691041000;4657670000;9304624000;1374128000;402965000;1777093000;1488460000;2384819000;4161912000;1836242000;-4073699000;7752831000;5142712000;9304624000
BDX;71373;USD;2008;Q4;2008-09-30;2009-08-10;;;1030419000;1079051000;1080426000;3614675000;2744474000;;1553794000;4298268000;7912943000;1215267000;201312000;1416579000;953226000;1560796000;2977375000;1706887000;-3532398000;6838589000;4935568000;7912943000
BDX;71373;USD;2017;Q4;2017-09-30;2017-11-22;228318000;237940000;14200000000;1744000000;1818000000;18634000000;4638000000;;14462000000;19100000000;37734000000;3139000000;203000000;3342000000;18667000000;21444000000;24786000000;9985000000;-8427000000;13111000000;12948000000;37734000000
BDX;71373;USD;2018;Q4;2018-09-30;2018-11-21;268201000;287180000;1157000000;2319000000;2451000000;7411000000;5375000000;;41119000000;46494000000;53905000000;4614000000;2601000000;7215000000;18894000000;25693000000;32908000000;16548000000;-6243000000;12596000000;20994000000;53902000000
BCR;71733;USD;2016;Q4;2016-12-31;2017-02-13;73900000;149100000;905000000;477300000;483000000;2316400000;489500000;;2500200000;2989700000;5306100000;1108900000;0;1108900000;1641700000;2522100000;3631000000;2365000000;;-454400000;1675100000;5306100000
BCR;71733;USD;2015;Q4;2015-12-31;2016-02-12;73700000;-144500000;950500000;445100000;413700000;1969300000;472400000;;2402300000;2874700000;4844000000;1010500000;250200000;1260700000;1144100000;2128000000;3388700000;2166800000;;-503500000;1455300000;4844000000
BCR;71733;USD;2014;Q4;2014-12-31;2015-02-18;75500000;-72100000;960100000;455200000;376200000;2047100000;446400000;;2599100000;3045500000;5092600000;536600000;78000000;614600000;1401900000;2673100000;3287700000;1964000000;;-70300000;1804900000;5092600000
BCR;71733;USD;2013;Q4;2013-12-31;2014-02-19;77600000;-158200000;1066900000;479600000;356200000;2090400000;391200000;;2559500000;2950700000;5041100000;586500000;0;586500000;1405700000;2366400000;2952900000;1749000000;;360100000;2088200000;5041100000
BCR;71733;USD;2012;Q4;2012-12-31;2013-02-20;81800000;-250400000;896300000;480900000;328500000;1847200000;359300000;;1944800000;2304100000;4151300000;447600000;;447600000;1409600000;1778000000;2225600000;1533700000;;473200000;1925700000;4151300000
BCR;71733;USD;2011;Q4;2011-12-31;2012-02-23;85100000;173500000;596400000;488900000;319200000;1688900000;355400000;;1887100000;2242500000;3931400000;610900000;304500000;915400000;908700000;1244800000;2160200000;1371000000;;466800000;1771200000;3931400000
BCR;71733;USD;2010;Q4;2010-12-31;2011-02-24;90500000;374900000;641400000;460800000;308900000;1529300000;327900000;;1314300000;1642200000;3171500000;317200000;80500000;397700000;896900000;1142300000;1540000000;1167700000;;520000000;1631500000;3171500000
BCR;71733;USD;2009;Q4;2009-12-31;2010-02-25;96200000;1300000;674400000;442100000;295400000;1491800000;333100000;;1082000000;1415100000;2906900000;281700000;0;281700000;149800000;419300000;701000000;1084900000;;1133400000;2205900000;2906900000
BCR;71733;USD;2008;Q4;2008-12-31;2009-07-27;;;592100000;394100000;275100000;1354200000;333400000;;978100000;1311500000;2665700000;273100000;;273100000;149800000;404400000;677500000;991400000;;1080200000;1988200000;2665700000
BHI;71832;USD;2015;Q4;2015-12-31;2016-02-17;438000000;438000000;2324000000;3217000000;2917000000;9268000000;6693000000;;8119000000;14812000000;24080000000;2624000000;151000000;2775000000;3890000000;4923000000;7698000000;7698000000;-9000000;9614000000;16382000000;24080000000
BHI;71832;USD;2014;Q4;2014-12-31;2015-02-26;436000000;437000000;1740000000;5418000000;4074000000;12045000000;9063000000;;7719000000;16782000000;28827000000;4417000000;220000000;4637000000;3913000000;5460000000;10097000000;7496000000;0;11878000000;18730000000;28827000000
BHI;71832;USD;2013;Q4;2013-12-31;2014-02-12;442000000;443000000;1399000000;5138000000;3884000000;11295000000;9076000000;;7563000000;16639000000;27934000000;4079000000;499000000;4578000000;3882000000;5444000000;10022000000;7779000000;;10438000000;17912000000;27934000000
BHI;71832;USD;2012;Q4;2012-12-31;2013-02-13;442000000;443000000;1015000000;4815000000;3781000000;10417000000;8707000000;;7565000000;16272000000;26689000000;3045000000;1079000000;4124000000;3837000000;5297000000;9421000000;7936000000;;9609000000;17268000000;26689000000
BHI;71832;USD;2011;Q4;2011-12-31;2012-02-24;436000000;438000000;1050000000;4878000000;3222000000;9797000000;7415000000;;7635000000;15050000000;24847000000;3278000000;224000000;3502000000;3845000000;5381000000;8883000000;7740000000;;8561000000;15964000000;24847000000
BHI;71832;USD;2010;Q4;2010-12-31;2011-02-25;433000000;435000000;1706000000;3942000000;2594000000;8707000000;6310000000;;7969000000;14279000000;22986000000;2808000000;331000000;3139000000;3554000000;5561000000;8700000000;7437000000;;7083000000;14286000000;22986000000
BHI;71832;USD;2009;Q4;2009-12-31;2010-02-26;310000000;314000000;1595000000;2331000000;1836000000;6225000000;3161000000;;2053000000;5214000000;11439000000;1598000000;15000000;1613000000;1785000000;2542000000;4155000000;1186000000;;6512000000;7284000000;11439000000
BHI;71832;USD;2008;Q4;2008-12-31;2009-08-06;;;1955000000;2759000000;2021000000;7145000000;2833000000;;1883000000;4716000000;11861000000;1953000000;558000000;2511000000;1775000000;2543000000;5054000000;1054000000;;6276000000;6807000000;11861000000
BHI;71832;USD;2016;Q4;2016-12-31;2017-02-08;426000000;;981000000;2563000000;3224000000;7401000000;2325000000;;11995000000;14320000000;21721000000;1898000000;239000000;4934000000;38000000;18514000000;23448000000;0;;0;-1727000000;21721000000
BHI;71832;USD;2017;Q4;2017-12-31;2018-02-23;;;7019000000;6127000000;4590000000;18608000000;6959000000;;31319000000;38278000000;56886000000;3377000000;2037000000;8905000000;6312000000;8823000000;17728000000;41351000000;;-459000000;39158000000;56886000000
BHI;71832;USD;2018;Q4;2018-12-31;2019-02-19;;;3677000000;6062000000;4620000000;14998000000;6228000000;;31008000000;37236000000;52234000000;4018000000;942000000;9001000000;6285000000;8357000000;17358000000;37582000000;;-354000000;34876000000;52234000000
ICPT;72077;USD;2016;Q4;2016-12-31;2017-03-01;24807000;24807000;689385000;9126000;2279000;710144000;11295000;;17814000;29109000;739253000;72818000;;78512000;341356000;345809000;424321000;1426193000;;-1108460000;314932000;739253000
ICPT;72077;USD;2015;Q4;2015-12-31;2016-02-29;24374920;24374920;628055000;;0;641693000;10047000;;4018000;14065000;655758000;45591000;;47373000;;6236000;53609000;1300032000;;-695630000;602149000;655758000
ICPT;72077;USD;2014;Q4;2014-12-31;2015-03-02;20166015;20166015;239724000;;;245828000;5852000;;2469000;8321000;254149000;13459000;;15241000;;8017000;23258000;700376000;;-469202000;230890000;254148000
ICPT;72077;USD;2013;Q4;2013-12-31;2014-03-14;19387185;19387185;144831982;;;147564538;1672295;;1081747;2754042;150318580;7259805;;8881427;;59031053;67912480;268322007;;-185975760;82406100;150318580
ICPT;72077;USD;2012;Q4;2012-12-31;2013-04-01;15145154;15145154;110193911;;;111778219;148838;;251540;400378;112178597;3745773;;12964054;;33302678;46266732;184116666;;-118183350;65911865;112178597
ICPT;72077;USD;2011;Q4;2011-12-31;2012-12-21;3330866;3330866;17707476;;;18904094;311366;;254869;566235;19470329;1504198;81762;4032067;;17998040;22030107;72137223;;-74540279;-2559778;19470329
ICPT;72077;USD;2017;Q4;2017-12-31;2018-02-28;25153000;25153000;414917000;16501000;3480000;451787000;16184000;;16376000;32560000;484347000;102252000;;104034000;355677000;363927000;467961000;1486715000;;-1469543000;16386000;484347000
ICPT;72077;USD;2018;Q4;2018-12-31;2019-03-01;29733000;29733000;436160000;25694000;7108000;489533000;10411000;;9223000;19634000;509167000;112584000;;114205000;371250000;375832000;490037000;1800174000;;-1778785000;19130000;509167000
TGT;72458;USD;2017;Q4;2018-01-31;2018-03-14;541000000;546200000;2643000000;;8597000000;12540000000;21891000000;;5872000000;27763000000;40303000000;12771000000;281000000;13052000000;11117000000;15600000000;28652000000;5903000000;;6495000000;11651000000;40303000000
TGT;72458;USD;2016;Q4;2017-01-31;2017-03-08;559800000;564600000;2512000000;;8309000000;11990000000;22007000000;;3434000000;25441000000;37431000000;10989000000;1718000000;12707000000;11031000000;13771000000;26478000000;5707000000;;5884000000;10953000000;37431000000
TGT;72458;USD;2015;Q4;2016-01-31;2016-03-11;610400000;615400000;4046000000;;8601000000;14130000000;22600000000;;3532000000;26132000000;40262000000;11654000000;815000000;12622000000;11945000000;14683000000;27305000000;5398000000;;8188000000;12957000000;40262000000
TGT;72458;USD;2014;Q4;2015-01-31;2015-03-13;638000000;644200000;2210000000;;8282000000;13624000000;23400000000;;4148000000;27548000000;41172000000;11542000000;91000000;11736000000;12634000000;15439000000;27175000000;4952000000;;9644000000;13997000000;41172000000
TGT;72458;USD;2013;Q4;2014-01-31;2014-03-14;632200000;638300000;670000000;;8278000000;11573000000;24017000000;;8963000000;32980000000;44553000000;10945000000;1143000000;12777000000;11429000000;15545000000;28322000000;4523000000;;12599000000;16231000000;44553000000
TGT;72458;USD;2012;Q4;2013-01-31;2013-03-20;649000000;655700000;784000000;;7903000000;16388000000;28086000000;;3689000000;31775000000;48163000000;11037000000;2994000000;14031000000;14654000000;17574000000;31605000000;3979000000;;13155000000;16558000000;48163000000
TGT;72458;USD;2011;Q4;2012-01-31;2012-03-15;669400000;675200000;794000000;;7918000000;16449000000;26681000000;;3500000000;30181000000;46630000000;10501000000;3786000000;14287000000;13697000000;16522000000;30809000000;3543000000;;12959000000;15821000000;46630000000
TGT;72458;USD;2010;Q4;2011-01-31;2011-03-11;708000000;714300000;1712000000;;7596000000;17213000000;22960000000;;3532000000;26492000000;43705000000;9951000000;119000000;10070000000;15607000000;18148000000;28218000000;3370000000;;12698000000;15487000000;43705000000
TGT;72458;USD;2009;Q4;2010-01-31;2010-03-12;752000000;756100000;2200000000;;7179000000;18424000000;22705000000;;3404000000;26109000000;44533000000;9631000000;1696000000;11327000000;15118000000;17859000000;29186000000;2981000000;;12947000000;15347000000;44533000000
TGT;72458;USD;2008;Q4;2009-01-31;2009-08-28;752400000;754100000;864000000;;6705000000;17488000000;23170000000;;3448000000;26618000000;44106000000;9250000000;1262000000;10512000000;17490000000;19882000000;30394000000;2825000000;;11443000000;13712000000;44106000000
TGT;72458;USD;2018;Q4;2019-01-31;2019-03-13;519900000;524300000;1556000000;;9497000000;12519000000;22989000000;;5782000000;28771000000;41290000000;13962000000;1052000000;15014000000;10223000000;14979000000;29993000000;6085000000;;6017000000;11297000000;41290000000
ASNB;72924;USD;2016;Q4;2017-03-31;2017-06-26;21491000;22457000;27000;233000;189000;454000;1865000;;113000;1978000;2432000;855000;;875000;1986000;2158000;3033000;38125000;-30000;-38696000;-601000;2432000
ASNB;72924;USD;2015;Q4;2016-03-31;2016-06-27;21491000;25439000;80000;192000;257000;534000;1922000;;120000;2042000;2576000;470000;1000;526000;1986000;2146000;2672000;38121000;-30000;-38187000;-96000;2576000
ASNB;72924;USD;2014;Q4;2015-03-31;2015-07-14;;26219000;75000;290000;304000;675000;1998000;;127000;2125000;2800000;707000;8000;835000;1986000;2133000;2968000;38082000;-30000;-38220000;-168000;2800000
ASNB;72924;USD;2013;Q4;2014-03-31;2014-07-29;;21491000;268000;195000;181000;647000;2110000;;133000;2243000;2890000;524000;;629000;1986000;2122000;2751000;38071000;-30000;-37902000;139000;2890000
ASNB;72924;USD;2012;Q4;2013-03-31;2013-07-17;;;103000;353000;258000;720000;2299000;;103000;2402000;3122000;400000;;425000;1986000;2074000;2499000;38034000;-30000;-37381000;623000;3122000
ASNB;72924;USD;2011;Q4;2012-03-31;2012-11-13;;;484000;291000;351000;1366000;2487000;;100000;2587000;3953000;298000;;331000;1986000;2021000;2352000;38001000;-30000;-36370000;1601000;3953000
ASNB;72924;USD;2010;Q4;2011-03-31;2012-10-12;;;477000;153000;400000;1097000;2700000;;;2700000;3797000;395000;;436000;;0;436000;37949000;-30000;-34558000;3361000;3797000
ASNB;72924;USD;2017;Q4;2018-03-31;2018-07-16;21491000;21491000;120000;570000;297000;991000;1823000;;106000;1929000;2920000;954000;;1262000;1986000;2161000;3423000;38425000;-30000;-38898000;-503000;2920000
ASNB;72924;USD;2018;Q4;2019-03-31;2019-08-23;-21448018;-21442818;172;668;248;1091;1791;;99;1890;2981;949;;973;1986;2154;3127;38448;-30;-38564;-146;2981
MDT;73420;USD;2016;Q4;2016-04-30;2017-06-27;1371200000;1382900000;13708000000;5591000000;3338000000;24873000000;4361000000;;70582000000;74943000000;99816000000;4224000000;7520000000;14220000000;25921000000;35180000000;49400000000;29551000000;;23356000000;50416000000;99816000000
MDT;73420;USD;2015;Q4;2015-04-30;2016-06-28;1400800000;1416200000;12634000000;5562000000;3473000000;23600000000;4841000000;;71203000000;76044000000;99644000000;3987000000;993000000;7165000000;30109000000;40416000000;47581000000;32227000000;;21704000000;52063000000;99644000000
MDT;73420;USD;2014;Q4;2014-04-30;2015-06-23;1423700000;1442000000;19480000000;5112000000;3463000000;30844000000;4699000000;;71142000000;75841000000;106685000000;4156000000;2434000000;9173000000;33752000000;44282000000;53455000000;0;;54414000000;53230000000;106685000000
MDT;73420;USD;2013;Q4;2013-04-30;2015-06-23;;;14241000000;3811000000;1725000000;21210000000;2392000000;;14341000000;16733000000;37943000000;1921000000;1613000000;5559000000;10315000000;12941000000;18500000000;100000000;;19940000000;19443000000;37943000000
MDT;73420;USD;2017;Q4;2017-04-30;2018-06-22;1355800000;1377400000;11227000000;5987000000;3579000000;22980000000;4604000000;;63809000000;68413000000;91393000000;4595000000;2058000000;10084000000;23699000000;30487000000;40571000000;28127000000;;24379000000;50822000000;91393000000
KITE;73743;USD;2015;Q4;2015-12-31;2016-02-29;45013724;45013724;614722000;;;631093000;30116000;;46754000;76870000;707963000;19836000;;36169000;;56034000;92203000;775637000;;-159657000;615760000;707963000
KITE;73743;USD;2014;Q4;2014-12-31;2015-03-26;39497262;39497262;367040000;;;368370000;2275000;;108000;2383000;370753000;6725000;;6725000;;1439000;8164000;420890000;;-58004000;362589000;370753000
KITE;73743;USD;2013;Q4;2013-12-31;2014-08-14;5515858;5515858;22357000;;;22598000;274000;;110000;384000;22982000;1362000;;1362000;;39000;1401000;36996000;;-15435000;21581000;22982000
KITE;73743;USD;2016;Q4;2016-12-31;2017-02-28;48148036;48148036;414422000;;;427396000;44409000;;52499000;96908000;524304000;40142000;;55142000;;41192000;96334000;855614000;;-426727000;427970000;524304000
TPCS;74307;USD;2017;Q4;2018-03-31;2018-06-28;28824593;26976657;2689110;1446982;2088485;7023013;5202448;;2053158;7255606;14278619;1133789;766354;2080849;4185274;4185274;6266123;8564877;;-576617;8012496;14278619
TPCS;74307;USD;2016;Q4;2017-03-31;2016-06-28;27265011;27656547;3066156;1870672;141792;7597937;4912202;;2971680;7883882;15481819;1258723;717481;2619035;4874721;4892463;7511498;8261702;;-310709;7970321;15481819
TPCS;74307;USD;2015;Q4;2016-03-31;2015-06-29;23131428;23131428;1332166;2022480;128595;6409691;4814184;;860614;5674798;12084489;2809582;953106;5899541;3735410;4456777;10356318;7097481;;-5390878;1728171;12084489
TPCS;74307;USD;2014;Q4;2015-03-31;2014-07-15;22884119;22884119;1086701;2280469;293326;10378901;6489212;;105395;6594607;16973508;6781413;4169771;12412873;38071;1029167;13442040;6107606;;-3165151;3531468;16973508
TPCS;74307;USD;2013;Q4;2014-03-31;2013-08-16;19838876;19838876;3075376;4330637;354516;14267101;7300248;;;7300248;21567349;4644608;5784479;11182900;31108;286873;11469773;5078548;;3930240;10097576;21567349
TPCS;74307;USD;2012;Q4;2013-03-31;2012-07-16;17860559;9179866;2823485;4901791;373544;16267177;7395445;;388635;7784080;24051257;3946293;1358933;6104639;5776294;5776294;11880933;4413874;;6342177;12170324;24051257
TPCS;74307;USD;2011;Q4;2012-03-31;2011-09-13;15214119;28610678;7541000;5578072;723400;17388702;5312112;;181141;5493253;22881955;2051359;1371767;3805256;5217421;5217421;9022677;3348459;;8465283;13859278;22881955
TPCS;74307;USD;2018;Q4;2019-03-31;2019-06-27;29007374;31500250;2036646;1010443;1240315;9176295;4860609;;2010579;6871188;16047483;1362581;822105;2925633;3410542;3410542;6336175;8696029;;993339;9711308;16047483
EIGI;74731;USD;2018;Q4;2018-12-31;2019-02-21;143458307;156869375;88644000;12205000;;236108000;92275000;15000000;2263124000;2370399000;2606507000;119485000;39985000;536800000;1770055000;1895253000;2432053000;961249000;;-783584000;174454000;2606507000
EIGI;74731;USD;2017;Q4;2017-12-31;2018-02-22;139264922;139264922;66493000;15945000;;167143000;95452000;15267000;2322172000;2432891000;2600034000;114454000;41575000;526365000;1866019000;1990664000;2517029000;931047000;;-847501000;83005000;2600034000
EIGI;74731;USD;2016;Q4;2016-12-31;2017-02-24;135367445;133982254;53596000;13088000;;154108000;95272000;15857000;2491037000;2602166000;2756274000;111042000;42390000;516785000;1951792000;2097353000;2614138000;868242000;;-740193000;142136000;2756274000
EIGI;74731;USD;2015;Q4;2015-12-31;2016-02-29;131781321;130101462;33030000;12040000;;117586000;75762000;27905000;1581247000;1684914000;1802500000;63149000;83366000;487921000;1022100000;1134905000;1622826000;848754000;;-667362000;179674000;1802500000
EIGI;74731;USD;2014;Q4;2014-12-31;2015-02-27;128906778;128906778;32379000;10201000;;120644000;56837000;40447000;1528115000;1625399000;1746043000;47235000;64293000;395370000;1030677000;1145634000;1541004000;816605000;;-641592000;205039000;1746043000
EIGI;74731;USD;2013;Q4;2013-12-31;2014-02-28;117491436;117491436;66815000;7160000;;118801000;49715000;6535000;1405887000;1462137000;1580938000;43383000;10500000;279312000;1036875000;1125592000;1404904000;754074000;;-598757000;176034000;1580938000
EIGI;74731;USD;2012;Q4;2012-12-31;2013-12-06;96576540;96576540;23245000;5824000;;68143000;34604000;10227000;1425162000;1469993000;1538136000;39274000;23000000;271996000;1107000000;1195985000;1467981000;509725000;;-439570000;70155000;1538136000
BNED;75409;USD;2016;Q4;2016-04-30;2017-07-12;46473000;47266000;19003000;86040000;486890000;602631000;116613000;;580588000;697201000;1299832000;313220000;100000000;413220000;59600000;172904000;586124000;709365000;-28020000;32363000;713708000;1299832000
BNED;75409;USD;2015;Q4;2015-04-30;2016-06-29;47231000;47840000;28568000;50924000;360507000;446452000;111185000;;514046000;625231000;1071683000;258052000;0;258052000;0;105245000;363297000;699999000;-18615000;27002000;708386000;1071683000
BNED;75409;USD;2014;Q4;2014-04-30;2015-09-10;39942000;40021000;44816000;76551000;344974000;470966000;107557000;;512145000;619702000;1090668000;252778000;;252778000;;111221000;363999000;0;0;0;726669000;1090668000
BNED;75409;USD;2017;Q4;2017-04-30;2018-06-20;46916000;46615000;16126000;100060000;491338000;619371000;111287000;;308553000;419840000;1039211000;313465000;100000000;413465000;96400000;157783000;571248000;717824000;-29658000;-220203000;467963000;1039211000
BNED;75409;USD;2018;Q4;2018-04-30;2019-06-25;47562000;46546000;14013000;98246000;467323000;591360000;109777000;;245043000;354820000;946180000;308538000;100000000;408538000;33500000;87014000;495552000;726841000;-31636000;-244577000;450628000;946180000
CAMP;75639;USD;2017;Q4;2018-02-28;2018-05-10;35381000;37220000;156003000;71580000;36302000;275885000;21262000;;175846000;197108000;472993000;46084000;;95529000;154299000;178548000;274077000;218574000;;-19459000;198916000;472993000
CAMP;75639;USD;2016;Q4;2017-02-28;2017-05-15;34848000;34389000;100428000;67403000;29279000;206705000;21162000;;180272000;201434000;408139000;38221000;;77841000;146827000;167056000;244897000;211540000;;-47757000;163242000;408139000
CAMP;75639;USD;2015;Q4;2016-02-29;2016-04-20;37374000;37615000;228106000;49432000;16731000;298767000;11225000;;74371000;85596000;384363000;31752000;;49565000;139800000;145351000;194916000;229526000;;-39853000;189447000;384363000
CAMP;75639;USD;2014;Q4;2015-02-28;2015-04-21;35931000;36597000;44361000;47917000;18666000;116054000;10525000;;76038000;86563000;202617000;29534000;;47005000;0;4227000;51232000;208243000;;-56793000;151385000;202617000
CAMP;75639;USD;2013;Q4;2014-02-28;2014-04-24;35331000;36390000;27733000;36904000;14968000;92241000;5899000;518000;80607000;87024000;179265000;27102000;1156000;42118000;702000;4000000;46118000;206513000;;-73301000;133147000;179265000
CAMP;75639;USD;2012;Q4;2013-02-28;2013-04-25;57830075;60110737;63101000;19111000;13516000;106769000;2778000;0;41224000;44002000;150771000;17169000;2261000;28949000;2434000;4273000;33222000;202718000;;-85104000;117549000;150771000
CAMP;75639;USD;2011;Q4;2012-02-29;2012-04-26;27882000;28496000;5601000;14383000;10057000;39789000;1761000;;9931000;11692000;51481000;13928000;1100000;23601000;1900000;2903000;26504000;154772000;;-129730000;24977000;51481000
CAMP;75639;USD;2010;Q4;2011-02-28;2011-09-29;27325000;27325000;4241000;16814000;9890000;38103000;1877000;;15505000;17382000;55485000;17444000;0;32869000;4460000;5014000;37883000;153416000;;-134948000;17602000;55485000
CAMP;75639;USD;2018;Q4;2019-02-28;2019-05-01;33487000;35312000;274012000;78079000;32033000;403497000;27023000;;173106000;200129000;603626000;48706000;;83592000;275905000;314381000;397973000;208541000;;-2227000;205653000;603626000
AVAV;75856;USD;2017;Q4;2017-04-30;2018-06-27;23555123;24570202;257166000;56813000;37425000;399047000;19219000;40656000;14496000;74371000;473418000;25425000;;62088000;;2274000;64362000;170141000;;238913000;409056000;473418000
AVAV;75856;USD;2016;Q4;2016-04-30;2017-06-28;23147543;24142315;199875000;68719000;40908000;354085000;15962000;42096000;20357000;78415000;432500000;17314000;;48063000;161000;2244000;50307000;162152000;;219929000;382193000;432500000
AVAV;75856;USD;2015;Q4;2015-04-30;2016-06-29;22921725;23434213;227691000;56045000;37486000;344271000;16762000;33859000;15766000;66387000;410658000;18655000;;46345000;449000;2788000;49133000;154276000;;207450000;361525000;410658000
AVAV;75856;USD;2014;Q4;2014-04-30;2015-07-01;22901893;23792097;228791000;33607000;39414000;329032000;13499000;46769000;8167000;68435000;397467000;19935000;;46735000;;1820000;48555000;148295000;;201975000;348912000;397467000
AVAV;75856;USD;2013;Q4;2013-04-30;2014-07-09;22584416;23057336;197608000;31739000;50699000;306857000;19997000;50505000;7595000;78097000;384954000;13906000;;37735000;;4752000;42487000;143650000;;199080000;342467000;384954000
AVAV;75856;USD;2012;Q4;2012-04-30;2013-06-26;22176666;22840057;148573000;19770000;62561000;263454000;24429000;68916000;4805000;98150000;361604000;16144000;;42187000;;4231000;46418000;130529000;;185362000;315186000;361604000
AVAV;75856;USD;2011;Q4;2011-04-30;2012-06-27;21848202;22450821;141372000;56417000;43539000;280278000;23515000;58457000;6901000;88873000;369151000;29001000;;63099000;;6854000;69953000;124956000;;174936000;299198000;369151000
AVAV;75856;USD;2010;Q4;2010-04-30;2011-09-08;21659461;22655050;188880000;44376000;38137000;302509000;17498000;6275000;5465000;29238000;331747000;38538000;;62104000;;6175000;68279000;119767000;;144485000;263468000;331747000
REMI;76840;USD;2017;Q4;2018-03-31;2018-07-13;19995969;19995969;92875;1157424;123112;1670622;143682;3623790;;3767472;5438094;1992606;;2126259;;;2126259;24926265;-831450;-20024323;3311835;5438094
REMI;76840;USD;2016;Q4;2017-03-31;2016-06-29;19995969;19995969;147106;943251;110404;1284900;274357;3170537;;3444894;4729794;1479936;;1552171;;;1552171;24926265;-831450;-19969732;3177623;4729794
REMI;76840;USD;2015;Q4;2016-03-31;2015-06-29;19995969;19995969;94434;977802;410748;2858534;410944;2433314;;2844258;5702792;1137127;2222468;3433026;;;3433026;24926265;-831450;-20814102;2269766;5702792
REMI;76840;USD;2014;Q4;2015-03-31;2014-07-14;19995969;19995969;775286;787578;599251;3440693;489420;2218802;19579;2727801;6168494;1048861;2257403;3849624;;;3849624;24926265;-831450;-21080063;2318870;6168494
REMI;76840;USD;2013;Q4;2014-03-31;2013-07-15;19995969;19995969;64504;947971;991807;2570782;695084;3228911;32059;3956054;6526836;1708878;1214266;3908628;1131364;1131364;5039992;24926265;-831450;-21604571;1486844;6526836
REMI;76840;USD;2012;Q4;2013-03-31;2012-07-16;19995969;20091969;203584;838240;1077766;3268854;641220;3055023;0;3696243;6965097;1545507;863501;3607361;1452523;1452523;5059884;24926265;-831450;-20622635;1905213;6965097
REMI;76840;USD;2011;Q4;2012-03-31;2011-08-15;19995969;-4880997;1662520;2764651;2164046;7354170;1401735;0;866381;2268116;9622286;3000401;584679;6316358;273557;273557;6589915;24875879;-831450;-21113118;3032371;9622286
REMI;76840;USD;2018;Q4;2019-03-31;2019-06-28;19995969;19995969;66539;233908;110962;655933;125733;7114508;;7240241;7896174;2369442;;2433294;0;0;2433294;24926265;-831450;-17717166;5462880;7896174
AMWD;77084;USD;2016;Q4;2016-04-30;2017-06-29;16234382;16389794;176978000;63115000;42859000;339228000;107933000;;54112000;162045000;501273000;99899000;1598000;101497000;15279000;47327000;148824000;168835000;;224031000;352449000;501273000
AMWD;77084;USD;2015;Q4;2015-04-30;2016-06-29;16265230;16417125;174463000;55813000;39319000;302209000;99332000;;64819000;164151000;466360000;90739000;1574000;92313000;22145000;93286000;185599000;163290000;;164756000;280761000;466360000
AMWD;77084;USD;2014;Q4;2014-04-30;2015-06-30;15991699;16287880;149541000;46142000;35988000;271929000;85516000;;41459000;126975000;398904000;83333000;1457000;84790000;21498000;84272000;169062000;150001000;;120698000;229842000;398904000
AMWD;77084;USD;2013;Q4;2013-04-30;2014-06-30;15540327;15829469;135700000;46475000;31523000;225416000;74049000;;30599000;104648000;330064000;75273000;1146000;76419000;20453000;63100000;139519000;127371000;;89154000;190545000;330064000
AMWD;77084;USD;2012;Q4;2012-04-30;2013-06-28;14756550;15173678;96971000;39044000;29338000;177918000;74064000;;42011000;116075000;293993000;67953000;1155000;69108000;23594000;78690000;147798000;107165000;;71180000;146195000;293993000
AMWD;77084;USD;2011;Q4;2011-04-30;2012-06-29;14383410;14383410;66620000;32533000;22340000;131102000;75375000;;58644000;134019000;265121000;58346000;875000;59221000;23790000;75880000;135101000;96205000;;61422000;130020000;265121000
AMWD;77084;USD;2010;Q4;2010-04-30;2011-08-30;14282351;14282351;55420000;31067000;24471000;120416000;100628000;;47326000;147954000;268370000;49916000;928000;50844000;24655000;63561000;114405000;92408000;;83495000;153965000;268370000
AMWD;77084;USD;2017;Q4;2017-04-30;2018-06-29;17476912;17666195;78410000;136355000;104801000;364367000;218102000;;1062876000;1280978000;1645345000;166312000;4143000;170455000;809897000;893225000;1063680000;361158000;;269576000;581665000;1645345000
AMWD;77084;USD;2018;Q4;2018-04-30;2019-06-28;16880416;16896281;57656000;125901000;108528000;306035000;208263000;;1015633000;1223896000;1529931000;147304000;2286000;149590000;689205000;759988000;909578000;352424000;;317420000;620353000;1529931000
GIS;78526;USD;2017;Q4;2017-05-31;2017-06-29;578900000;588500000;766100000;1430100000;1483600000;4061400000;3687700000;;14063500000;17751200000;21812600000;2119800000;1838800000;5330800000;7642900000;11796300000;17127100000;1196400000;-7762900000;13138900000;4685500000;21812600000
GIS;78526;USD;2016;Q4;2016-05-31;2016-06-30;598900000;611200000;763700000;1360800000;1413700000;3937200000;3743600000;;14031500000;17775100000;21712300000;2046500000;1373200000;5014700000;7057700000;11390500000;16405200000;1252500000;-6326600000;12616500000;5307100000;21712300000
GIS;78526;USD;2015;Q4;2015-05-31;2015-07-06;599800000;613900000;334200000;1386700000;1540900000;3685600000;3783300000;;14363100000;18146400000;21832000000;1684000000;1616200000;4890100000;7575300000;11549200000;16439300000;1372200000;-6055600000;11990800000;5392700000;21832000000
GIS;78526;USD;2014;Q4;2014-05-31;2014-07-03;614700000;632300000;867300000;1483600000;1559400000;4393500000;3941900000;;14810300000;18752200000;23145700000;1611300000;2362300000;5423500000;6423500000;10716800000;16140300000;1307300000;-5219400000;11787200000;7005400000;23145700000
GIS;78526;USD;2013;Q4;2013-05-31;2013-07-03;647400000;665400000;741400000;1446400000;1545500000;4298900000;3878100000;;14481000000;18359100000;22658000000;1423200000;2043000000;5293900000;5926100000;10235600000;15529500000;1242100000;-3687200000;10702600000;7128500000;22658000000
GIS;78526;USD;2012;Q4;2012-05-31;2012-07-03;650300000;666700000;471200000;1323600000;1478800000;3691400000;3652700000;;13752700000;17405400000;21096800000;1148900000;1267700000;3843200000;6161900000;10370900000;14214100000;1383900000;-3177000000;9958500000;6882700000;21096800000
GIS;78526;USD;2011;Q4;2011-05-31;2011-07-08;642500000;662700000;619600000;1162300000;1609300000;3902000000;3345900000;;11426600000;14772500000;18674500000;995100000;1342600000;3659200000;5542500000;8403100000;12062300000;1395300000;-3210300000;9191300000;6612200000;18674500000
GIS;78526;USD;2010;Q4;2010-05-31;2010-07-09;664400000;689800000;673200000;1041600000;1344000000;3480000000;3127700000;;11071200000;14198900000;17678900000;849500000;1157400000;3769100000;5268500000;8261800000;12030900000;1382600000;-2615200000;8122400000;5648000000;17678900000
GIS;78526;USD;2009;Q4;2009-05-31;2009-09-24;;;749800000;953400000;1346800000;3534900000;3034900000;;11305000000;14339900000;17874800000;803400000;1320700000;3606000000;5754800000;8852300000;12458300000;1287600000;-2473100000;7235600000;5416500000;17874800000
GIS;78526;USD;2018;Q4;2018-05-31;2018-06-29;586900000;592900000;399000000;1684200000;1642200000;4123700000;4047200000;;22453100000;26500300000;30624000000;2746200000;3149900000;7341900000;12668700000;16789700000;24131600000;1278000000;-7167500000;14459600000;6492400000;30624000000
GIS;78526;USD;2019;Q4;2019-05-31;2019-06-28;603800000;609300000;450000000;1679700000;1559300000;4186500000;3787200000;;22137500000;25924700000;30111200000;2854100000;2865200000;9118100000;11624800000;13625400000;22743500000;1462200000;-6779000000;14996700000;7367700000;30111200000
JBL;79450;USD;2015;Q4;2015-08-31;2015-10-16;193908000;196929000;913963000;1467247000;2507264000;5866309000;2804333000;;932565000;3736898000;9603207000;5348853000;323833000;5675141000;1346558000;1593055000;7268196000;1955351000;-1058551000;1468910000;2335011000;9603207000
JBL;79450;USD;2014;Q4;2014-08-31;2014-10-21;197967000;195916000;1000249000;1208516000;2008077000;5359017000;2271705000;;849024000;3120729000;8479746000;4295920000;12960000;4321097000;1669585000;1898281000;6219378000;1874463000;-965369000;1245772000;2260368000;8479746000
JBL;79450;USD;2013;Q4;2013-08-31;2013-10-28;202960000;209071000;1011373000;1168954000;2118716000;5820245000;2309320000;;1024216000;3333536000;9153781000;4446739000;215448000;4864434000;1690418000;1933780000;6798214000;1853647000;-670783000;1071175000;2355567000;9153781000
JBL;79450;USD;2012;Q4;2012-08-31;2012-10-25;205667000;211098000;1217256000;1125015000;2268949000;5639328000;1779155000;;384658000;2163813000;7803141000;3837010000;18031000;3858996000;1658326000;1836810000;5695806000;1753079000;-521231000;766934000;2107335000;7803141000
JBL;79450;USD;2011;Q4;2011-08-31;2011-10-27;212738000;222112000;888611000;1100926000;2227339000;5115787000;1641335000;;300818000;1942153000;7057940000;3810546000;74160000;3889888000;1112594000;1284229000;5174117000;1649656000;-419035000;441793000;1883823000;7057940000
JBL;79450;USD;2010;Q4;2010-08-31;2011-01-07;216157000;224047000;744329000;1408319000;2094135000;4654018000;1451392000;;262337000;1713729000;6367747000;3433207000;167566000;3605174000;1018930000;1169801000;4774975000;1541727000;-209046000;123303000;1592772000;6367747000
JBL;79450;USD;2016;Q4;2016-08-31;2016-10-20;189134000;191394000;912059000;1359610000;2456612000;5848381000;3331879000;;1142417000;4474296000;10322677000;5522246000;45810000;5568056000;2074012000;2297124000;7865180000;2034775000;-1217547000;1660820000;2457497000;10322677000
JBL;79450;USD;2017;Q4;2017-08-31;2017-10-19;178646000;189448000;1189919000;1397424000;2942083000;6626683000;3228678000;;1240634000;4469312000;11095995000;6425095000;445498000;6870593000;1632592000;1857058000;8727651000;2104456000;-1536455000;1730893000;2368344000;11095995000
JBL;79450;USD;2018;Q4;2018-08-31;2018-10-19;166863000;169741000;1257949000;1693268000;3457706000;7549923000;3198016000;;1297702000;4495718000;12045641000;7205676000;25197000;7230873000;2493502000;2851388000;10082261000;2218930000;-2009371000;1760097000;1963380000;12045641000
JBL;79450;USD;2019;Q4;2019-08-31;2019-10-22;153281000;158503000;1163343000;2745226000;3023003000;8345085000;3333750000;;1291640000;4625390000;12970475000;8156924000;375181000;8532105000;2121284000;2537612000;11069717000;2304812000;-2371612000;2037037000;1900758000;12970475000
MON;79638;USD;2016;Q4;2016-08-31;2016-10-19;441000000;452300000;1736000000;1926000000;3241000000;8157000000;5231000000;101000000;6247000000;11579000000;19736000000;3343000000;1587000000;6729000000;7453000000;8462000000;15191000000;11632000000;-15053000000;10763000000;4545000000;19736000000
MON;79638;USD;2015;Q4;2015-08-31;2015-10-29;467000000;470900000;3748000000;1636000000;3496000000;10625000000;4973000000;42000000;6280000000;11295000000;21920000000;3231000000;615000000;5177000000;8429000000;9738000000;14915000000;11470000000;-12053000000;10374000000;7005000000;21920000000
MON;79638;USD;2014;Q4;2014-08-31;2014-10-29;501200000;506900000;2407000000;2014000000;3597000000;9675000000;5082000000;92000000;7069000000;12243000000;21918000000;3479000000;233000000;5112000000;7465000000;8892000000;14004000000;10009000000;-10032000000;9012000000;7914000000;21918000000
MON;79638;USD;2013;Q4;2013-08-31;2013-10-23;531100000;537500000;3922000000;1715000000;2947000000;10077000000;4654000000;237000000;5696000000;10587000000;20664000000;2956000000;51000000;4336000000;2061000000;3600000000;7936000000;10789000000;-4140000000;7188000000;12728000000;20664000000
MON;79638;USD;2012;Q4;2012-08-31;2012-10-19;1069099465;1081499459;3585000000;1897000000;2839000000;9658000000;4365000000;376000000;5825000000;10566000000;20224000000;3104000000;36000000;4221000000;2038000000;3967000000;8188000000;10377000000;-3045000000;5537000000;12036000000;20224000000
MON;79638;USD;2009;Q4;2009-08-31;2010-01-08;;554;1956000000;1556000000;2851000000;7783000000;3609000000;557000000;5882000000;10048000000;17831000000;2478000000;79000000;3727000000;1724000000;3996000000;7723000000;9701000000;-1577000000;2665000000;10108000000;17831000000
MON;79638;USD;2011;Q4;2011-08-31;2011-11-14;2145998391;2169598373;2874000000;2117000000;2591000000;8809000000;4394000000;475000000;6166000000;11035000000;19844000000;2835000000;678000000;4729000000;1543000000;3399000000;8128000000;10102000000;-2613000000;4174000000;11716000000;19844000000
MON;79638;USD;2010;Q4;2010-08-31;2010-10-27;539;553;1485000000;1590000000;2649000000;7050000000;4227000000;513000000;6062000000;10802000000;17852000000;2215000000;241000000;3556000000;1862000000;4183000000;7739000000;9902000000;-2110000000;3178000000;10113000000;17852000000
MON;79638;USD;2017;Q4;2017-08-31;2017-10-27;439300000;447800000;1856000000;2161000000;3340000000;8651000000;5930000000;121000000;6631000000;12682000000;21333000000;4024000000;870000000;6398000000;7254000000;8477000000;14875000000;11846000000;-15053000000;12072000000;6458000000;21333000000
DTRM;80268;USD;2016;Q4;2017-03-31;2016-07-01;11711000;11711000;9429000;7042000;;18058000;85000;;24248000;24333000;42391000;6249000;;28377000;7599000;8915000;37292000;317372000;-472000;-311749000;5099000;42391000
DTRM;80268;USD;2015;Q4;2016-03-31;2015-06-29;10908000;10908000;9418000;7031000;;18034000;136000;;26043000;26179000;44213000;6024000;;26147000;5420000;7159000;33306000;313679000;-472000;-302297000;10907000;44213000
DTRM;80268;USD;2014;Q4;2015-03-31;2014-06-27;8086000;8086000;16907000;3006000;;20602000;312000;;886000;1198000;21800000;2364000;;14444000;;618000;15062000;278087000;-472000;-274530000;6738000;21800000
DTRM;80268;USD;2013;Q4;2014-03-31;2013-06-17;15364776000;15364776000;12098000;3455000;;16406000;407000;;39000;446000;16852000;2155000;;14540000;;1792000;16332000;;;;520000;16852000
DTRM;80268;USD;2012;Q4;2013-03-31;2012-06-29;2853000;2853000;16076000;2446000;;19053000;362000;;39000;401000;19454000;2254000;;13648000;;1368000;15016000;266512000;-472000;-261602000;4438000;19454000
DTRM;80268;USD;2011;Q4;2012-03-31;2011-08-12;2760000;2760000;17021000;2695000;;20166000;423000;;;423000;20589000;1359000;786000;5891000;3482000;4056000;9947000;265977000;;-255335000;10642000;20589000
DTRM;80268;USD;2017;Q4;2018-03-31;2018-06-29;15646000;15646000;9928000;6605000;;18103000;90000;;23871000;23961000;42064000;6596000;;28259000;7475000;8865000;37124000;325949000;-472000;-321697000;4940000;42064000
QLGC;80382;USD;2016;Q4;2017-03-31;2016-05-26;82740000;83812000;354847000;55546000;39745000;463406000;71738000;;288724000;360462000;823868000;49920000;;61076000;;15414000;76490000;1015884000;-2037302000;1769130000;747378000;823868000
QLGC;80382;USD;2015;Q4;2016-03-31;2015-05-26;87299000;88970000;316415000;87436000;29978000;455631000;78501000;;314523000;393024000;848655000;65684000;;77402000;;24237000;101639000;983794000;-1959343000;1722664000;747016000;848655000
QLGC;80382;USD;2014;Q4;2015-03-31;2014-05-23;87017000;86447000;278041000;65213000;18036000;392960000;86527000;;318776000;405303000;798263000;58594000;;78671000;;26166000;104837000;958222000;-1937302000;1672071000;693426000;798263000
QLGC;80382;USD;2013;Q4;2014-03-31;2013-05-23;90687000;91104000;455506000;66135000;20160000;579218000;96336000;;149609000;245945000;825163000;61680000;;74007000;;16879000;90886000;932769000;-1890716000;1690337000;734277000;825163000
QLGC;80382;USD;2012;Q4;2013-03-31;2012-05-25;98977000;100825000;537955000;76588000;19724000;686889000;78010000;;148519000;226529000;913418000;65323000;;81217000;;72358000;153575000;901945000;-1760336000;1617201000;759843000;913418000
QLGC;80382;USD;2011;Q4;2012-03-31;2011-05-26;105113000;106672000;384076000;70134000;26931000;519648000;77134000;;160425000;237559000;757207000;66686000;;82338000;;73705000;156043000;844754000;-1631969000;1387765000;601164000;757207000
QLGC;80382;USD;2010;Q4;2011-03-31;2010-08-02;113345000;115562000;375673000;73301000;19403000;489198000;83496000;;178043000;261539000;750737000;62126000;;82435000;;84963000;167398000;779058000;-1445600000;1248675000;583339000;750737000
LNN;80469;USD;2017;Q4;2017-08-31;2017-10-13;10692000;10731000;121620000;73850000;86155000;292934000;74498000;;138600000;213098000;506032000;36717000;201000;92037000;116775000;143940000;235977000;81786000;-277238000;477615000;270055000;506032000
LNN;80469;USD;2016;Q4;2016-08-31;2016-10-18;10632000;10676000;101246000;80610000;74750000;276775000;77627000;;133113000;210740000;487515000;32268000;197000;87860000;116976000;148088000;235948000;76051000;-277238000;466926000;251567000;487515000
LNN;80469;USD;2015;Q4;2015-08-31;2015-10-20;11376000;11418000;139093000;74063000;74930000;306360000;78656000;;151452000;230108000;536468000;38814000;193000;95112000;117173000;152796000;247908000;73868000;-228903000;458903000;288560000;536468000
LNN;80469;USD;2014;Q4;2014-08-31;2014-10-15;12686000;12746000;171842000;94135000;71696000;356344000;72457000;;97750000;170207000;526551000;42424000;;116367000;;27537000;143904000;71502000;-132020000;445366000;382647000;526551000
LNN;80469;USD;2013;Q4;2013-08-31;2013-10-18;12864000;12922000;151927000;120291000;68607000;356086000;65064000;;91146000;156210000;512296000;42276000;;102092000;;29566000;131658000;68335000;-90961000;405580000;380638000;512296000
LNN;80469;USD;2012;Q4;2012-08-31;2012-10-26;12717000;12841000;143444000;82565000;52873000;289360000;56180000;;69991000;126171000;415531000;31372000;4285000;80438000;;24255000;104693000;61561000;-90961000;341115000;310838000;415531000
LNN;80469;USD;2011;Q4;2011-08-31;2012-01-06;12626000;12736000;108167000;79006000;49524000;249095000;58465000;;73584000;132049000;381144000;32153000;4286000;79319000;4285000;26160000;105479000;57432000;-90961000;302732000;275665000;381144000
LNN;80469;USD;2018;Q4;2018-08-31;2018-10-24;10759000;10798000;160787000;69107000;79233000;331051000;57248000;;111957000;169205000;500256000;30530000;205000;80094000;116570000;143296000;223390000;87306000;-277238000;484886000;276866000;500256000
LNN;80469;USD;2019;Q4;2019-08-31;2019-10-31;10786000;10834000;127204000;75551000;92287000;313490000;68968000;;117856000;186824000;500314000;29434000;209000;82131000;115846000;149974000;232105000;90554000;-277238000;474740000;268209000;500314000
UA;80553;USD;2016;Q4;2016-12-31;2017-02-23;438321000;1328426000;250470000;622685000;917491000;1965153000;804211000;;874967000;1679178000;3644331000;618429000;27000000;685816000;790388000;927615000;1613431000;823629000;;1259414000;2030900000;3644331000
UA;80553;USD;2015;Q4;2015-12-31;2016-02-22;1265000;3266000;129852000;433638000;783031000;1498763000;538531000;;828676000;1367207000;2865970000;393395000;42000000;478810000;624070000;718938000;1197748000;636702000;;1076533000;1668222000;2865970000
UA;80553;USD;2014;Q4;2014-12-31;2015-02-20;213815000;225332000;593175000;279835000;536714000;1549399000;305564000;;240120000;545684000;2095083000;358113000;28951000;421627000;255250000;323156000;744783000;508421000;;856687000;1350300000;2095083000
UA;80553;USD;2013;Q4;2013-12-31;2014-02-21;211404000;219270000;347489000;209952000;469006000;1128811000;223952000;;224978000;448930000;1577741000;299185000;4972000;426630000;47951000;97757000;524387000;397318000;;653842000;1053354000;1577741000
UA;80553;USD;2012;Q4;2012-12-31;2013-02-26;522058000;532568000;341841000;175524000;319286000;903598000;180850000;;72635000;253485000;1157083000;228766000;9132000;252228000;52757000;87933000;340161000;321373000;;493181000;816922000;1157083000
UA;80553;USD;2011;Q4;2011-12-31;2012-02-27;154830000;157733000;175384000;134043000;324409000;689663000;159135000;;70412000;229547000;919210000;169812000;6882000;183607000;70842000;99171000;282778000;268240000;;366164000;636432000;919210000
UA;80553;USD;2010;Q4;2010-12-31;2011-02-24;254271000;257112000;203870000;102034000;215355000;555850000;76127000;;43401000;119528000;675378000;139817000;6865000;149147000;9077000;29265000;178412000;224904000;;270021000;496966000;675378000
UA;80553;USD;2009;Q4;2009-12-31;2010-08-05;50199000;50845000;187297000;79356000;148488000;448000000;72926000;;24662000;97588000;545588000;109595000;9275000;120162000;10948000;25429000;145591000;197359000;;202188000;399997000;545588000
UA;80553;USD;2017;Q4;2017-12-31;2017-11-09;441858000;434694000;312483000;609670000;1158548000;2337679000;885774000;;782914000;1668688000;4006367000;857949000;27000000;1060375000;765046000;927350000;1987725000;872412000;;1184441000;2018642000;4006367000
UA;80553;USD;2018;Q4;2018-12-31;2019-02-25;448512000;444547000;557403000;652546000;1019496000;2593628000;826868000;;824526000;1651394000;4245022000;901299000;25000000;1315977000;703834000;912174000;2228151000;916776000;;1139082000;2016871000;4245022000
DG;80798;USD;2016;Q4;2017-02-28;2017-03-24;275811000;276667000;187915000;;3258785000;3677771000;2434456000;;5560071000;7994527000;11672298000;2121855000;500950000;2622805000;2710576000;3643199000;6266004000;3395417000;;2015867000;5406294000;11672298000
DG;80798;USD;2015;Q4;2016-02-29;2016-03-22;288402000;289323000;157947000;;3074153000;3432410000;2264062000;;5561413000;7825475000;11257885000;1994217000;1379000;1995596000;2969175000;3884413000;5880009000;3358138000;;2025545000;5377876000;11257885000
DG;80798;USD;2014;Q4;2015-02-28;2015-03-20;303106000;304433000;579823000;;2782521000;3532609000;2116075000;;5559958000;7676033000;11208642000;1861314000;101158000;1962472000;2623965000;3536132000;5498604000;3314320000;;2403045000;5710038000;11208642000
DG;80798;USD;2013;Q4;2014-02-28;2014-03-20;318088000;319102000;505566000;;2552993000;3205607000;2080305000;;5581612000;7661917000;10867524000;1714210000;75966000;1811971000;2742788000;3653360000;5465331000;3286650000;;2125453000;5402193000;10867524000
DG;80798;USD;2012;Q4;2013-02-28;2013-03-25;327598000;328861000;140809000;;2397175000;2677113000;2088665000;;5601904000;7690569000;10367682000;1714432000;892000;1738547000;2771336000;3643805000;5382352000;3277536000;;1710732000;4985330000;10367682000
DG;80798;USD;2011;Q4;2012-02-29;2012-03-22;339925000;343673000;126126000;;2009206000;2275074000;1794960000;;5618486000;7413446000;9688520000;1505590000;590000;1509902000;2617891000;3504036000;5013938000;3262855000;;1416918000;4674582000;9688520000
DG;80798;USD;2010;Q4;2011-02-28;2011-06-01;341306000;345318000;497446000;;1765433000;2367825000;1524575000;;5653822000;7178397000;9546222000;1327362000;1157000;1365373000;3287070000;4126370000;5491743000;3243843000;;830932000;4054479000;9546222000
DG;80798;USD;2017;Q4;2018-02-28;2018-03-23;270303000;271220000;267441000;;3609025000;4247852000;2701282000;;5567777000;8269059000;12516911000;2563533000;401345000;2964878000;2604613000;3426259000;6391137000;3431603000;;2698352000;6125774000;12516911000
DG;80798;USD;2018;Q4;2019-02-28;2019-03-22;261406000;262537000;235487000;;4097004000;4663020000;2970806000;;5570212000;8541018000;13204038000;3013907000;1950000;3015857000;2862740000;3770788000;6786645000;3479493000;;2941107000;6417393000;13204038000
PACB;81196;USD;2016;Q4;2016-12-31;2017-03-06;92730000;92730000;71978000;11421000;15634000;109011000;14560000;;14313000;28873000;137884000;24963000;;33774000;16106000;19442000;53216000;872207000;;-787544000;84668000;137884000
PACB;81196;USD;2015;Q4;2015-12-31;2016-03-11;153027267;147753267;82270000;5245000;10955000;110541000;8548000;;12018000;20566000;131107000;20300000;;38178000;14948000;19389000;57567000;786716000;;-713169000;73540000;131107000
PACB;81196;USD;2014;Q4;2014-12-31;2015-03-12;143228485;143228485;101348000;3406000;11335000;117760000;6601000;;29000;6630000;124390000;17049000;;31489000;13991000;37952000;69441000;736413000;;-681473000;54949000;124390000
PACB;81196;USD;2013;Q4;2013-12-31;2014-03-14;66319000;66319000;112528000;2746000;10050000;126459000;9236000;;490000;9726000;136185000;9622000;;22555000;13347000;44450000;67005000;684479000;;-615313000;69180000;136185000
PACB;81196;USD;2012;Q4;2012-12-31;2013-03-15;56196000;56196000;100580000;2822000;9592000;115000000;14329000;;354000;14683000;129683000;2988000;173000;14743000;;5558000;20301000;645372000;;-536020000;109382000;129683000
PACB;81196;USD;2011;Q4;2011-12-31;2012-03-01;55098000;55098000;177434000;4557000;15517000;199601000;18398000;;317000;18715000;218316000;4742000;140000;19376000;;7477000;26853000;632961000;;-441555000;191463000;218316000
PACB;81196;USD;2010;Q4;2010-12-31;2011-08-12;;;283674000;341000;6864000;293114000;12311000;;322000;12633000;305747000;9515000;110000;20840000;;5041000;25881000;612054000;;-332167000;279866000;305747000
PACB;81196;USD;2017;Q4;2017-12-31;2018-02-26;116627000;116627000;62872000;13433000;23065000;101619000;37920000;;4545000;42465000;144084000;21711000;;28635000;13635000;29346000;57981000;965868000;;-879733000;86103000;144084000
PACB;81196;USD;2018;Q4;2018-12-31;2019-02-26;149596000;149596000;102354000;8595000;17878000;131659000;34073000;;4543000;38616000;170275000;19559000;;26884000;14659000;29330000;56214000;1096203000;;-982106000;114061000;170275000
O;81605;USD;2017;Q4;2017-12-31;2018-02-22;282422027;282662546;6898000;119533000;;133105000;12669825000;;1255236000;13925061000;14058166000;5726507000;110000000;6222172000;445286000;445286000;6667458000;9624264000;;;7390708000;14058166000
O;81605;USD;2016;Q4;2016-12-31;2017-02-23;258631006;259151318;9420000;104584000;;140579000;11877216000;;1135076000;13012292000;13152871000;4576869000;1120000000;6046691000;319127000;319127000;6365818000;8228594000;;;6787053000;13152871000
O;81605;USD;2015;Q4;2015-12-31;2016-02-11;249110029;249381579;40294000;81678000;;131739000;10609117000;;1104523000;11713640000;11845379000;4430330000;238000000;4973211000;318835000;318835000;5292046000;7666428000;;;6553333000;11845379000
O;81605;USD;2014;Q4;2014-12-31;2015-02-18;223517974;224150465;3852000;64386000;;83078000;9766700000;;1162844000;10929544000;11012622000;4804909000;223000000;5301523000;70000000;70000000;5371523000;6464987000;;;5641099000;11012622000
O;81605;USD;2013;Q4;2013-12-31;2014-02-14;204017925;202376629;10257000;39323000;;61602000;8784587000;;1078252000;9862839000;9924441000;4112803000;128000000;4433083000;70000000;70000000;4503083000;5767878000;;;5421358000;9924441000
O;81605;USD;2012;Q4;2012-12-31;2013-02-14;133334972;133075425;5248000;21659000;;46126000;5022918000;;360304000;5383222000;5429348000;2806024000;158000000;3016554000;;0;3016554000;2572092000;;;2412794000;5429348000
O;81605;USD;2011;Q4;2011-12-31;2012-02-13;133234382;132863896;4165000;15375000;;21693000;4157855000;;239841000;4397696000;4419389000;1897956000;237400000;2164535000;;0;2164535000;2563048000;;;2254854000;4419389000
O;81605;USD;2010;Q4;2010-12-31;2011-02-10;112429824;112341593;17607000;11301000;;32539000;3401247000;;101804000;3503051000;3535590000;1666070000;0;1688625000;;0;1688625000;2066287000;;;1846965000;3535590000
O;81605;USD;2009;Q4;2009-12-31;2010-07-29;103723172;103725530;10026000;10396000;;28688000;2808616000;;77483000;2886099000;2914787000;1405371000;4600000;1426778000;;;1426778000;1629237000;;;1488009000;2914787000
O;81605;USD;2018;Q4;2018-12-31;2019-02-22;298198965;298771166;10387000;144991000;;171963000;13826932000;;1261588000;15088520000;15260483000;5880920000;252000000;6570895000;568610000;568610000;7139505000;10754495000;;;8120978000;15260483000
TRUE;81812;USD;2016;Q4;2016-12-31;2017-03-01;85717000;85717000;107721000;36867000;;152910000;66941000;;74597000;141538000;294448000;35361000;;35361000;28833000;34506000;69867000;542816000;;-318235000;224581000;294448000
TRUE;81812;USD;2015;Q4;2015-12-31;2016-03-10;82766000;82766000;112371000;33761000;;152959000;71390000;;78025000;149415000;302374000;39104000;;39104000;26987000;30578000;69682000;508592000;;-275900000;232692000;302374000
TRUE;81812;USD;2014;Q4;2014-12-31;2015-03-12;78582000;78582000;147539000;28748000;;184520000;30731000;;81701000;112432000;296952000;38854000;;38854000;6093000;8900000;47754000;460187000;;-210989000;249198000;296952000
TRUE;81812;USD;2013;Q4;2013-12-31;2014-08-14;59872000;59872000;43819000;18803000;;69576000;15238000;;89936000;105174000;174750000;26175000;;30939000;;1338000;32277000;275809000;;-162560000;142473000;174750000
TRUE;81812;USD;2017;Q4;2017-12-31;2018-03-01;100267000;100267000;197762000;39169000;;243551000;70710000;;70573000;141283000;384834000;37978000;;37978000;29129000;33738000;71716000;664202000;;-351084000;313118000;384834000
TRUE;81812;USD;2018;Q4;2018-12-31;2019-03-01;104110000;104110000;196128000;47760000;;255459000;61511000;0;103990000;165501000;420960000;41562000;;41562000;22987000;32845000;74407000;720035000;;-373482000;346553000;420960000
KO;82117;USD;2017;Q4;2017-12-31;2018-02-23;4262000000;4315000000;20675000000;3667000000;2655000000;36545000000;8203000000;21952000000;21196000000;51351000000;87896000000;9158000000;16503000000;27194000000;31182000000;41725000000;68919000000;17624000000;-50677000000;60430000000;18977000000;87896000000
KO;82117;USD;2016;Q4;2016-12-31;2016-10-27;4302000000;4345000000;22201000000;3856000000;2675000000;34010000000;10635000000;17249000000;25376000000;53260000000;87270000000;9797000000;16025000000;26532000000;29684000000;37518000000;64050000000;16753000000;-47988000000;65502000000;23220000000;87270000000
KO;82117;USD;2015;Q4;2015-12-31;2016-02-25;4339000000;4391000000;19900000000;3941000000;2902000000;33395000000;12571000000;15788000000;28242000000;56601000000;89996000000;9991000000;15805000000;26929000000;28311000000;37303000000;64232000000;15776000000;-45066000000;65018000000;25764000000;89996000000
KO;82117;USD;2014;Q4;2014-12-31;2015-02-25;4373000000;4437000000;21675000000;4466000000;3100000000;32986000000;14633000000;13625000000;30779000000;59037000000;92023000000;9634000000;22682000000;32374000000;19063000000;29088000000;61462000000;14914000000;-42225000000;63408000000;30561000000;92023000000
KO;82117;USD;2013;Q4;2013-12-31;2014-02-27;4409000000;4481000000;20268000000;4873000000;3277000000;31304000000;14967000000;11512000000;32272000000;58751000000;90055000000;9886000000;17925000000;27811000000;19154000000;28804000000;56615000000;14036000000;-39091000000;61660000000;33440000000;90055000000
KO;82117;USD;2012;Q4;2012-12-31;2013-02-27;4478000000;4556000000;16551000000;4759000000;3264000000;30328000000;14476000000;10448000000;30922000000;55846000000;86174000000;9151000000;17874000000;27821000000;14736000000;25185000000;53006000000;13139000000;-35009000000;58045000000;33168000000;86174000000
KO;82117;USD;2011;Q4;2011-12-31;2012-02-23;4537000000;4609000000;14035000000;4920000000;3092000000;25497000000;14939000000;8374000000;31164000000;54477000000;79974000000;9371000000;14912000000;24283000000;13656000000;23770000000;48053000000;12092000000;-31304000000;53621000000;31921000000;79974000000
KO;82117;USD;2010;Q4;2010-12-31;2011-02-28;4624000000;4692000000;11337000000;4430000000;2650000000;21579000000;14727000000;7585000000;29030000000;51342000000;72921000000;9132000000;9376000000;18508000000;14041000000;23096000000;41604000000;10937000000;-27762000000;49278000000;31317000000;72921000000
KO;82117;USD;2009;Q4;2009-12-31;2010-02-26;4628000000;4684000000;9213000000;3758000000;2354000000;17551000000;9561000000;6755000000;14804000000;31120000000;48671000000;6921000000;6800000000;13721000000;5059000000;9604000000;23325000000;9417000000;-25398000000;41537000000;25346000000;48671000000
KO;82117;USD;2008;Q4;2008-12-31;2009-07-30;4624000000;4642000000;4979000000;3090000000;2187000000;12176000000;8326000000;5779000000;14238000000;28343000000;40519000000;6457000000;6531000000;12988000000;2781000000;6669000000;19657000000;8846000000;-24213000000;38513000000;20862000000;40519000000
KO;82117;USD;2018;Q4;2018-12-31;2019-02-21;8515995745;8599995705;15964000000;3396000000;2766000000;30634000000;8232000000;20274000000;24076000000;52582000000;83216000000;9310000000;18191000000;29223000000;25364000000;34935000000;64158000000;18280000000;-51719000000;63234000000;19058000000;83216000000
CSCO;82202;USD;2016;Q4;2016-07-31;2016-09-08;5030000000;5077000000;65756000000;5847000000;1217000000;78719000000;3506000000;;39427000000;42933000000;121652000000;4524000000;4160000000;24911000000;24483000000;33156000000;58067000000;44516000000;;19396000000;63585000000;121652000000
CSCO;82202;USD;2015;Q4;2015-07-31;2015-09-08;5085000000;5120000000;60416000000;5344000000;1627000000;73368000000;3332000000;;36673000000;40005000000;113373000000;4215000000;3897000000;23412000000;21457000000;30254000000;53666000000;43592000000;;16045000000;59707000000;113373000000
CSCO;82202;USD;2014;Q4;2014-07-31;2014-09-09;5121000000;5187000000;52074000000;5157000000;1591000000;67114000000;3252000000;;34704000000;37956000000;105070000000;4372000000;508000000;19809000000;20337000000;28600000000;48409000000;41884000000;;14093000000;56661000000;105070000000
CSCO;82202;USD;2013;Q4;2013-07-31;2013-09-10;5368000000;5442000000;50610000000;5470000000;1476000000;65521000000;3322000000;;32348000000;35670000000;101191000000;4403000000;3283000000;21996000000;12928000000;20067000000;42063000000;42297000000;;16215000000;59128000000;101191000000
CSCO;82202;USD;2012;Q4;2012-07-31;2012-09-12;5330000000;5352000000;48716000000;4369000000;1663000000;61933000000;3402000000;;26424000000;29826000000;91759000000;4063000000;31000000;17731000000;16297000000;22727000000;40458000000;39271000000;;11354000000;51301000000;91759000000
CSCO;82202;USD;2011;Q4;2011-07-31;2011-09-14;5482000000;5453000000;44585000000;4698000000;1486000000;57231000000;3916000000;;25948000000;29864000000;87095000000;4159000000;588000000;17506000000;16234000000;22330000000;39836000000;38648000000;;7284000000;47259000000;87095000000
CSCO;82202;USD;2010;Q4;2010-07-31;2010-09-21;5689000000;5790000000;39861000000;4929000000;1327000000;51421000000;3941000000;;25768000000;29709000000;81130000000;4114000000;3096000000;19233000000;12188000000;17612000000;36845000000;37793000000;;5851000000;44285000000;81130000000
CSCO;82202;USD;2009;Q4;2009-07-31;2009-11-18;5778000000;5774000000;35001000000;3177000000;1074000000;44177000000;4043000000;;19908000000;23951000000;68128000000;3376000000;0;13655000000;10295000000;15796000000;29451000000;34344000000;;3868000000;38677000000;68128000000
CSCO;82202;USD;2017;Q4;2017-07-31;2017-09-07;4993000000;5045000000;70492000000;5146000000;1616000000;83703000000;3322000000;;42793000000;46115000000;129818000000;4378000000;7992000000;27583000000;25725000000;36098000000;63681000000;45253000000;;20838000000;66137000000;129818000000
CSCO;82202;USD;2018;Q4;2018-07-31;2018-09-06;4674000000;4762000000;46548000000;5554000000;1846000000;61837000000;3006000000;;43941000000;46947000000;108784000000;5894000000;5238000000;27035000000;20331000000;38545000000;65580000000;42820000000;;1233000000;43204000000;108784000000
AZZ;82401;USD;2016;Q4;2017-02-28;2017-04-20;25957304;26094944;11302000;138470000;123208000;296537000;228610000;;452692000;681302000;977839000;74023000;16629000;141850000;254800000;306350000;448200000;63703000;;495030000;529639000;977839000
AZZ;82401;USD;2015;Q4;2016-02-29;2016-04-21;25840612;25987732;40191000;131416000;102135000;309334000;226333000;;446343000;672676000;982010000;79918000;23192000;148405000;302429000;352389000;500794000;61022000;;450754000;481216000;982010000
AZZ;82401;USD;2014;Q4;2015-02-28;2015-04-22;25722580;25820780;22527000;125638000;107697000;298634000;196583000;;441697000;638280000;936914000;69514000;21866000;149142000;315982000;367720000;516862000;53438000;;389446000;420052000;936914000
AZZ;82401;USD;2013;Q4;2014-02-28;2014-04-28;25568892;25724554;27565000;116128000;107581000;296181000;197639000;;459433000;657072000;953253000;61952000;20848000;144016000;384768000;433324000;577340000;47531000;;339400000;375913000;953253000
AZZ;82401;USD;2012;Q4;2013-02-28;2013-04-29;25376968;25677140;55597751;97857193;82330926;262431939;154476220;;277296655;431772875;694204814;40504040;14285714;118899208;196428571;241371132;360270340;43030879;;294092945;333934474;694204814
AZZ;82401;USD;2011;Q4;2012-02-29;2012-05-10;25165228;25429500;143302666;74647303;60281130;302735899;135826703;;168211963;304038666;606774565;33388284;14285714;77978577;210714286;241187223;319165800;39419131;-174278;247059938;287608765;606774565
AZZ;82401;USD;2010;Q4;2011-02-28;2011-09-30;;;138389837;61945377;59552392;284019135;125361635;;157144071;282505706;566524841;31591796;;58186230;225000000;252320738;310506968;36750182;-542335;218889963;256017873;566524841
AZZ;82401;USD;2017;Q4;2018-02-28;2018-05-15;25933000;26050000;20853000;141488000;110761000;329154000;216855000;;482200000;699055000;1028209000;73317000;14286000;131739000;286609000;331267000;463006000;64405000;;526018000;565203000;1028209000
AZZ;82401;USD;2018;Q4;2019-02-28;2019-05-17;26085000;26152000;24005000;144887000;124847000;378545000;210227000;;499798000;710025000;1088570000;84074000;;164771000;240745000;320071000;484842000;72256000;;560224000;603728000;1088570000
IMGN;82671;USD;2018;Q4;2018-12-31;2019-03-01;147561000;147561000;262252000;1701000;0;278781000;12891000;;3709000;16600000;295381000;44463000;;70660000;2064000;213749000;284409000;1194307000;;-1183335000;10972000;295381000
IMGN;82671;USD;2017;Q4;2017-12-31;2018-03-07;124937000;124937000;267107000;2649000;1038000;276341000;14538000;;3797000;18335000;294676000;36586000;;55770000;2050000;256801000;312571000;1010687000;;-1028582000;-17895000;294676000
PM;82860;USD;2017;Q4;2017-12-31;2018-02-13;1550000000;1551000000;8447000000;3738000000;8806000000;21594000000;7271000000;;14103000000;21374000000;42968000000;12957000000;3005000000;15962000000;31334000000;37236000000;53198000000;1972000000;-35382000000;29859000000;-10230000000;42968000000
PM;82860;USD;2016;Q4;2016-12-31;2016-10-25;1552000000;1552000000;4239000000;3499000000;9017000000;17608000000;6064000000;;13179000000;19243000000;36851000000;13251000000;3216000000;16467000000;25851000000;31284000000;47751000000;1964000000;-35490000000;30397000000;-10900000000;36851000000
PM;82860;USD;2015;Q4;2015-12-31;2016-02-17;1550000000;1550000000;3417000000;2778000000;8473000000;15804000000;5721000000;;12431000000;18152000000;33956000000;11950000000;3230000000;15386000000;25250000000;30046000000;45432000000;1929000000;-35613000000;29842000000;-11476000000;33956000000
PM;82860;USD;2014;Q4;2014-12-31;2015-02-20;1550000000;1550000000;1682000000;4004000000;8592000000;15484000000;6071000000;;13632000000;19703000000;35187000000;12428000000;2526000000;15112000000;26929000000;31278000000;46390000000;710000000;-35762000000;29249000000;-11203000000;35187000000
PM;82860;USD;2013;Q4;2013-12-31;2014-02-21;1597000000;1597000000;2154000000;3853000000;9846000000;16852000000;6755000000;;14561000000;21316000000;38168000000;13299000000;3655000000;17066000000;24023000000;27376000000;44442000000;723000000;-32142000000;27843000000;-6274000000;38168000000
PM;82860;USD;2012;Q4;2012-12-31;2013-02-22;1665000000;1665000000;2983000000;3589000000;8949000000;16590000000;6645000000;;14435000000;21080000000;37670000000;11702000000;5200000000;17016000000;17639000000;22507000000;39523000000;1334000000;-26282000000;25076000000;-1853000000;37670000000
PM;82860;USD;2011;Q4;2011-12-31;2012-02-24;1730000000;1733000000;2550000000;3201000000;8120000000;14859000000;6250000000;;14379000000;20629000000;35488000000;10901000000;3717000000;14794000000;14828000000;18931000000;33725000000;1235000000;-19900000000;21757000000;1763000000;35488000000
PM;82860;USD;2010;Q4;2010-12-31;2011-02-25;1808000000;1811000000;1703000000;3009000000;8317000000;13756000000;6499000000;;14795000000;21294000000;35050000000;9534000000;3132000000;12804000000;13370000000;17125000000;29929000000;1225000000;-14712000000;18133000000;5121000000;35050000000
PM;82860;USD;2009;Q4;2009-12-31;2010-02-26;1898000000;1905000000;1540000000;3098000000;9207000000;14682000000;6390000000;;13480000000;19870000000;34552000000;9243000000;1744000000;11178000000;13672000000;17229000000;28407000000;1403000000;-10228000000;15358000000;6145000000;34552000000
PM;82860;USD;2008;Q4;2008-12-31;2009-08-14;;;1531000000;2848000000;9664000000;14939000000;6348000000;;11685000000;18033000000;32972000000;9382000000;584000000;10144000000;11377000000;14924000000;25068000000;1581000000;-5154000000;13354000000;7904000000;32972000000
PM;82860;USD;2018;Q4;2018-12-31;2019-02-07;1557000000;1556000000;6593000000;2950000000;8804000000;19442000000;7201000000;;13158000000;20359000000;39801000000;12407000000;4784000000;17191000000;26975000000;33349000000;50540000000;1939000000;-35301000000;31014000000;-10739000000;39801000000
BOJA;82963;USD;2014;Q4;2014-12-31;2015-06-11;;39531164;13201000;4285000;2743000;23634000;42478000;;486531000;529009000;552643000;34118000;4365000;40138000;248393000;374753000;414891000;-56220000;;21135000;137752000;552643000
VMW;83200;USD;2017;Q4;2017-12-31;2018-03-29;403389000;413673000;11653000000;1394000000;;13836000000;1074000000;;6296000000;7370000000;21206000000;1372000000;;4810000000;3964000000;7772000000;12582000000;848000000;;7791000000;8624000000;21206000000
VMW;83200;USD;2016;Q4;2016-12-31;2017-02-24;412039000;419686000;8393000000;1192000000;;9851000000;1042000000;;5504000000;6546000000;16397000000;940000000;;4289000000;0;3892000000;8181000000;1847000000;;6373000000;8216000000;16397000000
VMW;83200;USD;2015;Q4;2015-12-31;2016-02-25;421552000;424914000;7509000000;1633000000;;9360000000;1128000000;;5258000000;6386000000;15746000000;884000000;;4129000000;;3694000000;7823000000;2732000000;;5195000000;7923000000;15746000000
VMW;83200;USD;2014;Q4;2014-12-31;2015-02-26;430195000;435006000;7075000000;1520000000;;8882000000;1035000000;;5299000000;6334000000;15216000000;1014000000;;3996000000;;3634000000;7630000000;3384000000;;4198000000;7586000000;15216000000
VMW;83200;USD;2013;Q4;2013-12-31;2014-02-25;430322000;435860000;6175000000;1220000000;;7681000000;845000000;;3801000000;4646000000;12327000000;717000000;;3293000000;;2218000000;5511000000;3500000000;;3312000000;6816000000;12327000000
VMW;83200;USD;2012;Q4;2012-12-31;2013-02-27;427443000;435083000;4631000000;1151000000;;6120000000;665000000;;3811000000;4476000000;10596000000;734000000;;2930000000;;1926000000;4856000000;3436000000;;2298000000;5740000000;10596000000
VMW;83200;USD;2011;Q4;2011-12-31;2012-02-24;425621000;435399000;4512206000;882857000;;5677772000;525490000;;2477546000;3003036000;8680808000;637397000;;2401506000;;1509020000;3910526000;3216500000;;1552606000;4770282000;8680808000
VMW;83200;USD;2010;Q4;2010-12-31;2011-02-28;415054000;428017000;3323640000;614726000;;4297655000;419065000;;2080599000;2499664000;6797319000;518726000;;1789152000;;1199724000;2988876000;2960138000;;828670000;3808443000;6797319000
VMW;83200;USD;2009;Q4;2009-12-31;2010-08-05;398940000;406805000;2513821000;534196000;;3182480000;402356000;;1482148000;1884504000;5066984000;385089000;;1294042000;;1029991000;2324033000;2267157000;;471231000;2742951000;5066984000
VMW;83200;USD;2018;Q4;2018-12-31;2019-03-29;410276000;418373000;2849000000;1576000000;;5651000000;1133000000;;7878000000;9011000000;14662000000;1728000000;;5696000000;3972000000;8415000000;14111000000;535000000;;14000000;551000000;14662000000
SQ;83293;USD;2017;Q4;2017-12-31;2018-02-27;390331000;390331000;866050000;73420000;;1778294000;91496000;203667000;113813000;408976000;2187270000;829672000;;972827000;358572000;428110000;1400937000;1630386000;;-842735000;786333000;2187270000
SQ;83293;USD;2016;Q4;2016-12-31;2017-02-27;356515000;356515000;511931000;42144000;;1001425000;88328000;27366000;94243000;209937000;1211362000;503841000;;577464000;0;57745000;635209000;1357381000;;-779239000;576153000;1211362000
SQ;83293;USD;2015;Q4;2015-12-31;2016-05-06;235336000;235336000;461329000;604000;;705563000;87222000;0;101987000;189209000;894772000;295811000;;334202000;0;52522000;386724000;1116882000;;-607649000;508048000;894772000
SQ;83293;USD;2018;Q4;2018-12-31;2019-02-27;413985000;348760000;1124164000;89974000;;2111905000;142402000;464680000;562036000;1169118000;3281023000;865251000;;1018541000;899695000;1141981000;2160522000;2012328000;;-885774000;1120501000;3281023000
NFLX;83548;USD;2016;Q4;2016-12-31;2017-01-27;429751000;440072000;1733782000;;;5720291000;250395000;;7615924000;7866319000;13586610000;510474000;;4586657000;3364311000;6320153000;10906810000;1599762000;;1128603000;2679800000;13586610000
NFLX;83548;USD;2015;Q4;2015-12-31;2016-01-28;427723000;438312000;2310715000;;;5431840000;173412000;;4597619000;4771031000;10202871000;393880000;;3529624000;2371362000;4449821000;7979445000;1324809000;;941925000;2223426000;10202871000
NFLX;83548;USD;2014;Q4;2014-12-31;2015-01-29;422289000;432557000;1608496000;;;3927053000;149875000;;2965572000;3115447000;7042500000;271327000;;2663154000;885849000;2521638000;5184792000;1042870000;;819284000;1857708000;7042500000
NFLX;83548;USD;2013;Q4;2013-12-31;2014-02-03;416636000;429226000;1200405000;;;3058763000;133605000;;2220195000;2353800000;5412563000;162453000;;2154203000;500000000;1924799000;4079002000;777501000;;552485000;1333561000;5412563000
NFLX;83548;USD;2012;Q4;2012-12-31;2013-02-01;388927000;438354000;748078000;;;2240791000;131681000;;1595418000;1727099000;3967890000;139607000;;1675926000;400000000;1547291000;3223217000;301672000;;440082000;744673000;3967890000
NFLX;83548;USD;2011;Q4;2011-12-31;2012-02-10;375130000;388157000;797811000;;;1830857000;136353000;;1101986000;1238339000;3069196000;141223000;;1225055000;400000000;1201331000;2426386000;219174000;;422930000;642810000;3069196000
NFLX;83548;USD;2010;Q4;2010-12-31;2011-02-18;368039000;379302000;350387000;;;637231000;128570000;;216266000;344836000;982067000;92701000;;388579000;200000000;303324000;691903000;51675000;;237739000;290164000;982067000
NFLX;83548;USD;2009;Q4;2009-12-31;2010-02-22;374416000;387499000;320242000;;;411013000;131653000;;137068000;268721000;679734000;125929000;1410000;227436000;236572000;253155000;480591000;53000;;198817000;199143000;679734000
NFLX;83548;USD;2008;Q4;2008-12-31;2009-07-31;412237000;422590000;297271000;;;358925000;124948000;;131551000;256499000;615424000;131738000;1152000;216017000;37988000;52252000;268269000;338639000;-100020000;108452000;347155000;615424000
NFLX;83548;USD;2017;Q4;2017-12-31;2018-01-29;433140000;448174000;2822795000;;;7669974000;319404000;;11023364000;11342768000;19012742000;674649000;;5466312000;6499432000;9964474000;15430786000;1871396000;;1731117000;3581956000;19012742000
NFLX;83548;USD;2018;Q4;2018-12-31;2019-01-29;436416000;451146000;3794483000;;;9694135000;418281000;;15861984000;16280265000;25974400000;1040402000;;6487320000;10360058000;14248315000;20735635000;2315988000;;2942359000;5238765000;25974400000
SNX;84398;USD;2017;Q4;2017-11-30;2018-01-29;39634000;39868000;556163000;2846371000;2162626000;5739778000;346589000;;1612159000;1958748000;7698526000;3218848000;805471000;4041207000;1136089000;1373624000;5414831000;467989000;-77133000;1954758000;2283695000;7698526000
SNX;84398;USD;2016;Q4;2016-11-30;2017-01-26;39431000;39647000;385826000;1756494000;1741734000;3995030000;312716000;;907535000;1220251000;5215281000;2082964000;362889000;2476532000;601095000;762951000;3239483000;440754000;-67262000;1695400000;1975798000;5215281000
SNX;84398;USD;2015;Q4;2015-11-30;2016-01-28;39140000;39434000;341618000;1759491000;1328967000;3649781000;248627000;;545739000;794366000;4444147000;1818403000;92093000;1918157000;638798000;726093000;2644250000;411727000;-51287000;1494178000;1799897000;4444147000
SNX;84398;USD;2014;Q4;2014-11-30;2015-01-29;38888000;39236000;187271000;2091511000;1398463000;3899989000;200803000;;612250000;813053000;4713042000;2000343000;716257000;2721729000;264246000;337328000;3059057000;384665000;-32723000;1308244000;1653985000;4713042000
SNX;84398;USD;2013;Q4;2013-11-30;2014-01-27;37141000;37074000;166756000;1593191000;1095107000;2931733000;133249000;;260907000;394156000;3325889000;1532994000;252523000;1789378000;65405000;124870000;1914248000;286367000;-27450000;1133137000;1411641000;3325889000
SNX;84398;USD;2012;Q4;2012-11-30;2013-01-28;36726000;37091000;179632000;1401087000;923340000;2580461000;122923000;;259878000;382801000;2963262000;1299347000;194134000;1494707000;81152000;149200000;1643907000;324329000;-21611000;980900000;1319355000;2963262000
SNX;84398;USD;2011;Q4;2011-11-30;2012-01-27;36145000;36677000;83588000;1293027000;975047000;2438415000;125157000;;269723000;394880000;2833295000;1213053000;159200000;1372253000;223822000;292584000;1664837000;310353000;-11524000;829524000;1168458000;2833295000
SNX;84398;USD;2010;Q4;2010-11-30;2011-10-07;35346000;36144000;99457000;986917000;912237000;2209193000;91995000;;198673000;290668000;2499861000;1064840000;245973000;1314008000;140333000;193026000;1507034000;290548000;-5106000;679193000;992827000;2499861000
SNX;84398;USD;2018;Q4;2018-11-30;2019-01-28;46406000;46609000;457275000;3855431000;2518319000;7099752000;571326000;;3809356000;4380682000;11480434000;4038320000;833216000;4894441000;2622782000;3153925000;8048366000;1512254000;-149533000;2195635000;3432068000;11480434000
RAD;84515;USD;2016;Q4;2017-03-31;2017-05-03;52302250;53932750;245410000;1771126000;1789541000;5065288000;1526462000;;5002002000;6528464000;11593752000;2954856000;17709000;3005248000;3273092000;7974434000;10979682000;;;;614070000;11593752000
RAD;84515;USD;2015;Q4;2016-03-31;2016-04-25;52057850;52694200;124471000;1601008000;2697104000;4550727000;2255398000;;4470885000;6726283000;11277010000;2970047000;26848000;2996895000;6967288000;7698687000;10695582000;;;;581428000;11277010000
RAD;84515;USD;2014;Q4;2015-03-31;2015-04-23;48886200;51651050;115899000;980904000;2882980000;4221758000;2091369000;;2464298000;4555667000;8777425000;2326939000;100376000;2485000000;5458740000;6235369000;8720369000;;;;57056000;8777425000
RAD;84515;USD;2013;Q4;2014-03-31;2014-04-23;47696950;49536250;146406000;949062000;2993948000;4285125000;1957329000;;702417000;2659746000;6944871000;2458278000;49174000;2507452000;5707969000;6551121000;9058573000;5439480000;;-7515848000;-2113702000;6944871000
RAD;84515;USD;2012;Q4;2013-03-31;2013-04-23;44502800;46703350;129452000;929476000;3154742000;4409047000;1895650000;;774022000;2669672000;7078719000;2540959000;37311000;2578270000;5996220000;6959883000;9538153000;5185099000;;-7765262000;-2459434000;7078719000
RAD;84515;USD;2011;Q4;2012-03-31;2012-04-24;44355550;44355550;162285000;1013233000;3138455000;4504586000;1902021000;;957684000;2859705000;7364291000;2490898000;79421000;2570319000;6248780000;7380728000;9951047000;5177675000;;-7883367000;-2586756000;7364291000
RAD;84515;USD;2010;Q4;2011-03-31;2011-04-26;44189200;44189200;91116000;966457000;3158145000;4411365000;2039383000;;1105102000;3144485000;7555850000;2357278000;63045000;2420323000;6156820000;7346894000;9767217000;5171920000;;-7514796000;-2211367000;7555850000
RAD;84515;USD;2009;Q4;2010-03-31;2010-10-07;;;103594000;955502000;3238644000;4508668000;2293153000;;1248090000;3541243000;8049911000;2124190000;51502000;2175692000;6319397000;7547770000;9723462000;5164836000;;-6959372000;-1673551000;8049911000
RAD;84515;USD;2017;Q4;2018-03-31;2018-04-26;52731800;51430050;447334000;1869100000;1799539000;4735291000;1431246000;;2822790000;4254036000;8989327000;2883099000;20761000;3464065000;3370874000;3924252000;7388317000;5918030000;;-4282471000;1601010000;8989327000
RAD;84515;USD;2018;Q4;2019-03-31;2019-04-25;52954000;52954000;144353000;1788712000;1871941000;4101719000;1308514000;;2181134000;3489648000;7591367000;2427024000;16111000;2443135000;3478649000;3961542000;6404677000;5930993000;;-4713244000;1186690000;7591367000
ARA;84598;USD;2017;Q4;2017-12-31;2018-03-06;31337707;28599303;71521000;79662000;4665000;187591000;168537000;;608080000;776617000;964208000;112369000;44534000;156903000;515554000;546925000;703828000;68046000;;-123789000;260380000;964208000
ARA;84598;USD;2016;Q4;2016-12-31;2017-03-08;30988376;29845209;100916000;81127000;4676000;210380000;170118000;;605526000;775644000;986024000;105516000;48274000;153790000;522058000;556206000;709996000;95246000;;-128646000;276028000;986024000
ARA;84598;USD;2015;Q4;2015-12-31;2016-05-16;22210564;22791340;90988000;76919000;4291000;193747000;142701000;;601830000;744531000;938278000;71863000;25610000;97473000;657372000;681884000;779357000;98000;;-128261000;158921000;938278000
ARA;84598;USD;2018;Q4;2018-12-31;2019-09-05;32124574;29551526;55200000;99526000;11433000;194863000;180268000;;610712000;790980000;985843000;154785000;42855000;197640000;517511000;549193000;746833000;105911000;;-164451000;239010000;985843000
CRM;85017;USD;2016;Q4;2017-01-31;2017-03-06;702080000;727633000;2208887000;3196643000;;5996827000;1787534000;566953000;9233609000;11588096000;17584923000;1752664000;0;7295466000;2008391000;2789330000;10084796000;8040878000;;-464910000;7500127000;17584923000
CRM;85017;USD;2015;Q4;2016-01-31;2016-03-07;669282000;658781000;2725377000;2496165000;;5731323000;1715828000;520721000;4795048000;7031597000;12762920000;1349338000;;5617005000;1286095000;2143046000;7760051000;5706057000;;-653271000;5002869000;12762920000
CRM;85017;USD;2014;Q4;2015-01-31;2015-03-06;637516000;637516000;995429000;1905506000;;3514544000;1125866000;1070629000;4954088000;7150583000;10665127000;1103335000;;4390103000;1370692000;2299841000;6689944000;4605136000;;-605845000;3975183000;10665127000
CRM;85017;USD;2013;Q4;2014-01-31;2014-03-05;607645000;576944000;838774000;1360837000;;2680252000;1240746000;482243000;4749689000;6472678000;9152930000;934324000;542159000;3950188000;1331930000;2164232000;6114420000;3363987000;;-343157000;3038510000;9152930000
CRM;85017;USD;2012;Q4;2013-01-31;2013-03-08;580472000;580472000;867621000;872634000;;2015880000;604669000;890664000;2017743000;3513076000;5528956000;597706000;521278000;2917624000;0;293699000;3211323000;2411478000;;-110982000;2317633000;5528956000
CRM;85017;USD;2011;Q4;2012-01-31;2012-03-09;547256000;516824000;777866000;683745000;;1672222000;527946000;669308000;1294678000;2491932000;4164154000;512260000;496149000;2300031000;;276763000;2576794000;1415214000;;159463000;1587360000;4164154000
CRM;85017;USD;2010;Q4;2011-01-31;2011-03-23;530024000;571684000;496970000;426943000;;1074924000;387174000;910587000;718480000;2016241000;3091165000;363227000;0;1276466000;472538000;538208000;1814674000;1098737000;;171035000;1276491000;3091165000
CRM;85017;USD;2009;Q4;2010-01-31;2010-03-11;504940000;527780000;1241965000;320956000;;1706159000;89711000;485083000;179248000;754042000;2460201000;217953000;;908130000;450198000;495405000;1403535000;938671000;;106561000;1056666000;2460201000
CRM;85017;USD;2008;Q4;2009-01-31;2009-08-25;489820000;501572000;697603000;266555000;;1068557000;77027000;184962000;149276000;411265000;1479822000;183203000;;766966000;0;30369000;797335000;648847000;;25842000;682487000;1479822000
CRM;85017;USD;2017;Q4;2018-01-31;2018-03-09;724018000;764726000;4521000000;3921000000;;9584000000;1947000000;677000000;9776000000;12400000000;21984000000;2047000000;;9042000000;1720000000;2566000000;11608000000;9753000000;;635000000;10376000000;21984000000
CRM;85017;USD;2018;Q4;2019-01-31;2019-03-08;768000000;787000000;4342000000;4924000000;;10683000000;2051000000;1302000000;16701000000;20054000000;30737000000;2688000000;;11252000000;3176000000;3880000000;15132000000;13928000000;;1735000000;15605000000;30737000000
INTC;85652;USD;2018;Q4;2018-12-31;2019-02-01;4547000000;4619000000;5807000000;6722000000;7253000000;28787000000;48976000000;9430000000;40770000000;99176000000;127963000000;7446000000;1261000000;16626000000;25098000000;36774000000;53400000000;25365000000;;50172000000;74563000000;127963000000
INTC;85652;USD;2017;Q4;2017-12-31;2018-02-16;4683000000;4793000000;5247000000;5607000000;6983000000;29500000000;41109000000;12291000000;40349000000;93749000000;123249000000;6454000000;1776000000;17421000000;25037000000;36809000000;54230000000;26074000000;;42083000000;69019000000;123249000000
INTC;85652;USD;2016;Q4;2016-12-31;2016-10-31;4735000000;4882000000;8785000000;4690000000;5553000000;35508000000;36171000000;10896000000;30752000000;77819000000;113327000000;5940000000;4634000000;20302000000;20649000000;26799000000;47101000000;25373000000;;40747000000;66226000000;113327000000
INTC;85652;USD;2015;Q4;2015-12-31;2015-10-28;4721000000;4877000000;17990000000;4787000000;5167000000;38320000000;31858000000;7851000000;23430000000;63139000000;101459000000;6161000000;2634000000;15646000000;20036000000;24728000000;40374000000;23411000000;;37614000000;61085000000;101459000000
INTC;85652;USD;2014;Q4;2014-12-31;2014-10-29;4769000000;4939000000;4991000000;4427000000;4273000000;27730000000;33238000000;9120000000;21812000000;64170000000;91900000000;7315000000;1596000000;16011000000;12059000000;20024000000;36035000000;21781000000;;33418000000;55865000000;91900000000
INTC;85652;USD;2013;Q4;2013-12-31;2013-10-28;4973000000;5102000000;11646000000;3582000000;4172000000;32084000000;31428000000;7694000000;21152000000;60274000000;92358000000;7113000000;281000000;13568000000;13165000000;20534000000;34102000000;21536000000;;35477000000;58256000000;92358000000
INTC;85652;USD;2012;Q4;2012-12-31;2012-10-31;4967000000;5096000000;12477000000;3833000000;4734000000;31358000000;27983000000;4917000000;20093000000;52993000000;84351000000;7010000000;312000000;12898000000;13136000000;20250000000;33148000000;19464000000;;32138000000;51203000000;84351000000
INTC;85652;USD;2011;Q4;2011-12-31;2011-11-04;5084000000;5257000000;10246000000;3650000000;4096000000;25872000000;23627000000;1451000000;20169000000;45247000000;71119000000;7038000000;247000000;12028000000;7084000000;13180000000;25208000000;17036000000;;29656000000;45911000000;71119000000
INTC;85652;USD;2010;Q4;2010-12-31;2010-11-02;5553000000;5698000000;16792000000;2867000000;3757000000;31611000000;17899000000;4034000000;9642000000;31575000000;63186000000;6185000000;38000000;9327000000;2077000000;4429000000;13756000000;16178000000;;32919000000;49430000000;63186000000
INTC;85652;USD;2009;Q4;2009-12-31;2009-11-02;5523000000;5735000000;9272000000;2273000000;2935000000;21157000000;17225000000;4952000000;9761000000;31938000000;53095000000;5104000000;172000000;7591000000;2242000000;3800000000;11391000000;14993000000;;26318000000;41704000000;53095000000
INTC;85652;USD;2008;Q4;2008-12-31;2009-08-03;5564000000;5622000000;8681000000;1712000000;3744000000;19871000000;17574000000;3276000000;9751000000;30601000000;50472000000;5352000000;102000000;7818000000;1921000000;3108000000;10926000000;13402000000;;26537000000;39546000000;50472000000
QCOM;85758;USD;2017;Q4;2017-09-30;2017-11-01;1475000000;1485000000;37308000000;3632000000;2035000000;43593000000;3216000000;1270000000;17407000000;21893000000;65486000000;3154000000;2495000000;10907000000;19398000000;23833000000;34740000000;274000000;;30088000000;30746000000;65486000000
QCOM;85758;USD;2016;Q4;2016-09-30;2016-11-02;1476000000;1491000000;18648000000;2219000000;1556000000;22981000000;2306000000;13702000000;13370000000;29378000000;52359000000;2792000000;1749000000;7311000000;10008000000;13280000000;20591000000;414000000;;30936000000;31768000000;52359000000
QCOM;85758;USD;2015;Q4;2015-09-30;2015-11-04;1558000000;1574000000;17321000000;1964000000;1492000000;22099000000;2534000000;13626000000;12537000000;28697000000;50796000000;2161000000;1000000000;6100000000;9969000000;13282000000;19382000000;0;;31226000000;31414000000;50796000000
QCOM;85758;USD;2014;Q4;2014-09-30;2014-11-05;1673000000;1701000000;17565000000;2412000000;1458000000;22413000000;2487000000;14457000000;9217000000;26161000000;48574000000;2985000000;0;6013000000;0;3395000000;9408000000;7736000000;;30799000000;39166000000;48574000000
QCOM;85758;USD;2013;Q4;2013-09-30;2013-11-06;1702000000;1737000000;14966000000;2142000000;1302000000;19555000000;2995000000;14440000000;8526000000;25961000000;45516000000;2393000000;;5213000000;;4216000000;9429000000;9874000000;;25461000000;36087000000;45516000000
QCOM;85758;USD;2012;Q4;2012-09-30;2012-11-07;1703000000;1742000000;12374000000;1459000000;1030000000;15645000000;2851000000;14463000000;10053000000;27367000000;43012000000;1962000000;;5302000000;;4165000000;9467000000;11956000000;;20701000000;33545000000;43012000000
QCOM;85758;USD;2011;Q4;2011-09-30;2011-11-02;1682000000;1718000000;11652000000;993000000;765000000;14293000000;2414000000;9261000000;10454000000;22129000000;36422000000;1613000000;994000000;5289000000;;4161000000;9450000000;10394000000;;16204000000;26972000000;36422000000
QCOM;85758;USD;2010;Q4;2010-09-30;2010-11-03;1609000000;1621000000;10279000000;730000000;528000000;12133000000;2373000000;8123000000;7943000000;18439000000;30572000000;2674000000;1086000000;5468000000;;4246000000;9714000000;6856000000;;13305000000;20858000000;30572000000
QCOM;85758;USD;2009;Q4;2009-09-30;2009-12-22;1664000000;1699000000;11069000000;700000000;453000000;12570000000;2387000000;6673000000;5815000000;14875000000;27445000000;1145000000;0;2813000000;;4316000000;7129000000;8493000000;;11235000000;20316000000;27445000000
QCOM;85758;USD;2008;Q4;2008-09-30;2009-11-05;;;6411000000;4187000000;521000000;11872000000;2162000000;4858000000;5820000000;12840000000;24712000000;976000000;;2440000000;;4328000000;6768000000;7511000000;;10717000000;17944000000;24712000000
QCOM;85758;USD;2018;Q4;2018-09-30;2018-11-07;1415000000;1394000000;12088000000;2904000000;1693000000;17384000000;2975000000;35000000;12292000000;15302000000;32686000000;5218000000;1005000000;13548000000;15365000000;18210000000;31758000000;0;;663000000;928000000;32686000000
GLUU;85988;USD;2017;Q4;2017-12-31;2018-03-09;137733000;137733000;63764000;34673000;;117130000;14630000;;167538000;182168000;299298000;54742000;;132904000;;12534000;145438000;589976000;;-436110000;153860000;299298000
GLUU;85988;USD;2016;Q4;2016-12-31;2017-03-10;133737000;133737000;102102000;21477000;;155030000;5640000;;178834000;184474000;339504000;39204000;;84340000;;22350000;106690000;571256000;;-338688000;232814000;339504000
GLUU;85988;USD;2015;Q4;2015-12-31;2016-03-04;127775000;119594000;180542000;17956000;;237054000;5447000;;160485000;165932000;402986000;39172000;;70626000;;25932000;96558000;557761000;;-251248000;306428000;402986000
GLUU;85988;USD;2014;Q4;2014-12-31;2015-03-13;103408000;111303000;70912000;32231000;;121395000;6116000;;124152000;130268000;251663000;38688000;;76021000;;3936000;79957000;415777000;;-244063000;171706000;251663000
GLUU;85988;USD;2013;Q4;2013-12-31;2014-03-14;78074000;78074000;28496000;18305000;;54464000;5096000;;27451000;32547000;87011000;19733000;;37957000;;2357000;40314000;298601000;;-252211000;46697000;87011000
GLUU;85988;USD;2012;Q4;2012-12-31;2013-03-15;65677000;65677000;22325000;11881000;;39373000;5026000;;30556000;35582000;74955000;18167000;;29878000;;6190000;36068000;271022000;;-232302000;38887000;74955000
GLUU;85988;USD;2011;Q4;2011-12-31;2012-03-14;;;32212000;11821000;;48603000;3934000;;32473000;36407000;85010000;17102000;;27334000;;8503000;35837000;260750000;;-211843000;49173000;85010000
GLUU;85988;USD;2010;Q4;2010-12-31;2011-08-15;;;12863000;10660000;;28548000;2134000;;14134000;16268000;44816000;18253000;2288000;23072000;;7859000;30931000;203468000;;-190742000;13885000;44816000
GLUU;85988;USD;2018;Q4;2018-12-31;2019-02-28;143588000;143588000;97834000;27325000;;145029000;13888000;;155516000;169404000;314433000;43899000;;129929000;;7191000;137120000;617795000;;-440483000;177313000;314433000
SNAK;86600;USD;2016;Q4;2016-12-31;2017-03-31;19674000;19674000;776000;8941000;13398000;92514000;34367000;;54599000;88966000;181480000;24915000;79883000;154135000;;3656000;157791000;35921000;-471000;-11761000;23689000;181480000
SNAK;86600;USD;2015;Q4;2015-12-31;2016-03-10;19611000;19611000;2319000;19928000;81807000;110316000;59963000;;40194000;100157000;210473000;44612000;1826000;72389000;83300000;85596000;157985000;34471000;-471000;18488000;52488000;210473000
SNAK;86600;USD;2014;Q4;2014-12-31;2015-03-10;19565000;20062000;495000;22420000;65216000;89351000;55200000;;50759000;105959000;195310000;28511000;7041000;54354000;59218000;68990000;123344000;33300000;-471000;39271000;71966000;195310000
SNAK;86600;USD;2013;Q4;2013-12-31;2014-03-14;19454000;19917000;910000;23618000;43086000;68837000;50140000;;51114000;101254000;170091000;29501000;6110000;38834000;61865000;72104000;110938000;31158000;-471000;28710000;59153000;170091000
SNAK;86600;USD;2012;Q4;2012-12-31;2013-03-13;19072000;19686000;419000;17547000;27071000;46360000;34051000;;15483000;49534000;95894000;20593000;1646000;32356000;6897000;12439000;44795000;29856000;-471000;22092000;51099000;95894000
SNAK;86600;USD;2011;Q4;2011-12-31;2012-03-27;18222000;21239000;664488;15741758;31682080;49615144;33182331;;15177448;48359779;97974923;24423239;3025011;42632160;8595109;13733213;56365373;27862098;-471195;14643672;41609550;97974923
SNAK;86600;USD;2010;Q4;2010-12-31;2011-08-04;17973017;18714531;980547;11703056;21814930;35794370;28007869;;15018628;43026497;78820867;14160320;1692193;24949405;11567800;16081804;41031209;26740920;-471195;11826835;37789658;78820867
SBUX;86689;USD;2017;Q4;2017-09-30;2017-11-17;1439600000;1451300000;2690900000;870400000;1364000000;5283400000;4919500000;542300000;3620400000;9082200000;14365600000;2717000000;0;4220700000;3932600000;4687900000;8908600000;42500000;;5563200000;5457000000;14365600000
SBUX;86689;USD;2016;Q4;2016-09-30;2016-11-18;1463100000;1477600000;2263200000;768800000;1378500000;4757900000;4533800000;1141700000;3879100000;9554600000;14312500000;2729700000;399900000;4546800000;3185300000;3875000000;8421800000;42600000;;5949800000;5890700000;14312500000
SBUX;86689;USD;2015;Q4;2015-09-30;2015-11-12;1485800000;1504600000;1611400000;719000000;1306400000;3971000000;4088300000;312500000;4044500000;8445300000;12416300000;2439500000;0;3648100000;2347500000;2948400000;6596500000;42600000;;5974800000;5819800000;12416300000
SBUX;86689;USD;2014;Q4;2014-09-30;2014-11-14;1501600000;1521700000;1843800000;631000000;1090900000;4168700000;3519000000;318400000;2746800000;6584200000;10752900000;2048100000;;3038700000;2048300000;2440500000;5479200000;40100000;;5206600000;5273700000;10752900000
SBUX;86689;USD;2013;Q4;2013-09-30;2013-11-18;1504200000;1529000000;3233800000;561400000;1111200000;5471400000;3200500000;58300000;2786500000;6045300000;11516700000;4545100000;;5377300000;1299400000;1657100000;7034400000;282900000;;4130300000;4482300000;11516700000
SBUX;86689;USD;2012;Q4;2012-09-30;2012-11-16;1512400000;1546800000;2037000000;485900000;1241500000;4199600000;2658900000;116000000;1244700000;4019600000;8219200000;1531900000;;2209800000;549600000;894900000;3104700000;40100000;;5046200000;5114500000;8219200000
SBUX;86689;USD;2011;Q4;2011-09-30;2011-11-18;1493400000;1536800000;2050700000;386500000;965800000;3794900000;2355000000;107000000;1103500000;3565500000;7360400000;1480900000;;2075800000;549500000;897300000;2973100000;41200000;;4297400000;4387300000;7360400000
SBUX;86689;USD;2010;Q4;2010-09-30;2010-11-22;1480400000;1520600000;1400500000;302700000;543300000;2756400000;2416500000;191800000;1021200000;3629500000;6385900000;1118600000;;1779100000;549400000;924500000;2703600000;146300000;;3471200000;3682300000;6385900000
SBUX;86689;USD;2009;Q4;2009-09-30;2009-11-20;1482200000;1515800000;621300000;271000000;664900000;2035800000;2536400000;71200000;933400000;3541000000;5576800000;910200000;;1581000000;549300000;938900000;2519900000;187100000;;2793200000;3056900000;5576800000
SBUX;86689;USD;2008;Q4;2008-09-30;2009-08-05;1467800000;1483400000;272800000;329500000;692800000;1748000000;2956400000;71400000;896800000;3924600000;5672600000;879000000;713700000;2189700000;549600000;992000000;3181700000;40100000;;2402400000;2490900000;5672600000
SBUX;86689;USD;2018;Q4;2018-09-30;2018-11-16;1337800000;1348700000;8937800000;693100000;1400500000;12494200000;5929100000;267700000;5465400000;11662200000;24156400000;3477700000;349900000;5684200000;9090200000;17296400000;22980600000;42400000;;1457400000;1175800000;24156400000
SWY;86808;USD;2015;Q4;2015-12-31;2015-03-04;;;2255100000;373400000;2187900000;5609100000;6776500000;;991400000;7767900000;13377000000;2626200000;97900000;2753500000;2902000000;5173100000;7926600000;2053800000;-491800000;4310100000;5450400000;13377000000
SWY;86808;USD;2014;Q4;2014-12-31;2015-03-04;229300000;233100000;4647300000;1211400000;2089600000;8463700000;7537500000;;1218300000;8755800000;17219500000;5554200000;302200000;5856400000;3890800000;5488000000;11344400000;1984300000;-480600000;4586900000;5875100000;17219500000
SWY;86808;USD;2013;Q4;2013-12-31;2014-02-26;240900000;245000000;4647300000;1211400000;2089600000;8463700000;7537500000;;1218300000;8755800000;17219500000;5554200000;302200000;5856400000;3890800000;5488000000;11344400000;1984300000;-480600000;4586900000;5875100000;17219500000
SWY;86808;USD;2012;Q4;2012-12-31;2013-02-26;234400000;234800000;352200000;909000000;2562000000;4167900000;9224600000;;1264500000;10489100000;14657000000;4269200000;330200000;4629800000;5243500000;7118000000;11747800000;4511700000;-9119800000;7585600000;2909200000;14657000000
SWY;86808;USD;2011;Q4;2011-12-31;2012-02-27;314000000;313100000;729400000;652100000;2469600000;4186800000;9637600000;;1249200000;10886800000;15073600000;4093800000;840500000;5012100000;4569700000;6346200000;11358300000;4469900000;-7874400000;7175300000;3715300000;15073600000
SWY;86808;USD;2010;Q4;2010-12-31;2010-03-02;365800000;365900000;471500000;522400000;2508900000;3825300000;10282700000;;855600000;11138300000;14963600000;3593900000;540800000;4237800000;4360900000;5779400000;10017200000;4218300000;-5661800000;6403700000;4946400000;14963600000
SWY;86808;USD;2009;Q4;2009-12-31;2009-10-19;391200000;388200000;382800000;515100000;2591400000;3976200000;10643100000;;2865400000;13508500000;17484700000;3593000000;799000000;4499200000;4700800000;6199300000;10698500000;4134200000;-4776800000;7657500000;6786200000;17484700000
GBX;87143;USD;2018;Q4;2018-08-31;2018-10-26;32707000;33019000;530655000;348406000;432314000;1451120000;780051000;61414000;172879000;1014344000;2465464000;886062000;;992016000;27725000;59465000;1051481000;442569000;;830898000;1413983000;2465464000
GBX;87143;USD;2017;Q4;2017-08-31;2017-10-27;29325000;32719000;611466000;279964000;400127000;1391721000;743962000;108255000;153767000;1005984000;2397705000;973289000;;1102549000;4324000;80115000;1182664000;315306000;;709103000;1215041000;2397705000
GBX;87143;USD;2016;Q4;2016-08-31;2016-10-25;29076000;32592000;222679000;232517000;365805000;990212000;636256000;98682000;110624000;845562000;1835774000;671607000;;767328000;;51619000;818947000;282886000;;618178000;1016827000;1835774000
GBX;87143;USD;2015;Q4;2015-08-31;2015-10-30;30069000;33526000;172930000;196029000;445535000;1035897000;558526000;87270000;108819000;754615000;1790512000;781642000;;815478000;50888000;111545000;927023000;295444000;;458599000;863489000;1790512000
GBX;87143;USD;2014;Q4;2014-08-31;2014-10-30;27983000;34028000;184916000;199679000;305656000;836241000;502546000;69359000;109022000;680927000;1517168000;828380000;;848983000;13081000;94464000;943447000;235763000;;282559000;573721000;1517168000
GBX;87143;USD;2013;Q4;2013-08-31;2013-10-31;25739000;12058000;97435000;154848000;316783000;646353000;507001000;10739000;125648000;643388000;1289741000;689827000;;698665000;48209000;134249000;832914000;259864000;;174842000;456827000;1289741000
GBX;87143;USD;2012;Q4;2012-08-31;2012-11-01;27161000;33953000;53571000;146326000;316741000;620713000;545397000;;218434000;763831000;1384544000;757587000;;774781000;60755000;156118000;930899000;252256000;;185890000;453645000;1384544000
GBX;87143;USD;2011;Q4;2011-08-31;2012-01-06;27084000;36688000;50222000;188443000;323512000;594980000;482341000;;224334000;706675000;1301655000;745676000;;751576000;90339000;174178000;925754000;242286000;;127182000;375901000;1301655000
GBX;87143;USD;2019;Q4;2019-08-31;2019-10-29;32589000;33178000;329684000;373383000;664693000;1558832000;1084661000;91818000;255326000;1431805000;2990637000;1391245000;;1476315000;27115000;41061000;1517376000;453943000;;867602000;1473261000;2990637000
WBA;87466;USD;2017;Q4;2017-08-31;2017-10-25;1055100000;1057600000;3301000000;6528000000;8899000000;19753000000;13642000000;6320000000;26294000000;46256000000;66009000000;17967000000;251000000;18547000000;12684000000;19188000000;37735000000;10351000000;-9971000000;30137000000;28274000000;66009000000
WBA;87466;USD;2016;Q4;2016-08-31;2016-10-20;1082400000;1107000000;9807000000;6260000000;8956000000;25883000000;14335000000;6174000000;26296000000;46805000000;72688000000;16484000000;323000000;17013000000;18705000000;25393000000;42406000000;10123000000;-4934000000;27684000000;30282000000;72688000000
WBA;87466;USD;2015;Q4;2015-08-31;2015-10-28;1092000000;1081000000;3000000000;6849000000;8678000000;19657000000;15068000000;1242000000;32815000000;49125000000;68782000000;15313000000;1068000000;16557000000;13315000000;20923000000;37480000000;9965000000;-3977000000;25089000000;31302000000;68782000000
WBA;87466;USD;2014;Q4;2014-08-31;2014-12-30;955800000;955800000;2646000000;3218000000;6076000000;12242000000;12257000000;7336000000;5415000000;25008000000;37250000000;8016000000;774000000;8895000000;3716000000;7733000000;16628000000;1252000000;-3197000000;22327000000;20622000000;37250000000
WBA;87466;USD;2018;Q4;2018-08-31;2018-10-11;974800000;978100000;785000000;6573000000;9565000000;17846000000;13911000000;6610000000;29757000000;50278000000;68124000000;19428000000;1966000000;21667000000;12431000000;19768000000;41435000000;10505000000;-15047000000;33551000000;26689000000;68124000000
MSM;87559;USD;2017;Q4;2017-08-31;2017-10-31;112908619;113350392;16083000;471795000;464959000;1005579000;316305000;;777028000;1093333000;2098912000;225739000;331986000;557725000;200991000;316047000;873772000;627061000;-553470000;1168812000;1225140000;2098912000
MSM;87559;USD;2016;Q4;2016-08-31;2016-11-01;60016000;60214000;52890000;392463000;444221000;981491000;320544000;;762916000;1083460000;2064951000;211552000;267050000;478602000;339772000;487973000;966575000;584082000;-506756000;1040148000;1098376000;2064951000
MSM;87559;USD;2015;Q4;2015-08-31;2015-10-28;61284000;61416000;38267000;403468000;506631000;1032076000;291156000;;776954000;1068110000;2100186000;208822000;25165000;421987000;214119000;345329000;767316000;604974000;-487233000;1232381000;1332870000;2100186000
MSM;87559;USD;2014;Q4;2014-08-31;2014-10-29;61692000;62016000;47154000;382784000;449814000;961415000;294348000;;804984000;1099332000;2060747000;212335000;26829000;309164000;240235000;353020000;662184000;573799000;-456250000;1286068000;1398563000;2060747000
MSM;87559;USD;2013;Q4;2013-08-31;2013-10-30;62895000;63201000;55876000;345366000;419012000;893489000;251536000;;797978000;1049514000;1943003000;199395000;14184000;213579000;241566000;339041000;552620000;528839000;-266897000;1132868000;1390383000;1943003000
MSM;87559;USD;2012;Q4;2012-08-31;2012-10-31;62184000;62522000;168453000;297215000;393412000;920111000;174597000;;350168000;524765000;1444876000;169508000;1007000;170515000;2189000;87250000;257765000;483751000;-265162000;970965000;1187111000;1444876000
MSM;87559;USD;2011;Q4;2011-08-31;2011-10-26;63180000;63546000;95959000;266545000;344854000;758434000;148813000;;337176000;485989000;1244423000;172202000;;172202000;;79109000;251311000;439102000;-219054000;775149000;993112000;1244423000
MSM;87559;USD;2010;Q4;2010-08-31;2011-01-06;62224000;62642000;121191000;221013000;285985000;676536000;143609000;;333178000;476787000;1153323000;150924000;39361000;190285000;;63158000;253443000;378381000;-151809000;675968000;899880000;1153323000
MSM;87559;USD;2018;Q4;2018-08-31;2018-10-30;56274000;56628000;46217000;523892000;518496000;1147507000;311685000;;829535000;1141220000;2288727000;266426000;224097000;490523000;311236000;410950000;901473000;657814000;-576748000;1325822000;1387254000;2288727000
MSM;87559;USD;2019;Q4;2019-08-31;2019-10-24;55181000;55452000;32286000;541091000;559136000;1199612000;310854000;;800771000;1111625000;2311237000;271463000;175453000;446916000;266431000;380442000;827358000;659282000;-104607000;946651000;1483879000;2311237000
KMI;88392;USD;2018;Q4;2018-12-31;2019-02-08;2248000000;2248000000;3280000000;1498000000;385000000;5722000000;37897000000;7481000000;27766000000;73144000000;78866000000;2487000000;3388000000;6681000000;33105000000;36988000000;43669000000;41724000000;;-7716000000;35197000000;78866000000
KMI;88392;USD;2017;Q4;2017-12-31;2018-02-09;2229000000;2229000000;264000000;1448000000;424000000;2715000000;40155000000;7298000000;28887000000;76340000000;79055000000;2508000000;2828000000;6181000000;33988000000;37750000000;43931000000;41931000000;;-7754000000;35124000000;79055000000
KMI;88392;USD;2016;Q4;2016-12-31;2016-10-21;2232000000;2232000000;684000000;1370000000;357000000;3229000000;38705000000;7027000000;31344000000;77076000000;80305000000;2143000000;2696000000;5924000000;36105000000;39579000000;45503000000;41761000000;;-6669000000;34802000000;80305000000
KMI;88392;USD;2015;Q4;2015-12-31;2016-02-16;2229000000;2231000000;229000000;1315000000;407000000;2824000000;40547000000;6040000000;34693000000;81280000000;84104000000;2185000000;821000000;4065000000;40632000000;44636000000;48701000000;41683000000;;-6103000000;35403000000;84104000000
KMI;88392;USD;2014;Q4;2014-12-31;2015-02-23;;1463000000;315000000;1641000000;459000000;3752000000;38564000000;6036000000;34697000000;79297000000;83049000000;2608000000;2717000000;6362000000;38212000000;42261000000;48623000000;36199000000;;-2106000000;34426000000;83049000000
KMI;88392;USD;2013;Q4;2013-12-31;2014-02-24;;;598000000;1721000000;430000000;3868000000;35847000000;5951000000;29519000000;71317000000;75185000000;2825000000;2306000000;6075000000;31810000000;40825000000;46900000000;14489000000;;-1372000000;28285000000;75185000000
KMI;88392;USD;2012;Q4;2012-12-31;2013-03-01;;;714000000;1333000000;374000000;3674000000;30996000000;5804000000;27771000000;64571000000;68245000000;1875000000;2401000000;5228000000;29409000000;38917000000;44145000000;14927000000;;-943000000;24100000000;68245000000
KMI;88392;USD;2011;Q4;2011-12-31;2012-02-23;;;411000000;914000000;172000000;1663000000;17926000000;3744000000;7384000000;29054000000;30717000000;1081000000;2899000000;4529000000;13161000000;17620000000;22149000000;3439000000;;-3000000;8568000000;30717000000
KMI;88392;USD;2010;Q4;2010-12-31;2011-08-25;;;502400000;971400000;92000000;1786900000;17070700000;4291100000;5759400000;27121200000;28908100000;1036900000;2013300000;3644100000;13056600000;16725000000;20369100000;3575600000;;0;8539000000;28908100000
FIS;88558;USD;2016;Q4;2016-12-31;2017-02-23;329000000;334000000;683000000;1639000000;;4282000000;626000000;;21123000000;21749000000;26031000000;1146000000;332000000;3151000000;10146000000;13035000000;16186000000;10384000000;-3611000000;3299000000;9845000000;26031000000
FIS;88558;USD;2015;Q4;2015-12-31;2016-02-26;296000000;299800000;682000000;1731000000;;3509000000;611000000;;22080000000;22691000000;26200000000;1196000000;15000000;2364000000;11429000000;14429000000;16793000000;10214000000;-3687000000;3073000000;9407000000;26200000000
FIS;88558;USD;2014;Q4;2014-12-31;2015-02-27;282600000;286700000;492800000;1126400000;;2473100000;483300000;;11564100000;12047400000;14520500000;730300000;13100000;1598900000;5054600000;6230100000;7829000000;7340700000;-3423600000;2746800000;6691500000;14520500000
FIS;88558;USD;2013;Q4;2013-12-31;2014-02-28;288700000;293800000;547500000;987900000;;2351900000;439000000;;11169200000;11608200000;13960100000;768000000;128800000;1672700000;4339800000;5550100000;7222800000;7251500000;-3003000000;2341900000;6737300000;13960100000
FIS;88558;USD;2012;Q4;2012-12-31;2013-02-26;292400000;298400000;517600000;925700000;;1844200000;419500000;;11286000000;11705500000;13549700000;624600000;153900000;1256800000;4231600000;5499300000;6756100000;7200800000;-2695700000;2105800000;6793600000;13549700000
FIS;88558;USD;2011;Q4;2011-12-31;2012-02-24;296400000;301600000;415500000;858500000;;1674000000;414500000;;11784700000;12199200000;13873200000;642900000;259200000;1356300000;4550600000;5865700000;7222000000;7228500000;-2642200000;1880400000;6651200000;13873200000
FIS;88558;USD;2010;Q4;2010-12-31;2011-02-25;298400000;304300000;338000000;839400000;;1673000000;390000000;;12113300000;12503300000;14176300000;591800000;256900000;1300400000;4935200000;6314300000;7614700000;7203500000;-2359400000;1471200000;6561600000;14176300000
FIS;88558;USD;2009;Q4;2009-12-31;2010-02-26;374200000;378700000;430900000;765400000;;1666100000;375900000;;11955600000;12331500000;13997600000;523200000;236700000;1234700000;3016600000;4244300000;5479000000;7348900000;-256800000;1134600000;8518600000;13997600000
FIS;88558;USD;2008;Q4;2008-12-31;2009-08-05;189800000;191100000;220900000;513000000;;1166200000;272600000;;6061600000;6334200000;7500400000;386200000;105500000;816500000;2409000000;2986900000;3803400000;2961800000;-402800000;1076100000;3697000000;7500400000
FIS;88558;USD;2017;Q4;2017-12-31;2018-02-22;331000000;341000000;665000000;1624000000;;3688000000;610000000;;20228000000;20838000000;24526000000;1241000000;1045000000;4011000000;7718000000;9695000000;13706000000;10538000000;-3604000000;4109000000;10820000000;24526000000
FIS;88558;USD;2018;Q4;2018-12-31;2019-02-21;325000000;330000000;703000000;1472000000;;3733000000;587000000;;19450000000;20037000000;23770000000;1099000000;315000000;3125000000;8670000000;10423000000;13548000000;10804000000;-4687000000;4528000000;10222000000;23770000000
PPSI;88673;USD;2017;Q4;2017-12-31;2018-04-02;8728000;8663000;218000;13432000;23192000;47461000;6335000;;20459000;26794000;74255000;18870000;24026000;46752000;4153000;9954000;56706000;23810000;;-463000;17549000;74255000
PPSI;88673;USD;2016;Q4;2016-12-31;2017-03-29;8700000;8677000;246000;14266000;22279000;46188000;5925000;;25295000;31220000;77408000;16569000;23041000;43740000;4005000;7469000;51209000;23224000;;8838000;26199000;77408000
PPSI;88673;USD;2015;Q4;2015-12-31;2016-03-31;8704000;8704000;648000;14223000;17663000;35034000;7349000;;24493000;31842000;66876000;22190000;15911000;38101000;165000;1381000;39482000;23162000;;9901000;27394000;66876000
PPSI;88673;USD;2014;Q4;2014-12-31;2015-04-02;7224000;7028000;3832000;13101000;14429000;33507000;11195000;;28136000;39331000;72838000;14919000;9343000;24262000;9539000;17742000;42004000;18377000;;15782000;30834000;72838000
PPSI;88673;USD;2013;Q4;2013-12-31;2014-03-14;7187000;7266000;425000;9739000;12643000;26145000;12213000;;15503000;27716000;53861000;9442000;2903000;12345000;7205000;10724000;23069000;16171000;;16050000;30792000;53861000
PPSI;88673;USD;2012;Q4;2012-12-31;2013-04-01;5907000;5922000;467000;10579000;14912000;27522000;10937000;;13719000;24656000;52178000;13179000;7335000;20639000;9795000;13624000;34263000;8071000;;10780000;17915000;52178000
PPSI;88673;USD;2011;Q4;2011-12-31;2012-03-30;23610279;23778083;1398000;8172000;13711000;25429000;9983000;;13426000;23409000;48838000;11761000;8870000;21185000;9015000;12885000;34070000;7801000;;7790000;14768000;48838000
PPSI;88673;USD;2010;Q4;2010-12-31;2011-09-14;5905;5979;516000;5263000;7193000;16934000;4588000;;10581000;15169000;32103000;7489000;6063000;14376000;17000;2635000;17011000;7547000;;7850000;15092000;32103000
PPSI;88673;USD;2018;Q4;2018-12-31;2019-03-29;8726000;8718000;200000;3384000;3678000;46924000;878000;;24709000;25587000;72511000;9124000;21929000;52415000;2619000;8145000;60560000;23975000;;-6127000;11951000;72511000
MCO;88874;USD;2017;Q4;2017-12-31;2018-02-27;191200000;194600000;1183300000;1147200000;;2580600000;325100000;;5688500000;6013600000;8594200000;750300000;429400000;2063300000;5111100000;6645800000;8709100000;532000000;-8152900000;7465400000;-114900000;8594200000
MCO;88874;USD;2016;Q4;2016-12-31;2016-10-24;190700000;193600000;2224900000;887400000;;3253100000;325900000;;1748300000;2074200000;5327300000;1444300000;300000000;2428200000;3063000000;3926400000;6354600000;480600000;-8029600000;6688900000;-1027300000;5327300000
MCO;88874;USD;2015;Q4;2015-12-31;2016-02-25;197000000;200200000;2232200000;802000000;;3243100000;306400000;;1553500000;1859900000;5103000000;566600000;;1218500000;3380600000;4217500000;5436000000;454700000;-7389200000;6709000000;-333000000;5103000000
MCO;88874;USD;2014;Q4;2014-12-31;2015-02-26;206400000;210400000;1677600000;792400000;;2686400000;302300000;;1680300000;1982600000;4669000000;557600000;;1199700000;2547300000;3426400000;4626100000;387300000;-6384200000;6044300000;42900000;4669000000
MCO;88874;USD;2013;Q4;2013-12-31;2014-02-27;214200000;218600000;2106300000;694200000;;2968800000;278700000;;1147600000;1426300000;4395100000;538900000;;1141300000;2101800000;2825900000;3967200000;409200000;-5319700000;5302100000;427900000;4395100000
MCO;88874;USD;2012;Q4;2012-12-31;2013-02-26;223000000;225700000;1773300000;621800000;;2525700000;307100000;;1128100000;1435200000;3960900000;555300000;63800000;1164900000;1607400000;2327100000;3492000000;368500000;-4614500000;4713300000;468900000;3960900000
MCO;88874;USD;2011;Q4;2011-12-31;2012-02-27;222100000;225700000;774800000;489800000;;1424400000;326800000;;1124900000;1451700000;2876100000;452300000;71300000;1134000000;1172500000;1840000000;2974000000;397900000;-4635500000;4176100000;-97900000;2876100000
MCO;88874;USD;2010;Q4;2010-12-31;2011-02-28;233500000;235100000;672300000;497500000;;1343000000;319300000;;878000000;1197300000;2540300000;414400000;11300000;933800000;1228300000;1904900000;2838700000;394900000;-4407300000;3736200000;-298400000;2540300000
MCO;88874;USD;2009;Q4;2009-12-31;2010-03-01;236500000;238400000;483900000;444900000;;1012900000;293000000;;697400000;990400000;2003300000;317200000;447500000;1236000000;746200000;1363400000;2599400000;394500000;-4288500000;3329000000;-596100000;2003300000
MCO;88874;USD;2008;Q4;2008-12-31;2009-08-14;236400000;237500000;253000000;421800000;;809100000;247700000;;716600000;964300000;1773400000;240400000;104700000;1393100000;750000000;1366400000;2759500000;396100000;-4361600000;3023200000;-986100000;1773400000
MCO;88874;USD;2018;Q4;2018-12-31;2019-02-25;191300000;194200000;1817500000;1287100000;;3386900000;320400000;;5818900000;6139300000;9526200000;695200000;449900000;2098500000;5226100000;6771200000;8869700000;604300000;-8312500000;8594400000;656500000;9526200000
ATU;89259;USD;2017;Q4;2017-08-31;2017-10-26;59729000;57580000;229571000;190206000;143651000;646926000;94521000;;775508000;870029000;1516955000;190406000;30000000;378934000;531940000;637482000;1016416000;154489000;-617731000;1191042000;500539000;1516955000
ATU;89259;USD;2016;Q4;2016-08-31;2016-10-28;58939000;57747000;179604000;186829000;130756000;542652000;114015000;;781993000;896008000;1438660000;171206000;18750000;241912000;561681000;675798000;917710000;130859000;-617731000;1259645000;520950000;1438660000
ATU;89259;USD;2015;Q4;2015-08-31;2015-10-28;59315000;60619000;168846000;193081000;142752000;560389000;142458000;;934070000;1076528000;1636917000;176627000;3969000;235056000;584309000;728860000;963916000;120095000;-600630000;1367176000;673001000;1636917000
ATU;89259;USD;2014;Q4;2014-08-31;2014-10-27;68024000;69390000;109012000;227008000;162620000;542990000;169101000;;1144788000;1313889000;1856879000;237109000;4500000;299121000;385500000;556047000;855168000;109144000;-388627000;1349602000;1001711000;1856879000
ATU;89259;USD;2013;Q4;2013-08-31;2013-10-25;73046000;74846000;103986000;219075000;142549000;785240000;201496000;;1132596000;1334092000;2119332000;211863000;0;321842000;515000000;717223000;1039065000;65157000;-104915000;1188685000;1080267000;2119332000
ATU;89259;USD;2012;Q4;2012-08-31;2012-10-26;72828000;74142000;68184000;234756000;211690000;561281000;115884000;;1329954000;1445838000;2007119000;239341000;7500000;319006000;390000000;636277000;955283000;22827000;-63083000;1161564000;1051836000;2007119000
ATU;89259;USD;2011;Q4;2011-08-31;2011-10-28;68392000;75278000;44221000;223760000;223235000;548853000;128649000;;1385715000;1514364000;2063217000;261065000;2690000;330525000;522727000;813679000;1144204000;-140500000;;1077192000;919013000;2063217000
ATU;89259;USD;2010;Q4;2010-08-31;2011-01-07;67717000;74367000;40222000;185693000;146154000;460150000;108382000;;1053171000;1161553000;1621703000;201166000;;313422000;367380000;568560000;881982000;-161547000;;968373000;739721000;1621703000
ATU;89259;USD;2018;Q4;2018-08-31;2018-10-29;60892000;59773000;250490000;187749000;156356000;660900000;90220000;;730218000;820438000;1481338000;189437000;30000000;330961000;502695000;591665000;922626000;183733000;-617731000;1166955000;558712000;1481338000
PKE;89458;USD;2017;Q4;2018-02-28;2018-05-11;20240000;20313000;108231000;6961000;3955000;141268000;9805000;;21987000;31792000;173060000;4303000;;12227000;;25572000;37799000;169011000;-14878000;-21099000;135261000;173060000
PKE;89458;USD;2016;Q4;2017-02-28;2017-05-12;20235000;20251000;238590000;17238000;11105000;269130000;18638000;;20810000;39448000;308578000;10623000;3500000;14123000;68500000;111629000;125752000;169708000;-15020000;27112000;182826000;308578000
PKE;89458;USD;2015;Q4;2016-02-29;2016-05-13;20252000;20250000;237425000;22583000;10214000;272185000;21512000;;21080000;42592000;314777000;13678000;3000000;16678000;72000000;117232000;133910000;168494000;-15020000;25922000;180867000;314777000
PKE;89458;USD;2014;Q4;2015-02-28;2015-05-15;20896000;20938000;272133000;21431000;14439000;313259000;26537000;;10886000;37423000;350682000;15790000;10000000;29724000;84000000;139359000;169083000;166915000;-2832000;16048000;181599000;350682000
PKE;89458;USD;2013;Q4;2014-02-28;2014-05-16;20875000;20783000;270356000;22881000;13871000;311240000;29674000;;36179000;65853000;377093000;14243000;10000000;24243000;94000000;152307000;176550000;163765000;-94000;35651000;200543000;377093000
PKE;89458;USD;2012;Q4;2013-02-28;2012-10-04;20807000;20821000;275216000;25878000;12918000;320674000;32187000;;16797000;48984000;369658000;16678000;;16678000;52000000;53058000;69736000;160873000;-94000;138514000;299922000;369658000
PKE;89458;USD;2011;Q4;2012-02-29;2012-05-10;20766000;20816000;268785000;23533000;15823000;311590000;38695000;;15703000;54398000;365988000;21441000;;21441000;;1336000;22777000;159194000;-1000;181941000;343211000;365988000
PKE;89458;USD;2010;Q4;2011-02-28;2011-10-06;20682000;20777000;250444000;29822000;12888000;296959000;41292000;;15557000;56849000;353808000;25253000;;25253000;;3247000;28500000;156531000;-1000;166795000;325308000;353808000
PKE;89458;USD;2018;Q4;2019-02-28;2019-05-20;40611747;40871618;151624000;9352000;5267000;167933000;10791000;;10127000;20918000;188851000;11155000;;11155000;0;18685000;29840000;171491000;-9853000;-2605000;159011000;188851000
TRIP;89539;USD;2016;Q4;2016-12-31;2017-02-17;144917000;146392000;730000000;189000000;;950000000;260000000;16000000;1012000000;1288000000;2238000000;279000000;80000000;423000000;91000000;313000000;736000000;831000000;-197000000;945000000;1502000000;2238000000
TRIP;89539;USD;2015;Q4;2015-12-31;2016-02-18;144357000;146209000;661000000;180000000;;865000000;247000000;37000000;979000000;1263000000;2128000000;247000000;1000000;312000000;200000000;404000000;716000000;741000000;-92000000;826000000;1412000000;2128000000
TRIP;89539;USD;2014;Q4;2014-12-31;2015-02-17;142942000;145682000;563000000;151000000;;737000000;195000000;31000000;985000000;1211000000;1948000000;246000000;78000000;381000000;259000000;442000000;823000000;673000000;-145000000;628000000;1125000000;1948000000
TRIP;89539;USD;2013;Q4;2013-12-31;2014-02-11;142132000;145279000;482000000;113000000;;630000000;82000000;188000000;573000000;843000000;1473000000;131000000;68000000;243000000;300000000;365000000;608000000;608000000;-145000000;402000000;865000000;1473000000
TRIP;89539;USD;2012;Q4;2012-12-31;2013-02-15;142474000;143812000;486485000;81459000;;632494000;43802000;99248000;523650000;666700000;1299194000;91932000;72145000;195640000;340000000;376586000;572226000;531399000;;196438000;726968000;1299194000
TRIP;89539;USD;2011;Q4;2011-12-31;2012-03-15;133461000;139077000;183532000;67936000;;278322000;34754000;0;522810000;557564000;835886000;60401000;46734000;126530000;380000000;411956000;538486000;293878000;;2369000;297400000;835886000
TRIP;89539;USD;2010;Q4;2010-12-31;2012-03-15;;;113430000;51150000;;176801000;30744000;;515344000;546088000;722889000;128791000;1779000;142689000;0;40568000;183257000;541561000;;0;539632000;722889000
TRIP;89539;USD;2017;Q4;2017-12-31;2018-02-21;138897000;136738000;708000000;230000000;;993000000;263000000;27000000;989000000;1279000000;2272000000;305000000;7000000;372000000;230000000;537000000;909000000;926000000;-447000000;926000000;1363000000;2272000000
TRIP;89539;USD;2018;Q4;2018-12-31;2019-02-22;137747000;141046000;670000000;212000000;;915000000;253000000;;999000000;1252000000;2167000000;330000000;;393000000;;303000000;696000000;1037000000;-547000000;1043000000;1471000000;2167000000
JNJ;89661;USD;2016;Q4;2017-01-31;2017-02-27;2715000000;2780600000;41907000000;11699000000;8144000000;65032000000;15912000000;;60264000000;76176000000;141208000000;21603000000;4684000000;26287000000;22442000000;44503000000;70790000000;3120000000;-28352000000;110551000000;70418000000;141208000000
JNJ;89661;USD;2015;Q4;2016-01-31;2015-10-30;2763900000;2806400000;38376000000;10734000000;8053000000;60210000000;15905000000;;57296000000;73201000000;133411000000;20743000000;7004000000;27747000000;12857000000;34514000000;62261000000;3120000000;-22684000000;103879000000;71150000000;133411000000
JNJ;89661;USD;2014;Q4;2015-01-31;2014-10-30;2793200000;2842400000;33089000000;10985000000;8184000000;55744000000;16126000000;;58488000000;74614000000;130358000000;21393000000;3638000000;25031000000;15122000000;35575000000;60606000000;3120000000;-19891000000;97245000000;69752000000;130358000000
JNJ;89661;USD;2013;Q4;2014-01-31;2013-11-04;2818500000;2875000000;29206000000;11713000000;7878000000;56407000000;16710000000;;59566000000;76276000000;132683000000;20823000000;4852000000;25675000000;13328000000;32955000000;58630000000;3120000000;-15700000000;89493000000;74053000000;132683000000
JNJ;89661;USD;2012;Q4;2013-01-31;2012-11-09;2771500000;2859200000;21089000000;11309000000;7495000000;46116000000;16097000000;;59134000000;75231000000;121347000000;19586000000;4676000000;24262000000;11489000000;32259000000;56521000000;3120000000;-18476000000;85992000000;64826000000;121347000000
JNJ;89661;USD;2011;Q4;2012-01-31;2011-11-08;2728100000;2769000000;32261000000;10581000000;6285000000;54316000000;14739000000;;44589000000;59328000000;113644000000;16153000000;6658000000;22811000000;12969000000;33753000000;56564000000;3120000000;-21659000000;81251000000;57080000000;113644000000
JNJ;89661;USD;2010;Q4;2011-01-31;2010-11-10;2742000000;2775500000;27658000000;9774000000;5378000000;47307000000;14553000000;;41048000000;55601000000;102908000000;15455000000;7617000000;23072000000;9156000000;23257000000;46329000000;3120000000;-20783000000;77773000000;56579000000;102908000000
JNJ;89661;USD;2009;Q4;2010-01-31;2009-11-04;2759600000;2791600000;19425000000;9646000000;5180000000;39541000000;14759000000;;40382000000;55141000000;94682000000;15413000000;6318000000;21731000000;8223000000;22363000000;44094000000;3120000000;-19780000000;70306000000;50588000000;94682000000
JNJ;89661;USD;2008;Q4;2009-01-31;2009-08-04;2774300000;2799000000;12809000000;9719000000;5052000000;34377000000;14365000000;;36170000000;50535000000;84912000000;17120000000;3732000000;20852000000;8120000000;21549000000;42401000000;3120000000;-19033000000;63379000000;42511000000;84912000000
JNJ;89661;USD;2017;Q4;2018-01-31;2018-02-21;2684900000;2747500000;18296000000;13490000000;8765000000;43088000000;17005000000;;97210000000;114215000000;157303000000;26631000000;3906000000;30537000000;30675000000;66606000000;97143000000;3120000000;-31554000000;101793000000;60160000000;157303000000
JNJ;89661;USD;2018;Q4;2019-01-31;2019-02-20;2678300000;2734000000;19687000000;14098000000;8599000000;45083000000;17035000000;;90836000000;107871000000;152954000000;28434000000;2796000000;31230000000;27684000000;61972000000;93202000000;3120000000;-34362000000;106216000000;59752000000;152954000000
DHR;89750;USD;2016;Q4;2016-12-31;2017-02-22;693100000;701900000;963700000;3186100000;1709400000;6665100000;2354000000;;36276200000;38630200000;45295300000;4279200000;2594800000;6874000000;9674200000;15344500000;22218500000;5321000000;;20703500000;23076800000;45295300000
DHR;89750;USD;2015;Q4;2015-12-31;2016-02-24;461603200;467734700;790800000;2985100000;1573100000;7836700000;2302700000;;38082800000;40385500000;48222200000;4001300000;845200000;6170400000;12025200000;18287800000;24458200000;4989200000;;21012300000;23764000000;48222200000
DHR;89750;USD;2014;Q4;2014-12-31;2015-02-25;33755900;33034600;3005600000;3445800000;1782800000;9431300000;2171900000;;25388500000;27560400000;36991700000;5016500000;71900000;5396400000;3401500000;8145500000;13541900000;4488800000;;20323000000;23449800000;36991700000
DHR;89750;USD;2013;Q4;2013-12-31;2014-02-21;922112900;941634100;3115200000;3451600000;1783500000;9113700000;2211300000;;23347200000;25558500000;34672200000;4465100000;62300000;4527400000;3436700000;7693400000;12220800000;4165500000;;18005300000;22451400000;34672200000
DHR;89750;USD;2012;Q4;2012-12-31;2013-02-22;911824700;935962400;1678700000;3267300000;1813400000;7587800000;2140900000;;23212300000;25353200000;32941000000;4150600000;55500000;4206100000;5287600000;9651000000;13857100000;3695800000;;15379900000;19083900000;32941000000
DHR;89750;USD;2011;Q4;2011-12-31;2012-02-24;908441465;938428930;537000000;3049900000;1781400000;6272400000;2101000000;;21576100000;23677100000;29949500000;4073600000;98400000;4172000000;5206800000;8805700000;12977700000;3884800000;;13056900000;16971800000;29949500000
DHR;89750;USD;2010;Q4;2010-12-31;2011-02-24;866259845;906560571;1632980000;2097974000;1165623000;6065455000;1129781000;;15021894000;16151675000;22217130000;3279941000;40761000;3320702000;2783907000;5123662000;8444364000;2419696000;;10945928000;13772766000;22217130000
DHR;89750;USD;2017;Q4;2017-12-31;2018-02-21;697300000;707700000;630300000;3521800000;1840800000;6850000000;2454600000;;37344000000;39798600000;46648600000;4597600000;194700000;4792300000;10327400000;15488500000;20280800000;5546300000;;22806100000;26367800000;46648600000
DHR;89750;USD;2018;Q4;2018-12-31;2019-02-21;702200000;711200000;787800000;3489600000;1910100000;7093800000;2511200000;;38227500000;40738700000;47832500000;4789700000;51800000;4841500000;9688500000;14764300000;19605800000;5842500000;;25163000000;28226700000;47832500000
EBF;90209;USD;2016;Q4;2017-02-28;2016-05-11;25587856;25592017;80466000;37368000;27965000;149250000;49995000;;125040000;175035000;324285000;14427000;;29968000;30000000;42962000;72930000;196659000;-80728000;150685000;251355000;324285000
EBF;90209;USD;2015;Q4;2016-02-29;2016-05-11;25819642;25869013;7957000;36546000;27619000;175841000;50791000;;163412000;214203000;390044000;13974000;;40400000;40000000;51098000;91498000;196731000;-77005000;206105000;298546000;390044000
EBF;90209;USD;2014;Q4;2015-02-28;2015-05-08;25740340;25713985;15346000;62865000;119814000;216542000;92875000;;143845000;236720000;453262000;21931000;;40247000;106500000;128335000;168582000;196821000;-78357000;188413000;284680000;453262000
EBF;90209;USD;2013;Q4;2014-02-28;2014-05-09;26234758;26243915;5316000;63695000;130095000;214143000;91565000;;230639000;322204000;536347000;22845000;;41877000;105500000;131535000;173412000;197651000;-73440000;251137000;362935000;536347000
EBF;90209;USD;2012;Q4;2013-02-28;2013-05-10;26161338;26172875;6232000;60071000;109698000;193416000;91913000;;209963000;301876000;495292000;23459000;;43039000;57500000;91037000;134076000;197320000;-72914000;251713000;361216000;495292000
EBF;90209;USD;2011;Q4;2012-02-29;2012-05-11;25992976;26005396;10410000;58790000;132572000;219210000;99516000;;213236000;312752000;531962000;29654000;;50241000;90000000;121846000;172087000;196524000;-73726000;249862000;359875000;531962000
EBF;90209;USD;2010;Q4;2011-02-28;2011-09-30;25902649;25898162;12305000;58359000;100363000;182398000;93661000;;197669000;291330000;473728000;22388000;586000;47098000;50000000;78947000;126045000;196440000;-74945000;234636000;347683000;473728000
EBF;90209;USD;2017;Q4;2018-02-28;2018-05-11;25441937;25472706;96230000;35654000;26480000;163344000;45908000;;120187000;166095000;329439000;12303000;;29571000;30000000;38164000;67735000;196467000;-82512000;164177000;261704000;329439000
EBF;90209;USD;2018;Q4;2019-02-28;2019-05-06;26123983;26117000;88442000;40357000;35411000;166165000;53134000;;143786000;196920000;363085000;31623000;;31623000;30000000;42335000;73958000;198199000;-71371000;179003000;289127000;363085000
CCF;90312;USD;2017;Q4;2017-08-31;2017-11-09;9264794;9411531;47354000;38051000;25618000;114135000;34760000;;105843000;140603000;254738000;27340000;;27340000;;16469000;43809000;14995000;;209403000;210929000;254738000
CCF;90312;USD;2016;Q4;2016-08-31;2016-11-14;9199095;9289616;73411000;34835000;25814000;138849000;36742000;;87228000;123970000;262819000;25114000;43400000;68514000;;20216000;88730000;15647000;;173921000;174089000;262819000
CCF;90312;USD;2015;Q4;2015-08-31;2015-11-16;9135011;9323482;43819000;39488000;29476000;116046000;40921000;;98675000;139596000;255642000;29116000;8400000;37516000;43400000;63784000;101300000;15215000;;147113000;154342000;255642000
CCF;90312;USD;2014;Q4;2014-08-31;2014-11-14;8977147;9181135;53222000;35601000;31539000;125853000;44085000;;75607000;119692000;245545000;29094000;7000000;36094000;51800000;71961000;108055000;14530000;;126272000;137490000;245545000
CCF;90312;USD;2013;Q4;2013-08-31;2013-11-14;8873726;9066088;29997000;32084000;32048000;99975000;45192000;;79193000;124385000;224360000;26794000;5600000;32394000;58800000;78106000;110500000;14243000;;103734000;113860000;224360000
CCF;90312;USD;2012;Q4;2012-08-31;2012-11-14;8766853;8796621;15180000;31621000;32323000;83142000;49279000;;82411000;131690000;214832000;24675000;5600000;30275000;64400000;84912000;115187000;13009000;;90146000;99645000;214832000
CCF;90312;USD;2011;Q4;2011-08-31;2012-01-09;8736852;8765192;14982000;19103000;20841000;57991000;28594000;;42324000;70918000;128909000;15524000;4400000;19924000;8267000;17105000;37029000;11573000;;83973000;91880000;128909000
CCF;90312;USD;2018;Q4;2018-08-31;2018-11-27;9308845;9377367;34828000;44610000;39699000;126232000;32845000;;157392000;190237000;316469000;28935000;;28935000;25000000;40778000;69713000;14043000;;245049000;246756000;316469000
LULU;90670;USD;2016;Q4;2017-01-31;2017-03-29;137061000;137246000;734846000;9200000;298432000;1162737000;423499000;;71305000;494804000;1657541000;171536000;;241990000;;55578000;297568000;267259000;;1294214000;1359973000;1657541000
LULU;90670;USD;2015;Q4;2016-01-31;2016-03-30;137839000;138002000;501482000;13108000;284009000;917039000;349605000;;47433000;397038000;1314077000;167768000;;225504000;;61091000;286595000;246170000;;1019515000;1027482000;1314077000
LULU;90670;USD;2014;Q4;2015-01-31;2015-03-26;141997000;142346000;664479000;13746000;208116000;951012000;296008000;;49193000;345201000;1296213000;113629000;;159881000;;46764000;206645000;242356000;;1020619000;1089568000;1296213000
LULU;90670;USD;2013;Q4;2014-01-31;2014-03-27;145232000;146393000;698649000;11903000;188790000;945539000;255603000;;51246000;306849000;1252388000;77871000;;116214000;;39492000;155706000;240928000;;923822000;1096682000;1252388000
LULU;90670;USD;2012;Q4;2013-01-31;2013-03-21;144293000;146161000;590179000;6351000;155222000;787053000;214639000;;49386000;264025000;1051078000;98244000;;133357000;;30422000;163779000;221934000;;644275000;887299000;1051078000
LULU;90670;USD;2011;Q4;2012-01-31;2012-03-22;143491000;145625000;409437000;5202000;104097000;527093000;162941000;;44600000;207541000;734634000;80666000;;103439000;;25014000;128453000;206108000;;373719000;606181000;734634000
LULU;90670;USD;2010;Q4;2011-01-31;2011-03-17;142166000;145098000;316286000;9116000;57469000;389279000;70954000;;39069000;110023000;499302000;67196000;;85364000;;19645000;105009000;180404000;;189656000;394293000;499302000
LULU;90670;USD;2009;Q4;2010-01-31;2010-09-10;140778000;143038000;159573000;8238000;44070000;216410000;61591000;;29257000;90848000;307258000;46979000;;58678000;;15472000;74150000;159432000;;67809000;233108000;307258000
LULU;90670;USD;2017;Q4;2018-01-31;2018-03-27;135380000;135719000;990501000;19173000;329562000;1436282000;473642000;;88559000;562201000;1998483000;209930000;;292598000;;108925000;401523000;284881000;;1455002000;1596960000;1998483000
LULU;90670;USD;2018;Q4;2019-01-31;2019-03-27;131758000;132346000;881320000;35786000;404842000;1429282000;567237000;;88192000;655429000;2084711000;288367000;;500477000;;138259000;638736000;315893000;;1346890000;1445975000;2084711000
WFM;90839;USD;2017;Q4;2017-09-30;2017-11-17;;;826000000;242000000;471000000;2145000000;3514000000;121000000;896000000;4531000000;6676000000;768000000;2000000;1355000000;1081000000;1891000000;3246000000;2972000000;;496000000;3430000000;6676000000
WFM;90839;USD;2016;Q4;2016-09-30;2016-11-18;322100000;322800000;730000000;242000000;517000000;1975000000;3442000000;;924000000;4366000000;6341000000;757000000;3000000;1341000000;1048000000;1776000000;3117000000;2933000000;-2026000000;2349000000;3224000000;6341000000
WFM;90839;USD;2015;Q4;2015-09-30;2015-11-13;355400000;356800000;392000000;218000000;500000000;1544000000;3163000000;63000000;971000000;4197000000;5741000000;776000000;3000000;1252000000;62000000;720000000;1972000000;2904000000;-1124000000;2017000000;3769000000;5741000000
WFM;90839;USD;2014;Q4;2014-09-30;2014-11-21;362400000;364500000;743000000;198000000;441000000;1756000000;2923000000;120000000;945000000;3988000000;5744000000;698000000;2000000;1257000000;60000000;674000000;1931000000;2863000000;-711000000;1668000000;3813000000;5744000000
WFM;90839;USD;2013;Q4;2013-09-30;2013-11-22;372100000;375400000;1023000000;188000000;414000000;1980000000;2428000000;302000000;828000000;3558000000;5538000000;651000000;1000000;1088000000;26000000;572000000;1660000000;2765000000;-153000000;1265000000;3878000000;5538000000
WFM;90839;USD;2012;Q4;2012-09-30;2012-11-21;368300000;371600000;1220000000;197000000;374000000;2103000000;2193000000;221000000;777000000;3191000000;5294000000;580000000;1000000;977000000;23000000;515000000;1492000000;2592000000;-28000000;1233000000;3802000000;5294000000
WFM;90839;USD;2011;Q4;2011-09-30;2011-11-23;354150000;357968000;654324000;175310000;336799000;1453144000;1997212000;52815000;788904000;2838931000;4292075000;536327000;466000;879361000;17439000;421409000;1300770000;2120972000;0;870497000;2991305000;4292075000
WFM;90839;USD;2010;Q4;2010-09-30;2010-11-24;336034000;375110000;461734000;133346000;323487000;1161519000;1886130000;96146000;842745000;2825021000;3986540000;457639000;410000;747872000;508288000;865410000;1613282000;1773897000;;598570000;2373258000;3986540000
WFM;90839;USD;2009;Q4;2009-09-30;2010-08-13;281002000;281002000;430130000;104731000;310602000;1055380000;1897853000;;830155000;2728008000;3783388000;405797000;389000;684024000;738848000;1471488000;2155512000;1283028000;;358215000;1627876000;3783388000
FDS;91248;USD;2017;Q4;2017-08-31;2017-10-30;39143000;39311000;227175000;148331000;;409377000;100454000;;903485000;1003939000;1413316000;151262000;;201139000;575000000;652485000;853624000;742266000;-1606678000;1458823000;559691000;1413315000
FDS;91248;USD;2016;Q4;2016-08-31;2016-10-31;40237000;40672000;252624000;97797000;;369276000;84622000;;565263000;649885000;1019161000;124672000;;158210000;300000000;343570000;501780000;623707000;-1321700000;1283927000;517381000;1019161000
FDS;91248;USD;2015;Q4;2015-08-31;2015-11-02;41347000;41997000;182411000;95064000;;304174000;59264000;;373233000;432497000;736671000;100730000;;139780000;35000000;65307000;205087000;542858000;-988873000;1021651000;531584000;736671000
FDS;91248;USD;2014;Q4;2014-08-31;2014-10-30;41897000;42385000;136386000;90354000;;249775000;57641000;;355796000;413437000;663212000;90787000;;127291000;0;24839000;152130000;414245000;-734746000;849504000;511082000;663212000
FDS;91248;USD;2013;Q4;2013-08-31;2013-10-30;43477000;44572000;209352000;73290000;;318034000;65371000;;306792000;372163000;690197000;88934000;;120649000;;27769000;148418000;327350000;-454917000;700519000;541779000;690197000
FDS;91248;USD;2012;Q4;2012-08-31;2012-10-30;44358000;45694000;202963000;74251000;;299125000;76530000;;318488000;395018000;694143000;82681000;;113176000;;28703000;141879000;138025000;-122749000;559714000;552264000;694143000
FDS;91248;USD;2011;Q4;2011-08-31;2011-10-31;45334000;47352000;181685000;75004000;;273170000;81620000;;302650000;384270000;657440000;81171000;;109423000;;32829000;142252000;433152000;-824382000;912078000;515188000;657440000
FDS;91248;USD;2010;Q4;2010-08-31;2011-01-10;46175000;47349000;195741000;59693000;;265145000;79495000;;299968000;379463000;644608000;84242000;;109276000;;32926000;142202000;344745000;-607798000;786844000;502406000;644608000
FDS;91248;USD;2018;Q4;2018-08-31;2018-04-09;38262000;38878000;237882000;156639000;;430916000;100545000;;887986000;988531000;1419447000;171434000;;221134000;574775000;672413000;893547000;667924000;-213428000;122843000;525900000;1419447000
HELE;91621;USD;2017;Q4;2018-02-28;2018-04-30;25577000;25532000;20738000;275565000;251511000;557708000;123503000;;942506000;1066009000;1623717000;297602000;1884000;299486000;287985000;309772000;609258000;233334000;;780494000;1014459000;1623717000
HELE;91621;USD;2016;Q4;2017-02-28;2016-04-29;28008000;28288000;23848000;229416000;280877000;556078000;126502000;;1130516000;1257018000;1813096000;253750000;24404000;289367000;461211000;502963000;792330000;221463000;;798130000;1020766000;1813096000
HELE;91621;USD;2015;Q4;2016-02-29;2015-04-29;28425000;28931000;225800000;217543000;301609000;755088000;130465000;;963341000;1093806000;1848894000;244958000;22644000;267602000;597270000;651249000;918851000;200851000;;728527000;930043000;1848894000
HELE;91621;USD;2014;Q4;2015-02-28;2014-04-29;32080000;32610000;70027000;213054000;289255000;615476000;129117000;;788709000;917826000;1533302000;232273000;96900000;329354000;95707000;174461000;503815000;184088000;;846490000;1029487000;1533302000
HELE;91621;USD;2013;Q4;2014-02-28;2013-04-29;31799000;32088000;12842000;219719000;280872000;545205000;101716000;;827083000;928799000;1474004000;206326000;20000000;308665000;155000000;238733000;547398000;167658000;;761677000;926606000;1474004000
HELE;91621;USD;2012;Q4;2013-02-28;2012-04-30;31619000;31763000;21846000;195283000;246142000;488536000;100690000;;846497000;947187000;1435723000;201829000;3000000;378889000;175000000;260105000;638994000;154174000;;648144000;796729000;1435723000
HELE;91621;USD;2011;Q4;2012-02-29;2011-10-07;30756000;31541000;27193000;188404000;217230000;460451000;82487000;;697586000;780073000;1240524000;214941000;53000000;338941000;178000000;216034000;554975000;133099000;;560300000;685549000;1240524000
HELE;91621;USD;2018;Q4;2019-02-28;2019-04-29;25355000;25675000;11871000;280280000;302339000;604859000;130338000;;914338000;1044676000;1649535000;310147000;1884000;312031000;318900000;340867000;652898000;249080000;;746366000;996637000;1649535000
P;91899;USD;2013;Q4;2013-12-31;2013-03-18;284709600;284709600;344417000;164023000;;518783000;35151000;105686000;13715000;154552000;673335000;113356000;;156006000;;9098000;165104000;675123000;;-166591000;508231000;673335000
P;91899;USD;2012;Q4;2012-12-31;2012-03-19;583407360;244159200;90581000;66738000;;160125000;15576000;;2314000;17890000;178015000;51675000;;70907000;;2568000;73475000;205971000;;-101426000;104540000;178015000
WNDW;92543;USD;2018;Q4;2018-08-31;2018-11-29;36303063;60229887;696826;;;889620;39614;;;39614;929234;93616;;93616;2936082;4460025;4553641;42259892;;-45884299;-3624407;929234
WNDW;92543;USD;2017;Q4;2017-08-31;2017-11-22;34156222;-32212849;670853;;;778755;52953;;;52953;831708;230184;;230184;3186623;4233000;4463184;35398276;;-39029752;-3631476;831708
WNDW;92543;USD;2016;Q4;2016-08-31;2016-11-21;28314903;-10214489;2509215;;;2874269;21331;;;21331;2895600;251144;18146;794588;1349880;2019124;2813712;33758215;;-33676327;81888;2895600
WNDW;92543;USD;2015;Q4;2015-08-31;2015-12-11;26062261;26062261;228465;;;355752;30535;;;30535;386287;540936;2120192;2661128;593484;593484;3254612;26170689;;-29039014;-2868325;386287
WNDW;92543;USD;2014;Q4;2014-08-31;2014-11-14;23677331;24307534;785237;;;949494;24597;;;24597;974091;337390;686320;1023710;0;0;1023710;20896651;;-20946270;-49619;974091
WNDW;92543;USD;2013;Q4;2013-08-31;2013-11-27;24252925;;347493;;;519872;13823;;;13823;533695;122356;0;122356;;0;122356;17465228;;-17053889;411339;533695
WNDW;92543;USD;2012;Q4;2012-08-31;2012-11-28;20638360;;1046918;;;1107746;19966;;;19966;1127712;89634;515;90149;;;90149;13818920;;-12781357;1037563;1127712
WNDW;92543;USD;2011;Q4;2011-08-31;2012-01-17;;;2320185;;;2545846;927;;;927;2546773;280877;0;280877;;;280877;12613822;;-10347926;2265896;2546773
ARO;93605;USD;2014;Q4;2015-01-31;2014-04-04;79122000;79122000;106517000;;172311000;376621000;235401000;;35619000;271020000;647641000;240361000;;240361000;;126588000;366949000;231988000;-1606000;51493000;280692000;647641000
ARO;93605;USD;2013;Q4;2014-01-31;2013-04-03;78492000;78492000;231501000;;155463000;439940000;262778000;;38126000;300904000;740844000;203506000;;203506000;;126974000;330480000;216850000;0;193324000;410364000;740844000
ARO;93605;USD;2012;Q4;2013-01-31;2012-03-28;78133000;78506000;223712000;;163522000;441799000;287393000;;6041000;293434000;735233000;193211000;;193211000;;132588000;325799000;207583000;-256589000;459279000;409434000;735233000
ARO;93605;USD;2011;Q4;2012-01-31;2011-06-03;80757000;81472000;265553000;;156596000;469565000;299242000;;4390000;303632000;773197000;216102000;;216102000;101504000;124458000;340560000;196308000;-152992000;389764000;432637000;773197000
ARO;93605;USD;2010;Q4;2011-01-31;2010-09-08;87461000;88599000;346976000;;132915000;530017000;251558000;;10734000;262292000;792309000;241840000;;241840000;;115980000;357820000;173186000;-654494000;922790000;434489000;792309000
LEDS;93692;USD;2018;Q4;2018-08-31;2018-11-26;3561000;3561000;3421000;282000;1818000;5861000;7213000;;1176000;8389000;14250000;6399000;335000;7234000;2013000;2013000;9247000;175527000;;-174251000;5003000;14250000
LEDS;93692;USD;2017;Q4;2017-08-31;2017-11-29;3582000;3582000;3582000;1111000;2946000;8044000;8275000;;1351000;9626000;17670000;6627000;335000;7462000;2391000;2391000;9853000;175386000;;-171270000;7817000;17670000
LEDS;93692;USD;2016;Q4;2016-08-31;2016-11-21;2990000;2990000;6030000;900000;4067000;11637000;8813000;;1785000;10598000;22235000;4087000;314000;4901000;2595000;5692000;10593000;175384000;;-167179000;11642000;22235000
LEDS;93692;USD;2015;Q4;2015-08-31;2015-12-15;2935100;2935100;4808000;2049000;5924000;13672000;20779000;;4069000;24848000;38520000;5247000;1068000;6315000;2839000;2839000;9154000;172117000;;-145904000;29366000;38520000
LEDS;93692;USD;2014;Q4;2014-08-31;2014-12-12;2845700;2845700;12649000;2171000;9212000;25941000;27063000;;4613000;31676000;57617000;7535000;1934000;9469000;4256000;4256000;13725000;170953000;;-132630000;43892000;57617000
LEDS;93692;USD;2013;Q4;2013-08-31;2013-11-26;2778400;2778400;36272000;2272000;10500000;50124000;30473000;;5108000;35581000;85705000;10359000;2294000;12704000;6169000;6508000;19212000;169114000;;-108155000;66493000;85705000
LEDS;93692;USD;2012;Q4;2012-08-31;2012-12-13;2748900;2748900;56059000;4916000;13016000;75121000;46642000;;5771000;52413000;127534000;12322000;967000;13340000;4953000;5343000;18683000;167070000;;-64431000;108851000;127534000
LEDS;93692;USD;2011;Q4;2011-08-31;2012-01-12;2750000;2696700;83619000;5480000;16217000;106858000;51804000;;19664000;71468000;178326000;12797000;981000;13829000;6105000;6546000;20375000;164370000;;-14974000;157951000;178326000
RHT;94011;USD;2018;Q4;2019-02-28;2019-04-24;176813000;181547000;2176457000;980188000;;3463656000;198969000;248512000;1677152000;2124633000;5588289000;491259000;69827000;2722574000;231540000;1251783000;3974357000;2791919000;-3189434000;2054069000;1613932000;5588289000
RHT;94011;USD;2017;Q4;2018-02-28;2018-04-26;177037000;187417000;2042490000;806744000;;3142097000;206105000;430442000;1695849000;2332396000;5474493000;427139000;23806000;2305507000;744194000;1690862000;3996369000;2416104000;-2525072000;1619688000;1478124000;5474493000
RHT;94011;USD;2016;Q4;2017-02-28;2017-04-26;177845000;181629000;1460791000;634821000;;2315702000;189629000;672440000;1357414000;2219483000;4535185000;376957000;0;1891073000;745633000;1396792000;3287865000;2294486000;-2311805000;1352991000;1247320000;4535185000
RHT;94011;USD;2015;Q4;2016-02-29;2016-04-26;182109000;185457000;1208920000;509715000;;1872433000;166886000;786470000;1329310000;2282666000;4155099000;284802000;;1559177000;723942000;1261490000;2820667000;2162287000;-1853144000;1099738000;1334432000;4155099000
RHT;94011;USD;2014;Q4;2015-02-28;2015-04-28;183543000;187098000;1262727000;468021000;;1883443000;172151000;546016000;1182959000;1901126000;3784569000;237733000;;1334033000;702939000;1162198000;2496231000;1963874000;-1515288000;900373000;1288338000;3784569000
RHT;94011;USD;2013;Q4;2014-02-28;2014-04-24;189615000;192378000;982129000;360594000;;1462918000;173917000;505300000;964484000;1643701000;3106619000;179468000;;1148086000;;407368000;1555454000;1891871000;-1056419000;720172000;1551165000;3106619000
RHT;94011;USD;2012;Q4;2013-02-28;2013-04-25;193203000;195818000;879465000;302942000;;1279984000;141586000;438908000;953182000;1533676000;2813660000;154202000;;985712000;;307787000;1293499000;1802922000;-816674000;541880000;1520161000;2813660000
RHT;94011;USD;2011;Q4;2012-02-29;2012-04-25;193119000;196878000;813515000;255180000;;1151590000;92065000;446838000;800606000;1339509000;2491099000;114078000;;826305000;;265977000;1092282000;1709105000;-696012000;391676000;1398817000;2491099000
RHT;94011;USD;2010;Q4;2011-02-28;2011-04-29;192927000;201678000;860600000;184741000;;1108838000;75558000;331791000;683135000;1090484000;2199322000;106514000;;679801000;;228822000;908623000;1610260000;-562792000;245050000;1290699000;2199322000
RHT;94011;USD;2009;Q4;2010-02-28;2010-10-08;187915000;193410000;760774000;139436000;;945168000;71708000;209411000;644585000;925704000;1870872000;84817000;;566267000;;193553000;759820000;1444870000;-472646000;137772000;1111052000;1870872000
SOTK;94282;USD;2017;Q4;2018-02-28;2018-05-24;14981715;15300920;6422364;774778;1354083;9087018;2555740;;136576;2692316;11779334;1630676;156119;2130893;870532;1255916;3386809;9051035;;-760115;8392525;11779334
SOTK;94282;USD;2016;Q4;2017-02-28;2016-05-25;15048567;15101823;4899407;1150801;1340684;7833339;2749271;;153326;2902597;10735936;1219935;149698;1448535;1026650;1364376;2812911;9009097;;-1128322;7923025;10735936
SOTK;94282;USD;2015;Q4;2016-02-29;2015-05-27;14807093;14715400;4084044;1214713;1945383;7509008;2986502;;174027;3160529;10669537;1308993;143388;1653859;1176349;1348068;3001927;8961778;;-1224028;7667610;10669537
SOTK;94282;USD;2014;Q4;2015-02-28;2014-05-28;14652889;14381650;3862815;860296;1674815;6558299;2959013;;261849;3220862;9779161;1250713;191466;1805025;1479058;1479058;3284083;8872968;;-2377890;6495078;9779161
SOTK;94282;USD;2013;Q4;2014-02-28;2013-05-22;14503780;14213566;2916816;941032;1829171;5766624;3067276;;232544;3299820;9066444;892096;125999;1086941;1987236;1987236;3074177;8854631;;-2862364;5992267;9066444
SOTK;94282;USD;2012;Q4;2013-02-28;2012-05-11;14445699;17608696;2785676;754605;2559128;6211801;3096850;;169622;3266472;9478273;1119961;120303;1556510;2114196;2114196;3670706;8802182;;-2994615;5807567;9478273
SOTK;94282;USD;2011;Q4;2012-02-29;2011-10-14;14441470;14359767;1932901;976339;1868144;4908788;2944385;;85692;3030077;7938865;1150832;62247;1586656;2035579;2035579;3622235;8743538;;-4426908;4316630;7938865
SOTK;94282;USD;2018;Q4;2019-02-28;2019-05-28;15193399;15176825;5509829;1397891;1658016;8960741;2784479;;454958;3239437;12200178;1224672;162816;2537046;707715;1078472;3615518;9081583;;-496923;8584660;12200178
MOS;94993;USD;2017;Q4;2017-12-31;2018-02-21;351000000;348900000;2153500000;642600000;1547200000;4616500000;9711700000;;4305200000;14016900000;18633400000;1681500000;349600000;2031100000;4878100000;6963200000;8994300000;48000000;;10631100000;9639100000;18633400000
MOS;94993;USD;2016;Q4;2016-12-31;2016-11-01;350400000;352300000;673100000;627800000;1391100000;3057700000;9198500000;;4584500000;13783000000;16840700000;1437900000;38900000;1476800000;3779300000;5741400000;7218200000;33400000;;10863400000;9622500000;16840700000
MOS;94993;USD;2015;Q4;2015-12-31;2016-02-19;352400000;354000000;1276300000;675000000;1563500000;4143400000;8721000000;;4525100000;13246100000;17389500000;1979800000;67200000;2047000000;3769500000;5777500000;7824500000;9900000;;11014800000;9565000000;17389500000
MOS;94993;USD;2014;Q4;2014-12-31;2015-02-17;336300000;;2374600000;754400000;1718300000;5215500000;9313900000;;3753600000;13067500000;18283000000;1542200000;54500000;1596700000;3778000000;5965700000;7562400000;7900000;;11168900000;10720600000;18283000000
MOS;94993;USD;2013;Q4;2013-12-31;2013-07-17;425400000;426800000;5293100000;543100000;1432900000;8105800000;8576600000;;2871600000;11448200000;19554000000;1236500000;23000000;3265900000;3008900000;4967500000;8233400000;5900000;;11182100000;11320600000;19554000000
MOS;94993;USD;2012;Q4;2012-12-31;2012-07-17;425200000;426600000;3811000000;751600000;1237600000;6581100000;7545900000;;2563400000;10109300000;16690400000;1812300000;43000000;1917700000;1010000000;2773300000;4691000000;1463800000;;10141300000;11999400000;16690400000
MOS;94993;USD;2011;Q4;2011-12-31;2011-07-19;446400000;448100000;3906400000;926000000;1266400000;6684900000;6635900000;;2466100000;9102000000;15786900000;1784700000;71600000;1928500000;761300000;2196500000;4125000000;2600800000;;8330600000;11661900000;15786900000
MOS;94993;USD;2010;Q4;2010-12-31;2010-10-29;445600000;446800000;2523000000;614800000;1002300000;4974800000;5465600000;;2267300000;7732900000;12707700000;1172200000;98300000;1303900000;1245600000;2655400000;3959300000;2527500000;;5905300000;8748400000;12707700000
MOS;94993;USD;2018;Q4;2018-12-31;2019-03-13;385700000;386800000;847700000;838500000;2270200000;4237000000;11746500000;;4135700000;15882200000;20119200000;2446200000;37500000;2483700000;4491500000;7030800000;9514500000;989700000;;11064700000;10604700000;20119200000
BHE;95106;USD;2015;Q4;2015-12-31;2016-02-29;50457000;51048000;465995000;479140000;411986000;1388628000;178170000;;327080000;505250000;1893878000;256232000;12284000;333094000;222909000;238880000;571974000;630015000;;704905000;1321904000;1893878000
BHE;95106;USD;2014;Q4;2014-12-31;2014-05-09;53016000;53941000;427376000;520389000;401261000;1378616000;190180000;;106552000;296732000;1675348000;295236000;676000;359078000;8845000;26645000;385723000;655015000;;644085000;1289625000;1675348000
BHE;95106;USD;2013;Q4;2013-12-31;2014-02-28;53762000;54855000;345555000;559763000;396699000;1342833000;185319000;9921000;119298000;314538000;1657371000;330523000;582000;398377000;9521000;31961000;430338000;649977000;-272000;586422000;1227033000;1657371000
BHE;95106;USD;2012;Q4;2012-12-31;2013-02-28;55019000;55457000;384579000;459081000;324041000;1214191000;176104000;10324000;100858000;287286000;1501477000;264450000;497000;330515000;10103000;31437000;361952000;656667000;-272000;493666000;1139525000;1501477000
BHE;95106;USD;2011;Q4;2011-12-31;2012-02-29;57443000;58164000;283920000;425936000;391580000;1201001000;163660000;24673000;110664000;298997000;1499998000;290895000;419000;351950000;10600000;32300000;384250000;680277000;-272000;449193000;1115748000;1499998000
BHE;95106;USD;2010;Q4;2010-12-31;2011-02-25;60754000;61465000;346345000;455930000;361570000;1214111000;127442000;35297000;100218000;262957000;1477068000;263268000;362000;322474000;11019000;35369000;357843000;713247000;-272000;413212000;1119225000;1477068000
BHE;95106;USD;2009;Q4;2009-12-31;2010-08-09;64167000;64846000;421243000;417268000;315743000;1198675000;126250000;45686000;95109000;267045000;1465720000;282364000;300000;339580000;11381000;35237000;374817000;739366000;-272000;356802000;1090903000;1465720000
BHE;95106;USD;2016;Q4;2016-12-31;2017-02-28;49056000;49932000;681433000;440692000;381334000;1531662000;166148000;;300858000;467006000;1998668000;329783000;12396000;412381000;211252000;220822000;633203000;631239000;;748402000;1365465000;1998668000
BHE;95106;USD;2017;Q4;2017-12-31;2018-03-01;49578000;48071000;742546000;436560000;397181000;1618670000;186473000;;292174000;478647000;2097317000;374363000;18274000;478316000;193406000;290182000;768498000;639106000;;697862000;1328819000;2097317000
BHE;95106;USD;2018;Q4;2018-12-31;2019-02-28;43059000;44017000;458102000;468161000;309975000;1403550000;210954000;;285279000;496233000;1899783000;432488000;6793000;537159000;147277000;230399000;767558000;559075000;;584274000;1132225000;1899783000
VIDE;95336;USD;2017;Q4;2018-02-28;2018-05-29;5887000;5884000;261000;664000;4584000;5765000;1463000;375000;424000;2262000;8027000;1931000;346000;3003000;421000;438000;3441000;7549000;-16272000;13309000;4586000;8027000
VIDE;95336;USD;2016;Q4;2017-02-28;2016-05-26;5891000;5892000;503000;2771000;5838000;9533000;1281000;;616000;1897000;11430000;2241000;229000;3245000;667000;727000;3972000;7479000;-16268000;16247000;7458000;11430000
VIDE;95336;USD;2015;Q4;2016-02-29;2015-05-29;6057000;5988000;740000;1581000;7216000;9849000;1313000;;782000;2095000;11944000;2152000;137000;3053000;131000;431000;3484000;7475000;-16268000;17253000;8460000;11944000
VIDE;95336;USD;2014;Q4;2015-02-28;2014-05-29;7458000;7486000;7213000;1876000;9915000;22748000;1561000;;3171000;4732000;27480000;1871000;48000;1919000;233000;1327000;3246000;7453000;-12611000;29392000;24234000;27480000
VIDE;95336;USD;2013;Q4;2014-02-28;2013-05-29;7569000;7647000;403000;3125000;11173000;44530000;1851000;;5912000;7763000;52293000;3224000;5096000;22301000;281000;1084000;23385000;7409000;-10574000;32073000;28908000;52293000
VIDE;95336;USD;2012;Q4;2013-02-28;2012-05-29;7591000;7645000;148000;7193000;29736000;43771000;4416000;;3416000;7832000;51603000;5182000;945000;17526000;4878000;5124000;22650000;7407000;-10519000;32065000;28953000;51603000
VIDE;95336;USD;2011;Q4;2012-02-29;2011-10-14;8385000;8721000;1399000;8496000;30593000;54032000;4522000;;4916000;9438000;63470000;8077000;1339000;26986000;7196000;7680000;34666000;7468000;-7152000;28488000;28804000;63470000
VIDE;95336;USD;2018;Q4;2019-02-28;2019-05-29;5876000;6276000;410000;1746000;3451000;6292000;1321000;;194000;1515000;7807000;1390000;348000;2603000;289000;543000;3146000;7567000;-16282000;13376000;4661000;7807000
PRTX;95453;USD;2016;Q4;2016-05-31;2016-07-15;28767582;28767582;444179;;;499866;;;3407;3407;503273;607255;;607255;;17252248;17859503;77266298;;-94622528;-17356230;503273
PRTX;95453;USD;2015;Q4;2015-05-31;2015-07-14;28767582;28767582;928279;;;984710;;;4427;4427;989137;554655;;554655;;13022936;13577591;72618624;;-85207078;-12588454;989137
PRTX;95453;USD;2014;Q4;2014-05-31;2014-08-05;28299425;28299425;1614758;;;1660085;;;5447;5447;1665532;452853;;452853;;9397168;9850021;65402793;;-73587282;-8184489;1665532
PRTX;95453;USD;2013;Q4;2013-05-31;2013-08-28;18926547;18926615;2457046;;;2499366;;;6467;6467;2505833;734255;4210833;4945088;;6057616;11002704;53238182;;-61735053;-8496871;2505833
PRTX;95453;USD;2012;Q4;2012-05-31;2012-08-29;18926615;18926615;190395;;;233074;;;7487;7487;240561;759594;1594498;2354092;;1010083;3364175;52331205;;-55454819;-3123614;240561
PRTX;95453;USD;2011;Q4;2011-05-31;2011-09-28;;;1542025;;;1580466;;;8507;8507;1588973;436172;0;436172;660975;660975;1097147;51502061;;-51010235;491826;1588973
PRTX;95453;USD;2017;Q4;2017-05-31;2017-08-23;28767582;28767582;487383;;;594592;;;2387;2387;596979;546815;;546815;;21789782;22336597;77446631;;-99186249;-21739618;596979
PRTX;95453;USD;2018;Q4;2018-05-31;2018-09-11;47679981;47679981;555411;;;629797;;;1367;1367;631164;629135;;629135;75127;2101963;2731098;102122498;;-104222432;-2099934;631164
WINH;97546;USD;2016;Q4;2017-03-31;2017-07-14;49989500;49989500;;;;;;13042386;;13042386;13042386;87045;;205725;;0;205725;16071154;;-3235951;12836661;13042386
WINH;97546;USD;2015;Q4;2016-03-31;2016-07-14;49989500;49989500;21548630;1417860;1523959;24848499;;;2105965;2105965;26954464;2139162;6205280;8821641;;0;8821641;21676765;;-10598978;18132823;26954464
WINH;97546;USD;2014;Q4;2015-03-31;2015-07-14;49989500;49989500;1103726;1246200;2621655;5341134;;;430327;430327;5771461;852110;732212;1656550;;;1656550;2716572;;1366619;4114911;5771461
WINH;97546;USD;2013;Q4;2014-03-31;2014-08-19;50003210;50003210;155160;;41254;402356;;;84290;84290;486646;183013;433283;622560;;;622560;860485;;-999933;-135914;486646
PPHM;97638;USD;2017;Q4;2017-04-30;2018-07-16;53155075;53155075;42265000;3754000;16129000;67827000;26479000;;1454000;27933000;95760000;4473000;;37863000;0;2159000;40022000;614865000;;-559129000;55738000;95760000
PPHM;97638;USD;2016;Q4;2016-04-30;2017-07-14;42722804;42722804;46799000;7742000;33099000;89874000;26045000;;2193000;28238000;118112000;8055000;;62931000;;1599000;64530000;591015000;;-537435000;53582000;118112000
PPHM;97638;USD;2015;Q4;2015-04-30;2016-07-14;35569495;35569495;61412000;2859000;16186000;81808000;24302000;;2933000;27235000;109043000;21844000;;57574000;;1395000;58969000;559348000;;-509276000;50074000;109043000
PPHM;97638;USD;2014;Q4;2014-04-30;2015-07-14;28494985;28494985;68001000;3813000;7354000;80523000;15124000;;1817000;16941000;97464000;18901000;;37331000;;1098000;38429000;512657000;;-453624000;59035000;97464000
PPHM;97638;USD;2013;Q4;2013-04-30;2014-07-14;24745416;24745416;77490000;1332000;5530000;85771000;2447000;;2327000;4774000;90545000;10704000;;22207000;;639000;22846000;470964000;;-403266000;67699000;90545000
PPHM;97638;USD;2012;Q4;2012-04-30;2013-07-11;19222227;19222227;35204000;1662000;4339000;41914000;2678000;;466000;3144000;45058000;7333000;;20561000;;737000;21298000;391664000;;-367904000;23760000;45058000
PPHM;97638;USD;2011;Q4;2011-04-30;2012-07-16;13854638;13854638;18033000;2353000;3611000;24792000;2900000;;570000;3470000;28262000;8071000;;17639000;;1140000;18779000;347607000;;-338124000;9483000;28262000
PPHM;97638;USD;2010;Q4;2010-04-30;2011-09-09;9527322;;23075000;1389000;5284000;30815000;2209000;;1742000;3951000;34766000;7793000;1321000;17679000;;1669000;19348000;311423000;;-296005000;15418000;34766000
PPHM;97638;USD;2018;Q4;2018-04-30;2019-06-27;56076747;56076747;32351000;7374000;6557000;51318000;25625000;;1452000;27077000;78395000;7892000;;23162000;;2165000;25327000;613671000;;-560605000;53068000;78395000
MYCC;97729;USD;2015;Q4;2015-12-31;2016-02-29;64188000;63906000;116347000;68671000;20929000;225854000;1534520000;;374877000;1909397000;2135251000;92401000;20414000;335003000;1079320000;1621466000;1956469000;264568000;0;-88955000;178782000;2135251000
MYCC;97729;USD;2014;Q4;2014-12-31;2015-03-12;64048000;65189000;75047000;65337000;20931000;203665000;1474763000;;386643000;1861406000;2065071000;98275000;18025000;311433000;965187000;1532779000;1844212000;293650000;;-79443000;220859000;2065071000
MYCC;97729;USD;2013;Q4;2013-12-31;2014-03-21;64978000;66702000;53781000;83161000;15819000;176503000;1234903000;;324811000;1559714000;1736217000;83991000;11567000;287070000;638112000;1211197000;1498267000;320912000;;-92669000;237950000;1736217000
MYCC;97729;USD;2012;Q4;2012-12-31;2013-10-18;50570000;50570000;81965000;51590000;14361000;168191000;1223539000;;328817000;1552356000;1720547000;80337000;24988000;249638000;768369000;1327827000;1577465000;184966000;;-51777000;143082000;1720547000
MYCC;97729;USD;2016;Q4;2016-12-31;2017-02-27;64546000;64650000;84601000;79115000;22743000;202575000;1553382000;;372757000;1926139000;2128714000;101055000;19422000;361924000;1067071000;1614403000;1976327000;236526000;-2258000;-82260000;152387000;2128714000
SIRI;97841;USD;2016;Q4;2016-12-31;2017-02-02;4793780000;4840218000;213939000;223029000;20363000;642649000;1398693000;;5962253000;7360946000;8003595000;827667000;5485000;2668601000;5842764000;6127009000;8795610000;3122411000;-22906000;-3891381000;-792015000;8003595000
SIRI;97841;USD;2015;Q4;2015-12-31;2016-02-02;5190693000;5246787000;111838000;234782000;22295000;561889000;1415401000;;6069372000;7484773000;8046662000;716968000;4764000;2496487000;5443614000;5716666000;8213153000;4788948000;-23727000;-4931210000;-166491000;8046662000
SIRI;97841;USD;2014;Q4;2014-12-31;2015-02-05;5569882000;5090107000;147724000;220579000;19397000;1549746000;1510112000;;5309207000;6819319000;8369065000;668195000;8876000;2313792000;4487419000;4745436000;7059228000;6777207000;-26034000;-5440934000;1309837000;8369065000
SIRI;97841;USD;2013;Q4;2013-12-31;2014-02-04;6111810000;6198018000;134805000;192912000;13863000;1419013000;1594574000;;5831193000;7425767000;8844780000;620418000;511555000;2738904000;3093821000;3360134000;6099038000;8680225000;0;-5934175000;2745742000;8844780000
SIRI;97841;USD;2012;Q4;2012-12-31;2013-02-06;5269154000;7873603000;520945000;106142000;25337000;1828182000;1571922000;;5654739000;7226661000;9054843000;621606000;212088000;2314588000;2430986000;2700690000;5015278000;10350829000;;-6311390000;4039565000;9054843000
SIRI;97841;USD;2011;Q4;2011-12-31;2012-02-09;3751532000;6210237000;773990000;101705000;36711000;1276954000;1673919000;;4545123000;6219042000;7495996000;613598000;285731000;2247596000;3012351000;4544255000;6791851000;10488153000;;-9784092000;704145000;7495996000
SIRI;97841;USD;2010;Q4;2010-12-31;2011-02-16;3722299000;6495384000;586691000;121658000;21918000;991775000;1761274000;;4630037000;6391311000;7383086000;665627000;466891000;2349709000;3021763000;4825741000;7175450000;10424537000;;-10211053000;207636000;7383086000
SIRI;97841;USD;2009;Q4;2009-12-31;2010-08-06;3610695000;3610695000;383489000;113580000;16193000;859780000;1711003000;;4751423000;6462426000;7322206000;618252000;266713000;2076641000;3063281000;5150043000;7226684000;10356173000;;-10254108000;95522000;7322206000
SIRI;97841;USD;2017;Q4;2017-12-31;2018-01-31;4569078000;4669557000;69022000;241727000;20199000;470901000;1462766000;;6395707000;7858473000;8329374000;931769000;5105000;2821538000;6741243000;7031710000;9853248000;1718346000;-17154000;-3243473000;-1523874000;8329374000
SIRI;97841;USD;2018;Q4;2018-12-31;2019-01-30;4400364000;4492853000;54431000;232986000;22198000;478233000;1512865000;;6181638000;7694503000;8172736000;863283000;3447000;2802678000;6884536000;7186979000;9989657000;246581000;0;-2057309000;-1816921000;8172736000
K;97995;USD;2016;Q4;2016-12-31;2017-02-21;349000000;353000000;280000000;1231000000;1238000000;2940000000;3569000000;438000000;8164000000;12171000000;15111000000;2815000000;1069000000;4474000000;6698000000;8711000000;13185000000;911000000;-3997000000;6571000000;1926000000;15111000000
K;97995;USD;2015;Q4;2015-12-31;2016-02-24;354000000;356000000;251000000;1344000000;1250000000;3236000000;3621000000;456000000;7938000000;12015000000;15251000000;1907000000;2470000000;5739000000;5275000000;7374000000;13113000000;850000000;-3943000000;6597000000;2138000000;15251000000
K;97995;USD;2014;Q4;2014-12-31;2015-02-25;355000000;356000000;443000000;1276000000;1279000000;3340000000;3769000000;1000000;8043000000;11813000000;15153000000;1528000000;1435000000;4364000000;5935000000;7938000000;12302000000;783000000;-3470000000;6689000000;2851000000;15153000000
K;97995;USD;2013;Q4;2013-12-31;2014-02-24;363000000;363000000;273000000;1424000000;1248000000;3267000000;3856000000;;8351000000;12207000000;15474000000;1432000000;1028000000;3835000000;6330000000;8032000000;11867000000;731000000;-2999000000;6749000000;3607000000;15474000000
K;97995;USD;2012;Q4;2012-12-31;2013-02-26;360000000;363000000;281000000;1454000000;1365000000;3380000000;3782000000;;8007000000;11789000000;15169000000;1402000000;1820000000;4523000000;6082000000;8181000000;12704000000;678000000;-2943000000;5615000000;2465000000;15169000000
K;97995;USD;2011;Q4;2011-12-31;2012-02-29;360000000;359000000;460000000;1188000000;1174000000;3069000000;3281000000;;5593000000;8874000000;11943000000;1189000000;995000000;3313000000;5037000000;6832000000;10145000000;627000000;-3130000000;5305000000;1798000000;11943000000
K;97995;USD;2010;Q4;2010-12-31;2011-02-25;370000000;368000000;444000000;1190000000;1056000000;2915000000;3128000000;;5804000000;8932000000;11847000000;1149000000;996000000;3184000000;4908000000;6509000000;9693000000;600000000;-2650000000;6122000000;2154000000;11847000000
K;97995;USD;2009;Q4;2009-12-31;2010-02-26;381000000;386000000;334000000;1093000000;910000000;2558000000;3010000000;;5632000000;8642000000;11200000000;1077000000;45000000;2288000000;4835000000;6637000000;8925000000;577000000;-1820000000;5481000000;2275000000;11200000000
K;97995;USD;2008;Q4;2008-12-31;2009-09-02;382000000;385000000;255000000;1100000000;897000000;2521000000;2933000000;;5492000000;8425000000;10946000000;1135000000;1388000000;3552000000;4068000000;5939000000;9491000000;543000000;-1790000000;4836000000;1455000000;10946000000
K;97995;USD;2017;Q4;2017-12-31;2018-02-20;347000000;346000000;281000000;1389000000;1217000000;3036000000;3716000000;429000000;9169000000;13314000000;16350000000;2269000000;779000000;4479000000;7836000000;9643000000;14122000000;983000000;-4417000000;7103000000;2228000000;16350000000
K;97995;USD;2018;Q4;2018-12-31;2019-02-25;348000000;347000000;321000000;1375000000;1330000000;3157000000;3731000000;413000000;10479000000;14623000000;17780000000;2427000000;686000000;4529000000;8207000000;10092000000;14621000000;1000000000;-4551000000;7652000000;3159000000;17780000000
MAR;98192;USD;2016;Q4;2016-12-31;2017-02-21;388700000;395400000;858000000;1695000000;;3371000000;2335000000;;18434000000;20769000000;24140000000;1861000000;309000000;5147000000;8197000000;13636000000;18783000000;5813000000;-6460000000;6501000000;5357000000;24140000000
MAR;98192;USD;2015;Q4;2015-12-31;2016-02-18;256900000;263100000;96000000;1103000000;;1384000000;1029000000;;3669000000;4698000000;6082000000;1454000000;300000000;3233000000;3807000000;6439000000;9672000000;2826000000;-11098000000;4878000000;-3590000000;6082000000
MAR;98192;USD;2014;Q4;2014-12-31;2015-02-19;282100000;289800000;104000000;1100000000;;1610000000;1460000000;;3763000000;5223000000;6833000000;1404000000;324000000;3038000000;3447000000;5995000000;9033000000;2807000000;-9223000000;4286000000;-2200000000;6833000000
MAR;98192;USD;2013;Q4;2013-12-31;2014-02-20;299600000;308500000;126000000;1081000000;;1903000000;1543000000;;3348000000;4891000000;6794000000;1374000000;6000000;2675000000;3147000000;5534000000;8209000000;2721000000;-7929000000;3837000000;-1415000000;6794000000
MAR;98192;USD;2012;Q4;2012-12-31;2013-02-20;309400000;319700000;88000000;1028000000;;1475000000;1539000000;;3328000000;4867000000;6342000000;1314000000;407000000;2773000000;2528000000;4854000000;7627000000;2590000000;-7340000000;3509000000;-1285000000;6342000000
MAR;98192;USD;2011;Q4;2011-12-31;2012-02-16;331000000;352600000;102000000;875000000;11000000;1324000000;1168000000;;3418000000;4586000000;5910000000;1198000000;355000000;2558000000;1816000000;4133000000;6691000000;2518000000;-6463000000;3212000000;-781000000;5910000000
MAR;98192;USD;2010;Q4;2010-12-31;2011-02-18;300439400;315543200;505000000;938000000;1489000000;3382000000;1307000000;;4294000000;5601000000;8983000000;1326000000;138000000;2501000000;2691000000;4897000000;7398000000;3649000000;-5348000000;3286000000;1585000000;8983000000
MAR;98192;USD;2009;Q4;2009-12-31;2010-02-12;293406900;293406900;115000000;838000000;1444000000;2851000000;1362000000;;3720000000;5082000000;7933000000;1081000000;64000000;2287000000;2234000000;4504000000;6791000000;3590000000;-5564000000;3103000000;1142000000;7933000000
MAR;98192;USD;2008;Q4;2008-12-31;2009-07-17;;;134000000;898000000;1981000000;3406000000;1443000000;;4054000000;5497000000;8903000000;1337000000;120000000;2533000000;2975000000;4979000000;7512000000;3595000000;-5765000000;3565000000;1391000000;8903000000
MAR;98192;USD;2017;Q4;2017-12-31;2018-02-15;365100000;370000000;383000000;1973000000;;2740000000;1793000000;;19313000000;21106000000;23846000000;1997000000;398000000;5807000000;7840000000;14457000000;20264000000;5775000000;-9418000000;7242000000;3582000000;23846000000
MAR;98192;USD;2018;Q4;2018-12-31;2019-03-01;341900000;345600000;316000000;2133000000;;2706000000;1956000000;;19034000000;20990000000;23696000000;2112000000;833000000;6437000000;8514000000;15034000000;21471000000;5819000000;-12185000000;8982000000;2225000000;23696000000
LII;98304;USD;2017;Q4;2017-12-31;2018-02-16;41800000;42400000;68200000;506500000;484200000;1137300000;397800000;;356400000;754200000;1891500000;621000000;33500000;654500000;970500000;1186900000;1841400000;1062400000;-2430800000;1575900000;50100000;1891500000
LII;98304;USD;2016;Q4;2016-12-31;2017-02-21;42800000;43500000;50200000;469800000;418500000;1005900000;361400000;;393000000;754400000;1760300000;636100000;252500000;888600000;615700000;833700000;1722300000;1047100000;-2167400000;1353000000;38000000;1760300000
LII;98304;USD;2018;Q4;2018-12-31;2019-02-19;39900000;40500000;46300000;472700000;509800000;1089400000;408300000;;319500000;727800000;1817200000;707700000;300800000;1008500000;740500000;958300000;1966800000;1079700000;-2895500000;1855000000;-149600000;1817200000
KLXI;98588;USD;2017;Q4;2018-01-31;2017-04-14;51500000;52200000;255300000;316100000;1407900000;2031000000;286400000;;1472600000;1759000000;3790000000;287500000;;287500000;1184600000;1232600000;1520100000;2757000000;-182700000;-280000000;2269900000;3790000000
KLXI;98588;USD;2016;Q4;2017-01-31;2016-03-24;52200000;51900000;277300000;261300000;1381400000;1959600000;248300000;;1490400000;1738700000;3698300000;257100000;;257100000;1182000000;1220100000;1477200000;2687000000;-54400000;-328000000;2221100000;3698300000
KLXI;98588;USD;2015;Q4;2016-01-31;2015-05-28;;;447200000;304200000;1322100000;2124800000;333300000;;1766500000;2099800000;4224600000;240600000;;332800000;1177200000;1290700000;1623500000;2645300000;;11300000;2601100000;4224600000
YUM;98663;USD;2015;Q4;2015-12-31;2016-02-16;602303000;607867000;737000000;377000000;229000000;1687000000;4189000000;;2185000000;6374000000;8061000000;2062000000;922000000;3087000000;3041000000;3999000000;7086000000;0;;1150000000;975000000;8061000000
YUM;98663;USD;2014;Q4;2014-12-31;2014-04-28;612040000;624559000;578000000;325000000;301000000;1553000000;4498000000;;2283000000;6781000000;8334000000;2047000000;267000000;2409000000;3077000000;4312000000;6721000000;0;;1737000000;1613000000;8334000000
YUM;98663;USD;2013;Q4;2013-12-31;2014-02-18;623168000;631514000;573000000;319000000;294000000;1691000000;4459000000;;2545000000;7004000000;8695000000;2098000000;71000000;2265000000;2918000000;4162000000;6427000000;0;;2102000000;2268000000;8695000000
YUM;98663;USD;2012;Q4;2012-12-31;2013-02-20;631514000;646815000;776000000;301000000;313000000;1925000000;4250000000;;2838000000;7088000000;9013000000;2133000000;10000000;2279000000;2932000000;4422000000;6701000000;0;;2286000000;2312000000;9013000000
YUM;98663;USD;2011;Q4;2011-12-31;2012-02-21;644033000;657943000;1198000000;286000000;273000000;2321000000;4042000000;;2471000000;6513000000;8834000000;2016000000;320000000;2450000000;2997000000;4468000000;6918000000;18000000;;2052000000;1916000000;8834000000
YUM;98663;USD;2010;Q4;2010-12-31;2011-02-15;1321449341;1356224325;1426000000;256000000;189000000;2313000000;3830000000;;2173000000;6003000000;8316000000;1663000000;673000000;2448000000;2915000000;4199000000;6647000000;86000000;;1717000000;1669000000;8316000000
YUM;98663;USD;2009;Q4;2009-12-31;2010-02-17;663507000;676026000;353000000;239000000;122000000;1208000000;3899000000;;2041000000;5940000000;7148000000;1495000000;59000000;1653000000;3207000000;4381000000;6034000000;253000000;;996000000;1114000000;7148000000
YUM;98663;USD;2008;Q4;2008-12-31;2009-10-13;;;216000000;229000000;143000000;951000000;3710000000;;1866000000;5576000000;6527000000;1587000000;25000000;1722000000;3564000000;4899000000;6621000000;7000000;;303000000;-94000000;6527000000
CLRB;99062;USD;2016;Q4;2016-12-31;2017-03-15;759161;754333;11444619;;;12193188;1444058;;1687334;3131392;15324580;;89318;1632876;5249;151832;1784708;83451326;;-70787026;13539872;15324580
CLRB;99062;USD;2015;Q4;2015-12-31;2016-03-11;85898;85898;3857791;;;4180574;1728471;;1687334;3415805;7596379;;246039;5703045;94607;243531;5946576;66256503;;-64606700;1649803;7596379
CLRB;99062;USD;2014;Q4;2014-12-31;2015-05-20;76190;76190;9422627;;;9698238;2033944;;1687334;3721278;13419516;;122103;6233006;341203;488977;6721983;65809203;;-59111670;6697533;13419516
CLRB;99062;USD;2013;Q4;2013-12-31;2014-03-19;28744;28744;2418384;;;2768071;2360534;;1687334;4047868;6815939;;1694;4523155;450000;593234;5116389;52759118;;-51059568;1699550;6815939
CLRB;99062;USD;2012;Q4;2012-12-31;2013-03-28;22845;22845;4677545;;;5130477;2645003;;3702684;6347687;11478164;;2397;732691;451694;587098;1319789;50435775;;-40277400;10158375;11478164
CLRB;99062;USD;2011;Q4;2011-12-31;2012-03-09;15146;15146;5505960;;;5815927;3044565;;1702684;4747249;10563176;;2235;503581;454091;578472;1082053;40961549;;-31480426;9481123;10563176
CLRB;99062;USD;2010;Q4;2010-12-31;2011-08-12;;;673739;;;1279781;3510489;;11872;3522361;4802142;305049;206887;904817;3648252;3763563;4668380;24178766;;-24045004;133762;4802142
CLRB;99062;USD;2017;Q4;2017-12-31;2018-03-21;1718206;1718206;10006421;;;10939417;244713;;1687334;1932047;12871464;;3036;2114788;2213;2213;2117001;94107997;;-84349316;10754463;12871464
CLRB;99062;USD;2018;Q4;2018-12-31;2019-02-26;5250652;5250652;13255616;;;13951834;543339;540823;18086;1102248;15054082;;2213;1589032;;204089;1793121;108323255;;-97588343;13260961;15054082
KSU;99395;USD;2017;Q4;2017-12-31;2018-01-26;103004000;103398000;134100000;237800000;150800000;680100000;8403800000;44600000;70200000;8518600000;9198700000;587800000;383900000;971700000;2235500000;3361600000;4333300000;944300000;;3611400000;4865400000;9198700000
KSU;99395;USD;2016;Q4;2016-12-31;2017-01-27;106842000;107050000;170600000;191000000;152600000;648000000;8069700000;32900000;66900000;8169500000;8817500000;537700000;206700000;744400000;2271500000;3668600000;4413000000;955900000;;3134100000;4404500000;8817500000
KSU;99395;USD;2015;Q4;2015-12-31;2016-01-29;108501000;108717000;136600000;171900000;137900000;537000000;7705400000;34700000;63900000;7804000000;8341000000;401500000;356100000;757600000;2045000000;3358700000;4116300000;948200000;;2964700000;4224700000;8341000000
KSU;99395;USD;2014;Q4;2014-12-31;2015-01-30;110224000;110491000;348000000;181600000;111000000;718200000;7154700000;36400000;67100000;7258200000;7976400000;423900000;474900000;898800000;1826500000;3013500000;3912300000;950900000;;2801700000;4064100000;7976400000
KSU;99395;USD;2013;Q4;2013-12-31;2014-01-31;110014000;110399000;429500000;198300000;121300000;942400000;6356300000;41100000;95600000;6493000000;7435400000;398600000;332000000;730600000;1856900000;3028200000;3758800000;943600000;;2422900000;3676600000;7435400000
KSU;99395;USD;2012;Q4;2012-12-31;2013-02-04;109798000;110141000;72600000;183600000;125600000;522300000;5684800000;51500000;137300000;5873600000;6395900000;364600000;60200000;424800000;1547600000;2570400000;2995200000;926400000;;2166500000;3400700000;6395900000
KSU;99395;USD;2011;Q4;2011-12-31;2012-02-08;109620000;109897000;72400000;166000000;109600000;642500000;5321600000;50400000;130600000;5502600000;6145100000;401100000;36300000;437400000;1602800000;2649000000;3086400000;885300000;;1875300000;3058700000;6145100000
KSU;99395;USD;2010;Q4;2010-12-31;2011-02-09;102337000;123802000;85400000;160000000;101400000;576200000;4902400000;46400000;115900000;5064700000;5640900000;403000000;18100000;421100000;1621600000;2506100000;2927200000;878200000;;1548000000;2713500000;5640700000
KSU;99395;USD;2009;Q4;2009-12-31;2010-02-12;95199000;89202000;117500000;139400000;106400000;578000000;4722400000;46800000;107100000;4876300000;5454300000;342700000;68100000;410800000;1911900000;2717700000;3128500000;662300000;;1378800000;2325600000;5454100000
KSU;99395;USD;2008;Q4;2008-12-31;2009-10-29;89842000;97429000;229900000;163800000;96300000;651600000;4598400000;60500000;128700000;4787600000;5439200000;455400000;637400000;1092800000;1448700000;2161200000;3254000000;573200000;;1337600000;2185000000;5439000000
KSU;99395;USD;2018;Q4;2018-12-31;2019-01-25;101084000;101502000;100500000;301200000;160300000;635400000;8691100000;44900000;98400000;8834400000;9469800000;436900000;10100000;447000000;2679300000;3890100000;4337100000;947600000;;3870600000;5132700000;9469800000
CALD;100006;USD;2015;Q4;2015-12-31;2016-02-25;56468000;56468000;97209000;43461000;;152055000;20540000;;69047000;89587000;241642000;27163000;;101807000;;11034000;112841000;428832000;-14430000;-283866000;128801000;241642000
CALD;100006;USD;2014;Q4;2014-12-31;2015-03-02;49032000;47619000;36966000;41623000;;88973000;18755000;;68570000;87325000;176298000;29450000;1001000;91878000;10481000;25946000;117824000;344361000;-14430000;-270718000;58474000;176298000
CALD;100006;USD;2013;Q4;2013-12-31;2014-03-10;41832000;41832000;36161000;29216000;;71609000;11351000;;51233000;62584000;134193000;15759000;1308000;64448000;15184000;27692000;92140000;315475000;-14430000;-259157000;42053000;134193000
CALD;100006;USD;2012;Q4;2012-12-31;2012-03-13;36372000;36372000;29171000;22567000;;58496000;10580000;;55667000;66247000;124743000;18723000;921000;56071000;59223000;65244000;121315000;255365000;-14430000;-237746000;3428000;124743000
CALD;100006;USD;2011;Q4;2011-12-31;2012-03-13;32751000;32751000;52789000;21778000;;80508000;6772000;;46327000;53099000;133607000;20065000;1196000;52068000;60130000;66997000;119065000;238831000;-14430000;-210048000;14542000;133607000
CALD;100006;USD;2010;Q4;2010-12-31;2011-08-08;32343000;32343000;30703000;19908000;;55052000;8016000;787000;15950000;24753000;79805000;12327000;1119000;43554000;2162000;8169000;51723000;222394000;;-194214000;28082000;79805000
CALD;100006;USD;2016;Q4;2016-12-31;2017-02-27;63611000;63611000;187274000;55464000;;261013000;35456000;;90032000;125488000;386501000;36530000;;136288000;;13352000;149640000;559264000;-14430000;-302832000;236861000;386501000
CALD;100006;USD;2017;Q4;2017-12-31;2018-02-28;66017000;66017000;150499000;76750000;;251256000;57058000;;139133000;196191000;447447000;51242000;;184555000;;17933000;202488000;583556000;-14430000;-323105000;244959000;447447000
SHLD;100266;USD;2017;Q4;2018-02-28;2018-03-23;108400000;108400000;182000000;343000000;2798000000;3823000000;1729000000;;1721000000;3450000000;7273000000;823000000;1883000000;4922000000;2249000000;6077000000;10999000000;;;;-3726000000;7273000000
SHLD;100266;USD;2016;Q4;2017-02-28;2016-03-16;106800000;100000000;286000000;466000000;3959000000;4996000000;2240000000;;2126000000;4366000000;9362000000;1387000000;590000000;4681000000;3573000000;8505000000;13186000000;9131000000;-5891000000;-5512000000;-3824000000;9362000000
SHLD;100266;USD;2015;Q4;2016-02-29;2015-03-17;106300000;106300000;238000000;419000000;5172000000;6045000000;2631000000;;2661000000;5292000000;11337000000;1858000000;868000000;5438000000;2108000000;7855000000;13293000000;9174000000;-5928000000;-3291000000;-1956000000;11337000000
SHLD;100266;USD;2014;Q4;2015-02-28;2014-03-18;106200000;106200000;1028000000;553000000;7034000000;8959000000;5394000000;;3908000000;9302000000;18261000000;2956000000;1415000000;8185000000;2834000000;7893000000;16078000000;9299000000;-5963000000;-480000000;2183000000;18261000000
SHLD;100266;USD;2013;Q4;2014-02-28;2013-03-20;105900000;105700000;609000000;635000000;7558000000;9265000000;6053000000;;4022000000;10075000000;19340000000;3241000000;1177000000;8414000000;1943000000;7754000000;16168000000;9299000000;-5970000000;885000000;3172000000;19340000000
SHLD;100266;USD;2012;Q4;2013-02-28;2012-03-14;106100000;106100000;747000000;695000000;8407000000;10244000000;6577000000;;4560000000;11137000000;21381000000;3435000000;1405000000;9212000000;2088000000;7828000000;17040000000;10004000000;-5981000000;1865000000;4339000000;21379000000
SHLD;100266;USD;2011;Q4;2012-02-29;2011-03-11;;;1359000000;689000000;8951000000;11560000000;7102000000;;5698000000;12800000000;24360000000;3592000000;849000000;8643000000;2344000000;7103000000;15746000000;10186000000;-5826000000;4930000000;8614000000;24360000000
SHLD;100266;USD;2010;Q4;2011-02-28;2010-08-20;;;1689000000;652000000;8705000000;11438000000;7709000000;;5661000000;13370000000;24808000000;3869000000;807000000;8786000000;1698000000;6587000000;15373000000;10466000000;-5446000000;4797000000;9435000000;24808000000
CBM;100602;USD;2016;Q4;2016-12-31;2017-02-03;32246000;33180000;74141000;110622000;123184000;322655000;217092000;;72118000;289210000;611865000;87956000;;95462000;;110976000;206438000;157074000;-13503000;327376000;405427000;611865000
CBM;100602;USD;2015;Q4;2015-12-31;2016-02-09;31681000;33043000;43974000;90920000;109920000;259279000;186487000;;59773000;246260000;505539000;83504000;30000000;129802000;;64902000;194704000;135333000;-14747000;245698000;310835000;505539000
CBM;100602;USD;2014;Q4;2014-12-31;2015-02-06;31058000;32137000;45518000;77124000;85630000;223762000;163567000;;99258000;262825000;486587000;84495000;0;98590000;60000000;136771000;235361000;122549000;-14823000;188481000;251226000;486587000
CBM;100602;USD;2013;Q4;2013-12-31;2014-02-11;30357000;30808000;22745000;71276000;89965000;202560000;171966000;;83511000;255477000;458037000;77150000;;97271000;79250000;150546000;247817000;112988000;-14984000;131178000;210220000;458037000
CBM;100602;USD;2012;Q4;2012-12-31;2013-02-07;29876000;30871000;23551000;43094000;71221000;143970000;151815000;;89946000;241761000;385731000;70913000;;82483000;64000000;139951000;222434000;107342000;-15217000;105263000;163297000;385731000
CBM;100602;USD;2011;Q4;2011-12-31;2012-02-07;29522000;29717000;31921000;36510000;62095000;136609000;139628000;;66594000;206222000;342831000;58073000;;59133000;98000000;183357000;242490000;104789000;-15821000;42960000;100341000;342831000
CBM;100602;USD;2010;Q4;2010-12-31;2011-08-04;29421000;29543000;29614000;39025000;61408000;135129000;150483000;;66139000;216622000;351751000;52983000;;52983000;115900000;191133000;244116000;104411000;-16876000;31992000;107635000;351751000
CBM;100602;USD;2017;Q4;2017-12-31;2018-02-08;32816000;33598000;183284000;75144000;138542000;422078000;254299000;;64188000;318487000;740565000;77834000;;82541000;;113160000;195701000;169406000;-12140000;429826000;544864000;740565000
CBM;100602;USD;2018;Q4;2018-12-31;2019-02-13;33587000;33505000;95852000;146330000;111062000;410092000;360528000;;452808000;813336000;1223428000;92699000;;104412000;300000000;465289000;569701000;186178000;-10777000;538463000;653727000;1223428000
EOG;100699;USD;2015;Q4;2015-12-31;2016-02-25;546366000;542187000;718506000;930610000;598935000;2592244000;24210721000;;167505000;24378226000;26970470000;1657117000;6579000;1819287000;6648911000;12208148000;14027435000;3128963000;-23406000;9870816000;12943035000;26970470000
EOG;100699;USD;2014;Q4;2014-12-31;2015-02-18;544411000;547891000;2087213000;1779311000;706597000;5416021000;29172644000;;174022000;29346666000;34762687000;3092240000;6579000;3384308000;5903354000;13665797000;17050105000;3042642000;-70102000;14763098000;17712582000;34762687000
EOG;100699;USD;2013;Q4;2013-12-31;2014-02-24;541673000;547753000;1318209000;1658853000;563268000;4072015000;26148836000;;353387000;26502223000;30574238000;2464578000;6579000;2861716000;5906642000;12294063000;15155779000;2849611000;-15263000;12168277000;15418459000;30574238000
EOG;100699;USD;2012;Q4;2012-12-31;2013-02-22;537642000;543678000;876435000;1656618000;683187000;3589884000;23337681000;;409013000;23746694000;27336578000;2286833000;406579000;2924058000;5905602000;11127756000;14051814000;2703060000;-33822000;10175631000;13284764000;27336578000
EOG;100699;USD;2011;Q4;2011-12-31;2012-02-24;527714000;535258000;615726000;1451227000;590594000;3253938000;21288824000;;296035000;21584859000;24838797000;2223298000;0;2522319000;5009166000;9675574000;12197893000;2474745000;-24932000;9789345000;12640904000;24838797000
EOG;100699;USD;2010;Q4;2010-12-31;2011-02-24;1004115970;1018753970;788853000;1113279000;415792000;2527446000;18680900000;;415887000;19096787000;21624233000;1786074000;220000000;2220099000;5003341000;9172502000;11392601000;932534000;-11152000;8870179000;10231632000;21624233000
EOG;100699;USD;2009;Q4;2009-12-31;2010-02-25;996419586;1009323586;685751000;771417000;261723000;1839541000;16139225000;;139901000;16279126000;18118667000;1108283000;37000000;1345560000;2760000000;6775065000;8120625000;799228000;-7653000;8866747000;9998042000;18118667000
EOG;100699;USD;2008;Q4;2008-12-31;2010-02-25;495238000;499746000;331311000;722695000;187970000;2108451000;13657302000;;185473000;13842775000;15951226000;1241935000;37000000;1764916000;1860000000;5171813000;6936729000;526303000;-5736000;8466143000;9014497000;15951226000
EOG;100699;USD;2016;Q4;2016-12-31;2017-02-27;571648000;571648000;1599895000;1216320000;350017000;3385216000;25707078000;;206907000;25913985000;29299201000;1726357000;6579000;2027291000;6979779000;13290329000;15317620000;5626155000;-23682000;8398118000;13981581000;29299201000
EOG;100699;USD;2017;Q4;2017-12-31;2018-02-27;575323000;578960000;834228000;1597494000;483865000;3279108000;25665037000;;888933000;26553970000;29833078000;2092415000;356235000;2725542000;6030836000;10824263000;13549805000;5742335000;-33298000;10593533000;16283273000;29833078000
EOG;100699;USD;2018;Q4;2018-12-31;2019-02-26;577148000;580104000;1555634000;1915215000;859359000;5057390000;28075519000;;801565000;28877084000;33934474000;2581547000;913093000;3728364000;5170169000;10841922000;14570286000;5864598000;-42182000;13543130000;19364188000;33934474000
CBK;100810;USD;2016;Q4;2017-02-28;2017-03-16;37086000;37008000;35006000;2549000;36834000;78390000;55332000;;898000;56230000;134620000;46906000;;46906000;;16419000;63325000;126989000;-112711000;57017000;71295000;134620000
CBK;100810;USD;2015;Q4;2016-02-29;2016-03-18;36922000;36922000;34521000;4067000;42481000;90641000;59224000;;1025000;60249000;150890000;44060000;;44060000;;18422000;62482000;126319000;-112711000;74800000;88408000;150890000
CBK;100810;USD;2014;Q4;2015-02-28;2015-04-09;37601000;38427000;50538000;4000000;45318000;110951000;45107000;4752000;35227000;85086000;196037000;45356000;;45356000;;14792000;60148000;124708000;-112711000;123894000;135889000;196037000
CBK;100810;USD;2013;Q4;2014-02-28;2014-03-21;36327000;38147000;54056000;2428000;44877000;109079000;36458000;3143000;298000;39899000;148978000;53268000;;53268000;;8773000;62041000;122877000;-112711000;76768000;86937000;148978000
CBK;100810;USD;2012;Q4;2013-02-28;2013-03-25;35912000;35525000;40739000;3630000;42704000;94301000;41230000;0;401000;41631000;135932000;50213000;;50213000;;10253000;60466000;120099000;-112711000;68078000;75466000;135932000
CBK;100810;USD;2011;Q4;2012-02-29;2012-04-12;35635000;35635000;48442000;3649000;39455000;96023000;56443000;13284000;266000;69993000;166016000;50863000;;50863000;;25791000;76654000;117857000;-112711000;84154000;89362000;166016000
CBK;100810;USD;2010;Q4;2011-02-28;2011-10-06;35488000;35488000;76772000;3967000;39211000;128378000;76647000;28824000;314000;105785000;234163000;44963000;;44963000;;24971000;69934000;115363000;-112711000;161642000;164229000;234163000
CBK;100810;USD;2017;Q4;2018-02-28;2018-03-09;37317000;37317000;23077000;2626000;41361000;69951000;47773000;;1640000;49413000;119364000;52335000;;52335000;;16620000;68955000;128127000;-112711000;34993000;50409000;119364000
CBK;100810;USD;2018;Q4;2019-02-28;2019-03-18;37611000;37611000;10239000;2767000;41039000;57685000;31643000;;1775000;33418000;91103000;48682000;0;48682000;;21898000;70580000;129195000;-112809000;4137000;20523000;91103000
SBAC;100897;USD;2015;Q4;2015-12-31;2016-02-26;125962000;124823000;118745000;83326000;;293960000;2782353000;;4236667000;7019020000;7312980000;144225000;20000000;273371000;8432070000;8745753000;9019124000;1963970000;;-3168069000;-1706144000;7312980000
SBAC;100897;USD;2014;Q4;2014-12-31;2015-03-02;129120000;119324000;44992000;104268000;;326888000;2762417000;;4751820000;7514237000;7841125000;161582000;32500000;331050000;7828299000;8170875000;8501925000;2064066000;;-2542380000;-660800000;7841125000
SBAC;100897;USD;2013;Q4;2013-12-31;2014-02-27;128421000;119394000;127558000;71339000;;343652000;2578444000;;3861092000;6439536000;6783188000;157122000;481886000;747673000;5394721000;5678549000;6426222000;2908730000;;-2518085000;356966000;6783188000
SBAC;100897;USD;2016;Q4;2016-12-31;2017-03-01;122665000;124065000;146109000;78344000;;324571000;2792076000;;4244298000;7036374000;7360945000;133952000;627157000;873447000;8148426000;8483419000;9356866000;2011730000;;-3637467000;-1995921000;7360945000
SBAC;100897;USD;2017;Q4;2017-12-31;2018-03-01;117190000;118891000;68783000;90673000;;259533000;2812346000;;4248326000;7060672000;7320205000;152095000;20000000;278905000;9290686000;9640414000;9919319000;2168634000;;-4388288000;-2599114000;7320205000
SBAC;100897;USD;2018;Q4;2018-12-31;2019-02-28;113481000;116589000;143444000;111035000;;373854000;2786355000;;4053498000;6839853000;7213707000;146695000;941728000;1206279000;8996825000;9384251000;10590530000;2271450000;;-5136368000;-3376823000;7213707000
ITGR;101027;USD;2018;Q4;2019-01-31;2019-02-22;32393000;33030000;25569000;185501000;190076000;416250000;231269000;;1679162000;1910431000;2326681000;127070000;37500000;164570000;888007000;1101618000;1266188000;691116000;-8125000;344498000;1060493000;2326681000
ITGR;101027;USD;2017;Q4;2018-01-31;2018-02-22;31696000;32381000;37341000;194845000;176738000;531909000;235180000;;2081256000;2316436000;2848345000;130831000;30469000;209003000;1578696000;1745961000;1954964000;669788000;-4654000;176068000;893381000;2848345000
ITGR;101027;USD;2016;Q4;2017-01-31;2017-02-28;30845000;31254000;52116000;204626000;225151000;517307000;372042000;;1943194000;2315236000;2832543000;153876000;31344000;185220000;1698819000;1922084000;2107304000;637986000;-5834000;109087000;725239000;2832543000
ITGR;101027;USD;2015;Q4;2016-01-31;2016-03-01;29179000;26479000;82478000;207342000;252166000;574604000;379492000;;2028040000;2407532000;2982136000;184840000;29000000;213840000;1685053000;1917671000;2131511000;620501000;-3100000;231854000;850625000;2982136000
ITGR;101027;USD;2014;Q4;2015-01-31;2015-03-03;24949000;26382000;76824000;124953000;129242000;350683000;144925000;;459514000;604439000;955122000;96823000;11250000;108661000;175363000;233099000;341760000;366098000;-1307000;239448000;613362000;955122000
ITGR;101027;USD;2013;Q4;2014-01-31;2014-03-04;24253000;26767000;35465000;113679000;118358000;282533000;145773000;;462397000;608170000;890703000;91189000;0;91802000;197500000;256846000;348648000;344939000;-1232000;183990000;542055000;890703000
ITGR;101027;USD;2012;Q4;2013-01-31;2013-02-27;23659000;22966000;20284000;120923000;106612000;268133000;150893000;;470849000;621742000;889875000;90883000;;91757000;225414000;317258000;409015000;320642000;-452000;147723000;480860000;889875000
ITGR;101027;USD;2011;Q4;2012-01-31;2012-02-28;23308000;23508000;36508000;101946000;109913000;264956000;145806000;;470585000;616391000;881347000;93204000;;94049000;235950000;320015000;414064000;307219000;-1387000;152522000;467283000;881347000
ITGR;101027;USD;2010;Q4;2011-01-31;2011-08-09;23100000;23844000;22883000;70947000;101440000;211509000;146380000;;419087000;565467000;776976000;60073000;;60587000;220629000;289560000;350147000;298428000;-1469000;119400000;426829000;776976000
SRCL;101113;USD;2016;Q4;2016-12-31;2017-03-15;85087042;85264160;44189000;634902000;;773618000;723894000;;5482549000;6206443000;6980061000;385798000;72822000;542853000;2877315000;3620822000;4163675000;1167309000;;2006064000;2816386000;6980061000
SRCL;101113;USD;2015;Q4;2015-12-31;2016-03-15;84895035;85952081;55703000;614494000;;761828000;665602000;;5637733000;6303335000;7065163000;346531000;161409000;587349000;3040352000;3729976000;4317325000;1143869000;;1868645000;2747838000;7065163000
SRCL;101113;USD;2014;Q4;2014-12-31;2015-03-02;84903719;86221562;22616000;465473000;;551894000;460408000;;3361000000;3821408000;4373302000;246339000;131969000;460907000;1527246000;1995210000;2456117000;290060000;;1743371000;1917185000;4373302000
SRCL;101113;USD;2013;Q4;2013-12-31;2014-02-28;85542231;87091937;67580000;388996000;;540265000;358967000;;2988741000;3347708000;3887973000;196591000;150380000;416184000;1280663000;1704251000;2120435000;195965000;;1610964000;1767538000;3887973000
SRCL;101113;USD;2012;Q4;2012-12-31;2013-02-28;85857927;87344554;31827000;322246000;;441286000;335870000;;2769582000;3105452000;3546738000;196878000;87781000;331060000;1268303000;1658355000;1989415000;117580000;;1463277000;1557323000;3546738000
SRCL;101113;USD;2011;Q4;2011-12-31;2012-02-28;84909664;86623734;22927000;290854000;;390596000;293912000;;2492582000;2786494000;3177090000;207156000;100526000;326914000;1284113000;1622925000;1949839000;847000;;1243303000;1227251000;3177090000
SRCL;101113;USD;2010;Q4;2010-12-31;2011-02-28;85278354;87404071;95524000;214899000;;368688000;267971000;;2002364000;2270335000;2639023000;189132000;91406000;308489000;1014222000;1250184000;1558673000;47797000;;1017497000;1080350000;2639023000
SRCL;101113;USD;2009;Q4;2009-12-31;2010-08-09;84351700;86493134;16898000;179770000;;246540000;246154000;;1690109000;1936263000;2182803000;139834000;78026000;232814000;910825000;1092816000;1325630000;48369000;;809618000;857173000;2182803000
SRCL;101113;USD;2017;Q4;2017-12-31;2018-02-26;85365118;85934708;42200000;624100000;;813400000;741000000;;5433900000;6174900000;6988300000;790300000;119500000;969400000;2615300000;3110300000;4079700000;1154100000;;2029500000;2908600000;6988300000
SRCL;101113;USD;2018;Q4;2018-12-31;2019-02-28;90600000;90000000;34300000;599600000;;747300000;743500000;;4964700000;5708200000;6455500000;581400000;104300000;733200000;2663900000;3125200000;3858400000;1163500000;;1789200000;2597100000;6455500000
VZ;101219;USD;2015;Q4;2015-12-31;2016-02-23;4073000000;4088000000;4820000000;13457000000;1252000000;22355000000;83541000000;;138279000000;221820000000;244175000000;19362000000;6489000000;35052000000;103240000000;191709000000;226761000000;11620000000;-7416000000;11246000000;17414000000;244175000000
VZ;101219;USD;2014;Q4;2014-12-31;2015-02-23;4172000000;4182000000;11153000000;13993000000;1153000000;29499000000;89947000000;;113170000000;203117000000;232616000000;16680000000;2735000000;27987000000;110536000000;191377000000;219364000000;11579000000;-3263000000;2447000000;13252000000;232616000000
VZ;101219;USD;2013;Q4;2013-12-31;2014-02-27;2867000000;2878000000;54129000000;12439000000;1020000000;70994000000;88956000000;;114148000000;203104000000;274098000000;16453000000;3933000000;27050000000;89658000000;152053000000;179103000000;38236000000;-3961000000;1782000000;94995000000;274098000000
VZ;101219;USD;2012;Q4;2012-12-31;2013-02-26;2864000000;2875000000;3563000000;12576000000;1075000000;21235000000;88642000000;;115345000000;203987000000;225222000000;16182000000;4369000000;26956000000;47618000000;113173000000;140129000000;38287000000;-4071000000;-3734000000;85093000000;225222000000
VZ;101219;USD;2011;Q4;2011-12-31;2012-02-24;2836000000;2845000000;13954000000;11776000000;940000000;30939000000;88434000000;;111088000000;199522000000;230461000000;14689000000;4849000000;30761000000;50303000000;114100000000;144861000000;38216000000;-5002000000;1179000000;85600000000;230461000000
VZ;101219;USD;2010;Q4;2010-12-31;2011-02-28;2828000000;2838000000;7213000000;11781000000;1131000000;22348000000;87711000000;;109946000000;197657000000;220005000000;15702000000;7542000000;30597000000;45252000000;102696000000;133293000000;38219000000;-5267000000;4368000000;86712000000;220005000000
VZ;101219;USD;2009;Q4;2009-12-31;2010-02-26;2276777400;2276777400;2499000000;12573000000;1426000000;21745000000;91985000000;;113177000000;205162000000;226907000000;15223000000;7205000000;29136000000;55051000000;113717000000;142853000000;40405000000;-5000000000;7260000000;84054000000;226907000000
VZ;101219;USD;2008;Q4;2008-12-31;2009-07-30;2273592800;2267195600;10291000000;11703000000;2092000000;26075000000;86546000000;4781000000;84950000000;176277000000;202352000000;13814000000;4993000000;25906000000;46959000000;97620000000;123526000000;40588000000;-4839000000;19250000000;78826000000;202352000000
VZ;101219;USD;2016;Q4;2016-12-31;2017-02-21;4082000000;4088000000;2880000000;17513000000;1202000000;26395000000;84751000000;;133034000000;217785000000;244180000000;19593000000;2645000000;30340000000;105433000000;190257000000;220597000000;11606000000;-7263000000;15059000000;23583000000;244180000000
VZ;101219;USD;2017;Q4;2017-12-31;2018-02-23;4088000000;4093000000;2079000000;23493000000;1034000000;29913000000;88568000000;;138662000000;227230000000;257143000000;21232000000;3453000000;33037000000;113642000000;179835000000;212872000000;11525000000;-7139000000;35635000000;44271000000;257143000000
VZ;101219;USD;2018;Q4;2018-12-31;2019-02-15;4137000000;4142000000;2745000000;25102000000;1336000000;34636000000;89286000000;;140907000000;230193000000;264829000000;22501000000;7190000000;37930000000;105873000000;172542000000;210472000000;13866000000;-6986000000;43542000000;54357000000;264829000000
BSQR;101318;USD;2015;Q4;2015-12-31;2016-02-11;12159000;12858000;29723000;19009000;;49312000;1167000;;4779000;5946000;55258000;15644000;;17077000;;1274000;18351000;133331000;;-95555000;36907000;55258000
BSQR;101318;USD;2014;Q4;2014-12-31;2015-02-19;11741000;12215000;26390000;13626000;;40733000;1336000;;5172000;6508000;47241000;16057000;;17044000;;1620000;18664000;131071000;;-101648000;28577000;47241000
BSQR;101318;USD;2013;Q4;2013-12-31;2014-02-25;11246000;11246000;20805000;15893000;;39023000;411000;;5214000;5625000;44648000;17012000;;19189000;;788000;19977000;129423000;;-103993000;24671000;44648000
BSQR;101318;USD;2012;Q4;2012-12-31;2013-02-22;11040000;12525000;19729000;16095000;;36978000;759000;;8054000;8813000;45791000;15589000;;16426000;;360000;16786000;128474000;;-98736000;29005000;45791000
BSQR;101318;USD;2011;Q4;2011-12-31;2012-02-23;10773000;9533000;18124000;13403000;;33328000;1037000;;8427000;9464000;42792000;14130000;;15363000;;394000;15757000;127318000;;-99652000;27035000;42792000
BSQR;101318;USD;2010;Q4;2010-12-31;2011-08-04;10288000;12628000;22143000;14128000;;36819000;653000;122000;4502000;5277000;42096000;15357000;;16774000;;240000;17014000;124716000;;-99189000;25082000;42096000
BSQR;101318;USD;2016;Q4;2016-12-31;2017-02-21;12476000;12047000;33200000;21579000;;55657000;1089000;;4262000;5351000;61008000;17836000;;20221000;;2675000;22896000;135660000;;-96607000;38112000;61008000
BSQR;101318;USD;2017;Q4;2017-12-31;2018-02-22;12642000;12344000;24754000;18014000;;43316000;989000;;5129000;6118000;49434000;13869000;;17427000;;577000;18004000;137622000;;-105276000;31430000;49434000
BSQR;101318;USD;2018;Q4;2018-12-31;2019-03-04;12757000;12757000;16414000;11581000;;28950000;911000;;2133000;3044000;31994000;10467000;;12119000;;1534000;13653000;138280000;;-119013000;18341000;31994000
CLR;101392;USD;2015;Q4;2015-12-31;2016-02-24;369666000;368303000;11463000;;94151000;822339000;14063328000;;34141000;14097469000;14919808000;917232000;2144000;923028000;7115644000;9327880000;10250908000;1349354000;;3322900000;4668900000;14919808000
CLR;101392;USD;2014;Q4;2014-12-31;2015-02-24;369098000;372114000;24381000;;102179000;1389601000;13635852000;;50580000;13686432000;15076033000;1795636000;2078000;1806664000;5926800000;8301525000;10108189000;1291661000;;3676568000;4967844000;15076033000
CLR;101392;USD;2013;Q4;2013-12-31;2014-02-27;368385000;370241000;28482000;;54440000;1147266000;10721272000;;72644000;10793916000;11941182000;1375174000;2011000;1473156000;4713821000;6514908000;7988064000;1253891000;;2699227000;3953118000;11941182000
CLR;101392;USD;2012;Q4;2012-12-31;2013-02-28;367926000;368458000;35729000;;46743000;946783000;8105269000;;87957000;8193226000;9140009000;1104847000;1950000;1125865000;3537771000;4850445000;5976310000;1228691000;;1935008000;3163699000;9140009000
CLR;101392;USD;2011;Q4;2011-12-31;2012-02-24;1076544236;1081661052;53544000;;41270000;936373000;4681733000;;27980000;4709713000;5646086000;982590000;;1111801000;1254301000;2226159000;3337960000;1112503000;;1195623000;2308126000;5646086000
CLR;101392;USD;2010;Q4;2010-12-31;2011-02-25;338546000;338808000;7916000;;38362000;582326000;2981991000;;27468000;3009459000;3591785000;618772000;;702222000;925991000;1681408000;2383630000;441604000;;766551000;1208155000;3591785000
CLR;101392;USD;2009;Q4;2009-12-31;2010-08-06;;;14222000;;26711000;236028000;2068055000;;10844000;2078899000;2314927000;203331000;;219710000;523524000;1064938000;1284648000;431983000;;598296000;1030279000;2314927000
CLR;101392;USD;2016;Q4;2016-12-31;2017-02-22;370540000;370540000;16643000;;111987000;913233000;12881227000;;17316000;12898543000;13811776000;870537000;2219000;932393000;6577697000;8577387000;9509780000;1379035000;;2923221000;4301996000;13811776000
CLR;101392;USD;2017;Q4;2017-12-31;2018-02-21;371180000;377593000;43902000;;97406000;1251725000;12933789000;;14137000;12947926000;14199651000;1327813000;2286000;1330242000;6351405000;7738206000;9068448000;1413078000;;3717818000;5131203000;14199651000
CLR;101392;USD;2018;Q4;2018-12-31;2019-02-19;371992000;376043000;282749000;;88544000;1412361000;13869800000;;15786000;13885586000;15297947000;1384946000;2360000;1387509000;5765989000;7488577000;8876086000;1438583000;;4706135000;6421861000;15297947000
DNKN;101599;USD;2017;Q4;2017-12-31;2018-02-26;90274297;91765912;1018317000;121849000;;1304333000;181542000;140615000;2310943000;2633100000;3937433000;53417000;32096000;485499000;3043037000;3706473000;4191972000;724204000;-1060000;-968148000;-254539000;3937433000
DNKN;101599;USD;2016;Q4;2016-12-31;2017-02-22;91464808;92517251;361425000;85184000;;606358000;176662000;114738000;2329624000;2621024000;3227382000;12682000;25589000;424201000;2409548000;2966439000;3390640000;807583000;-1060000;-945797000;-163258000;3227382000
DNKN;101599;USD;2015;Q4;2015-12-31;2016-02-18;93204037;94124537;260430000;128360000;;557824000;182614000;106878000;2349803000;2639295000;3197119000;18663000;25546000;418792000;2428097000;2999070000;3417862000;876649000;-1075000;-1076479000;-220743000;3197119000
DNKN;101599;USD;2014;Q4;2014-12-31;2015-02-19;104437126;105687482;208080000;105060000;;393402000;182061000;164493000;2384444000;2730998000;3124400000;13814000;4358000;355519000;1803198000;2393931000;2749450000;1093467000;0;-711531000;374950000;3124400000
DNKN;101599;USD;2013;Q4;2013-12-31;2014-02-20;106743589;108332148;256933000;79765000;;461760000;182858000;170644000;2419428000;2772930000;3234690000;12445000;5432000;344298000;1825605000;2478104000;2822402000;1196533000;-10773000;-779741000;412288000;3234690000
DNKN;101599;USD;2012;Q4;2012-12-31;2013-02-22;105837976;107916672;252618000;53056000;;419780000;181172000;174823000;2441738000;2797733000;3217513000;16256000;27051000;353515000;1830529000;2514023000;2867538000;1251604000;0;-914094000;349975000;3217513000
DNKN;101599;USD;2011;Q4;2011-12-31;2012-02-24;122920975;122920975;246715000;58787000;;406474000;185360000;164636000;2467548000;2817544000;3224018000;25281000;15197000;316540000;1458272000;2161542000;2478082000;1478410000;;-752075000;745936000;3224018000
DNKN;101599;USD;2010;Q4;2010-12-31;2011-08-04;;;134100000;79943000;;284377000;193273000;169276000;2500362000;2862911000;3147288000;9822000;12705000;280555000;1852176000;2560492000;2841047000;195254000;-1807000;-741415000;306241000;3147288000
DNKN;101599;USD;2018;Q4;2018-12-31;2019-02-27;82699284;83744389;517594000;140375000;;813473000;209202000;146395000;2287511000;2643108000;3456581000;80037000;31650000;539581000;3018100000;3629797000;4169378000;642017000;-1060000;-1338709000;-712797000;3456581000
NKE;101814;USD;2016;Q4;2016-05-31;2016-07-21;1682300000;1726700000;5457000000;3241000000;4838000000;15025000000;3520000000;;2834000000;6354000000;21379000000;5313000000;45000000;5358000000;1993000000;3763000000;9121000000;7786000000;;4151000000;12255000000;21376000000
NKE;101814;USD;2015;Q4;2015-05-31;2015-07-23;1715100000;1765500000;5924000000;3358000000;4337000000;15587000000;3011000000;;2999000000;6010000000;21597000000;6151000000;181000000;6332000000;1079000000;2558000000;8890000000;6773000000;;4685000000;12704000000;21594000000
NKE;101814;USD;2014;Q4;2014-05-31;2014-07-25;1747400000;1794200000;5142000000;3434000000;3947000000;13696000000;2834000000;;2064000000;4898000000;18594000000;4853000000;174000000;5027000000;1199000000;2743000000;7770000000;5865000000;;4871000000;10821000000;18591000000
NKE;101814;USD;2013;Q4;2013-05-31;2013-07-23;1785400000;1836000000;5965000000;3117000000;3484000000;13630000000;2452000000;;1463000000;3915000000;17545000000;3789000000;155000000;3962000000;1210000000;2502000000;6464000000;5184000000;;5620000000;11078000000;17542000000
NKE;101814;USD;2012;Q4;2012-05-31;2012-07-24;1832800000;1876600000;3757000000;3132000000;3222000000;11845000000;2209000000;;1411000000;3620000000;15465000000;3555000000;157000000;3882000000;228000000;1202000000;5084000000;4641000000;;5588000000;10378000000;15462000000
NKE;101814;USD;2011;Q4;2011-05-31;2011-07-22;1877600000;1923600000;4538000000;3138000000;2715000000;11297000000;2115000000;;1586000000;3701000000;14998000000;3571000000;387000000;3958000000;276000000;1197000000;5155000000;3944000000;;5801000000;9840000000;14995000000
NKE;101814;USD;2010;Q4;2010-05-31;2010-07-20;1938400000;1988800000;5146000000;2650000000;2041000000;10959000000;1932000000;;1528000000;3460000000;14419000000;3218000000;146000000;3364000000;446000000;1301000000;4665000000;3441000000;;6095000000;9751000000;14416000000
NKE;101814;USD;2009;Q4;2009-05-31;2009-10-08;;;3455100000;2883900000;2357000000;9734000000;1957700000;;1557900000;3515600000;13249600000;2902100000;374900000;3277000000;437200000;1279200000;4556200000;2873900000;;5451400000;8693100000;13249300000
NKE;101814;USD;2017;Q4;2017-05-31;2017-07-20;1647000000;1679600000;6179000000;3677000000;5055000000;16061000000;3989000000;;3209000000;7198000000;23259000000;5143000000;331000000;5474000000;3471000000;5378000000;10852000000;8638000000;;3979000000;12404000000;23256000000
NKE;101814;USD;2018;Q4;2018-05-31;2018-07-25;1605600000;1675100000;5245000000;3498000000;5261000000;15134000000;4454000000;;2948000000;7402000000;22536000000;5698000000;342000000;6040000000;3468000000;6684000000;12724000000;6384000000;;3517000000;9809000000;22533000000
NKE;101814;USD;2019;Q4;2019-05-31;2019-07-23;1570600000;1608900000;4663000000;4272000000;5622000000;16525000000;4744000000;;2448000000;7192000000;23717000000;7851000000;15000000;7866000000;3464000000;6811000000;14677000000;7163000000;;1643000000;9037000000;23714000000
LRCX;101897;USD;2018;Q4;2018-06-30;2018-08-14;160918000;198334000;4949595000;2176936000;1876162000;9149911000;902547000;;2427020000;3329567000;12479478000;1820192000;610030000;3150308000;1806562000;2827319000;5977627000;6144582000;-7846476000;8261194000;6501851000;12479478000
LRCX;101897;USD;2017;Q4;2017-06-30;2017-08-15;162214000;186426000;6041162000;1673398000;1232916000;9142498000;685595000;;2294672000;2980267000;12122765000;1434004000;908439000;2950115000;1784974000;2355199000;5305314000;5845647000;-5216187000;6249691000;6817451000;12122765000
LRCX;101897;USD;2016;Q4;2016-06-30;2016-08-17;159861000;177647000;6827934000;1262145000;971911000;9213150000;639608000;;2411557000;3051165000;12264315000;1121109000;947733000;2418041000;3378129000;3951757000;6369798000;5573058000;-4429317000;4820109000;5894517000;12264315000
LRCX;101897;USD;2015;Q4;2015-06-30;2015-08-13;158591000;176573000;4076486000;1093582000;943346000;6270849000;621418000;;2472381000;3093799000;9364648000;949641000;1359650000;2631361000;1001382000;1630143000;4261504000;5366932000;-4302847000;4096855000;5103144000;9364648000
LRCX;101897;USD;2014;Q4;2014-06-30;2014-08-26;171525000;183256000;3065644000;800616000;740503000;4783662000;543496000;;2666148000;3209644000;7993306000;827811000;518267000;1582001000;817202000;1381570000;2963571000;5239729000;-3757076000;3575737000;5029735000;7993306000
LRCX;101897;USD;2013;Q4;2013-06-30;2013-08-27;162067000;170263000;2497218000;602624000;559317000;3793829000;603910000;;2852576000;3456486000;7250315000;664782000;514655000;1404475000;789256000;1356968000;2761443000;5084707000;-3539830000;2972688000;4488872000;7250315000
LRCX;101897;USD;2012;Q4;2012-06-30;2012-08-22;133994000;135054000;2862683000;765818000;632853000;4415109000;584596000;;3004947000;3589543000;8004652000;750956000;511139000;1426928000;761783000;1445943000;2872871000;4943726000;-2636936000;2858809000;5131781000;8004652000
LRCX;101897;USD;2011;Q4;2011-06-30;2011-08-19;123676000;124795000;2122247000;590568000;396607000;3273265000;270458000;;510144000;780602000;4053867000;522297000;4782000;680759000;738488000;903263000;1584022000;1531589000;-1761591000;2690086000;2469845000;4053867000
LRCX;101897;USD;2010;Q4;2010-06-30;2010-11-03;126355000;127198000;826457000;499890000;318479000;1756661000;200336000;;530395000;730731000;2487392000;430496000;4967000;558657000;17645000;160600000;719257000;1453065000;-1581417000;1966336000;1768135000;2487392000
OLLI;102057;USD;2016;Q4;2017-02-28;2017-03-29;60624000;62920000;98683000;301000;210107000;312830000;46333000;;680212000;726545000;1039375000;99744000;5077000;104821000;188923000;283293000;388114000;565922000;-86000;85425000;651261000;1039375000
OLLI;102057;USD;2015;Q4;2016-02-29;2016-04-11;58563000;60878000;30259000;183000;190608000;223806000;39292000;;680724000;720016000;943822000;91750000;5018000;96768000;193433000;285105000;381873000;536374000;-86000;25661000;561949000;943822000
OLLI;102057;USD;2014;Q4;2015-02-28;2015-09-11;48198877;49188981;21952000;318000;169872000;198277000;33926000;;684928000;718854000;917131000;82840000;7794000;90634000;313493000;409662000;500296000;393126000;-29000;23738000;416835000;917131000
OLLI;102057;USD;2017;Q4;2018-02-28;2018-04-04;61850000;65420000;39234000;1271000;255185000;303676000;54888000;;679635000;734523000;1038199000;126568000;10158000;136726000;38835000;105011000;241737000;583529000;-86000;213019000;796462000;1038199000
OLLI;102057;USD;2018;Q4;2019-02-28;2019-03-29;62912000;66033000;51941000;570000;296407000;358497000;119052000;;681454000;800506000;1159003000;150758000;238000;150996000;441000;65355000;216351000;600297000;-86000;342441000;942652000;1159003000
WBC;102132;USD;2018;Q4;2018-12-31;2019-02-15;51704073;52115811;639600000;611500000;319100000;1796900000;553600000;;1388100000;1941700000;3738600000;546100000;;596000000;845200000;1877400000;2473400000;899300000;-2159300000;2960800000;1265200000;3738600000
WBC;102132;USD;2017;Q4;2017-12-31;2018-02-16;53709879;54020481;1142100000;669200000;321400000;2394200000;522300000;;1406900000;1929200000;4323400000;1019500000;;1073300000;1023300000;2049000000;3122300000;884000000;-1861300000;2563200000;1201100000;4323400000
WBC;102132;USD;2016;Q4;2016-12-31;2017-02-17;54825216;55498926;862500000;493700000;223600000;1874000000;408600000;;773400000;1182000000;3056000000;466800000;;530900000;958900000;1757800000;2288700000;862000000;-1744400000;2161100000;767300000;3056000000
WBC;102132;USD;2015;Q4;2015-12-31;2016-02-11;57144859;57831983;559000000;444000000;212700000;1386400000;398000000;;805500000;1203500000;2589900000;427800000;;464800000;498700000;1288800000;1753600000;853400000;-1497300000;1938500000;836300000;2589900000
WBC;102132;USD;2014;Q4;2014-12-31;2015-02-19;58582537;59182966;411700000;445600000;189600000;1161700000;424900000;;846100000;1271000000;2432700000;391900000;;417700000;307100000;1126000000;1543700000;829100000;-1248100000;1663300000;889000000;2432700000
WBC;102132;USD;2013;Q4;2013-12-31;2014-02-13;61837704;62710200;528000000;346200000;207200000;1234600000;422500000;;735700000;1158200000;2392800000;455600000;;485400000;47000000;710000000;1195400000;801000000;-896600000;1371800000;1197400000;2392800000
WBC;102132;USD;2012;Q4;2012-12-31;2013-02-15;63062293;64364876;175000000;301500000;191800000;792600000;389000000;;565400000;954400000;1747000000;411900000;;445700000;0;572600000;1018300000;736200000;-655800000;718600000;728700000;1747000000
WBC;102132;USD;2011;Q4;2011-12-31;2012-02-17;65308056;67602253;102400000;296300000;198000000;750700000;357400000;;515100000;872500000;1623200000;393200000;;451600000;52000000;535800000;987400000;694100000;-456800000;416600000;635800000;1623200000
WBC;102132;USD;2010;Q4;2010-12-31;2011-02-17;65199438;61578278;67100000;265900000;192600000;657700000;350300000;;516900000;867200000;1524900000;396700000;;500500000;96800000;564400000;1064900000;647100000;-276300000;59600000;460000000;1524900000
WBC;102132;USD;2009;Q4;2009-12-31;2010-07-28;64071193;68096473;350200000;264200000;155300000;815700000;368200000;;531700000;899900000;1715600000;258400000;;355200000;154400000;681500000;1036700000;592200000;-276300000;285700000;678900000;1715600000
CP;102322;USD;2016;Q4;2016-12-31;2017-02-16;146400000;147300000;164000000;591000000;184000000;1009000000;16689000000;194000000;1329000000;18212000000;19221000000;1322000000;25000000;1347000000;8659000000;13248000000;14595000000;2054000000;;4371000000;4626000000;19221000000
CP;102322;USD;2015;Q4;2015-12-31;2016-02-29;152600000;154000000;650000000;645000000;188000000;1537000000;16273000000;152000000;1675000000;18100000000;19637000000;1417000000;30000000;1447000000;8927000000;13394000000;14841000000;2101000000;;4172000000;4796000000;19637000000
CP;102322;USD;2014;Q4;2014-12-31;2016-02-29;;;226000000;702000000;177000000;1221000000;14438000000;112000000;779000000;15329000000;16550000000;1277000000;134000000;1411000000;5625000000;9529000000;10940000000;2221000000;;5608000000;5610000000;16550000000
CP;102322;USD;2017;Q4;2017-12-31;2018-02-16;145100000;145400000;338000000;687000000;152000000;1274000000;17016000000;182000000;1663000000;18861000000;20135000000;1238000000;746000000;1984000000;7413000000;11714000000;13698000000;2075000000;;6103000000;6437000000;20135000000
CP;102322;USD;2018;Q4;2018-12-31;2019-02-15;141800000;142100000;61000000;815000000;173000000;1117000000;18418000000;203000000;1516000000;20137000000;21254000000;1449000000;506000000;1955000000;8190000000;12663000000;14618000000;2044000000;;6635000000;6636000000;21254000000
WINA;102395;USD;2015;Q4;2015-12-31;2016-03-08;4129268;4331635;1234500;1416900;45200;24431300;1121500;21246000;607500;22975000;47406300;3519000;2028700;7510900;64316500;70569200;78080100;406500;;-31047400;-30673800;47406300
WINA;102395;USD;2014;Q4;2014-12-31;2015-03-11;4997830;5159802;2556500;1328200;93500;28441100;1420300;24188900;677500;26286700;54727800;3714700;227300;24584600;25800;8533700;33118300;422400;;21224200;21609500;54727800
WINA;102395;USD;2013;Q4;2013-12-31;2014-03-12;5137422;5297885;11379100;1205500;96700;30675000;1382200;20301400;677500;22361100;53036100;3674500;424900;10507500;277400;4383900;14891400;2949500;;35199300;38144700;53036100
WINA;102395;USD;2012;Q4;2012-12-31;2013-03-14;4986973;5179518;2319300;1237100;71200;18934700;1229500;22697100;677500;24604100;43538800;3624800;896800;20513200;177900;5097600;25610800;;;17932000;17928000;43538800
WINA;102395;USD;2011;Q4;2011-12-31;2012-03-15;4975666;5235378;10063900;1316200;68500;23674000;1474800;21919400;677500;24071700;47745700;2806300;20800;7779000;;4858000;12637000;629800;;34461900;35108700;47745700
WINA;102395;USD;2010;Q4;2010-12-31;2011-07-25;5013765;5231572;2418100;1841300;85900;18879300;1785900;20776300;680500;23242700;42122000;2787800;530400;15284200;26500;3824800;19109000;513700;;22499300;23013000;42122000
WINA;102395;USD;2016;Q4;2016-12-31;2017-03-10;4149959;4361109;1452800;1479200;87500;22793800;769600;24410700;607500;25787800;48581600;3503100;1990000;7357800;43326500;49075800;56433600;2976100;;-10818200;-7852000;48581600
WINA;102395;USD;2017;Q4;2017-12-31;2018-03-09;3830390;4111222;1073200;1796000;97100;21365200;486800;25945300;607500;27039600;48404800;3910300;3806900;9453400;65362600;69629600;79083000;1476200;;-32154400;-30678200;48404800
WINA;102395;USD;2018;Q4;2018-12-31;2019-03-08;3906797;4176669;2496000;1553100;107600;24251300;866200;20455500;1090100;22411800;46663100;4480400;6258000;12483300;28328400;38988300;51471600;4425600;;-9234100;-4808500;46663100
URI;102754;USD;2015;Q4;2015-12-31;2016-01-27;92813000;93513000;179000000;930000000;69000000;1294000000;6631000000;;4158000000;10789000000;12083000000;626000000;607000000;1233000000;7555000000;9374000000;10607000000;2198000000;-1560000000;1088000000;1476000000;12083000000
URI;102754;USD;2014;Q4;2014-12-31;2015-01-21;99244000;103730000;158000000;940000000;78000000;1298000000;6446000000;;4385000000;10831000000;12129000000;860000000;618000000;1478000000;7344000000;8853000000;10331000000;2171000000;-802000000;503000000;1798000000;12129000000
URI;102754;USD;2013;Q4;2013-12-31;2014-01-22;93295000;106521000;175000000;804000000;70000000;1362000000;5795000000;;4074000000;9869000000;11231000000;682000000;604000000;1286000000;6569000000;8097000000;9383000000;2075000000;-209000000;-37000000;1848000000;11231000000
URI;102754;USD;2012;Q4;2012-12-31;2013-01-23;92939000;114622000;106000000;793000000;68000000;1343000000;5394000000;;4289000000;9683000000;11026000000;721000000;630000000;1351000000;6734000000;8101000000;9452000000;2029000000;-115000000;-424000000;1574000000;11026000000
URI;102754;USD;2011;Q4;2011-12-31;2012-02-07;62767000;85160000;36000000;464000000;44000000;723000000;2983000000;;437000000;3420000000;4143000000;469000000;395000000;864000000;2647000000;3176000000;4040000000;527000000;0;-499000000;103000000;4143000000
URI;102754;USD;2010;Q4;2010-12-31;2011-07-19;;;203000000;377000000;39000000;725000000;2673000000;;295000000;2968000000;3693000000;340000000;229000000;569000000;2700000000;3144000000;3713000000;493000000;;-600000000;-20000000;3693000000
URI;102754;USD;2016;Q4;2016-12-31;2017-01-25;84318000;85239000;312000000;920000000;68000000;1361000000;430000000;;10197000000;10627000000;11988000000;587000000;597000000;1184000000;7193000000;9156000000;10340000000;2289000000;-2077000000;1654000000;1648000000;11988000000
URI;102754;USD;2017;Q4;2017-12-31;2018-01-24;84642000;85871000;352000000;1233000000;75000000;1772000000;467000000;;12791000000;13258000000;15030000000;945000000;723000000;1668000000;8717000000;10256000000;11924000000;2357000000;-2105000000;3005000000;3106000000;15030000000
URI;102754;USD;2018;Q4;2018-12-31;2019-01-23;80552000;81511000;43000000;1545000000;109000000;1761000000;614000000;;15758000000;16372000000;18133000000;1213000000;903000000;2116000000;10844000000;12614000000;14730000000;2409000000;-2870000000;4101000000;3403000000;18133000000
NVEC;102816;USD;2016;Q4;2017-03-31;2016-05-04;4839498;4838865;27791197;3436802;3358298;35193580;1413248;56810923;357055;58581226;93774806;952588;;1095321;;;1095321;19555758;;73162025;92679485;93774806
NVEC;102816;USD;2015;Q4;2016-03-31;2016-05-04;4845752;4844457;27231977;2244086;3205233;33415820;1691713;65695335;51188;67438236;100854056;874664;;1589469;;;1589469;19254032;;79559196;99264587;100854056
NVEC;102816;USD;2014;Q4;2015-03-31;2015-05-06;4857949;4872178;29536550;2963974;3742492;36919981;2255408;70913807;0;73169215;110089196;1485954;;1485954;;275708;1761662;20899342;;86681745;108327534;110089196
NVEC;102816;USD;2013;Q4;2014-03-31;2014-06-06;4848661;4853155;13622391;2331574;3207333;20214961;3004772;82022310;;85027082;105242043;1182802;;1182802;;354600;1537402;20513393;;82313391;103704641;105242043
NVEC;102816;USD;2012;Q4;2013-03-31;2013-05-01;4861435;4810636;12220712;2521395;3336592;19036846;3688393;73040257;;76728650;95765496;1340152;;1780888;;0;1780888;21249366;;71177516;93984608;95765496
NVEC;102816;USD;2011;Q4;2012-03-31;2012-05-02;4824653;4790015;19096165;2684840;3229376;26170233;2511232;54445298;;56956530;83126763;1531033;;1667905;;;1667905;21022724;;59348678;81458858;83126763
NVEC;102816;USD;2010;Q4;2011-03-31;2011-07-25;4771331;4788879;8922567;3596239;3343857;17047969;1531116;53257140;;54788256;71836225;1718983;;1865676;;;1865676;20942528;;47967583;69970549;71836225
NVEC;102816;USD;2017;Q4;2018-03-31;2018-05-02;4841999;4845675;25520891;2888779;3650439;32695269;1325383;52838158;572655;54736196;87431465;989725;;989725;;;989725;19647718;;67709657;86441740;87431465
NVEC;102816;USD;2018;Q4;2019-03-31;2019-05-01;4845988;4848638;19365125;2995638;4264876;27441684;894835;54925633;353735;56174203;83615887;835676;;835676;0;0;835676;19959018;;62903918;82780211;83615887
GGG;103052;USD;2016;Q4;2016-12-31;2017-02-21;;171366000;52365000;218365000;201609000;503362000;189596000;;550151000;739747000;1243109000;97185000;8913000;177985000;305685000;491304000;669289000;509228000;;206820000;573820000;1243109000
GGG;103052;USD;2015;Q4;2015-12-31;2016-02-16;;171831000;52295000;225509000;202136000;509017000;178437000;;703898000;882335000;1391352000;103625000;15901000;194616000;392695000;561185000;755801000;454540000;;285508000;635551000;1391352000
GGG;103052;USD;2014;Q4;2014-12-31;2015-02-17;;182916000;445423000;214944000;159797000;839538000;161230000;;544010000;705240000;1544778000;97871000;5016000;172737000;615000000;776009000;948746000;443903000;;252865000;596032000;1544778000
GGG;103052;USD;2013;Q4;2013-12-31;2014-02-18;;188745000;442053000;183293000;133787000;792593000;151717000;;382918000;534635000;1327228000;90102000;9584000;168853000;408370000;524010000;692863000;408061000;;272653000;634365000;1327228000
GGG;103052;USD;2012;Q4;2012-12-31;2013-02-19;;-554016468;457933000;172143000;121549000;776996000;151544000;;393194000;544738000;1321734000;78145000;8133000;151671000;556480000;715949000;867620000;348562000;;189297000;454114000;1321734000
GGG;103052;USD;2011;Q4;2011-12-31;2012-02-21;;-553798560;303150000;150912000;105347000;582970000;138248000;;153091000;291339000;874309000;73028000;8658000;131282000;300000000;420287000;551569000;301754000;;97467000;322740000;874309000
GGG;103052;USD;2010;Q4;2010-12-31;2011-02-22;;-546830364;9591000;124593000;91620000;252408000;134185000;;143881000;278066000;530474000;67186000;8183000;119754000;70255000;146606000;266360000;272121000;;44436000;264114000;530474000
GGG;103052;USD;2009;Q4;2009-12-31;2010-04-21;;;5412000;100824000;58658000;188993000;139053000;;148388000;287441000;476434000;44414000;12028000;103815000;86260000;162965000;266780000;250260000;;11121000;209654000;476434000
GGG;103052;USD;2017;Q4;2017-12-31;2018-02-20;;175743000;103662000;256421000;239349000;631926000;204298000;;542981000;747279000;1379205000;126892000;6578000;234426000;226035000;421716000;656142000;669253000;;181599000;723063000;1379205000
GGG;103052;USD;2018;Q4;2018-12-31;2019-02-19;;170901000;132118000;274608000;283982000;723216000;229295000;;520230000;749525000;1472741000;145679000;11083000;299803000;266391000;421065000;720868000;675996000;;220734000;751873000;1472741000
MIXX;103135;USD;2015;Q4;2015-08-31;2015-12-16;13063237;;434;279702;472587;790606;139394;;21825843;21965237;22755843;2541896;442404;2984300;4195001;8258247;11242547;31306352;;-19793056;11513296;22755843
MIXX;103135;USD;2014;Q4;2014-08-31;2014-11-28;10301637;;91794;0;580607;700364;5375;;19880000;19885375;20585739;583300;;583300;500000;500000;1083300;21558729;;-2056290;19502439;20585739
MIXX;103135;USD;2013;Q4;2013-08-31;2013-11-21;-3124112;;0;;0;0;0;;19880000;19880000;19880000;32771;;32771;0;0;32771;19908000;;-60771;19847229;19880000
SLM;103225;USD;2018;Q4;2018-12-31;2019-02-28;435609000;440283000;2735351000;1191981000;;26362610000;105504000;;170059000;275563000;26638173000;18943158000;;19381213000;4284304000;4284304000;23665517000;1364607000;-142591000;1340017000;2972656000;26638173000
SLM;103225;USD;2017;Q4;2017-12-31;2018-02-23;432010000;438935000;1778427000;967482000;;21415386000;89748000;;274450000;364198000;21779584000;15607668000;;16030058000;3275270000;3275270000;19305328000;1310970000;-107644000;868182000;2474256000;21779584000
SLM;103225;USD;2016;Q4;2016-12-31;2017-02-24;428374000;435454000;2127396000;766106000;;18344673000;87063000;;101267000;188330000;18533003000;13619991000;;14017966000;2167979000;2167979000;16185945000;1262891000;-67484000;595322000;2347058000;18533003000
SLM;103225;USD;2015;Q4;2015-12-31;2016-02-26;426161000;431345000;2611610000;564496000;;15020753000;81273000;;112072000;193345000;15214098000;11654369000;500175000;12538674000;579101000;579101000;13117775000;1221996000;-41223000;366609000;2096323000;15214098000
SLM;103225;USD;2014;Q4;2014-12-31;2015-02-26;423279000;432072000;2528714000;469697000;;12753312000;78470000;;140461000;218931000;12972243000;10732054000;0;11142285000;0;0;11142285000;1175472000;-12187000;113066000;1829958000;12972243000
SLM;103225;USD;2013;Q4;2013-12-31;2014-02-19;433351000;443193000;2284970000;356283000;;10572630000;74188000;;59846000;134034000;10706664000;9163755000;;9540521000;;0;9540521000;1164495000;0;0;1166143000;10706664000
SLM;103225;USD;2012;Q4;2012-12-31;2013-02-26;-2149830000;-2178694000;3972000000;;;172539000000;;;8721000000;8721000000;181260000000;;19856000000;23793000000;152401000000;152401000000;176194000000;4344000000;-1294000000;1451000000;5066000000;181260000000
SLM;103225;USD;2011;Q4;2011-12-31;2012-02-27;1415788000;1468950000;2864000000;;;184209000000;;;9136000000;9136000000;193345000000;;29573000000;33701000000;154393000000;154393000000;188094000000;4242000000;-320000000;770000000;5251000000;193345000000
SLM;103225;USD;2010;Q4;2010-12-31;2011-02-28;1381957382;1155512444;4426000000;;;195859000000;;;9448000000;9448000000;205307000000;;33616000000;36752000000;163543000000;163543000000;200295000000;6059000000;-1876000000;309000000;5012000000;205307000000
SLM;103225;USD;2009;Q4;2009-12-31;2010-02-26;1343487680;1352502836;7343288000;;;157059322000;;;12925976000;12925976000;169985298000;;30896811000;34160404000;130546272000;130546272000;164706676000;5201335000;-1861738000;604467000;5278622000;169985298000
SLM;103225;USD;2008;Q4;2008-12-31;2009-08-05;1305807014;1305807014;4931010000;;;154178143000;;;14590294000;14590294000;168768437000;;41933043000;45537303000;118224794000;118224794000;163762097000;4790995000;-1856394000;426175000;5006340000;168768437000
ISRG;103498;USD;2016;Q4;2016-12-31;2017-02-06;115500000;119400000;2554600000;430200000;182300000;3250400000;458400000;2283300000;494800000;3236500000;6486900000;355900000;;596500000;;112600000;709100000;4211800000;;1574900000;5777800000;6486900000
ISRG;103498;USD;2015;Q4;2015-12-31;2016-02-02;112500000;114300000;1559800000;394300000;167900000;2195500000;432100000;1788000000;491700000;2711800000;4907300000;266300000;;491900000;;95900000;587800000;3429800000;;899200000;4319500000;4907300000
ISRG;103498;USD;2014;Q4;2014-12-31;2015-02-06;108900000;111600000;1232500000;315100000;181700000;1811900000;387400000;1264500000;495600000;2147500000;3959400000;284600000;;501200000;;78800000;580000000;2896800000;;487700000;3379400000;3959400000
ISRG;103498;USD;2013;Q4;2013-12-31;2014-02-03;114000000;116700000;1403500000;301400000;179600000;1932400000;309900000;1350400000;357600000;2017900000;3950300000;180800000;;380900000;;68000000;448900000;2519900000;;979400000;3501400000;3950300000
ISRG;103498;USD;2012;Q4;2012-12-31;2013-02-04;119700000;123000000;1324400000;370300000;121500000;1892800000;241800000;1596100000;328500000;2166400000;4059200000;215900000;;401600000;;77500000;479100000;2240100000;;1333400000;3580100000;4059200000
ISRG;103498;USD;2011;Q4;2011-12-31;2012-02-06;118200000;120600000;1029200000;297900000;112100000;1466300000;197200000;1142600000;257000000;1596800000;3063100000;166400000;;320600000;;96900000;417500000;1742800000;;901900000;2645600000;3063100000
ISRG;103498;USD;2010;Q4;2010-12-31;2011-02-01;117900000;120000000;910400000;246800000;86800000;1275800000;159800000;698500000;256300000;1114600000;2390400000;147700000;;273800000;;79200000;353000000;1316900000;;718900000;2037400000;2390400000
ISRG;103498;USD;2009;Q4;2009-12-31;2010-01-29;114960000;119094000;555400000;205400000;57600000;847100000;125700000;616600000;220300000;962600000;1809700000;103400000;;202800000;;69600000;272400000;1024300000;;511700000;1537300000;1809700000
ISRG;103498;USD;2008;Q4;2008-12-31;2009-07-23;117690000;118998000;451369000;170107000;63460000;703890000;117021000;450504000;203209000;770734000;1474624000;86535000;;164516000;;43342000;207858000;871885000;;397824000;1266766000;1474624000
ISRG;103498;USD;2017;Q4;2017-12-31;2018-02-02;112100000;117700000;1960600000;507900000;241200000;2808900000;613100000;1885900000;468900000;2967900000;5776800000;419000000;;662800000;;333600000;996400000;4679300000;;115000000;4780400000;5776800000
ISRG;103498;USD;2018;Q4;2018-12-31;2019-02-04;114500000;119500000;3063100000;682300000;409000000;4333200000;812000000;1771300000;930200000;3513500000;7846700000;526300000;;820600000;;338600000;1159200000;5170400000;;1521700000;6687500000;7846700000
IVTY;103578;USD;2016;Q4;2016-12-31;2017-03-16;16986236;16986236;39037000;5782000;5052000;51140000;8286000;;909000;9195000;60335000;8543000;;9905000;;15982000;25887000;180664000;;-146216000;34448000;60335000
IVTY;103578;USD;2015;Q4;2015-12-31;2016-03-25;13508379;13508379;46296000;3619000;5182000;56020000;9195000;;1090000;10285000;66305000;6672000;;6672000;;17290000;23962000;147950000;;-105607000;42343000;66305000
IVTY;103578;USD;2014;Q4;2014-12-31;2015-08-12;669500;669500;6048000;2798000;4271000;15603000;8541000;;1180000;9721000;25324000;5237000;;5237000;;12159000;17396000;2210000;;-68037000;7928000;25324000
IVTY;103578;USD;2017;Q4;2017-12-31;2018-03-05;17166559;17166559;21002000;7421000;7436000;37314000;7169000;;1012000;8181000;45495000;8777000;;14636000;;31721000;46357000;185272000;;-186134000;-862000;45495000
LMT;103644;USD;2016;Q4;2016-12-31;2017-02-09;291100000;295400000;1837000000;8202000000;4670000000;15108000000;5549000000;;27149000000;32698000000;47806000000;3417000000;;12542000000;14282000000;33658000000;46200000000;289000000;;13324000000;1606000000;47806000000
LMT;103644;USD;2015;Q4;2015-12-31;2016-02-24;305400000;309800000;1090000000;7254000000;4819000000;14573000000;5389000000;;29342000000;34731000000;49304000000;3452000000;956000000;13918000000;14305000000;32289000000;46207000000;303000000;;14238000000;3097000000;49304000000
LMT;103644;USD;2014;Q4;2014-12-31;2015-02-09;315000000;320600000;1446000000;5877000000;2804000000;12322000000;4751000000;;19973000000;24724000000;37046000000;3386000000;;11112000000;6142000000;22534000000;33646000000;314000000;;14956000000;3400000000;37046000000
LMT;103644;USD;2013;Q4;2013-12-31;2014-02-14;319800000;326300000;2617000000;5834000000;2977000000;13329000000;4706000000;;18153000000;22859000000;36188000000;3206000000;;11120000000;6152000000;20150000000;31270000000;319000000;;14200000000;4918000000;36188000000
LMT;103644;USD;2012;Q4;2012-12-31;2013-02-28;322700000;327900000;1898000000;6563000000;2937000000;13855000000;4675000000;;20127000000;24802000000;38657000000;3687000000;150000000;12155000000;6158000000;26463000000;38618000000;321000000;;13211000000;39000000;38657000000
LMT;103644;USD;2011;Q4;2011-12-31;2012-02-23;322500000;326800000;3582000000;6064000000;2481000000;14094000000;4611000000;;19203000000;23814000000;37908000000;3933000000;;12130000000;6460000000;24777000000;36907000000;321000000;;11937000000;1001000000;37908000000
LMT;103644;USD;2010;Q4;2010-12-31;2011-02-25;355600000;359900000;2777000000;5692000000;2363000000;12893000000;4554000000;;17666000000;22220000000;35113000000;3497000000;;11401000000;5019000000;20215000000;31616000000;346000000;;12161000000;3497000000;35113000000
LMT;103644;USD;2009;Q4;2009-12-31;2010-02-25;377600000;381700000;2737000000;6061000000;2183000000;12477000000;4520000000;;18114000000;22634000000;35111000000;3678000000;;10703000000;5052000000;20279000000;30982000000;373000000;;12351000000;4129000000;35111000000
LMT;103644;USD;2008;Q4;2008-12-31;2009-07-22;;;2168000000;5296000000;1902000000;10683000000;4488000000;;18268000000;22756000000;33439000000;3714000000;242000000;10542000000;3563000000;20032000000;30574000000;393000000;;11621000000;2865000000;33439000000
LMT;103644;USD;2017;Q4;2017-12-31;2018-02-06;285600000;288400000;2861000000;8603000000;4487000000;17461000000;5775000000;;23285000000;29060000000;46521000000;3252000000;750000000;12637000000;13513000000;34493000000;47130000000;284000000;;11573000000;-609000000;46521000000
LMT;103644;USD;2018;Q4;2018-12-31;2019-02-08;283200000;285500000;772000000;2444000000;2997000000;16103000000;6124000000;;22649000000;28773000000;44876000000;4524000000;1500000000;14398000000;12604000000;29029000000;43427000000;281000000;;15434000000;1449000000;44876000000
NEM;103736;USD;2018;Q4;2018-12-31;2019-02-21;532000000;535000000;3445000000;346000000;1327000000;5277000000;12258000000;271000000;2909000000;15438000000;20715000000;679000000;653000000;1787000000;3608000000;7416000000;9203000000;10473000000;-70000000;383000000;11512000000;20715000000
NEM;103736;USD;2017;Q4;2017-12-31;2018-02-22;534000000;536000000;3321000000;237000000;1355000000;5066000000;12338000000;280000000;2962000000;15580000000;20646000000;932000000;4000000;1398000000;4061000000;7729000000;9127000000;10447000000;-30000000;410000000;11519000000;20646000000
NEM;103736;USD;2016;Q4;2016-12-31;2016-10-26;528000000;531000000;2812000000;343000000;1380000000;4677000000;12485000000;207000000;3662000000;16354000000;21031000000;777000000;566000000;1750000000;4049000000;7407000000;9157000000;10339000000;;716000000;11874000000;21031000000
NEM;103736;USD;2015;Q4;2015-12-31;2016-02-17;531000000;528000000;2382000000;215000000;1343000000;4023000000;13210000000;402000000;7495000000;21107000000;25130000000;631000000;9000000;1127000000;5854000000;9711000000;10838000000;10274000000;;1410000000;14292000000;25130000000
NEM;103736;USD;2014;Q4;2014-12-31;2015-02-20;500000000;498000000;2476000000;476000000;1366000000;5439000000;13650000000;334000000;5493000000;19477000000;24916000000;787000000;166000000;2198000000;6480000000;9629000000;11827000000;9510000000;;1242000000;13089000000;24916000000
NEM;103736;USD;2013;Q4;2013-12-31;2014-02-21;500000000;499000000;1633000000;482000000;1522000000;4889000000;14277000000;439000000;5002000000;19718000000;24607000000;832000000;595000000;2740000000;6145000000;8958000000;11698000000;9327000000;;848000000;12909000000;24607000000
NEM;103736;USD;2012;Q4;2012-12-31;2013-02-22;497000000;495000000;1647000000;860000000;1582000000;5945000000;18010000000;1446000000;4249000000;23705000000;29650000000;1047000000;10000000;3141000000;6288000000;9561000000;12702000000;9117000000;;4166000000;16948000000;29650000000
NEM;103736;USD;2011;Q4;2011-12-31;2012-02-24;495000000;510000000;1854000000;620000000;1385000000;5388000000;15881000000;1472000000;3370000000;20723000000;26111000000;1118000000;689000000;3940000000;3624000000;6400000000;10340000000;9192000000;;3052000000;15771000000;26111000000
NEM;103736;USD;2010;Q4;2010-12-31;2011-02-24;492000000;506000000;4169000000;670000000;1275000000;7253000000;12907000000;1568000000;3935000000;18410000000;25663000000;1070000000;259000000;2747000000;4182000000;7200000000;9947000000;9057000000;;3180000000;15716000000;25663000000
NEM;103736;USD;2009;Q4;2009-12-31;2010-02-25;496000000;493000000;3271000000;540000000;896000000;5822000000;12370000000;1186000000;2921000000;16477000000;22299000000;846000000;157000000;2320000000;4652000000;7366000000;9686000000;8928000000;;1149000000;12613000000;22299000000
NEM;103736;USD;2008;Q4;2008-12-31;2009-10-29;454000000;452000000;447000000;318000000;797000000;2301000000;10128000000;655000000;2643000000;13426000000;15727000000;642000000;165000000;1577000000;3072000000;5489000000;7066000000;7540000000;;4000000;8661000000;15727000000
EBAY;104109;USD;2015;Q4;2015-12-31;2016-02-01;1189000000;1203000000;6131000000;619000000;;7904000000;1554000000;3391000000;4906000000;9851000000;17755000000;421000000;0;2263000000;6749000000;8916000000;11179000000;14540000000;-16203000000;7713000000;6576000000;17755000000
EBAY;104109;USD;2014;Q4;2014-12-31;2015-02-06;1228000000;1210000000;7835000000;600000000;;26531000000;1486000000;5736000000;11379000000;18601000000;45132000000;232000000;850000000;17531000000;6777000000;7695000000;25226000000;13889000000;-14054000000;18900000000;19906000000;45132000000
EBAY;104109;USD;2013;Q4;2013-12-31;2014-01-31;-4055512000;-4114192000;9025000000;12948000000;;23283000000;2760000000;4971000000;10474000000;18205000000;41488000000;9676000000;6000000;12639000000;4117000000;5202000000;17841000000;13033000000;-9396000000;18854000000;23647000000;41488000000
EBAY;104109;USD;2012;Q4;2012-12-31;2013-02-01;3081672000;3138696000;9408000000;11076000000;;21398000000;2491000000;3044000000;10141000000;15676000000;37074000000;8458000000;413000000;10924000000;4106000000;5285000000;16209000000;12064000000;-8053000000;15998000000;20865000000;37074000000
EBAY;104109;USD;2011;Q4;2011-12-31;2012-01-31;3060288000;3107808000;5929000000;6151000000;;12661000000;1986000000;2453000000;10220000000;14659000000;27320000000;4548000000;565000000;6734000000;1525000000;2656000000;9390000000;11147000000;-7155000000;13389000000;17930000000;27320000000
EBAY;104109;USD;2010;Q4;2010-12-31;2011-01-28;3097881072;3145695696;6622814000;3961286000;;11065338000;1523333000;2492012000;6923079000;10938424000;22003762000;2776162000;300000000;4516514000;1494227000;2185069000;6701583000;10482222000;-6091435000;10160078000;15302179000;22003762000
EBAY;104109;USD;2009;Q4;2009-12-31;2010-02-17;3072776256;3137275152;4943804000;3188298000;;8460208000;1314328000;1381765000;7252019000;9948112000;18408320000;2560879000;0;3641968000;0;978704000;4620672000;9987685000;-5377258000;8359117000;13787648000;18408320000
EBAY;104109;USD;2008;Q4;2008-12-31;2009-07-29;3039647688;3050912304;3352662000;2473230000;;6286590000;1198714000;106178000;8000957000;9305849000;15592439000;1738717000;1000000000;3705087000;;803494000;4508581000;9587323000;-5376970000;5970020000;11083858000;15592439000
EBAY;104109;USD;2016;Q4;2016-12-31;2017-02-06;1103000000;1118000000;7149000000;592000000;;8875000000;1516000000;3969000000;9487000000;14972000000;23847000000;393000000;1451000000;3847000000;7509000000;9461000000;13308000000;14909000000;-19205000000;14959000000;10539000000;23847000000
EBAY;104109;USD;2017;Q4;2017-12-31;2018-02-05;1035000000;985000000;5863000000;696000000;;7744000000;1597000000;6331000000;10314000000;18242000000;25986000000;507000000;781000000;3559000000;9234000000;14378000000;17937000000;15295000000;-21892000000;13929000000;8049000000;25986000000
EBAY;104109;USD;2018;Q4;2018-12-31;2019-01-30;944000000;948000000;4915000000;712000000;;7126000000;1597000000;3778000000;10318000000;15693000000;22819000000;403000000;1546000000;4454000000;7685000000;12084000000;16538000000;15718000000;-26394000000;16459000000;6281000000;22819000000
ALV;104657;USD;2017;Q4;2017-12-31;2018-02-22;154722400;154938800;959500000;1696700000;704300000;4204700000;1608900000;341000000;2395300000;4345200000;8549900000;1786800000;19700000;2654600000;1310700000;1725900000;4380500000;1432100000;-1188700000;4079200000;4169400000;8549900000
ALV;104657;USD;2016;Q4;2016-12-31;2017-02-23;122560400;122699200;1226700000;1960100000;773400000;4140900000;1658100000;352200000;2083200000;4093500000;8234400000;2199100000;219800000;2597600000;1323600000;1710400000;4308000000;1432100000;-1051200000;3861800000;3926400000;8234400000
ALV;104657;USD;2015;Q4;2015-12-31;2016-02-19;122560400;122699200;1333500000;1787600000;711400000;4038300000;1437100000;255800000;1794300000;3487200000;7525500000;1996300000;39600000;2226400000;1499400000;1831000000;4057400000;1432100000;-1067400000;3499400000;3468100000;7525500000
ALV;104657;USD;2014;Q4;2014-12-31;2015-02-19;124364800;124781200;1529000000;1706300000;675500000;4136200000;1390200000;255300000;1661200000;3306700000;7442900000;1880700000;79600000;2138600000;1521200000;1862200000;4000800000;1432100000;-992000000;3240000000;3442100000;7442900000
ALV;104657;USD;2013;Q4;2013-12-31;2014-02-21;131721200;132692800;1118300000;1688000000;661800000;3700400000;1336200000;259000000;1687400000;3282600000;6983000000;1908600000;339400000;2428500000;279100000;554100000;2982600000;1432100000;-417200000;2965900000;4000400000;6983000000
ALV;104657;USD;2012;Q4;2012-12-31;2013-02-22;132831600;132970400;977700000;1509300000;611000000;3289200000;1232800000;341300000;1707000000;3281100000;6570300000;1606900000;69800000;1849800000;562900000;944400000;2794200000;1432100000;-305500000;2672500000;3776100000;6570300000
ALV;104657;USD;2011;Q4;2011-12-31;2012-02-23;123809600;129639200;739200000;1457800000;623300000;3000300000;1121200000;279600000;1716200000;3117000000;6117300000;1613600000;302800000;2085900000;363500000;682400000;2768300000;1575600000;-574500000;2374600000;3349000000;6117300000
ALV;104657;USD;2010;Q4;2010-12-31;2011-02-23;123254400;131027200;587700000;1367600000;561700000;2688600000;1025800000;228100000;1722000000;2975900000;5664500000;1579400000;87100000;1834500000;637700000;890800000;2725300000;1575600000;-594800000;1910100000;2939200000;5664500000
ALV;104657;USD;2009;Q4;2009-12-31;2010-07-23;118535200;135191200;472700000;1053100000;489000000;2179600000;1041800000;235500000;1728700000;3006000000;5185600000;1262300000;318600000;1693500000;820700000;1056100000;2749600000;1661800000;-760700000;1412800000;2436000000;5185600000
ALV;104657;USD;2018;Q4;2018-12-31;2019-02-21;53444000;53227600;615800000;1652100000;757900000;3285400000;1690100000;323500000;1422600000;3436200000;6721600000;1978600000;620700000;2865500000;1609000000;1959300000;4824800000;1432100000;-1167000000;2041800000;1896800000;6721600000
TEL;104745;USD;2016;Q4;2016-09-30;2016-11-15;358000000;357000000;647000000;2046000000;1596000000;4775000000;3052000000;;9781000000;12833000000;17608000000;1090000000;331000000;3066000000;3739000000;6057000000;9123000000;1969000000;-1624000000;8682000000;8485000000;17608000000
TEL;104745;USD;2015;Q4;2015-09-30;2015-11-10;400000000;406000000;3329000000;2120000000;1615000000;7885000000;2920000000;;9784000000;12704000000;20589000000;1143000000;498000000;3575000000;3386000000;7429000000;11004000000;4541000000;-1256000000;6673000000;9585000000;20589000000
TEL;104745;USD;2014;Q4;2014-09-30;2014-11-12;410000000;417000000;2457000000;2057000000;1509000000;8879000000;2920000000;;8353000000;11273000000;20152000000;1230000000;577000000;3993000000;3281000000;7146000000;11139000000;5415000000;-644000000;4253000000;9013000000;20152000000
TEL;104745;USD;2013;Q4;2013-09-30;2013-11-15;415000000;421000000;1403000000;2323000000;1762000000;6309000000;3166000000;;8986000000;12152000000;18461000000;1383000000;711000000;3924000000;2303000000;6151000000;10075000000;6325000000;-720000000;2472000000;8386000000;18461000000
TEL;104745;USD;2012;Q4;2012-09-30;2012-11-13;424000000;429000000;1589000000;2343000000;1808000000;6503000000;3213000000;;9590000000;12803000000;19306000000;1292000000;1015000000;4004000000;2696000000;7325000000;11329000000;7030000000;-484000000;1196000000;7977000000;19306000000
TEL;104745;USD;2011;Q4;2011-09-30;2011-11-18;428000000;432000000;1218000000;2341000000;1878000000;6981000000;3140000000;;7602000000;10742000000;17723000000;1454000000;;3410000000;2667000000;6829000000;10239000000;8197000000;-1235000000;84000000;7484000000;17723000000
TEL;104745;USD;2010;Q4;2010-09-30;2010-11-10;445000000;449000000;1990000000;2259000000;1583000000;6731000000;2867000000;;7394000000;10261000000;16992000000;1386000000;106000000;3460000000;2307000000;6476000000;9936000000;8684000000;-721000000;-1161000000;7056000000;16992000000
TEL;104745;USD;2009;Q4;2009-09-30;2009-11-18;461000000;458000000;1521000000;1975000000;1435000000;5579000000;3111000000;;7328000000;10439000000;16018000000;1068000000;101000000;2615000000;2316000000;6397000000;9012000000;9154000000;-349000000;-2264000000;7006000000;16018000000
TEL;104745;USD;2008;Q4;2008-09-30;2009-07-31;471000000;474000000;1090000000;2656000000;2159000000;7635000000;3342000000;;10623000000;13965000000;21600000000;1433000000;20000000;3387000000;3161000000;7130000000;10517000000;10267000000;-1264000000;1141000000;11083000000;21600000000
TEL;104745;USD;2017;Q4;2017-09-30;2017-11-14;353000000;356000000;1218000000;2290000000;1813000000;5926000000;3400000000;;10077000000;13477000000;19403000000;1436000000;710000000;3847000000;3634000000;5805000000;9652000000;157000000;-421000000;10175000000;9751000000;19403000000
TEL;104745;USD;2018;Q4;2018-09-30;2018-11-13;348000000;354000000;848000000;2361000000;1857000000;6199000000;3497000000;;10690000000;14187000000;20386000000;1548000000;963000000;4410000000;3037000000;5145000000;9555000000;157000000;-1134000000;12114000000;10831000000;20386000000
PAYX;106287;USD;2017;Q4;2017-05-31;2017-07-21;359000000;361900000;323400000;507500000;;5272000000;337200000;454000000;770500000;1561700000;6833700000;337700000;;4725100000;;153300000;4878400000;1033600000;;901700000;1955300000;6833700000
PAYX;106287;USD;2016;Q4;2016-05-31;2016-07-22;360500000;362700000;352100000;408600000;;4863600000;353000000;441100000;783100000;1577200000;6440800000;304500000;;4365900000;;163200000;4529100000;956300000;;926200000;1911700000;6440800000
PAYX;106287;USD;2015;Q4;2015-05-31;2015-07-21;362300000;364100000;536600000;176600000;;5088200000;353900000;399800000;625600000;1379300000;6467500000;262100000;;4573000000;;109000000;4682000000;883700000;;894300000;1785500000;6467500000
PAYX;106287;USD;2014;Q4;2014-05-31;2014-07-22;363600000;365500000;551200000;149400000;;5002500000;342200000;385600000;639800000;1367600000;6370100000;220500000;;4438900000;;154200000;4593100000;798000000;;957500000;1777000000;6370100000
PAYX;106287;USD;2013;Q4;2013-05-31;2013-07-22;364800000;366000000;505500000;133400000;;4832600000;346000000;369100000;616000000;1331100000;6163700000;180900000;;4268200000;;121800000;4390000000;663200000;;1088500000;1773700000;6163700000
PAYX;106287;USD;2012;Q4;2012-05-31;2012-07-20;362500000;363300000;316300000;142400000;;5075900000;324300000;473700000;605700000;1403700000;6479600000;200600000;;4745700000;;129400000;4875100000;564700000;;1002100000;1604500000;6479600000
PAYX;106287;USD;2011;Q4;2011-05-31;2011-07-15;362100000;362900000;464000000;161100000;;4257900000;308700000;207300000;619900000;1135900000;5393800000;217900000;;3788300000;;109300000;3897600000;539200000;;919500000;1496200000;5393800000
PAYX;106287;USD;2010;Q4;2010-05-31;2010-07-16;361600000;361800000;366800000;186600000;;4159100000;269300000;290100000;507800000;1067200000;5226300000;200500000;;3742200000;;82100000;3824300000;503300000;;856300000;1402000000;5226300000
PAYX;106287;USD;2009;Q4;2009-05-31;2009-09-23;360938000;361070000;492479000;177958000;;4239826000;274530000;82234000;530825000;887589000;5127415000;172398000;;3701893000;;84044000;3785937000;470037000;;829501000;1341478000;5127415000
PAYX;106287;USD;2018;Q4;2018-05-31;2018-07-20;358800000;361300000;424200000;492400000;;5893600000;393500000;295500000;1332800000;2021800000;7915400000;394300000;;5296700000;;261900000;5558600000;1130400000;;1262600000;2356800000;7915400000
PAYX;106287;USD;2019;Q4;2019-05-31;2019-07-24;359400000;362600000;712600000;420500000;;5677700000;408700000;10200000;2579400000;2998300000;8676000000;800900000;;4845000000;796400000;1211500000;6056500000;1209900000;;1409500000;2619500000;8676000000
CMCSA;106366;USD;2016;Q4;2016-12-31;2017-02-03;4767000000;4826000000;3301000000;7955000000;;16361000000;36253000000;5247000000;122639000000;164139000000;180500000000;14923000000;5480000000;21535000000;55566000000;101345000000;122880000000;38286000000;-7517000000;23076000000;57620000000;180500000000
CMCSA;106366;USD;2015;Q4;2015-12-31;2016-02-05;4904000000;4966000000;2295000000;6896000000;;12303000000;33665000000;3224000000;117382000000;154271000000;166574000000;13249000000;3627000000;18178000000;48994000000;93197000000;111375000000;38547000000;-7517000000;21413000000;55199000000;166574000000
CMCSA;106366;USD;2014;Q4;2014-12-31;2015-02-27;5110000000;5182000000;4512000000;6321000000;;13531000000;30953000000;3135000000;111567000000;145655000000;159186000000;12278000000;4217000000;17410000000;43864000000;87642000000;105052000000;38835000000;-7517000000;21539000000;54134000000;159186000000
CMCSA;106366;USD;2013;Q4;2013-12-31;2014-02-12;5226000000;5322000000;5291000000;6376000000;;14075000000;29840000000;3770000000;111128000000;144738000000;158813000000;14734000000;3280000000;18912000000;44567000000;87886000000;106798000000;38920000000;-7517000000;19235000000;52015000000;158813000000
CMCSA;106366;USD;2012;Q4;2012-12-31;2013-02-21;5298000000;5408000000;12415000000;5521000000;;19991000000;27232000000;6325000000;111423000000;144980000000;164971000000;13487000000;2376000000;16714000000;38082000000;81463000000;98177000000;40578000000;-7517000000;16280000000;66794000000;164971000000
CMCSA;106366;USD;2011;Q4;2011-12-31;2012-02-23;5428000000;5514000000;1674000000;4652000000;;8573000000;27559000000;9854000000;111832000000;149245000000;157818000000;11084000000;1367000000;13241000000;37942000000;80908000000;94149000000;40972000000;-7517000000;13971000000;63669000000;157818000000
CMCSA;106366;USD;2010;Q4;2010-12-31;2011-02-25;5570000000;5622000000;5984000000;1855000000;;8886000000;23515000000;6670000000;79463000000;109648000000;118534000000;6351000000;1800000000;8234000000;29615000000;65723000000;73957000000;39812000000;-7517000000;12158000000;44577000000;118534000000
CMCSA;106366;USD;2009;Q4;2009-12-31;2010-02-23;5708000000;5740000000;721000000;1711000000;;3223000000;23855000000;5947000000;79708000000;109510000000;112733000000;6093000000;1156000000;7249000000;27940000000;62507000000;69756000000;40279000000;-7517000000;10005000000;42977000000;112733000000
CMCSA;106366;USD;2008;Q4;2008-12-31;2009-08-06;;;1254000000;1626000000;;3716000000;24444000000;4783000000;80074000000;109301000000;113017000000;6661000000;2278000000;8939000000;30178000000;63331000000;72270000000;40653000000;-7517000000;7427000000;40747000000;113017000000
CMCSA;106366;USD;2017;Q4;2017-12-31;2018-01-31;4659000000;4726000000;3428000000;8834000000;;16343000000;38470000000;6931000000;125718000000;171119000000;187462000000;15172000000;5134000000;21993000000;59422000000;94653000000;116646000000;37552000000;-7517000000;38202000000;70816000000;187462000000
CMCSA;106366;USD;2018;Q4;2018-12-31;2019-01-31;4541000000;4593000000;3814000000;11104000000;;21848000000;44437000000;7883000000;177516000000;229836000000;251684000000;21023000000;4398000000;27603000000;107345000000;150263000000;177866000000;37515000000;-7517000000;41983000000;73818000000;251684000000
UPS;106423;USD;2017;Q4;2017-12-31;2018-02-21;869000000;871000000;4069000000;8773000000;;15718000000;22118000000;;7738000000;29856000000;45574000000;7219000000;4011000000;12886000000;20278000000;31664000000;44550000000;9000000;0;5852000000;1024000000;45574000000
UPS;106423;USD;2016;Q4;2016-12-31;2016-11-03;877000000;879000000;4567000000;7695000000;;13849000000;18800000000;;7728000000;26528000000;40377000000;5957000000;3681000000;11730000000;12394000000;28218000000;39948000000;9000000;0;4879000000;429000000;40377000000
UPS;106423;USD;2015;Q4;2015-12-31;2015-11-05;902000000;900000000;4726000000;7134000000;;13208000000;18352000000;;6751000000;25103000000;38311000000;5365000000;3018000000;10696000000;11316000000;25124000000;35820000000;9000000;0;6001000000;2491000000;38311000000
UPS;106423;USD;2014;Q4;2014-12-31;2014-11-06;910000000;916000000;3283000000;6661000000;;11218000000;18281000000;;5941000000;24222000000;35440000000;5127000000;923000000;8621000000;9856000000;24661000000;33282000000;9000000;0;5726000000;2158000000;35440000000
UPS;106423;USD;2013;Q4;2013-12-31;2013-11-05;930000000;936000000;5245000000;6502000000;;13387000000;17961000000;;4864000000;22825000000;36212000000;4803000000;48000000;7131000000;10824000000;22593000000;29724000000;9000000;0;6925000000;6488000000;36212000000
UPS;106423;USD;2012;Q4;2012-12-31;2012-11-02;955000000;963000000;7924000000;6111000000;;15591000000;17894000000;;5378000000;23272000000;38863000000;4205000000;1781000000;8390000000;11089000000;25740000000;34130000000;10000000;0;7997000000;4733000000;38863000000
UPS;106423;USD;2011;Q4;2011-12-31;2011-11-04;967000000;977000000;4275000000;6246000000;;12284000000;17621000000;;4796000000;22417000000;34701000000;4143000000;33000000;6514000000;11095000000;21079000000;27593000000;10000000;0;10128000000;7108000000;34701000000
UPS;106423;USD;2010;Q4;2010-12-31;2010-11-05;993000000;1001000000;4081000000;5627000000;;11569000000;17387000000;;4641000000;22028000000;33597000000;3479000000;355000000;5902000000;10491000000;19648000000;25550000000;10000000;0;10604000000;8047000000;33597000000
UPS;106423;USD;2009;Q4;2009-12-31;2009-11-06;998000000;1004000000;2100000000;5369000000;;9275000000;17979000000;;4629000000;22608000000;31883000000;3182000000;853000000;6239000000;8668000000;17948000000;24187000000;12000000;0;12745000000;7696000000;31883000000
UPS;106423;USD;2008;Q4;2008-12-31;2009-08-07;;;1049000000;5547000000;;8845000000;18265000000;;4769000000;23034000000;31879000000;3328000000;2074000000;7817000000;7797000000;17282000000;25099000000;10000000;0;12412000000;6780000000;31879000000
UPS;106423;USD;2018;Q4;2018-12-31;2019-02-21;867000000;870000000;5035000000;8958000000;;16210000000;26576000000;;7230000000;33806000000;50016000000;8950000000;2805000000;14087000000;19931000000;32892000000;46979000000;9000000;0;8006000000;3037000000;50016000000
PEB;107219;USD;2017;Q4;2017-12-31;2018-02-22;68773305;69375254;25410000;29206000;;61739000;2456450000;;72679000;2529129000;2590868000;143363000;740863000;942968000;45000000;144374000;1087342000;1686125000;;-191013000;1503526000;2590868000
PEB;107219;USD;2016;Q4;2016-12-31;2017-02-23;71923373;72939199;33410000;27687000;;68516000;2672654000;;68089000;2740743000;2809259000;151567000;814791000;1018683000;82000000;181460000;1200143000;1777123000;;-169227000;1609116000;2809259000
PEB;107219;USD;2015;Q4;2015-12-31;2016-02-22;71719553;72213665;26345000;25062000;;60860000;2673584000;248794000;75233000;2997611000;3058471000;144447000;841203000;1033245000;165000000;264392000;1297637000;1868764000;;-105765000;1760834000;3058471000
PEB;107219;USD;2014;Q4;2014-12-31;2014-04-24;70199495;71822297;52883000;21320000;;90586000;2343690000;258828000;77380000;2679898000;2770484000;109210000;793987000;938073000;50000000;50000000;988073000;1865455000;;-84163000;1782411000;2770484000
PEB;107219;USD;2013;Q4;2013-12-31;2014-02-20;62735066;63806509;55136000;16850000;;88468000;1717611000;260304000;50548000;2028463000;2116931000;63373000;554247000;641847000;0;0;641847000;1541775000;;-69652000;1475084000;2116931000
PEB;107219;USD;2012;Q4;2012-12-31;2013-02-21;60594018;61123888;85900000;13463000;;111397000;1417229000;283011000;34525000;1734765000;1846162000;48692000;468508000;533070000;0;0;533070000;1362959000;;-49798000;1313092000;1846162000
PEB;107219;USD;2011;Q4;2011-12-31;2012-02-21;50892222;51072650;65684000;11312000;;86465000;1127484000;171765000;30918000;1330167000;1416632000;34333000;251539000;300284000;0;0;300284000;1143413000;;-30252000;1116348000;1416632000
PEB;107219;USD;2010;Q4;2010-12-31;2011-08-02;;;220722000;3924000;;229131000;599714000;0;26670000;626384000;855515000;16103000;143570000;167063000;0;0;167063000;698498000;;-11586000;688452000;855515000
V;107326;USD;2017;Q4;2017-09-30;2017-11-17;2270250000;2812250000;13356000000;1132000000;;19023000000;2253000000;1926000000;44775000000;48954000000;67977000000;5050000000;1749000000;9994000000;16566000000;25171000000;35165000000;16900000000;0;9508000000;32812000000;67977000000
V;107326;USD;2016;Q4;2016-09-30;2016-11-15;2359250000;2919250000;8867000000;1041000000;;14313000000;2150000000;3931000000;43641000000;49722000000;64035000000;5069000000;0;8046000000;15848000000;23043000000;31089000000;17395000000;-170000000;10462000000;32946000000;64035000000
V;107326;USD;2015;Q4;2015-09-30;2015-11-20;2432250000;2950250000;5949000000;847000000;;10021000000;1888000000;3384000000;24074000000;29346000000;39367000000;3283000000;;5355000000;0;4170000000;9525000000;18073000000;0;11843000000;29842000000;39367000000
V;107326;USD;2014;Q4;2014-09-30;2014-11-21;3986250000;4912250000;3881000000;822000000;;9562000000;1892000000;3015000000;24100000000;29007000000;38569000000;4009000000;;6006000000;;5150000000;11156000000;18299000000;;9131000000;27413000000;38569000000
V;107326;USD;2013;Q4;2013-09-30;2013-11-22;7258250000;9024250000;4180000000;761000000;;7822000000;1732000000;2760000000;23642000000;28134000000;35956000000;2550000000;;4335000000;;4751000000;9086000000;18875000000;;7974000000;26870000000;35956000000
V;107326;USD;2012;Q4;2012-09-30;2012-11-16;1075250000;1222250000;2751000000;723000000;;11786000000;1634000000;3283000000;23310000000;28227000000;40013000000;6301000000;;7954000000;;4429000000;12383000000;19992000000;;7809000000;27630000000;40013000000
V;107326;USD;2011;Q4;2011-09-30;2011-11-18;1108250000;1283250000;3341000000;560000000;;9190000000;1541000000;711000000;23318000000;25570000000;34760000000;1992000000;;3451000000;;4872000000;8323000000;19907000000;;6706000000;26437000000;34760000000
V;107326;USD;2010;Q4;2010-09-30;2010-11-19;1290250000;1527250000;3991000000;476000000;;8734000000;1357000000;24000000;23293000000;24674000000;33408000000;2169000000;12000000;3498000000;32000000;4896000000;8394000000;20794000000;;4368000000;25014000000;33408000000
V;107326;USD;2009;Q4;2009-09-30;2009-11-20;1407950000;1695950000;4673000000;444000000;;9241000000;1204000000;168000000;21668000000;23040000000;32281000000;3334000000;12000000;4442000000;44000000;4646000000;9088000000;21160000000;;2219000000;23195000000;32283000000
V;107326;USD;2008;Q4;2008-09-30;2009-07-30;1087950000;1420950000;5334000000;342000000;;11174000000;1080000000;244000000;22483000000;23807000000;34981000000;4678000000;51000000;5657000000;55000000;7047000000;12704000000;22196000000;-35000000;186000000;22277000000;34981000000
V;107326;USD;2018;Q4;2018-09-30;2018-11-16;2223250000;2753250000;11611000000;1208000000;;18216000000;2472000000;4082000000;44455000000;51009000000;69225000000;5846000000;0;11305000000;16623000000;23907000000;35212000000;16678000000;;11318000000;34013000000;69225000000
CDNS;107614;USD;2017;Q4;2017-12-31;2018-02-20;273172000;282222000;692542000;190426000;33209000;979988000;251342000;12239000;1175145000;1438726000;2418714000;221101000;;642398000;644369000;787114000;1429512000;1829950000;-1178121000;341003000;989202000;2418714000
CDNS;107614;USD;2016;Q4;2016-12-31;2016-02-18;272580000;278916000;468289000;157171000;39475000;702034000;238607000;12949000;1143318000;1394874000;2096908000;239496000;;585562000;643493000;769576000;1355138000;1820081000;-1190053000;136902000;741770000;2096908000
CDNS;107614;USD;2015;Q4;2015-12-31;2015-02-20;297434000;310510000;711184000;164848000;56762000;964235000;228599000;4498000;1148183000;1381280000;2345515000;238022000;;536307000;343288000;433093000;969400000;1863086000;-400555000;-73991000;1376115000;2345515000
CDNS;107614;USD;2014;Q4;2014-12-31;2014-04-21;283975000;310316000;633048000;107624000;50220000;1221091000;238715000;3672000;965123000;1207510000;2428601000;216594000;324826000;1148210000;0;124286000;1272496000;1757242000;-140142000;-485306000;1156105000;2428601000
CDNS;107614;USD;2013;Q4;2013-12-31;2014-02-20;280125000;294704000;633048000;107624000;50220000;1221091000;238715000;3672000;965123000;1207510000;2428601000;216594000;324826000;1148210000;;124286000;1272496000;1757242000;-140142000;-485306000;1156105000;2428601000
CDNS;107614;USD;2012;Q4;2012-12-31;2013-02-21;272887000;286289000;827061000;97821000;36163000;1391235000;244439000;7559000;643770000;895768000;2287003000;171318000;447011000;1217270000;;154562000;1371832000;1721556000;-200786000;-649549000;915171000;2287003000
CDNS;107614;USD;2011;Q4;2011-12-31;2011-02-24;266121000;273060000;604639000;136772000;43243000;1063983000;262517000;11371000;423398000;697286000;1761269000;165791000;294061000;1015366000;131920000;334773000;1350139000;1733884000;-290462000;-1083245000;411130000;1761269000
CDNS;107614;USD;2010;Q4;2010-12-31;2010-08-04;259782000;271162000;571299000;200628000;24165000;850747000;311502000;58448000;189890000;559840000;1410587000;150207000;0;397898000;436012000;904316000;1302214000;1674396000;-431310000;-1177983000;108373000;1410587000
CDNS;107614;USD;2018;Q4;2018-12-31;2019-02-27;273863000;280505000;533298000;297082000;28162000;951092000;252630000;5972000;1258960000;1517562000;2468654000;256526000;;708982000;345291000;471271000;1180253000;1936124000;-1395652000;772709000;1288401000;2468654000
ESRX;107733;USD;2016;Q4;2016-12-31;2017-02-14;608700000;613100000;3077200000;7062100000;1959000000;12363400000;1273600000;;38107900000;39381500000;51744900000;15705800000;722300000;16428100000;14846000000;19073000000;35501100000;23242200000;-18795100000;11801200000;16243800000;51744900000
ESRX;107733;USD;2015;Q4;2015-12-31;2016-02-16;675900000;682200000;3186300000;6721300000;2023100000;12059500000;1291300000;;39892500000;41183800000;53243300000;15508900000;1646400000;17155300000;13946300000;18707500000;35862800000;22213200000;-13223200000;8396800000;17380500000;53243300000
ESRX;107733;USD;2014;Q4;2014-12-31;2015-02-23;729600000;737500000;1832600000;5979800000;2113200000;10568100000;1584000000;;41596200000;43180200000;53748300000;14461600000;2551000000;17012600000;10966400000;16671700000;33684300000;22679900000;-8548200000;5920400000;20064000000;53748300000
ESRX;107733;USD;2013;Q4;2013-12-31;2014-02-20;790300000;802600000;1991400000;4022900000;1871100000;8491400000;1658900000;;43397900000;45056800000;53548200000;11650000000;1584000000;13235300000;12363000000;18468100000;31703400000;21818200000;-3905300000;3912800000;21844800000;53548200000
ESRX;107733;USD;2012;Q4;2012-12-31;2013-02-19;819200000;846000000;2793100000;5425800000;1652100000;10756900000;1632100000;;45722200000;47354300000;58111200000;11971800000;934900000;13057400000;14980100000;21658100000;34715500000;21297900000;0;2068200000;23395700000;58111200000
ESRX;107733;USD;2011;Q4;2011-12-31;2012-05-10;484800000;488300000;5620100000;1915700000;374400000;8058000000;416200000;;7132800000;7549000000;15607000000;4458200000;999900000;5458100000;7076400000;7673600000;13131700000;2445100000;-6634000000;6645600000;2475300000;15607000000
ESRX;107733;USD;2017;Q4;2017-12-31;2018-02-27;564700000;568200000;2309600000;7056300000;2124900000;11957100000;551300000;;41747400000;42298700000;54255800000;16813500000;1032900000;17846400000;14981500000;18284100000;36130500000;23546400000;-21742500000;16318600000;18125300000;54255800000
TBI;108139;USD;2018;Q4;2019-01-31;2019-02-22;39527000;39864000;46988000;355373000;;429827000;57671000;;627346000;685017000;1114844000;139143000;;225526000;80000000;297879000;523405000;1000;;606087000;591439000;1114844000
TBI;108139;USD;2017;Q4;2018-01-31;2018-02-26;40546000;40695000;28780000;374273000;;428279000;60163000;;620589000;680752000;1109031000;131985000;;212419000;116489000;341765000;554184000;1000;;561650000;554847000;1109031000
TBI;108139;USD;2016;Q4;2017-01-31;2016-04-25;41640000;41050000;34970000;352606000;;427803000;63998000;;638644000;702642000;1130445000;146540000;;251135000;135362000;354131000;605266000;1000;;536611000;525179000;1130445000
TBI;108139;USD;2015;Q4;2016-01-31;2016-02-22;41337000;42031000;29781000;461476000;;542965000;57530000;;658947000;716477000;1259442000;155797000;;227976000;243397000;495893000;723869000;1000;;549585000;535573000;1259442000
TBI;108139;USD;2014;Q4;2015-01-31;2015-02-23;40832000;41806000;21166000;359903000;;415807000;61392000;;589472000;650864000;1066671000;119948000;;187230000;199383000;410107000;597337000;1000;;468462000;469334000;1066671000
TBI;108139;USD;2013;Q4;2014-01-31;2014-02-20;40410000;41133000;136748000;199519000;;356458000;54473000;;308530000;363003000;719461000;68944000;;121409000;29656000;204692000;326101000;1000;;391326000;393360000;719461000
TBI;108139;USD;2012;Q4;2013-01-31;2013-02-21;39550000;39579000;129513000;167292000;;317166000;58171000;;226406000;284577000;601743000;62394000;;113556000;0;154513000;268069000;1000;;330855000;333674000;601743000
TBI;108139;USD;2011;Q4;2012-01-31;2012-02-23;39405000;39802000;109311000;153878000;;280615000;56239000;;223915000;280154000;560769000;61133000;;112289000;;154901000;267190000;1000;;290935000;293579000;560769000
TBI;108139;USD;2010;Q4;2011-01-31;2011-02-22;86360917;87105917;163153000;108692000;;293500000;53958000;;199008000;252966000;546466000;43240000;;85923000;;147836000;233759000;1000;;309800000;312707000;546466000
TBI;108139;USD;2009;Q4;2010-01-31;2010-07-30;42944000;43266000;124377000;105246000;;248063000;60353000;;209713000;270066000;518129000;39757000;;84835000;;147862000;232697000;1000;;283156000;285432000;518129000
DRI;108420;USD;2016;Q4;2016-05-31;2016-07-25;111377620;113252090;274800000;64000000;175400000;820300000;2041600000;;1720700000;3762300000;4582600000;426100000;;1187100000;440000000;1443500000;2630600000;1502600000;-7800000;547500000;1952000000;4582600000
DRI;108420;USD;2015;Q4;2015-05-31;2015-07-24;110607860;116307860;535900000;78000000;163900000;1056400000;3215800000;;1722500000;4938300000;5994700000;404000000;15000000;1196700000;1452300000;2464500000;3661200000;1405900000;-7800000;1026000000;2333500000;5994700000
DRI;108420;USD;2014;Q4;2014-05-31;2014-07-18;85357730;86662440;98300000;83800000;196800000;1975800000;3381000000;;1725900000;5106900000;7082700000;423300000;222600000;1618500000;2463400000;3307300000;4925800000;1302200000;-7800000;995800000;2156900000;7082700000
DRI;108420;USD;2013;Q4;2013-05-31;2013-07-19;145207260;147892140;88200000;85400000;356900000;764900000;4391100000;;1780900000;6172000000;6936900000;531100000;164500000;1416400000;2548700000;3461000000;4877400000;1207600000;-8100000;998900000;2059500000;6936900000
DRI;108420;USD;2012;Q4;2012-05-31;2012-07-20;143529210;147109050;70500000;71400000;404100000;757600000;3951300000;;1235300000;5186600000;5944200000;475400000;612600000;1774100000;1508100000;2328100000;4102200000;2518800000;-3695800000;3172800000;1842000000;5944200000
DRI;108420;USD;2011;Q4;2011-05-31;2011-07-22;150577020;154716210;70500000;65400000;300100000;663800000;3622000000;;1180800000;4802800000;5466600000;492000000;185500000;1286800000;1463300000;2243600000;3530400000;2408800000;-3325300000;2921900000;1936200000;5466600000
DRI;108420;USD;2010;Q4;2010-05-31;2010-07-23;156841740;161428410;248800000;59400000;220800000;690200000;3403700000;;1182200000;4585900000;5276100000;471200000;225000000;1209800000;1466300000;2172300000;3382100000;2297900000;-2943500000;2621900000;1894000000;5276100000
DRI;108420;USD;2009;Q4;2009-05-31;2010-04-02;153709380;157401090;62900000;37100000;247000000;554800000;3306700000;;1163700000;4470400000;5025200000;435500000;150000000;1096100000;1691200000;2323000000;3419100000;2183100000;-2864200000;2357400000;1606100000;5025200000
DRI;108420;USD;2017;Q4;2017-05-31;2017-07-21;125100000;126500000;233100000;75900000;178900000;587900000;2272300000;;2432100000;4704400000;5292300000;454700000;0;1289200000;936600000;1901400000;3190600000;1614600000;-7800000;560100000;2101700000;5292300000
DRI;108420;USD;2018;Q4;2018-05-31;2018-07-20;123600000;125500000;146900000;83700000;205300000;553600000;2429800000;;2486200000;4916000000;5469600000;511100000;;1384500000;926500000;1890300000;3274800000;1631900000;-7800000;657600000;2194800000;5469600000
EW;108955;USD;2016;Q4;2016-12-31;2017-02-17;213500000;218000000;1271100000;414600000;396600000;2240000000;580000000;532100000;1157900000;2270000000;4510000000;532500000;;532500000;822300000;1358500000;1891000000;1410400000;-2499300000;3906300000;2619000000;4510000000
EW;108955;USD;2015;Q4;2015-12-31;2016-02-19;216000000;220800000;1224700000;315400000;339900000;2047900000;482500000;379900000;1146000000;2008400000;4056300000;476200000;;476200000;596900000;1077000000;1553200000;1185900000;-1837000000;3336800000;2503100000;4056300000
EW;108955;USD;2014;Q4;2014-12-31;2015-02-20;214600000;219400000;1438800000;288000000;296800000;2231100000;442900000;246700000;602300000;1291900000;3523000000;426100000;;426100000;598100000;905500000;1331600000;1007300000;-1556900000;2841900000;2191400000;3523000000
EW;108955;USD;2013;Q4;2013-12-31;2014-02-28;218600000;222200000;936900000;302500000;308900000;1725800000;421600000;29200000;533300000;984100000;2709900000;345600000;;345600000;593100000;819900000;1165500000;797200000;-1256000000;2030800000;1544400000;2709900000
EW;108955;USD;2012;Q4;2012-12-31;2013-02-28;230000000;235600000;521400000;321100000;281000000;1291900000;373300000;31000000;525300000;929600000;2221500000;347400000;;347400000;189300000;394800000;742200000;613200000;-749900000;1653900000;1479300000;2221500000
EW;108955;USD;2011;Q4;2011-12-31;2012-02-27;228200000;236200000;450500000;283800000;261300000;1168500000;304300000;46400000;461300000;812000000;1980500000;335200000;;335200000;150400000;307400000;642600000;420500000;-405800000;1360700000;1337900000;1980500000
EW;108955;USD;2010;Q4;2010-12-31;2011-02-28;229200000;240200000;396100000;277300000;203600000;1032600000;269800000;25000000;439800000;734600000;1767200000;296000000;41800000;337800000;;121200000;459000000;328300000;-102000000;1124000000;1308200000;1767200000
EW;108955;USD;2009;Q4;2009-12-31;2010-08-06;226200000;237400000;334100000;249400000;165900000;889200000;252000000;22300000;452000000;726300000;1615500000;290500000;;290500000;90300000;167100000;457600000;1132100000;-872300000;906000000;1157900000;1615500000
EW;108955;USD;2017;Q4;2017-12-31;2018-02-16;210600000;215300000;1337500000;438700000;554900000;2549200000;679700000;567000000;1870500000;3117200000;5666400000;770300000;598000000;1420000000;438400000;1290200000;2710200000;1378900000;-252100000;1962100000;2956200000;5666400000
EW;108955;USD;2018;Q4;2018-12-31;2019-02-15;208100000;212100000;956500000;456900000;607000000;2286900000;867500000;506300000;1663000000;3036800000;5323700000;876600000;0;876600000;593800000;1306700000;2183300000;1599600000;-1015400000;2694700000;3140400000;5323700000
WNC;109798;USD;2016;Q4;2016-12-31;2017-02-27;189953359;195800744;163467000;153634000;139953000;481405000;134138000;;283190000;417328000;898733000;163652000;2962000;166614000;234874000;259728000;426342000;641608000;-169961000;3591000;472391000;898733000
WNC;109798;USD;2015;Q4;2015-12-31;2016-02-26;-67457451;-70556125;178853000;152824000;166982000;529507000;140438000;;279725000;420163000;949670000;172660000;38417000;211077000;276760000;298782000;509859000;643623000;-90405000;-111907000;439811000;949670000
WNC;109798;USD;2014;Q4;2014-12-31;2015-02-27;68997;69688;146113000;135206000;177144000;485659000;142892000;;300100000;442992000;928651000;184903000;1954000;186857000;330573000;350962000;537819000;636315000;-28648000;-216198000;390832000;928651000
WNC;109798;USD;2013;Q4;2013-12-31;2014-02-27;-68258089;-68689545;113262000;120358000;184173000;449001000;142082000;;321162000;463244000;912245000;211509000;4854000;216363000;365741000;373503000;589866000;626676000;-27151000;-277128000;322379000;912245000
WNC;109798;USD;2012;Q4;2012-12-31;2013-02-28;68375;68597;81449000;96590000;189487000;418095000;132146000;;352385000;484531000;902626000;192172000;4521000;196693000;420630000;437206000;633899000;619252000;-27116000;-323657000;268727000;902626000
WNC;109798;USD;2011;Q4;2011-12-31;2012-02-29;-203940656;-205136328;19976000;52219000;189533000;264045000;96591000;;27414000;124005000;388050000;167009000;1507000;168516000;68314000;73188000;241704000;602186000;-26552000;-429288000;146346000;388050000
WNC;109798;USD;2010;Q4;2010-12-31;2011-08-03;;;21200000;37853000;110850000;172058000;98834000;;31942000;130776000;302834000;110041000;590000;110631000;58964000;63178000;173809000;599374000;-26019000;-444330000;129025000;302834000
WNC;109798;USD;2017;Q4;2017-12-31;2018-02-28;237252961;250207168;191521000;146836000;180735000;576391000;195363000;;579759000;775122000;1351513000;237358000;46310000;283668000;505103000;561782000;845450000;654172000;-244452000;98728000;506063000;1351513000
WNC;109798;USD;2018;Q4;2018-12-31;2019-02-28;55514000;55854000;132690000;181064000;184404000;549419000;206991000;;547983000;754974000;1304393000;269497000;2179000;271676000;503732000;558868000;830544000;629783000;-302835000;150244000;473849000;1304393000
DMRC;110139;USD;2016;Q4;2016-12-31;2017-02-23;10126000;10126000;56134000;5078000;;62907000;3570000;4392000;7867000;15829000;78736000;1523000;;4446000;;956000;5402000;120996000;;-47712000;73334000;78736000
DMRC;110139;USD;2015;Q4;2015-12-31;2016-02-25;8494000;8494000;36187000;4616000;;42290000;3010000;2999000;8065000;14074000;56364000;1657000;;4680000;;226000;4906000;77448000;;-26040000;51458000;56364000
DMRC;110139;USD;2014;Q4;2014-12-31;2015-02-20;7459000;7459000;38323000;4545000;;45479000;2976000;749000;8212000;11937000;57416000;1379000;;5039000;;203000;5242000;60230000;;-8106000;52174000;57416000
DMRC;110139;USD;2013;Q4;2013-12-31;2014-02-21;6916000;6456000;29662000;5838000;;37158000;2395000;5302000;12342000;20039000;57197000;1560000;;5778000;;496000;6274000;41505000;;9368000;50923000;57197000
DMRC;110139;USD;2012;Q4;2012-12-31;2013-08-07;6792000;6839000;32269000;4216000;;37501000;1453000;6787000;11590000;19830000;57331000;1143000;;3655000;;673000;4328000;39876000;;13077000;53003000;57331000
DMRC;110139;USD;2011;Q4;2011-12-31;2012-02-27;6698000;7626000;25663000;3502000;;30471000;1395000;7715000;6212000;15322000;45793000;952000;;3612000;;464000;4076000;34518000;;7149000;41717000;45793000
DMRC;110139;USD;2010;Q4;2010-12-31;2011-07-28;7189000;8001000;34781000;3481000;;39607000;1330000;11163000;3665000;16158000;55765000;1519000;;4081000;;525000;4606000;49616000;;1493000;51159000;55765000
DMRC;110139;USD;2017;Q4;2017-12-31;2018-02-22;11060000;11060000;67738000;6404000;;76313000;4236000;;7821000;12057000;88370000;1914000;;5038000;;985000;6023000;155805000;;-73508000;82347000;88370000
DMRC;110139;USD;2018;Q4;2018-12-31;2019-02-22;11443000;11443000;43656000;3888000;;49644000;3955000;;8188000;12143000;61787000;1092000;;4318000;;854000;5172000;162440000;;-105875000;56615000;61787000
NUVA;110456;USD;2018;Q4;2018-12-31;2019-02-20;51507000;53049000;117840000;196487000;273244000;618209000;238841000;;850809000;1089650000;1707859000;170485000;;179460000;602526000;693874000;873334000;1397890000;-571978000;17241000;834525000;1707859000
NUVA;110456;USD;2017;Q4;2017-12-31;2018-02-26;51101000;51862000;72803000;200220000;247138000;560063000;215326000;;864751000;1080077000;1640140000;134293000;;161395000;582920000;679329000;840724000;1363609000;-565867000;4762000;799416000;1640140000
NUVA;110456;USD;2016;Q4;2016-12-31;2017-02-09;50400000;57850000;153643000;171595000;208249000;575443000;181524000;;813837000;995361000;1570804000;131054000;61701000;242497000;564412000;627783000;870280000;1010293000;-237867000;-66859000;700524000;1570804000
NUVA;110456;USD;2015;Q4;2015-12-31;2016-02-11;49221000;53100000;357762000;127595000;168140000;702827000;141441000;112332000;346067000;599840000;1302667000;99616000;;99616000;372920000;484208000;583824000;989440000;-161788000;-104006000;718843000;1302667000
NUVA;110456;USD;2014;Q4;2014-12-31;2015-02-25;92992202;92992202;362716000;118959000;154638000;657959000;128565000;43042000;512005000;683612000;1341571000;184096000;;214096000;360746000;479117000;693213000;847193000;-10537000;-186938000;648358000;1341571000
NUVA;110456;USD;2013;Q4;2013-12-31;2014-03-03;44835000;50196000;246274000;104774000;136937000;536008000;128064000;79829000;435667000;643560000;1179568000;117152000;;117152000;346060000;457538000;574690000;769248000;0;-170218000;604878000;1179568000
NUVA;110456;USD;2012;Q4;2012-12-31;2013-02-27;-129505688;-132272912;261704000;88958000;126364000;513749000;125123000;84412000;440501000;650036000;1163785000;89964000;74311000;164275000;332404000;451932000;616207000;714909000;;-178120000;547578000;1163785000
NUVA;110456;USD;2011;Q4;2011-12-31;2012-02-27;42194000;40217000;309720000;87736000;119313000;591837000;124754000;32503000;374468000;531725000;1123562000;73959000;0;207380000;394019000;411432000;618812000;674832000;;-181264000;504750000;1123562000
NUVA;110456;USD;2010;Q4;2010-12-31;2011-02-25;39470000;60905000;179055000;74361000;107577000;371771000;102165000;50635000;277458000;430258000;802029000;76261000;;109302000;230000000;246495000;355797000;545154000;;-111415000;446232000;802029000
NUVA;110456;USD;2009;Q4;2009-12-31;2010-08-06;38680000;39852000;164692000;58462000;90191000;317102000;82602000;39968000;213148000;335718000;652820000;54747000;;85441000;230000000;257528000;342969000;485796000;;-189700000;309851000;652820000
EXP;110585;USD;2016;Q4;2017-03-31;2016-05-25;49101277;49592237;5391000;120221000;243595000;380003000;1255311000;;248321000;1503632000;1883635000;112589000;8000000;120589000;499714000;722515000;843104000;169454000;;882486000;1040531000;1883635000
EXP;110585;USD;2015;Q4;2016-03-31;2015-05-22;49668249;50363087;7514000;113577000;235464000;364370000;1221819000;;294137000;1515956000;1880326000;127531000;57045000;184576000;455714000;685157000;869733000;272943000;;749717000;1010593000;1880326000
EXP;110585;USD;2014;Q4;2015-03-31;2014-05-23;49101221;49923428;6482000;102917000;187096000;306960000;984051000;;220518000;1204569000;1511529000;99320000;9500000;108820000;371759000;571210000;680030000;254025000;;582957000;831499000;1511529000
EXP;110585;USD;2013;Q4;2014-03-31;2013-05-24;48742815;49679741;3897000;87543000;156380000;261271000;985724000;;229238000;1214962000;1476233000;100229000;;100229000;489259000;679834000;780063000;224548000;;478664000;696170000;1476233000
EXP;110585;USD;2012;Q4;2013-03-31;2012-05-25;44307268;44633403;6481000;56197000;123606000;191841000;580508000;;212796000;793304000;985145000;72366000;4677000;77043000;262259000;435591000;512634000;38145000;;439882000;472511000;985145000
EXP;110585;USD;2011;Q4;2012-03-31;2011-05-26;43991737;44413848;1874000;43855000;115237000;174626000;602830000;;208354000;811184000;985810000;69526000;;69526000;287000000;454770000;524296000;25303000;;439104000;461514000;985810000
EXP;110585;USD;2010;Q4;2011-03-31;2010-08-06;43775130;44052072;1416000;49721000;105871000;161274000;632469000;;220033000;852502000;1013776000;71884000;;71884000;303000000;490245000;562129000;15161000;;440004000;451647000;1013776000
EXP;110585;USD;2017;Q4;2018-03-31;2018-05-23;48020739;48395704;9315000;141685000;258159000;458735000;1595299000;;313969000;1909268000;2368003000;179329000;;179329000;620922000;770984000;950313000;122862000;;1298840000;1417690000;2368003000
EXP;110585;USD;2018;Q4;2019-03-31;2019-05-23;45298495;45525383;8601000;128722000;275194000;427621000;1426939000;;314603000;1741542000;2169163000;142833000;36500000;179333000;655092000;780343000;959676000;451000;;1212352000;1209487000;2169163000
MJCO;110826;USD;2017;Q4;2018-03-31;2018-06-22;36644727;36644727;9152000;19103000;;47799000;2755000;;45972000;48727000;96526000;24385000;203000;42058000;8367000;9295000;51353000;75095000;;-30283000;45173000;96526000
MJCO;110826;USD;2016;Q4;2017-03-31;2016-05-23;36481115;36365845;12464000;12227000;;41286000;3659000;;45069000;48728000;90014000;17834000;310000;31687000;10288000;12479000;44166000;71416000;;-25282000;45848000;90014000
MJCO;110826;USD;2015;Q4;2016-03-31;2015-08-10;30575000;30575000;6154000;22503000;;44335000;3462000;;46824000;50286000;94621000;20360000;159000;38670000;6920000;10394000;49064000;69578000;;-24360000;45557000;94621000
MJCO;110826;USD;2018;Q4;2019-03-31;2019-05-30;38940448;40914210;39437000;16933000;;89501000;2787000;;55752000;58539000;148040000;33182000;;44612000;0;4150000;48762000;122249000;;-23792000;99278000;148040000
RRC;110931;USD;2016;Q4;2016-12-31;2017-02-22;244860000;244860000;314000;241718000;26573000;281883000;9273210000;;1727152000;11000362000;11282245000;530373000;;702653000;3773517000;5171224000;5873877000;5526894000;-1209000;-117317000;5408368000;11282245000
RRC;110931;USD;2015;Q4;2015-12-31;2016-02-25;;;471000;123842000;33217000;439074000;6380760000;;80197000;6460957000;6900031000;335513000;;351720000;2651303000;3788653000;4140373000;2444316000;-2245000;317587000;2759658000;6900031000
RRC;110931;USD;2014;Q4;2014-12-31;2015-02-24;;;448000;188941000;17854000;570292000;8015154000;;119158000;8134312000;8704604000;624610000;;639677000;3030824000;4607498000;5247175000;2402162000;-3088000;1058355000;3457429000;8704604000
RRC;110931;USD;2013;Q4;2013-12-31;2014-02-26;;;348000;179667000;12451000;248301000;6791221000;129034000;130530000;7050785000;7299086000;464326000;;495561000;3140516000;4389073000;4884634000;1961270000;-3637000;450583000;2414452000;7299086000
RRC;110931;USD;2012;Q4;2012-12-31;2013-02-27;;;252000;167495000;22315000;327614000;6137751000;132449000;130921000;6401121000;6728735000;410278000;;455143000;2878185000;3916200000;4371343000;1917253000;-4760000;360990000;2357392000;6728735000
RRC;110931;USD;2011;Q4;2011-12-31;2012-02-23;;;92000;127180000;14070000;315263000;5210244000;138130000;181833000;5530207000;5845470000;449679000;;511932000;1974967000;2941118000;3453050000;1868167000;-6343000;373969000;2392420000;5845470000
RRC;110931;USD;2010;Q4;2010-12-31;2011-03-02;;;2848000;88536000;21352000;1113570000;4158062000;155105000;84977000;4398144000;5511714000;393233000;;443690000;1960536000;2844263000;3287953000;1822104000;-7512000;341699000;2223761000;5511714000
RRC;110931;USD;2009;Q4;2009-12-31;2010-02-24;;;767000;123622000;21292000;175280000;4990654000;146809000;83138000;5220601000;5395881000;297170000;;314104000;1707833000;2703188000;3017292000;1773603000;-7964000;606529000;2378589000;5395881000
RRC;110931;USD;2008;Q4;2008-12-31;2010-02-24;;;753000;162201000;19927000;404311000;4928274000;147126000;72168000;5147568000;5551879000;318465000;;353514000;1790668000;2747023000;3100537000;1696824000;-8557000;685568000;2451342000;5551879000
RRC;110931;USD;2017;Q4;2017-12-31;2018-02-28;245291000;246450000;448000;348833000;21346000;429234000;9581403000;;1718204000;11299607000;11728841000;704913000;;755473000;4108806000;5199096000;5954569000;5580213000;-599000;195990000;5774272000;11728841000
RRC;110931;USD;2018;Q4;2018-12-31;2019-02-25;246644000;245044000;545000;490723000;22964000;602185000;9032961000;;73008000;9105969000;9708154000;745182000;;754811000;3836861000;4893912000;5648723000;5630942000;-391000;-1570462000;4059431000;9708154000
AAPL;111052;USD;2018;Q4;2018-09-30;2018-11-05;4801587000;4847547000;66301000000;23186000000;3956000000;131339000000;41304000000;170799000000;22283000000;234386000000;365725000000;55888000000;20748000000;115929000000;93735000000;142649000000;258578000000;40201000000;;70400000000;107147000000;365725000000
AAPL;111052;USD;2017;Q4;2017-09-30;2017-08-02;5149428000;5183586000;74181000000;17874000000;4855000000;128645000000;33783000000;194714000000;18177000000;246674000000;375319000000;44242000000;18473000000;100814000000;97207000000;140458000000;241272000000;35867000000;;98330000000;134047000000;375319000000
AAPL;111052;USD;2016;Q4;2016-09-30;2016-10-26;5366911000;5393330000;67155000000;15754000000;2132000000;106869000000;27010000000;170430000000;17377000000;214817000000;321686000000;59321000000;11605000000;79006000000;75427000000;114431000000;193437000000;31251000000;;96364000000;128249000000;321686000000
AAPL;111052;USD;2015;Q4;2015-09-30;2015-10-28;5646917000;5682516000;41601000000;16849000000;2349000000;89378000000;22471000000;164065000000;14431000000;200967000000;290345000000;60671000000;10999000000;80610000000;53329000000;90380000000;170990000000;27416000000;;92284000000;119355000000;290345000000
AAPL;111052;USD;2014;Q4;2014-09-30;2014-10-27;5933847000;5972081000;25077000000;17460000000;2111000000;68531000000;20624000000;130162000000;12522000000;163308000000;231839000000;48649000000;6308000000;63448000000;28987000000;56844000000;120292000000;23313000000;;87152000000;111547000000;231839000000
AAPL;111052;USD;2013;Q4;2013-09-30;2013-10-30;6329142000;6363918000;40546000000;13102000000;1764000000;73286000000;16597000000;106215000000;10902000000;133714000000;207000000000;36223000000;0;43658000000;16960000000;39793000000;83451000000;19764000000;;104256000000;123549000000;207000000000
AAPL;111052;USD;2012;Q4;2012-09-30;2012-10-31;6566371000;6635264000;29129000000;10930000000;791000000;57653000000;15452000000;92122000000;10837000000;118411000000;176064000000;32589000000;;38542000000;0;19312000000;57854000000;16422000000;;101289000000;118210000000;176064000000
AAPL;111052;USD;2011;Q4;2011-09-30;2011-10-26;6499038000;6577704000;25952000000;5369000000;776000000;44988000000;7777000000;55618000000;7988000000;71383000000;116371000000;23879000000;;27970000000;;11786000000;39756000000;13331000000;;62841000000;76615000000;116371000000
AAPL;111052;USD;2010;Q4;2010-09-30;2010-10-27;6401899000;6501782000;25620000000;5510000000;1051000000;41678000000;4768000000;25391000000;3346000000;33505000000;75183000000;17738000000;;20722000000;;6670000000;27392000000;10668000000;;37169000000;47791000000;75183000000
AAPL;111052;USD;2009;Q4;2009-09-30;2009-10-27;6286210000;6400611000;23464000000;3361000000;455000000;31555000000;2954000000;10528000000;2464000000;15946000000;47501000000;9453000000;;11506000000;;4355000000;15861000000;8210000000;;23353000000;31640000000;47501000000
AAPL;111052;USD;2008;Q4;2008-09-30;2009-07-22;6209763000;6338304000;22111000000;2422000000;509000000;30006000000;2455000000;2379000000;1331000000;6165000000;36171000000;9744000000;;11361000000;;2513000000;13874000000;7177000000;;15129000000;22297000000;36171000000
AAPL;111052;USD;2019;Q4;2019-09-30;2019-10-31;4490812000;4520374000;100557000000;22926000000;4106000000;162819000000;37378000000;105341000000;32978000000;175697000000;338516000000;46236000000;16240000000;105718000000;91807000000;142310000000;248028000000;45174000000;;45898000000;90488000000;338516000000
SPG;111127;USD;2016;Q4;2016-12-31;2017-02-24;313712873;313712873;560059000;664619000;;1224678000;24360335000;;5518565000;29878900000;31103578000;2573760000;;3028800000;22977104000;22977104000;26005904000;9523118000;-682562000;-4459387000;5097674000;31103578000
SPG;111127;USD;2015;Q4;2015-12-31;2016-02-26;309393478;309393478;701134000;624605000;;1325739000;23547738000;;5691705000;29239443000;30565182000;2692345000;;2906594000;22416682000;22416682000;25323276000;9384481000;-437134000;-4266930000;5241906000;30565182000
SPG;111127;USD;2014;Q4;2014-12-31;2015-02-27;310786297;310786297;612282000;580197000;;1192479000;22367785000;;5972066000;28339851000;29532330000;2426844000;;2702295000;20852993000;20852993000;23555288000;9422268000;-103929000;-4208183000;5977042000;29532330000
SPG;111127;USD;2013;Q4;2013-12-31;2014-02-27;310440111;310440108;1691006000;520361000;;2211367000;22243845000;;8869362000;31113207000;33324574000;2273380000;;3641540000;22669917000;22669917000;26311457000;9217394000;-117897000;-3218686000;7013117000;33324574000
SPG;111127;USD;2012;Q4;2012-12-31;2013-02-28;252603787;252604650;1184518000;521301000;;1705819000;25184133000;;5696654000;30880787000;32586606000;2098916000;;2402504000;23113007000;23113007000;25515511000;9175755000;-135781000;-3083190000;7071095000;32586606000
SPG;111127;USD;2011;Q4;2011-12-31;2012-02-28;312344072;312355007;798650000;1137731000;;1936381000;21268916000;;3011628000;24280544000;26216925000;1787281000;;1958252000;18446440000;18446440000;20404692000;8103163000;-152541000;-3251740000;5812233000;26216925000
SPG;111127;USD;2010;Q4;2010-12-31;2011-02-25;311485765;311736056;796718000;1077736000;;1874454000;19797431000;;3185544000;22982975000;24857429000;1479593000;;1664448000;17473760000;17473760000;19138208000;8059882000;-166436000;-3114571000;5719221000;24857429000
SPG;111127;USD;2009;Q4;2009-12-31;2010-02-25;300394605;305077069;3957718000;1034729000;;4992447000;18331655000;;2624164000;20955819000;25948266000;1445284000;;1604629000;18630302000;18630302000;20234931000;7547988000;-176796000;-2955671000;5713335000;25948266000
SPG;111127;USD;2008;Q4;2008-12-31;2009-09-04;;;773544000;935556000;;1709100000;19021430000;;2692219000;21713649000;23422749000;1466978000;;1622129000;18042532000;18042532000;19664661000;5410171000;-186210000;-2491929000;3758088000;23422749000
SPG;111127;USD;2017;Q4;2017-12-31;2018-02-23;310826799;310826799;1482309000;742672000;;2224981000;24457515000;;5575142000;30032657000;32257638000;2675568000;;3195931000;24632463000;24632463000;27828394000;9614780000;-1079063000;-4782173000;4429244000;32257638000
SPG;111127;USD;2018;Q4;2018-12-31;2019-02-22;309275870;309275870;514335000;763815000;;1278150000;24208131000;;5199942000;29408073000;30686223000;2852972000;;3353569000;23305535000;23305535000;26659104000;9700450000;-1427431000;-4893069000;4027119000;30686223000
AGHI;111361;USD;2018;Q4;2018-12-31;2019-04-15;13619375;13619375;84700000;109500000;;338800000;91900000;;251300000;343200000;682000000;293600000;13800000;340300000;1559200000;1630200000;1970500000;414200000;-1100000;-1688000000;-1288600000;681900000
AGI;111482;USD;2016;Q4;2016-12-31;2017-03-31;;;36200000;135900000;;321500000;105500000;;339300000;444800000;766300000;341800000;7800000;404400000;1837600000;1900700000;2305100000;210400000;;-1734300000;-1538800000;766300000
AGI;111482;USD;2015;Q4;2015-12-31;2016-03-10;;;51200000;114000000;;338300000;119500000;;371200000;490700000;829000000;358700000;7800000;435800000;1868400000;1939100000;2374900000;210400000;;-1750800000;-1545900000;829000000
AGI;111482;USD;2014;Q4;2014-12-31;2015-03-19;;;28000000;119300000;;365700000;139000000;;533000000;672000000;1037700000;460200000;10800000;560900000;2018400000;2092700000;2653600000;102600000;;-1720800000;-1615900000;1037700000
AGI;111482;USD;2013;Q4;2013-12-31;2014-02-27;;;19600000;132500000;;380900000;140400000;;863200000;1003600000;1384500000;435600000;11700000;552700000;1947100000;2068800000;2621500000;102600000;;-1346400000;-1237000000;1384500000
AGI;111482;USD;2012;Q4;2012-12-31;2013-02-28;;;32500000;140100000;;415400000;136500000;;921200000;1057700000;1473100000;452700000;11800000;579100000;1911800000;2040100000;2619200000;102600000;;-1256800000;-1146100000;1473100000
AGI;111482;USD;2011;Q4;2011-12-31;2012-03-01;;;86300000;126800000;;440300000;134700000;;1076000000;1210700000;1651000000;436800000;11900000;601200000;1922500000;2061500000;2662700000;139600000;;-1157500000;-1011700000;1651000000
AGI;111482;USD;2010;Q4;2010-12-31;2011-07-28;;;121100000;119300000;;477400000;113400000;;924400000;1037800000;1515200000;387400000;9100000;560400000;1685200000;1819700000;2380100000;172100000;;-1047800000;-864900000;1515200000
CBI;111879;USD;2015;Q4;2015-12-31;2016-02-26;104713000;102816000;550221000;1331217000;289658000;3367299000;604043000;136845000;5083873000;5824761000;9192060000;1162077000;800871000;4856948000;1791832000;2171522000;7028470000;801929000;-206407000;1712508000;2163590000;9192060000
CBI;111879;USD;2014;Q4;2014-12-31;2015-02-25;108216000;109056000;351323000;1306567000;286155000;3530459000;771651000;107984000;4970937000;5850572000;9381031000;1256854000;270738000;4322230000;1564158000;2182498000;6504728000;778147000;-24428000;2246770000;2876303000;9381031000
CBI;111879;USD;2013;Q4;2013-12-31;2014-02-27;107605000;109244000;420502000;1385448000;302987000;3389565000;788797000;101754000;5109477000;6000028000;9389593000;1157478000;215000000;4797624000;1625000000;2084531000;6882155000;755017000;-23914000;1733409000;2507438000;9389593000
CBI;111879;USD;2012;Q4;2012-12-31;2013-02-28;96475000;98226000;643395000;752985000;32319000;2721555000;285871000;97267000;1224982000;1608120000;4329675000;654504000;0;1772522000;800000000;1160843000;2933365000;361576000;-193533000;1300742000;1396310000;4329675000
CBI;111879;USD;2011;Q4;2011-12-31;2012-02-24;195768460;200742153;671811000;494853000;;1653096000;262003000;95687000;1268563000;1626253000;3279349000;518749000;40000000;1756879000;;326040000;2082919000;363071000;-142666000;1018481000;1196430000;3279349000
CBI;111879;USD;2010;Q4;2010-12-31;2011-02-22;392905346000;401533375000;481738000;364661000;;1206648000;290206000;92400000;1320280000;1702886000;2909534000;359225000;40334000;1440633000;40000000;385056000;1825689000;333449000;-40166000;783171000;1083845000;2909534000
CBI;111879;USD;2009;Q4;2009-12-31;2010-07-27;97714292;100024312;326000000;477844000;;1195578000;316112000;132258000;1372819000;1821189000;3016767000;483192000;40709000;1679875000;80000000;439602000;2119477000;326897000;-30872000;578612000;897290000;3016767000
CBI;111879;USD;2016;Q4;2016-12-31;2017-03-01;100041000;97505000;490679000;401872000;173817000;2541752000;434252000;35541000;4827875000;5297668000;7839420000;864632000;911410000;4536249000;1287923000;1741834000;6278083000;783418000;-344870000;1370606000;1561337000;7839420000
CBI;111879;USD;2017;Q4;2017-12-31;2018-02-21;101470000;100002000;354639000;759701000;101573000;1830673000;418531000;206118000;3516260000;4140909000;5971582000;971735000;2262442000;5261912000;;491306000;5753218000;744416000;-254642000;-101696000;218364000;5971582000
SXC;112269;USD;2015;Q4;2015-12-31;2016-02-18;30500000;30500000;48600000;40000000;77100000;169100000;1326500000;;273300000;1599800000;1768900000;73600000;1100000;76800000;894500000;947100000;1023900000;;;;745000000;1768900000
SXC;112269;USD;2014;Q4;2014-12-31;2015-02-24;22000000;22000000;33300000;36300000;90400000;164000000;1213400000;;39600000;1253000000;1417000000;84600000;0;84600000;399000000;405700000;490300000;;;;926700000;1417000000
SXC;112269;USD;2013;Q4;2013-12-31;2014-02-28;15688860;15690271;46300000;20200000;59300000;133900000;871100000;;22500000;893600000;1027500000;69700000;40000000;109700000;149700000;153100000;262800000;;;;764700000;1027500000
SXC;112269;USD;2016;Q4;2016-12-31;2017-02-16;;;41800000;39700000;66900000;150000000;1294900000;;251100000;1546000000;1696000000;73400000;4900000;85500000;805700000;856800000;942300000;;;;753700000;1696000000
SXC;112269;USD;2017;Q4;2017-12-31;2018-02-15;;;6600000;42200000;79400000;135800000;1265600000;;240000000;1505600000;1641400000;73500000;2600000;77800000;818400000;947700000;1025500000;;;;615900000;1641400000
SXC;112269;USD;2018;Q4;2018-12-31;2019-02-15;;;12600000;48800000;79000000;144500000;1245100000;;229500000;1474600000;1619100000;85500000;2800000;91300000;793300000;921100000;1012400000;;;;606700000;1619100000
ACRX;113247;USD;2016;Q4;2016-12-31;2017-03-03;45334084;45324007;80310000;5833000;2154000;89053000;10712000;;228000;10940000;99993000;6153000;2912000;10191000;18637000;95139000;105330000;241022000;;-246362000;-5337000;99993000
ACRX;113247;USD;2015;Q4;2015-12-31;2016-03-07;44577085;44054775;113464000;3286000;466000;118947000;8610000;;228000;8838000;127785000;5517000;4541000;12780000;16381000;81892000;94672000;236319000;;-203205000;33113000;127785000
ACRX;113247;USD;2014;Q4;2014-12-31;2015-03-13;43715471;45525121;75350000;0;;76298000;9818000;;300000;10118000;86416000;6085000;6859000;13731000;18015000;26029000;39760000;225466000;;-178806000;46656000;86416000
ACRX;113247;USD;2013;Q4;2013-12-31;2014-03-17;43128175;43128175;103663000;;;104560000;5179000;;292000;5471000;110031000;6245000;;6868000;14364000;30004000;36872000;218611000;;-145453000;73159000;110031000
ACRX;113247;USD;2012;Q4;2012-12-31;2013-03-12;25631248;25631248;59763000;;;61766000;2485000;;269000;2754000;64520000;6888000;7443000;14331000;8530000;16342000;30673000;155873000;;-122027000;33847000;64520000
ACRX;113247;USD;2011;Q4;2011-12-31;2012-03-23;19596755;19596755;35785000;;;38146000;2306000;;383000;2689000;40835000;4041000;3804000;7845000;15275000;15522000;23367000;106132000;;-88664000;17468000;40835000
ACRX;113247;USD;2010;Q4;2010-12-31;2011-08-11;;;3682000;;;5779000;800000;;251000;1051000;6830000;1402000;12009000;13411000;;3370000;16781000;2671000;;-68563000;-9951000;6830000
ACRX;113247;USD;2017;Q4;2017-12-31;2018-03-09;50440978;50440978;60469000;1533000;956000;63413000;11051000;;1088000;12139000;75552000;4967000;7727000;13660000;11369000;98401000;112061000;261361000;;-297870000;-36509000;75552000
CIK;113301;USD;2015;Q4;2015-12-31;2016-02-25;116104592;117505000;180549000;219736000;403101000;857634000;631109000;;3835420000;4466529000;5324163000;388575000;17072000;405647000;2257012000;3112987000;3518634000;1379697000;-32110000;517330000;1805529000;5324163000
CIK;113301;USD;2014;Q4;2014-12-31;2015-02-24;115782000;116948888;38477000;190754000;356467000;715709000;605906000;;3879330000;4485236000;5200945000;369124000;14312000;383436000;2285984000;3103520000;3486956000;1364302000;-32110000;419531000;1713989000;5200945000
CIK;113301;USD;2013;Q4;2013-12-31;2014-03-06;115601792;116949960;116739000;164664000;361872000;792309000;523270000;;3765612000;4288882000;5081191000;304287000;27017000;331304000;2476167000;3151846000;3483150000;1330019000;0;275519000;1598041000;5081191000
CIK;113301;USD;2012;Q4;2012-12-31;2013-05-15;80202520;90806184;92281000;143884000;358051000;705277000;493666000;;3201045000;3694711000;4399988000;301166000;32558000;333724000;2576386000;3177538000;3511262000;697324000;;252955000;888726000;4399988000
CIK;113301;USD;2016;Q4;2016-12-31;2017-02-23;117489520;118875196;353076000;289582000;445491000;1098836000;723345000;;4865785000;5589130000;6687966000;545506000;26190000;571696000;3140496000;4167328000;4739024000;1430638000;-32110000;601049000;1948942000;6687966000
CIK;113301;USD;2017;Q4;2017-12-31;2018-03-01;118497619;119579833;249828000;281622000;489806000;1032317000;739713000;;4806234000;5545947000;6578264000;524638000;36673000;561311000;2925594000;3636715000;4198026000;1454254000;-32110000;987238000;2380238000;6578264000
CPN;113443;USD;2015;Q4;2015-12-31;2016-02-12;352779000;358987000;906000000;644000000;475000000;4095000000;13012000000;79000000;1495000000;14586000000;18681000000;681000000;221000000;3048000000;11716000000;12466000000;15514000000;9594000000;-1000000;-6305000000;3167000000;18681000000
CPN;113443;USD;2014;Q4;2014-12-31;2015-02-13;384504000;393025000;717000000;648000000;447000000;4220000000;13190000000;95000000;873000000;14158000000;18378000000;745000000;199000000;3199000000;11083000000;11748000000;14947000000;12441000000;-2345000000;-6540000000;3431000000;18378000000
CPN;113443;USD;2013;Q4;2013-12-31;2014-02-13;429016000;441335000;941000000;552000000;364000000;2856000000;12995000000;93000000;615000000;13703000000;16559000000;624000000;204000000;1531000000;10908000000;11460000000;12991000000;12390000000;-1230000000;-7486000000;3568000000;16559000000
CPN;113443;USD;2012;Q4;2012-12-31;2013-02-13;459151000;469869000;1284000000;437000000;;2832000000;13005000000;81000000;631000000;13717000000;16549000000;573000000;115000000;1318000000;10635000000;11175000000;12493000000;12336000000;-594000000;-7500000000;4056000000;16549000000
CPN;113443;USD;2011;Q4;2011-12-31;2012-02-10;482502000;482435000;1252000000;598000000;;3562000000;13019000000;80000000;710000000;13809000000;17371000000;638000000;104000000;2162000000;10321000000;10845000000;13007000000;12306000000;-125000000;-7699000000;4364000000;17371000000
CPN;113443;USD;2010;Q4;2010-12-31;2011-02-18;486107000;487579000;1327000000;669000000;;3429000000;12978000000;80000000;769000000;13827000000;17256000000;651000000;152000000;1789000000;10104000000;10798000000;12587000000;12282000000;-5000000;-7509000000;4669000000;17256000000
CPN;113443;USD;2009;Q4;2009-12-31;2010-08-11;;486763000;989000000;750000000;;4099000000;11583000000;214000000;754000000;12551000000;16650000000;639000000;463000000;2749000000;8996000000;9455000000;12204000000;12257000000;-3000000;-7540000000;4446000000;16650000000
CPN;113443;USD;2016;Q4;2016-12-31;2017-02-10;354242000;356500000;418000000;839000000;581000000;2851000000;13013000000;99000000;1530000000;14642000000;17493000000;796000000;748000000;2205000000;11431000000;11949000000;14154000000;9625000000;-7000000;-6213000000;3339000000;17493000000
CPN;113443;USD;2017;Q4;2017-12-31;2018-02-16;355498000;355488000;284000000;970000000;498000000;2306000000;12724000000;106000000;1317000000;14147000000;16453000000;881000000;225000000;1874000000;11180000000;11512000000;13386000000;9661000000;-15000000;-6552000000;3067000000;16453000000
CPN;113443;USD;2018;Q4;2018-12-31;2019-03-28;;;205000000;1022000000;525000000;2419000000;12442000000;76000000;1125000000;13643000000;16062000000;1054000000;637000000;2483000000;10148000000;10523000000;13006000000;9582000000;;-6542000000;3056000000;16062000000
DRQ;113753;USD;2017;Q4;2017-12-31;2018-02-27;37248652;36889000;493180000;191629000;291087000;1008549000;284247000;;107009000;391256000;1399805000;95144000;;99911000;;5433000;105344000;20455000;0;1400296000;1294461000;1399805000
DRQ;113753;USD;2016;Q4;2016-12-31;2017-02-28;37461000;37554000;423497000;213513000;355413000;1056711000;323149000;;81544000;404693000;1461404000;89596000;;101480000;;3500000;104980000;5843000;;1500988000;1356424000;1461404000
DRQ;113753;USD;2015;Q4;2015-12-31;2016-02-25;37650000;37748000;381336000;319780000;344458000;1124298000;294251000;;9701000;303952000;1428250000;82427000;;100815000;;2977000;103792000;378000;;1425344000;1324458000;1428250000
DRQ;113753;USD;2014;Q4;2014-12-31;2015-02-27;39221000;39431000;298705000;373993000;392559000;1127140000;309525000;;12586000;322111000;1449251000;127465000;;198642000;;5417000;204059000;16868000;;1278528000;1245192000;1449251000
DRQ;113753;USD;2013;Q4;2013-12-31;2014-02-28;40744000;41015000;384356000;279253000;368354000;1081006000;304806000;;10993000;315799000;1396805000;104418000;;149443000;;5344000;154787000;192372000;;1069816000;1242018000;1396805000
DRQ;113753;USD;2012;Q4;2012-12-31;2013-02-28;40453000;40639000;257191000;263213000;362181000;924388000;295982000;;11077000;307059000;1231447000;68776000;;155089000;;9926000;165015000;180273000;;899989000;1066432000;1231447000
DRQ;113753;USD;2011;Q4;2011-12-31;2012-02-27;40118000;40360000;298576000;180095000;277802000;799302000;274599000;;11957000;286556000;1085858000;74333000;57000;151000000;;9614000;160614000;162907000;;780780000;925244000;1085858000
DRQ;113753;USD;2010;Q4;2010-12-31;2011-02-28;39935000;40210000;245850000;158894000;243432000;688249000;247158000;;13144000;260302000;948551000;62172000;268000;111329000;58000;9208000;120537000;151818000;;685513000;828014000;948551000
DRQ;113753;USD;2009;Q4;2009-12-31;2010-08-09;39494000;39832000;197792000;130816000;251357000;616541000;194703000;;6002000;200705000;817246000;56688000;723000;104625000;316000;7536000;112161000;129924000;;583287000;705085000;817246000
DRQ;113753;USD;2018;Q4;2018-12-31;2019-02-27;35837000;35837000;418100000;202165000;191194000;852981000;274123000;;65406000;339529000;1192510000;72610000;;82258000;;14090000;96348000;35329000;;1205946000;1096162000;1192510000
HOT;113871;USD;2015;Q4;2015-12-31;2016-02-25;169000000;170000000;1023000000;575000000;15000000;2295000000;1673000000;170000000;4119000000;5962000000;8257000000;1949000000;32000000;2236000000;2144000000;4722000000;6958000000;117000000;;1847000000;1299000000;8257000000
HOT;113871;USD;2014;Q4;2014-12-31;2015-02-25;175000000;175000000;935000000;661000000;236000000;2321000000;2634000000;214000000;3490000000;6338000000;8659000000;2080000000;370000000;2450000000;2574000000;4681000000;7131000000;49000000;;1984000000;1528000000;8659000000
HOT;113871;USD;2013;Q4;2013-12-31;2014-02-24;189000000;190000000;616000000;643000000;217000000;1996000000;3034000000;251000000;3481000000;6766000000;8762000000;1825000000;99000000;1924000000;1523000000;3475000000;5399000000;663000000;;3032000000;3363000000;8762000000
HOT;113871;USD;2012;Q4;2012-12-31;2013-02-21;192000000;197000000;305000000;586000000;361000000;1889000000;3162000000;260000000;3544000000;6966000000;8855000000;1864000000;152000000;2016000000;1656000000;3697000000;5713000000;818000000;;2657000000;3142000000;8855000000
HOT;113871;USD;2011;Q4;2011-12-31;2012-02-21;190000000;196000000;454000000;569000000;812000000;2534000000;3232000000;259000000;3535000000;7026000000;9560000000;1859000000;133000000;1992000000;2596000000;4613000000;6605000000;965000000;;2337000000;2955000000;9560000000
HOT;113871;USD;2010;Q4;2010-12-31;2011-03-11;186000000;201000000;753000000;513000000;802000000;2621000000;3323000000;312000000;3520000000;7155000000;9776000000;2029000000;136000000;2165000000;3215000000;5125000000;7290000000;807000000;;1947000000;2486000000;9776000000
HOT;113871;USD;2009;Q4;2009-12-31;2010-02-25;180000000;171000000;87000000;445000000;783000000;1489000000;3350000000;368000000;3554000000;7272000000;8761000000;2022000000;5000000;2027000000;2955000000;4889000000;6916000000;554000000;;1553000000;1845000000;8761000000
HOT;113871;USD;2008;Q4;2008-12-31;2009-10-30;178000000;182000000;389000000;552000000;986000000;2166000000;3347000000;372000000;3818000000;7537000000;9703000000;2182000000;506000000;2688000000;3502000000;5371000000;8059000000;495000000;;1517000000;1644000000;9703000000
PLD;113992;USD;2015;Q4;2015-12-31;2016-02-19;523938000;544041000;264080000;;;877553000;24247084000;;6270130000;30517214000;31394767000;712725000;;1347100000;11626831000;11626831000;12973931000;19307612000;;-3926483000;18420836000;31394767000
PLD;113992;USD;2014;Q4;2014-12-31;2015-02-25;501232000;488484000;350692000;;;394626000;19399364000;;5981011000;25380375000;25775001000;627999000;;1254425000;9336977000;9336977000;10591402000;18472104000;;-3974493000;15183599000;25775001000
PLD;113992;USD;2013;Q4;2013-12-31;2014-02-26;498815000;499459000;491129000;107955000;;791126000;18255479000;;5525702000;23781181000;24572307000;563993000;;1384638000;9011216000;9011216000;10395854000;17979497000;;-3932664000;14176453000;24572307000
PLD;113992;USD;2012;Q4;2012-12-31;2013-02-28;460420000;449428000;100810000;171084000;;662847000;23328463000;;3318835000;26647298000;27310145000;611770000;;1746015000;11790794000;11790794000;13536809000;16416473000;;-3696093000;13773336000;27310145000
PLD;113992;USD;2011;Q4;2011-12-31;2012-02-29;460793000;462058000;176072000;147999000;;1163747000;22629630000;;3930535000;26560165000;27723912000;639490000;;1886030000;11382408000;11382408000;13268438000;16353922000;;-3092162000;14455474000;27723912000
PLD;113992;USD;2010;Q4;2010-12-31;2011-02-18;351647763;351647763;37634000;58979000;;1000629000;11283963000;;2618075000;13902038000;14902667000;388536000;;876283000;6506029000;6506029000;7382312000;9674105000;;-2515722000;7520355000;14902667000
PLD;113992;USD;2016;Q4;2016-12-31;2017-02-15;528077000;550514000;807316000;;;1161555000;23360958000;;5727419000;29088377000;30249932000;556179000;;1183498000;10608294000;10608294000;11791792000;19460326000;;-3610007000;18458140000;30249932000
PLD;113992;USD;2017;Q4;2017-12-31;2018-02-15;531551000;552913000;447046000;;;823366000;21779296000;;6878413000;28657709000;29481075000;702804000;;1362703000;9412631000;9412631000;10775334000;19368329000;;-2904461000;18705741000;29481075000
PLD;113992;USD;2018;Q4;2018-12-31;2019-02-13;630124000;654671000;343856000;;;966144000;29930307000;;7521213000;37451520000;38417664000;760515000;;1526961000;11089815000;11089815000;12616776000;25692283000;;-2378467000;25800888000;38417664000
GPRO;114240;USD;2015;Q4;2015-12-31;2016-02-29;137152000;144535000;474058000;145692000;188232000;833243000;70050000;;199683000;269733000;1102976000;282435000;;295177000;;35766000;330943000;663311000;-35613000;144335000;772033000;1102976000
GPRO;114240;USD;2014;Q4;2014-12-31;2015-02-20;127581000;165615000;422256000;183992000;153026000;823043000;41556000;;53092000;94648000;917691000;244747000;;258769000;;17718000;276487000;533000000;0;108204000;641204000;917691000
GPRO;114240;USD;2013;Q4;2013-12-31;2014-08-11;81330000;99751000;101410000;122669000;111994000;358040000;32111000;;49520000;81631000;439671000;212814000;60297000;280892000;53315000;86947000;367839000;14518000;;-19884000;71832000;439671000
GPRO;114240;USD;2016;Q4;2016-12-31;2017-02-16;141091000;141091000;217953000;164553000;167192000;587813000;76509000;;258318000;334827000;922640000;416351000;;430739000;0;44956000;475695000;757226000;-35613000;-274668000;446945000;922640000
GPRO;114240;USD;2017;Q4;2017-12-31;2018-02-16;136801000;132749000;247390000;112935000;150551000;573687000;68587000;;207972000;276559000;850246000;351287000;;370531000;130048000;181010000;551541000;854452000;-113613000;-442134000;298705000;850246000
GPRO;114240;USD;2018;Q4;2018-12-31;2019-02-15;140885000;140885000;197512000;129216000;116458000;474073000;46567000;;177719000;224286000;698359000;284370000;;299499000;138992000;186748000;486247000;894755000;-113613000;-569030000;212112000;698359000
USAP;114434;USD;2016;Q4;2016-12-31;2017-02-22;7207049;7207049;75000;19437000;91342000;113583000;182398000;;64000;182462000;296045000;23709000;4579000;29186000;67998000;85639000;114825000;56405000;-2290000;127084000;181220000;296045000
USAP;114434;USD;2015;Q4;2015-12-31;2016-02-24;7092878;7053396;112000;17683000;83373000;103752000;193505000;;45000;193550000;297302000;15106000;3000000;18746000;72884000;93579000;112325000;54836000;-2290000;132431000;184977000;297302000
USAP;114434;USD;2014;Q4;2014-12-31;2015-02-24;7040456;6800836;142000;29057000;101070000;132950000;199795000;;22129000;221924000;354874000;31020000;3000000;34881000;83875000;116363000;151244000;52817000;-2290000;153103000;203630000;354874000
USAP;114434;USD;2013;Q4;2013-12-31;2014-03-05;6977975;6293829;307000;21447000;82593000;121295000;203590000;;23039000;226629000;347924000;17718000;3000000;21741000;86796000;129725000;151466000;49695000;-2290000;149053000;196458000;347924000
USAP;114434;USD;2012;Q4;2012-12-31;2013-03-18;6908141;7483852;321000;24781000;95749000;146862000;206150000;;22686000;228836000;375698000;15281000;1500000;17516000;105242000;160469000;177985000;46751000;-2153000;153115000;197713000;375698000
USAP;114434;USD;2011;Q4;2011-12-31;2012-03-06;7470325;7405387;274000;34554000;85088000;155396000;183148000;;23128000;206276000;361672000;37459000;3000000;41425000;91650000;139941000;181366000;43727000;-1919000;138498000;180306000;361672000
USAP;114434;USD;2010;Q4;2010-12-31;2011-08-08;6796559;6921913;34400000;29273000;69710000;138920000;71581000;;100000;71681000;210601000;25510000;2833000;28824000;7990000;22154000;50978000;41348000;-1919000;120376000;159623000;210601000
USAP;114434;USD;2017;Q4;2017-12-31;2018-02-23;7238641;7694359;207000;24990000;116663000;146264000;174444000;;523000;174967000;321231000;38973000;4707000;44948000;75006000;84615000;129563000;58522000;-2290000;135529000;191668000;321231000
USAP;114434;USD;2018;Q4;2018-12-31;2019-02-20;8750981;8868939;3696000;32618000;134738000;174808000;177844000;;668000;178512000;353320000;52318000;3907000;59154000;42839000;57155000;116309000;93109000;-2290000;146191000;237011000;353320000
SPNC;114601;USD;2015;Q4;2015-12-31;2016-02-26;42615270;42619670;84594000;43359000;25155000;158279000;44719000;;265001000;309720000;467999000;37826000;;63679000;283677000;287351000;351030000;313484000;;-194605000;116969000;467999000
SPNC;114601;USD;2014;Q4;2014-12-31;2015-02-27;41938611;41938611;95505000;41090000;25446000;170134000;33819000;;253885000;287704000;457838000;39449000;;41343000;223088000;254338000;295681000;298568000;;-135131000;162157000;457838000
SPNC;114601;USD;2013;Q4;2013-12-31;2014-02-28;41196471;39657481;128395000;26766000;9476000;167830000;28281000;;21046000;49327000;217157000;21406000;;23225000;0;3932000;27157000;284535000;;-94230000;190000000;217157000
SPNC;114601;USD;2012;Q4;2012-12-31;2013-03-13;34704597;36521155;37775000;19945000;9288000;69827000;27006000;;13936000;40942000;110769000;17997000;;20193000;;1879000;22072000;183175000;;-93860000;88697000;110769000
SPNC;114601;USD;2011;Q4;2011-12-31;2012-03-15;33725780;35525438;39638000;18123000;8542000;69334000;27249000;;12453000;39702000;109036000;25777000;;27960000;;1566000;29526000;176311000;;-96086000;79510000;109036000
SPNC;114601;USD;2010;Q4;2010-12-31;2011-08-05;33082649;33082649;33662000;15664000;8054000;59111000;28669000;;5915000;34584000;93695000;16308000;;18599000;;598000;19197000;171923000;;-96980000;74498000;93695000
SPNC;114601;USD;2016;Q4;2016-12-31;2017-02-24;;43185670;57237000;43565000;27642000;135532000;44827000;;249719000;294546000;430078000;40611000;;66942000;284759000;288813000;355755000;332744000;;-252725000;74323000;430078000
ESI;114707;USD;2015;Q4;2015-12-31;2016-03-15;23731000;23986000;130897000;48837000;;243098000;142164000;;278392000;420556000;663654000;72178000;111857000;329747000;122429000;172771000;502518000;181531000;-1005925000;987223000;161136000;663654000
ESI;114707;USD;2014;Q4;2014-12-31;2015-05-29;23507000;23718000;135937000;46383000;;291414000;157072000;;304352000;461424000;752838000;80112000;67993000;322733000;236147000;288033000;610766000;199254000;-1022120000;963737000;142072000;752838000
ESI;114707;USD;2013;Q4;2013-12-31;2014-10-16;23419000;23067000;215771000;99530000;;434616000;168509000;;203726000;372235000;806851000;76128000;207883000;473777000;71341000;217428000;691205000;200411000;-1028360000;940449000;115646000;806851000
ESI;114707;USD;2012;Q4;2012-12-31;2013-02-22;23351000;23388000;243465000;78928000;;386580000;189890000;;98734000;288624000;675204000;84327000;0;327023000;140000000;222416000;549439000;197484000;-1031262000;967473000;125765000;675204000
ESI;114707;USD;2011;Q4;2011-12-31;2012-02-24;26318000;26491000;377481000;48106000;;456288000;201257000;;71273000;272530000;728818000;100314000;;345047000;150000000;214972000;560019000;189944000;-839341000;827675000;168799000;728818000
ESI;114707;USD;2010;Q4;2010-12-31;2011-02-18;30774000;30969000;312939000;68937000;;414097000;198213000;;62470000;260683000;674780000;96348000;;356151000;150000000;190559000;546710000;174306000;-566405000;524678000;128070000;674780000
ESI;114707;USD;2009;Q4;2009-12-31;2010-07-23;36110000;36532000;272195000;85426000;;390962000;195449000;;30294000;225743000;616705000;87598000;;284792000;150000000;175328000;460120000;155036000;-995261000;1006903000;156585000;616705000
SFS;114802;USD;2017;Q4;2018-01-31;2018-03-16;72100432;66615633;71671000;33019000;289712000;448643000;502227000;15380000;843687000;1361294000;1809937000;381864000;81512000;463376000;617867000;943515000;1406891000;506172000;;-78160000;403046000;1809937000
SFS;114802;USD;2016;Q4;2017-01-31;2017-03-17;71920347;82302386;54235000;31809000;278718000;435636000;444602000;14366000;1012491000;1471459000;1907095000;340085000;62352000;402437000;616588000;952409000;1354846000;500739000;;65093000;552249000;1907095000
SFS;114802;USD;2015;Q4;2016-01-31;2016-03-15;73195911;77614671;59327000;27304000;234289000;372463000;379876000;12763000;1051979000;1444618000;1817081000;305382000;3904000;309286000;586956000;941224000;1250510000;502378000;;70181000;566571000;1817081000
SFS;114802;USD;2014;Q4;2015-01-31;2015-03-25;72289813;75324217;106847000;23666000;223404000;402868000;306684000;11924000;1007816000;1326424000;1729292000;286146000;;286146000;588117000;925938000;1212084000;489624000;;32001000;517208000;1729292000
SFS;114802;USD;2013;Q4;2014-01-31;2014-11-17;57213695;59816281;53699000;19453000;209502000;321339000;243992000;10948000;1023262000;1278202000;1599541000;245155000;7200000;252355000;698991000;1005327000;1257682000;311992000;;-1117000;341859000;1599541000
SFS;114802;USD;2018;Q4;2019-01-31;2019-03-15;73554782;71509993;67217000;36771000;301938000;438272000;482147000;17468000;774031000;1273646000;1711918000;375742000;29095000;404837000;636381000;998926000;1403763000;521260000;;-190315000;308155000;1711918000
GPC;115285;USD;2016;Q4;2016-12-31;2017-02-27;148471000;149118000;242879000;1938562000;3210320000;5948431000;728124000;;2182845000;2910969000;8859400000;3185049000;325000000;4244150000;550000000;1407894000;5652044000;205015000;;4001734000;3207356000;8859400000
GPC;115285;USD;2015;Q4;2015-12-31;2016-02-26;150524000;151278000;211631000;1822419000;2999966000;5555316000;648217000;;1941238000;2589455000;8144771000;3062386000;375000000;3940654000;250000000;1044875000;4985529000;191434000;;3885751000;3159242000;8144771000
GPC;115285;USD;2014;Q4;2014-12-31;2015-02-26;152986000;154074000;137730000;1872365000;3043848000;5592525000;670102000;;1983611000;2653713000;8246238000;2808089000;265466000;3584115000;500000000;1349759000;4933874000;179527000;;3841932000;3312364000;8246238000
GPC;115285;USD;2013;Q4;2013-12-31;2014-02-27;154036000;155118000;196893000;1664819000;2946021000;5221491000;670061000;;1788745000;2458806000;7680297000;2497469000;264658000;3183044000;500000000;1138485000;4321529000;168708000;;3578021000;3358768000;7680297000
GPC;115285;USD;2012;Q4;2012-12-31;2013-02-26;310596190;312616051;403095000;1490028000;2602560000;4820131000;566365000;;1420565000;1986930000;6807061000;1878243000;250000000;2487638000;250000000;1311244000;3798882000;154841000;;3344538000;3008179000;6807061000
GPC;115285;USD;2011;Q4;2011-12-31;2012-02-27;311586794;313583852;525054000;1461011000;2440111000;4754710000;500204000;;947860000;1448064000;6202774000;1680966000;;2012548000;500000000;1436635000;3449183000;155651000;;3070394000;2753591000;6202774000
GPC;115285;USD;2010;Q4;2010-12-31;2011-02-25;-473971872;-475187156;529968000;1364406000;2224717000;4414887000;484130000;;566027000;1050157000;5465044000;1606155000;250000000;1971814000;250000000;690516000;2662330000;157636000;;2934535000;2802714000;5465044000
GPC;115285;USD;2009;Q4;2009-12-31;2010-02-26;159142000;159523000;336803000;1187075000;2214076000;4032828000;485024000;;486837000;971861000;5004689000;1307353000;0;1408284000;500000000;967033000;2375317000;158918000;;2772309000;2629372000;5004689000
GPC;115285;USD;2008;Q4;2008-12-31;2009-08-06;159432000;159905000;67777000;1224525000;2316880000;3871420000;423265000;;491665000;914930000;4786350000;1202987000;;1287103000;500000000;1105869000;2392972000;159443000;;2643451000;2393378000;4786350000
GPC;115285;USD;2017;Q4;2017-12-31;2018-02-27;146607000;147144000;314899000;2421563000;3771089000;7312893000;936702000;;4162786000;5099488000;12412381000;3744595000;694989000;5474025000;2550020000;3474200000;8948225000;214779000;;4049965000;3464156000;12412381000
GPC;115285;USD;2018;Q4;2018-12-31;2019-02-25;146390000;146929000;333547000;2493636000;3609389000;7575690000;1027231000;;4080119000;5107350000;12683040000;4101158000;711147000;5900733000;2432133000;3310316000;9211049000;224317000;;4341212000;3471991000;12683040000
CHSP;115723;USD;2017;Q4;2017-12-31;2018-02-15;59044994;59703623;44314000;20769000;;116887000;1823217000;;35256000;1858473000;1975360000;65783000;;97380000;829552000;829552000;926932000;1190849000;;-144734000;1048428000;1975360000
CHSP;115723;USD;2016;Q4;2016-12-31;2017-02-22;58737621;57830886;43060000;19966000;;116670000;1882869000;;35835000;1918704000;2035374000;64581000;;109389000;737310000;737310000;846699000;1304961000;;-116297000;1188675000;2035374000
CHSP;115723;USD;2015;Q4;2015-12-31;2016-02-18;58621338;59579532;50544000;15603000;;124408000;1926944000;;36414000;1963358000;2087766000;62683000;;108461000;769748000;769748000;878209000;1298474000;;-88675000;1209557000;2087766000
CHSP;115723;USD;2014;Q4;2014-12-31;2015-02-19;53871083;55056163;29326000;13102000;;96452000;1580427000;;43056000;1623483000;1719935000;53442000;;86230000;551723000;551723000;637953000;1138939000;;-57007000;1081982000;1719935000
CHSP;115723;USD;2013;Q4;2013-12-31;2014-02-20;48938843;48938843;28713000;13011000;;86437000;1422439000;;45282000;1467721000;1554158000;45982000;;75830000;531771000;531771000;607601000;991913000;;-45339000;946557000;1554158000
CHSP;115723;USD;2012;Q4;2012-12-31;2013-02-21;39438553;39438553;33194000;8384000;;79094000;1107722000;;46012000;1153734000;1232828000;34868000;;60812000;405208000;405208000;466020000;799676000;;-32089000;766808000;1232828000
CHSP;115723;USD;2011;Q4;2011-12-31;2012-02-24;31821050;31821050;20960000;6302000;;46666000;879224000;;45248000;924472000;971138000;21475000;;43273000;407736000;407736000;451009000;544183000;;-22924000;520129000;971138000
CHSP;115723;USD;2010;Q4;2010-12-31;2011-08-11;;;10551000;4186000;;21931000;364940000;;38437000;403377000;425308000;11160000;;15052000;105000000;105000000;120052000;311487000;;-6231000;305256000;425308000
CHSP;115723;USD;2018;Q4;2018-12-31;2019-02-21;59152227;58175880;71259000;18360000;;142245000;1732154000;;34678000;1766832000;1909077000;72555000;;103710000;751389000;751389000;855099000;1194058000;;-144341000;1053978000;1909077000
WCIC;116367;USD;2015;Q4;2015-12-31;2016-02-22;26212000;26538000;135308000;7374000;554191000;710626000;25649000;;125361000;151010000;861636000;103602000;;141396000;246473000;246473000;387869000;306824000;-781000;165981000;473767000;861636000
WCIC;116367;USD;2014;Q4;2014-12-31;2015-02-25;26029000;26352000;174756000;5637000;449249000;641767000;25021000;;138522000;163543000;805310000;89026000;;119688000;251179000;251179000;370867000;302370000;-505000;130581000;434443000;805310000
WCIC;116367;USD;2013;Q4;2013-12-31;2014-02-27;26116000;26435000;213352000;7107000;280293000;509663000;24479000;;151344000;175823000;685486000;54920000;;75622000;200000000;200000000;275622000;298788000;-196000;108984000;409864000;685486000
WCIC;116367;USD;2012;Q4;2012-12-31;2013-08-20;18099000;18323000;81094000;5672000;183168000;297640000;24313000;;25309000;49622000;347262000;40007000;;55928000;122729000;122729000;178657000;204014000;-196000;-37664000;168605000;347262000
WYN;116466;USD;2015;Q4;2015-12-31;2016-02-12;115000000;116000000;171000000;586000000;295000000;1743000000;1399000000;;6449000000;7848000000;9591000000;394000000;253000000;1957000000;4928000000;6681000000;8638000000;3925000000;-4493000000;1592000000;953000000;9591000000
WYN;116466;USD;2014;Q4;2014-12-31;2015-02-13;121000000;124000000;183000000;516000000;302000000;1867000000;1500000000;;6312000000;7812000000;9679000000;385000000;261000000;1859000000;4792000000;6563000000;8422000000;3891000000;-3843000000;1183000000;1257000000;9679000000
WYN;116466;USD;2013;Q4;2013-12-31;2014-02-14;129000000;133000000;194000000;505000000;346000000;1940000000;1555000000;;6246000000;7801000000;9741000000;360000000;233000000;1790000000;4608000000;6326000000;8116000000;3860000000;-3191000000;832000000;1625000000;9741000000
WYN;116466;USD;2012;Q4;2012-12-31;2013-02-15;141000000;140000000;195000000;442000000;379000000;1866000000;1292000000;;6305000000;7597000000;9463000000;307000000;544000000;1931000000;4018000000;5601000000;7532000000;3822000000;-2601000000;558000000;1931000000;9463000000
WYN;116466;USD;2011;Q4;2011-12-31;2012-02-17;149000000;153000000;142000000;409000000;351000000;1730000000;1117000000;;6176000000;7293000000;9023000000;278000000;242000000;1563000000;3773000000;5228000000;6791000000;3820000000;-2009000000;293000000;2232000000;9023000000
WYN;116466;USD;2010;Q4;2010-12-31;2011-02-22;175000000;183000000;156000000;425000000;348000000;1752000000;1041000000;;6623000000;7664000000;9416000000;274000000;234000000;1575000000;3510000000;4924000000;6499000000;3894000000;-1107000000;-25000000;2917000000;9416000000
WYN;116466;USD;2009;Q4;2009-12-31;2010-07-30;;;155000000;404000000;354000000;1740000000;953000000;;6659000000;7612000000;9352000000;260000000;384000000;1885000000;3138000000;4779000000;6664000000;3735000000;-870000000;-315000000;2688000000;9352000000
WYN;116466;USD;2016;Q4;2016-12-31;2017-02-17;107000000;108000000;185000000;610000000;315000000;1812000000;1340000000;;6667000000;8007000000;9819000000;468000000;229000000;2032000000;5283000000;7069000000;9101000000;3968000000;-5118000000;1977000000;718000000;9819000000
WYN;116466;USD;2017;Q4;2017-12-31;2018-02-20;100800000;101500000;48000000;195000000;1249000000;4511000000;822000000;;5117000000;5939000000;10450000000;232000000;2098000000;3790000000;3908000000;5886000000;9676000000;3998000000;-5719000000;2501000000;774000000;10450000000
WYN;116466;USD;2018;Q4;2018-12-31;2019-02-26;96400000;96200000;218000000;121000000;1224000000;5111000000;712000000;;1335000000;2047000000;7158000000;66000000;2357000000;4328000000;2881000000;3399000000;7727000000;4079000000;-6043000000;1442000000;-569000000;7158000000
KWR;116818;USD;2018;Q4;2018-12-31;2019-02-28;13281399;13327393;104147000;202139000;94090000;418510000;83923000;21316000;185916000;291155000;709665000;119692000;670000;151470000;35934000;121826000;273296000;110642000;;405125000;436369000;709665000
KWR;116818;USD;2017;Q4;2017-12-31;2018-02-28;13231174;13270751;89879000;208358000;87221000;406586000;86704000;25690000;203146000;315540000;722126000;121686000;5736000;154743000;61068000;157765000;312508000;106836000;;365936000;409618000;722126000
KWR;116818;USD;2016;Q4;2016-12-31;2017-02-28;13157727;13193925;88818000;195225000;77082000;376468000;85734000;22817000;207009000;315560000;692028000;102606000;707000;127411000;65769000;152011000;279422000;125753000;;364414000;412606000;692028000
KWR;116818;USD;2015;Q4;2015-12-31;2016-02-25;13180376;13188612;81053000;188297000;75099000;358031000;87619000;20354000;214723000;322696000;680727000;91853000;662000;124514000;81439000;174970000;299484000;119621000;;326740000;381243000;680727000
KWR;116818;USD;2014;Q4;2014-12-31;2015-02-26;13163840;13185366;64731000;189484000;77708000;351518000;85763000;21751000;206494000;314008000;665526000;100069000;403000;124901000;75328000;175490000;300391000;112357000;;299524000;365135000;665526000
KWR;116818;USD;2013;Q4;2013-12-31;2014-02-28;13077166;13098903;68492000;165629000;71557000;328847000;85488000;19397000;150414000;255299000;584146000;97819000;1395000;130856000;17321000;108594000;239450000;112234000;;258285000;344696000;584146000
KWR;116818;USD;2012;Q4;2012-12-31;2013-03-06;12967796;12966973;32547000;154197000;72471000;277810000;85112000;16603000;157109000;258824000;536634000;89824000;1468000;107792000;30000000;139166000;246958000;107565000;;215390000;289676000;536634000
KWR;116818;USD;2011;Q4;2011-12-31;2012-03-07;12670588;12803087;16909000;150676000;74758000;259549000;82916000;14073000;154614000;251603000;511152000;87150000;636000;106649000;46701000;143146000;249795000;102637000;;180710000;261357000;511152000
KWR;116818;USD;2010;Q4;2010-12-31;2011-07-27;;;25766000;116266000;60841000;215482000;76535000;9218000;148195000;233948000;449430000;82705000;890000;101191000;73855000;161140000;262331000;49767000;;144347000;187099000;449430000
PEG;117316;USD;2016;Q4;2016-12-31;2017-02-27;505000000;508000000;423000000;1161000000;561000000;3254000000;29286000000;;7530000000;36816000000;40070000000;1556000000;888000000;3276000000;10895000000;23664000000;26940000000;4936000000;-717000000;9174000000;13130000000;40070000000
PEG;117316;USD;2015;Q4;2015-12-31;2016-02-26;503000000;508000000;394000000;1068000000;513000000;3494000000;26539000000;;7502000000;34041000000;37535000000;1465000000;1098000000;3575000000;8834000000;20893000000;24468000000;4915000000;-671000000;9117000000;13067000000;37535000000
PEG;117316;USD;2014;Q4;2014-12-31;2015-02-26;506000000;509000000;402000000;1254000000;484000000;4119000000;23589000000;;7579000000;31168000000;35287000000;1273000000;883000000;3478000000;8215000000;19623000000;23101000000;4876000000;-635000000;8227000000;12186000000;35287000000
PEG;117316;USD;2013;Q4;2013-12-31;2014-02-26;505000000;509000000;493000000;1203000000;479000000;3614000000;21645000000;;7263000000;28908000000;32522000000;1317000000;841000000;3063000000;7862000000;17850000000;20913000000;4861000000;-615000000;7457000000;11609000000;32522000000
PEG;117316;USD;2012;Q4;2012-12-31;2013-02-26;506000000;507000000;379000000;1069000000;422000000;3869000000;19736000000;;8120000000;27856000000;31725000000;1395000000;1515000000;3777000000;6687000000;17167000000;20944000000;4833000000;-607000000;6942000000;10781000000;31725000000
PEG;117316;USD;2011;Q4;2011-12-31;2012-02-27;505796000;506928000;834000000;967000000;367000000;3911000000;17849000000;;8061000000;25910000000;29821000000;1281000000;633000000;2957000000;7461000000;16592000000;19549000000;4823000000;-601000000;6385000000;10272000000;29821000000
PEG;117316;USD;2010;Q4;2010-12-31;2011-02-25;505940000;507180000;280000000;1387000000;359000000;5051000000;16390000000;;8468000000;24858000000;29909000000;1284000000;1185000000;3485000000;7819000000;16783000000;20268000000;4807000000;-593000000;5575000000;9641000000;29909000000
PEG;117316;USD;2009;Q4;2009-12-31;2010-02-25;505944000;507256000;350000000;1224000000;335000000;4290000000;14886000000;;9502000000;24388000000;28678000000;1177000000;1051000000;3360000000;7645000000;16440000000;19800000000;4788000000;-588000000;4704000000;8878000000;28678000000
PEG;117316;USD;2008;Q4;2008-12-31;2009-08-03;506073000;507038000;321000000;1398000000;317000000;3999000000;14433000000;;10617000000;25050000000;29049000000;1326000000;1052000000;3410000000;8005000000;17777000000;21187000000;4756000000;-581000000;3773000000;7862000000;29049000000
PEG;117316;USD;2017;Q4;2017-12-31;2018-02-26;505000000;506000000;313000000;1348000000;577000000;3312000000;31797000000;;7607000000;39404000000;42716000000;1797000000;1542000000;4168000000;12068000000;24701000000;28869000000;4961000000;-763000000;9878000000;13847000000;42716000000
PEG;117316;USD;2018;Q4;2018-12-31;2019-02-28;504000000;507000000;177000000;1435000000;571000000;3507000000;34363000000;;7456000000;41819000000;45326000000;1561000000;2310000000;4935000000;13168000000;26014000000;30949000000;4980000000;-808000000;10582000000;14377000000;45326000000
CUBE;117529;USD;2016;Q4;2016-12-31;2017-02-17;180083000;181172000;2973000;;;13016000;3326816000;98682000;36514000;3462012000;3475028000;257621000;;277847000;1481125000;1481537000;1759384000;2315815000;;-658583000;1715644000;3475028000
CUBE;117529;USD;2015;Q4;2015-12-31;2016-02-19;173071000;174474000;62869000;;;90269000;2872983000;97281000;43631000;3013895000;3104164000;235174000;;252693000;1140087000;1140490000;1393183000;2232928000;;-584654000;1710981000;3104164000
CUBE;117529;USD;2014;Q4;2014-12-31;2015-02-27;161772000;161673000;2901000;;;16859000;2625129000;95709000;48642000;2769480000;2786339000;293186000;;308497000;978000000;978401000;1286898000;1975947000;;-519193000;1499441000;2786339000
CUBE;117529;USD;2013;Q4;2013-12-31;2014-02-28;138771000;146234000;3176000;;;19888000;2155170000;156310000;27256000;2338736000;2358624000;277772000;;290166000;938600000;938976000;1229142000;1544096000;;-440837000;1129482000;2358624000
CUBE;117529;USD;2012;Q4;2012-12-31;2013-02-28;129158000;129158000;4495000;;;18818000;2089707000;;41794000;2131501000;2150319000;305886000;;316976000;795000000;795444000;1112420000;1419781000;;-410225000;1037899000;2150319000
CUBE;117529;USD;2011;Q4;2011-12-31;2012-02-29;115396000;114007000;9069000;;;28433000;1788720000;15181000;43645000;1847546000;1875979000;420867000;;430435000;400000000;400490000;830925000;1310726000;;-342013000;1045054000;1875979000
CUBE;117529;USD;2010;Q4;2010-12-31;2011-08-09;96530000;96530000;5891000;;;31752000;1428491000;;18576000;1447067000;1478819000;415904000;;424777000;243000000;243489000;668266000;1027938000;;-302601000;810553000;1478819000
CUBE;117529;USD;2017;Q4;2017-12-31;2018-02-16;181448000;182052000;5268000;;;10750000;3408790000;91206000;34590000;3534586000;3545336000;310075000;;331604000;1523556000;1524042000;1855646000;2358442000;;-729311000;1689690000;3545336000
CUBE;117529;USD;2018;Q4;2018-12-31;2019-02-22;186546000;187319000;3764000;;;7445000;3600968000;95796000;48763000;3745527000;3752972000;318787000;;341382000;1638848000;1639322000;1980704000;2502622000;;-791915000;1772268000;3752972000
WFT;117829;USD;2018;Q4;2018-12-31;2019-02-15;999000000;999000000;602000000;1130000000;1025000000;3450000000;2086000000;;1065000000;3151000000;6601000000;1195000000;383000000;2300000000;7605000000;7967000000;10267000000;6712000000;;-8671000000;-3666000000;6601000000
WFT;117829;USD;2017;Q4;2017-12-31;2018-02-14;992000000;992000000;613000000;1103000000;1234000000;3878000000;2708000000;;3161000000;5869000000;9747000000;1392000000;148000000;2230000000;7541000000;8088000000;10318000000;6656000000;;-5763000000;-571000000;9747000000
WFT;117829;USD;2016;Q4;2016-12-31;2017-02-15;937000000;937000000;1037000000;1383000000;1802000000;4910000000;4480000000;66000000;3208000000;7754000000;12664000000;1391000000;179000000;2428000000;7403000000;8168000000;10596000000;6572000000;;-2950000000;2068000000;12664000000
WFT;117829;USD;2015;Q4;2015-12-31;2016-02-16;781000000;781000000;467000000;1781000000;2344000000;5564000000;5679000000;76000000;3441000000;9196000000;14760000000;1684000000;1582000000;4031000000;5852000000;6364000000;10395000000;5503000000;;442000000;4365000000;14760000000
WFT;117829;USD;2014;Q4;2014-12-31;2015-02-18;778000000;780000000;474000000;3015000000;3087000000;7944000000;7123000000;106000000;3716000000;10945000000;18889000000;2391000000;727000000;4027000000;6798000000;7829000000;11856000000;5412000000;;2427000000;7033000000;18889000000
WFT;117829;USD;2013;Q4;2013-12-31;2014-07-25;775000000;775000000;435000000;3351000000;3200000000;9934000000;7689000000;296000000;4058000000;12043000000;21977000000;2573000000;1653000000;5757000000;7061000000;8017000000;13774000000;5375000000;-37000000;3011000000;8203000000;21977000000
MKTX;118024;USD;2016;Q4;2016-12-31;2017-02-21;36836000;37741000;362647000;50668000;;424933000;31104000;;72005000;103109000;528042000;57514000;;60029000;;0;60029000;342431000;-117330000;255140000;468013000;528042000
MKTX;118024;USD;2015;Q4;2015-12-31;2016-02-25;36674000;37637000;284434000;40459000;;334773000;30897000;;73371000;104268000;439041000;46016000;;48328000;;0;48328000;321336000;-93405000;168011000;390713000;439041000
MKTX;118024;USD;2014;Q4;2014-12-31;2015-02-25;36728000;37713000;233787000;33836000;;274308000;32185000;;73391000;105576000;379884000;43211000;;45676000;;0;45676000;307179000;-70247000;101813000;334208000;379884000
MKTX;118024;USD;2013;Q4;2013-12-31;2014-02-24;36983000;38095000;200433000;34158000;;245231000;32703000;;75976000;108679000;353910000;40835000;;43548000;;0;43548000;295676000;-32273000;51042000;310362000;353910000
MKTX;118024;USD;2012;Q4;2012-12-31;2013-02-21;36502000;37588000;180116000;31044000;;219256000;18009000;;42576000;60585000;279841000;32260000;;37124000;;0;37124000;283727000;-32273000;-5644000;242717000;279841000
MKTX;118024;USD;2011;Q4;2011-12-31;2012-07-06;147913605;158313381;247730000;36170000;;292365000;14460000;;42633000;57093000;349458000;31693000;;37019000;;0;37019000;340838000;-25933000;-584000;312439000;349458000
MKTX;118024;USD;2010;Q4;2010-12-31;2011-07-27;32334000;38640000;197546000;25682000;;231151000;12545000;;55825000;68370000;299521000;30159000;;34730000;;0;34730000;340732000;-39685000;-34605000;264791000;299521000
MKTX;118024;USD;2017;Q4;2017-12-31;2018-02-21;36888000;37944000;406535000;52636000;;477888000;38548000;;64796000;103344000;581232000;63804000;;66464000;;0;66464000;331202000;-159791000;353583000;514768000;581232000
FEIM;118109;USD;2016;Q4;2016-04-30;2017-07-31;8808122;8625353;9978000;10986000;29051000;69855000;14813000;;28651000;43464000;113319000;5862000;;8111000;;15876000;23987000;64931000;-1592000;23712000;89332000;113319000
FEIM;118109;USD;2015;Q4;2015-04-30;2016-07-29;8743997;9113533;16929000;7166000;36280000;85862000;12314000;;24001000;36315000;122177000;7644000;;10308000;6000000;18517000;28825000;64740000;-1885000;28533000;93352000;122177000
FEIM;118109;USD;2014;Q4;2014-04-30;2015-07-29;8657125;9031476;18408000;9689000;38239000;83599000;12686000;;21540000;34226000;117825000;8350000;;8350000;6000000;17665000;26015000;63524000;-2132000;27528000;91810000;117825000
FEIM;118109;USD;2013;Q4;2013-04-30;2014-07-29;8559391;8862528;23728000;7741000;41227000;87862000;11240000;;20359000;31599000;119461000;9697000;;9697000;10100000;21418000;31115000;62345000;-2715000;24702000;88346000;119461000
FEIM;118109;USD;2012;Q4;2012-04-30;2013-07-29;8446487;8667757;21730000;7781000;37521000;81016000;8316000;;19577000;27893000;108909000;9169000;;9327000;6000000;17130000;26457000;61077000;-3200000;20662000;82452000;108909000
FEIM;118109;USD;2011;Q4;2011-04-30;2012-07-30;8369054;8611520;22440000;10866000;34299000;79362000;8374000;;18491000;26865000;106227000;9726000;;16109000;15000;10986000;27095000;59961000;-3659000;18660000;79132000;106227000
FEIM;118109;USD;2010;Q4;2010-04-30;2011-09-14;-16489301614;-16670318240;20632000;11663000;28172000;67736000;7163000;;14932000;22095000;89831000;7111000;;7386000;181000;10910000;18296000;59032000;-3975000;11286000;71535000;89831000
FEIM;118109;USD;2017;Q4;2017-04-30;2018-07-30;8856946;8715665;14018000;4268000;26186000;52075000;14127000;;17382000;31509000;83584000;5257000;;5257000;;15065000;20322000;65603000;-1361000;-65000;63262000;83584000
MPWR;118204;USD;2016;Q4;2016-12-31;2017-03-01;40739000;42403000;268224000;34248000;71469000;382984000;85171000;5354000;37617000;128142000;511126000;30005000;;52921000;;27089000;80010000;315969000;;119362000;431116000;511126000
MPWR;118204;USD;2015;Q4;2015-12-31;2016-02-29;39613000;41446000;234963000;30830000;63209000;331928000;65359000;5361000;28637000;99357000;431285000;23299000;;43283000;;19486000;62769000;265763000;;101287000;368516000;431285000
MPWR;118204;USD;2014;Q4;2014-12-31;2015-03-02;38805000;40320000;238718000;25630000;40918000;307912000;62942000;5389000;23123000;91454000;399366000;22158000;;36861000;;16080000;52941000;240500000;;100114000;346425000;399366000
MPWR;118204;USD;2013;Q4;2013-12-31;2014-03-10;38326000;39524000;226339000;23730000;39737000;292086000;64837000;9860000;2125000;76822000;368908000;21113000;;38489000;;7020000;45509000;234201000;;82938000;323399000;368908000
MPWR;118204;USD;2012;Q4;2012-12-31;2013-03-05;104270230;37015000;160625000;19383000;32115000;214301000;59412000;11755000;1694000;72861000;287162000;17545000;;23460000;;5408000;28868000;194079000;;60040000;258294000;287162000
MPWR;118204;USD;2011;Q4;2011-12-31;2012-03-12;136097536;140534752;174198000;15097000;20104000;211505000;47794000;13675000;893000;62362000;273867000;18225000;;26070000;;4920000;30990000;159336000;;79948000;242877000;273867000
MPWR;118204;USD;2010;Q4;2010-12-31;2011-08-09;143212096;151189610;177719000;18347000;25789000;224373000;37262000;19180000;788000;57230000;281603000;17771000;;28970000;;5738000;34708000;178269000;;66647000;246895000;281603000
MPWR;118204;USD;2017;Q4;2017-12-31;2018-03-01;41572000;44161000;299090000;38037000;99281000;449170000;144636000;5256000;53507000;203399000;652569000;38410000;;65917000;;64645000;130562000;376586000;;143608000;522007000;652569000
MPWR;118204;USD;2018;Q4;2018-12-31;2019-03-01;42467000;45057000;377281000;55214000;136384000;580810000;150001000;3241000;59380000;212622000;793432000;41477000;;80439000;;72900000;153339000;450908000;;194728000;640093000;793432000
MOBL;118286;USD;2016;Q4;2016-12-31;2017-02-14;88373000;88373000;90227000;43755000;;140113000;5503000;;7490000;12993000;153106000;22375000;;90528000;;21761000;112289000;383202000;;-342385000;40817000;153106000
MOBL;118286;USD;2015;Q4;2015-12-31;2016-02-23;80459000;80459000;96810000;42674000;;144293000;6572000;2094000;8155000;16821000;161114000;21747000;;77725000;;15250000;92975000;343344000;;-275205000;68139000;161114000
MOBL;118286;USD;2014;Q4;2014-12-31;2015-02-27;76834000;76834000;118156000;34676000;;156850000;3978000;22220000;8794000;34992000;191842000;22306000;;66402000;;10346000;76748000;305817000;;-190723000;115094000;191842000
MOBL;118286;USD;2013;Q4;2013-12-31;2014-08-07;10739000;10739000;73573000;24125000;;101410000;3095000;;6754000;9849000;111259000;15634000;4300000;52356000;;8469000;60825000;19009000;;-128834000;50434000;111259000
MOBL;118286;USD;2017;Q4;2017-12-31;2018-03-12;96654000;96654000;92630000;50629000;;158054000;8812000;;17574000;26386000;184440000;26439000;;101090000;;23798000;124888000;420535000;;-360983000;59552000;184440000
MOBL;118286;USD;2018;Q4;2018-12-31;2019-02-22;106118000;106118000;105613000;60994000;;183239000;7046000;;20102000;27148000;210387000;29501000;;123045000;;33225000;156270000;462015000;-3831000;-404067000;54117000;210387000
ADPT;118952;USD;2015;Q4;2015-12-31;2016-02-29;14317485;14317485;16037000;65954000;5167000;118690000;70187000;;332726000;402913000;521603000;50718000;7687000;59263000;117517000;312656000;371919000;85665000;;6323000;149684000;521603000
ADPT;118952;USD;2014;Q4;2014-12-31;2015-02-27;9845016;9845016;2002000;37422000;4287000;65643000;93892000;;123283000;217175000;282818000;38941000;1897000;41445000;109038000;141493000;182938000;51444000;;-3351000;99880000;282818000
ADPT;118952;USD;2013;Q4;2013-12-31;2014-08-08;;;11495000;15887000;1494000;33071000;62087000;;88134000;150221000;183292000;24365000;562000;25424000;78849000;79217000;104641000;78651000;;;78651000;183292000
CF;119051;USD;2017;Q4;2017-12-31;2018-02-22;234200000;235600000;835000000;307000000;275000000;1465000000;9175000000;;2823000000;11998000000;13463000000;563000000;;580000000;4692000000;6199000000;6779000000;1399000000;0;2443000000;6684000000;13463000000
CF;119051;USD;2016;Q4;2016-12-31;2016-11-03;232800000;232300000;1164000000;236000000;339000000;2655000000;9652000000;;2824000000;12476000000;15131000000;681000000;;686000000;5778000000;7953000000;8639000000;1382000000;-1000000;2365000000;6492000000;15131000000
CF;119051;USD;2015;Q4;2015-12-31;2016-02-25;233200000;233700000;286000000;267000000;321000000;1127000000;8539000000;;3017000000;11556000000;12683000000;1085000000;;1215000000;5537000000;7081000000;8296000000;1380000000;-153000000;3058000000;4387000000;12683000000
CF;119051;USD;2014;Q4;2014-12-31;2015-02-26;245900000;247000000;1996600000;191500000;202900000;2530500000;5525800000;;3197900000;8723700000;11254200000;931300000;;979700000;4592500000;5702000000;6681700000;1416400000;-222200000;3175300000;4572500000;11254200000
CF;119051;USD;2013;Q4;2013-12-31;2014-02-27;284100000;285000000;1710800000;230900000;274300000;2630100000;4101700000;;3946300000;8048000000;10678100000;758000000;;828300000;3098100000;4411400000;5239700000;1594900000;-201800000;3725600000;5438400000;10678100000
CF;119051;USD;2012;Q4;2012-12-31;2013-02-27;315000000;318000000;2274900000;217400000;277900000;2807600000;3900500000;;3458800000;7359300000;10166900000;934300000;5000000;950200000;1600000000;2934500000;3884700000;2493000000;-2300000;3461100000;6282200000;10166900000
CF;119051;USD;2011;Q4;2011-12-31;2012-02-27;326500000;329000000;1207000000;269400000;304200000;1798600000;3736000000;;3439900000;7175900000;8974500000;713400000;;1031200000;1617800000;3010400000;4041600000;2805500000;-1000200000;2841000000;4932900000;8974500000
CF;119051;USD;2010;Q4;2010-12-31;2011-02-25;358500000;364500000;800800000;238900000;270300000;1341400000;3942300000;;3470300000;7412600000;8754000000;816900000;4900000;948600000;1954100000;3372000000;4320600000;2732900000;;1370800000;4433400000;8754000000
CF;119051;USD;2009;Q4;2009-12-31;2010-02-25;243500000;246000000;882100000;167400000;207800000;1283100000;793800000;160200000;257800000;1211800000;2494900000;332000000;;479800000;4700000;270200000;750000000;724000000;;1048100000;1744900000;2494900000
CF;119051;USD;2008;Q4;2008-12-31;2009-08-03;260500000;264000000;625000000;175100000;588600000;1433200000;661900000;;292500000;954400000;2387600000;569800000;4100000;818100000;;218800000;1036900000;709900000;;703400000;1350700000;2387600000
CF;119051;USD;2018;Q4;2018-12-31;2019-02-22;229000000;230300000;682000000;235000000;309000000;1274000000;8623000000;;2764000000;11387000000;12661000000;699000000;;705000000;4698000000;6225000000;6930000000;1370000000;-504000000;2463000000;5731000000;12661000000
ROP;119446;USD;2017;Q4;2017-12-31;2018-02-23;102403000;103921000;671327000;641662000;204933000;1759402000;142535000;;12414476000;12557011000;14316413000;662018000;800944000;2029409000;4354611000;5423440000;7452849000;1603913000;-18706000;5464571000;6863564000;14316413000
ROP;119446;USD;2016;Q4;2016-12-31;2017-02-27;101472000;102550000;757200000;619854000;181952000;1776501000;141318000;;12407108000;12548426000;14324927000;555898000;400975000;1445272000;5808561000;7090790000;8536062000;1490103000;-18901000;4642402000;5788865000;14324927000
ROP;119446;USD;2015;Q4;2015-12-31;2016-02-26;100833000;101851000;778511000;488271000;189868000;1618047000;105510000;;8444808000;8550318000;10168365000;446293000;6805000;720128000;3264417000;4149290000;4869418000;1420290000;-19094000;4110530000;5298947000;10168365000
ROP;119446;USD;2014;Q4;2014-12-31;2015-02-20;100158000;101135000;610430000;511538000;193766000;1512105000;110876000;;6777204000;6888080000;8400185000;421959000;11092000;627947000;2190282000;3016878000;3644825000;1326359000;-19273000;3520201000;4755360000;8400185000
ROP;119446;USD;2013;Q4;2013-12-31;2014-02-21;99320000;100386000;459720000;519075000;204923000;1373337000;117310000;;6694334000;6811644000;8184981000;416253000;11016000;643091000;2453836000;3328840000;3971931000;1230246000;-19475000;2959196000;4213050000;8184981000
ROP;119446;USD;2012;Q4;2012-12-31;2013-02-25;98433000;99549000;370590000;526408000;190867000;1245542000;110397000;;5715165000;5825562000;7071104000;377415000;519015000;1086210000;1503107000;2297168000;3383378000;1159007000;-19676000;2489858000;3687726000;7071104000
ROP;119446;USD;2011;Q4;2011-12-31;2012-02-24;96468000;98671000;338101000;439134000;204758000;1115473000;108775000;;4095169000;4203944000;5319417000;378981000;69906000;554196000;1015110000;1570125000;2124321000;1118080000;-19894000;2063110000;3195096000;5319417000
ROP;119446;USD;2010;Q4;2010-12-31;2011-02-25;94835000;97456000;270394000;403337000;178559000;998091000;103487000;;3967946000;4071433000;5069524000;435858000;93342000;539645000;1247703000;1778972000;2318617000;1046257000;-20177000;1680849000;2750907000;5069524000
ROP;119446;USD;2009;Q4;2009-12-31;2010-02-26;91169000;93358000;167708000;381658000;178795000;870745000;109493000;;3347498000;3456991000;4327736000;363544000;112796000;478011000;1040962000;1428235000;1906246000;983279000;-21320000;1395586000;2421490000;4327736000
ROP;119446;USD;2008;Q4;2008-12-31;2009-08-17;89729000;92718000;178069000;376855000;185919000;858307000;112463000;;3000768000;3113231000;3971538000;385381000;233526000;618907000;1033689000;1348697000;1967604000;816655000;-21701000;1187467000;2003934000;3971538000
ROP;119446;USD;2018;Q4;2018-12-31;2019-02-25;103300000;104400000;364400000;700800000;190800000;1610700000;128700000;;13510100000;13638800000;15249500000;729900000;1500000;2379300000;4940200000;5131700000;7511000000;1752600000;-18500000;6247700000;7738500000;15249500000
LNT;119577;USD;2016;Q4;2016-12-31;2017-02-24;227400000;227400000;8200000;493300000;222300000;877100000;10279200000;337600000;1879900000;12496700000;13373800000;445300000;248700000;1162000000;4315600000;8149800000;9311800000;1695400000;;2177000000;4062000000;13373800000
LNT;119577;USD;2015;Q4;2015-12-31;2016-02-24;226800000;226800000;5800000;397600000;223500000;826800000;9519100000;346300000;1803000000;11668400000;12495200000;402400000;473200000;1359300000;3522200000;7211800000;8571100000;1664100000;;2068900000;3924100000;12495200000
LNT;119577;USD;2014;Q4;2014-12-31;2015-02-25;221600000;221600000;56900000;427300000;223800000;1043100000;8938400000;344900000;1737100000;11020400000;12063500000;427900000;324300000;1214700000;3584300000;7208300000;8423000000;1510200000;;1938000000;3640500000;12063500000
LNT;119577;USD;2013;Q4;2013-12-31;2014-02-25;221600000;221600000;9800000;473300000;211800000;1011200000;8326500000;329600000;1445100000;10101200000;11112400000;365000000;637900000;1433300000;2977800000;6195900000;7629200000;1508900000;;1780700000;3483200000;11112400000
LNT;119577;USD;2012;Q4;2012-12-31;2013-02-26;221920000;221822000;21200000;94900000;203900000;994300000;7838000000;319000000;1634200000;9791200000;10785500000;387300000;219000000;1020000000;3136600000;6423700000;7443700000;1512300000;;1630700000;3341800000;10785500000
LNT;119577;USD;2011;Q4;2011-12-31;2012-02-27;221920000;221592000;11400000;88100000;218100000;870600000;7033300000;300700000;1483300000;8817300000;9687900000;314400000;104200000;855200000;2703100000;5612800000;6468000000;1511900000;;1510200000;3219900000;9687900000
LNT;119577;USD;2010;Q4;2010-12-31;2011-02-28;221044000;221198000;159300000;120500000;233000000;1092700000;6730600000;289200000;1170400000;8190200000;9282900000;383000000;48700000;866700000;2703400000;5276800000;6143500000;1507900000;;1394700000;3139400000;9282900000
LNT;119577;USD;2009;Q4;2009-12-31;2010-08-05;220602000;220776000;175300000;246900000;238500000;1390000000;6192900000;281500000;1171600000;7646000000;9036000000;383000000;291500000;1076600000;2404500000;4940900000;6017500000;1500200000;;1281700000;3018500000;9036000000
LNT;119577;USD;2017;Q4;2017-12-31;2018-02-23;231200000;231200000;27900000;482800000;222400000;905100000;11234500000;396100000;1652100000;13282700000;14187800000;477300000;1270900000;2149000000;4010600000;7656600000;9805600000;1847800000;;2346000000;4382200000;14187800000
NI;119873;USD;2017;Q4;2017-12-31;2018-02-20;337648000;340238000;29000000;898900000;471100000;1763300000;14359500000;204100000;3634800000;18198400000;19961700000;1291800000;1490000000;3178400000;7512200000;12463200000;15641600000;5532500000;-95900000;-1073100000;4320100000;19961700000
NI;119873;USD;2016;Q4;2016-12-31;2017-02-22;322896000;324514000;26400000;847000000;494400000;1762100000;13068000000;193300000;3668500000;16929800000;18691900000;1166100000;1851100000;3452200000;6058200000;11168500000;14620700000;5157200000;-88700000;-972200000;4071200000;18691900000
NI;119873;USD;2015;Q4;2015-12-31;2016-02-18;318807000;322989000;15500000;660000000;536600000;1577200000;12111500000;187700000;3616100000;15915300000;17492500000;1071100000;1001100000;2657500000;5948500000;10991500000;13649000000;5081200000;-79300000;-1123300000;3843500000;17492500000
NI;119873;USD;2014;Q4;2014-12-31;2015-02-18;-169645990;-166960490;24900000;920800000;586200000;2162400000;11057400000;204800000;11165200000;22427400000;24589800000;1338100000;1843500000;3964300000;8151500000;14450200000;18414500000;4790800000;-58900000;1494000000;6175300000;24589800000
NI;119873;USD;2013;Q4;2013-12-31;2014-02-18;-1132865755;-1135316065;26800000;1005800000;500400000;1937500000;14365100000;204000000;6147300000;20716400000;22653900000;1531800000;1240800000;3178400000;7593200000;13588900000;16767300000;4693300000;-48600000;1285500000;5886600000;22653900000
NI;119873;USD;2012;Q4;2012-12-31;2013-02-19;789165307;795888179;36300000;907300000;495700000;2322700000;12915900000;194400000;6411700000;19522000000;21844700000;1370100000;1284100000;3319300000;6819100000;12971100000;16290400000;4600700000;-40500000;1059600000;5554300000;21844700000
NI;119873;USD;2011;Q4;2011-12-31;2012-02-24;716382125;745418030;11500000;850600000;565100000;2248600000;11779200000;150900000;6529600000;18459700000;20708300000;1263400000;1686700000;3646400000;6267100000;12064600000;15711000000;4170500000;-30500000;917000000;4997300000;20708300000
NI;119873;USD;2010;Q4;2010-12-31;2011-02-28;709037000;724261190;9200000;1079300000;428000000;2313100000;11097000000;139700000;6363600000;17600300000;19913400000;1550500000;1416700000;3666300000;5936100000;11349600000;15015900000;4106700000;-27400000;876100000;4897500000;19913400000
NI;119873;USD;2009;Q4;2009-12-31;2010-08-03;702420000;690458500;16400000;808600000;547000000;2198000000;10688000000;129200000;6256500000;17073700000;19271700000;1397400000;822700000;3149600000;5969100000;11268000000;14417600000;4060400000;-25900000;865500000;4854100000;19271700000
NI;119873;USD;2018;Q4;2018-12-31;2019-02-20;369823000;367873000;112800000;1058500000;422500000;2055400000;15542500000;204000000;4002100000;19748600000;21804000000;1605900000;2027200000;4036800000;7105400000;12016300000;16053100000;6407300000;-99900000;-1399300000;5750900000;21804000000
DISCA;120376;USD;2016;Q4;2016-12-31;2017-02-14;28000000;28000000;300000000;1495000000;;2599000000;482000000;;12677000000;13159000000;15758000000;1316000000;82000000;1561000000;7841000000;8787000000;10348000000;7051000000;-6356000000;5232000000;5410000000;15758000000
DISCA;120376;USD;2015;Q4;2015-12-31;2016-02-18;38000000;38000000;390000000;1479000000;;2596000000;488000000;;12780000000;13268000000;15864000000;1270000000;119000000;1579000000;7616000000;8593000000;10172000000;7026000000;-5461000000;4517000000;5692000000;15864000000
DISCA;120376;USD;2014;Q4;2014-12-31;2015-02-19;-1223287000;-1236986000;367000000;1433000000;;2491000000;554000000;;12925000000;13479000000;15970000000;1319000000;1107000000;2604000000;6002000000;7015000000;9619000000;6922000000;-4763000000;3809000000;6351000000;15970000000
DISCA;120376;USD;2013;Q4;2013-12-31;2014-02-20;684950000;694735000;408000000;1371000000;;2410000000;514000000;;12055000000;12569000000;14979000000;1133000000;17000000;1294000000;6482000000;7452000000;8746000000;6829000000;-3531000000;2892000000;6233000000;14979000000
DISCA;120376;USD;2012;Q4;2012-12-31;2013-02-14;714305000;726047000;1201000000;1130000000;;2730000000;388000000;;9812000000;10200000000;12930000000;792000000;31000000;946000000;5212000000;5691000000;6637000000;6692000000;-2482000000;2075000000;6293000000;12930000000
DISCA;120376;USD;2011;Q4;2011-12-31;2012-02-17;765187000;773015000;1048000000;1042000000;;2431000000;379000000;;9103000000;9482000000;11913000000;607000000;26000000;746000000;4219000000;4648000000;5394000000;6508000000;-1102000000;1132000000;6519000000;11913000000
DISCA;120376;USD;2010;Q4;2010-12-31;2011-02-18;827811000;831725000;466000000;880000000;;1735000000;399000000;;8885000000;9284000000;11019000000;480000000;20000000;785000000;3598000000;4001000000;4786000000;6361000000;-105000000;;6233000000;11019000000
DISCA;120376;USD;2009;Q4;2009-12-31;2010-02-22;;835639000;623000000;812000000;;1671000000;409000000;;8872000000;9281000000;10952000000;446000000;38000000;783000000;3457000000;3900000000;4683000000;6601000000;;-387000000;6267000000;10950000000
DISCA;120376;USD;2008;Q4;2008-12-31;2009-08-04;;835639000;100000000;780000000;;1109000000;395000000;;8980000000;9375000000;10484000000;421000000;458000000;1070000000;3331000000;3804000000;4874000000;6546000000;;-936000000;5608000000;10482000000
DISCA;120376;USD;2017;Q4;2017-12-31;2018-02-28;;-34000000;7309000000;1838000000;;9991000000;597000000;;11967000000;12564000000;22555000000;1586000000;30000000;1871000000;14755000000;15661000000;17532000000;7300000000;-6737000000;4632000000;5023000000;22555000000
DISCA;120376;USD;2018;Q4;2018-12-31;2019-03-01;;;986000000;2620000000;;4231000000;800000000;;27519000000;28319000000;32550000000;1929000000;1819000000;3997000000;14974000000;18036000000;22033000000;10654000000;-6737000000;5254000000;10517000000;32550000000
CBOE;120616;USD;2016;Q4;2016-12-31;2017-02-21;81328000;81328000;97300000;76700000;;235100000;55900000;;185700000;241600000;476700000;82400000;;89900000;0;56300000;146200000;140100000;-532200000;710800000;330500000;476700000
CBOE;120616;USD;2015;Q4;2015-12-31;2016-02-19;82323000;82323000;102253000;62535000;;204118000;60360000;;120310000;180670000;384788000;61737000;;73997000;;51146000;125143000;124504000;-467632000;603597000;259645000;384788000
CBOE;120616;USD;2014;Q4;2014-12-31;2015-02-20;84289000;84289000;147927000;58386000;;244107000;66856000;;72938000;139794000;383901000;60340000;;73665000;;60169000;133834000;111038000;-332287000;472005000;250067000;383901000
CBOE;120616;USD;2013;Q4;2013-12-31;2014-02-21;87064000;87064000;221341000;49888000;;308861000;67294000;14581000;50853000;132728000;441589000;96789000;;107458000;;49614000;157072000;91904000;-155627000;349290000;284517000;441589000
CBOE;120616;USD;2012;Q4;2012-12-31;2013-05-02;87269000;87269000;135597000;45666000;;202909000;74044000;14270000;47635000;135949000;338858000;45148000;;52150000;;47586000;99736000;68725000;-104201000;275491000;239122000;338858000
CBOE;120616;USD;2011;Q4;2011-12-31;2012-02-28;89393000;89393000;134936000;37578000;;189682000;76798000;14305000;47083000;138186000;327868000;46071000;;52287000;;39311000;91598000;56377000;-51329000;232121000;236270000;327868000
CBOE;120616;USD;2010;Q4;2010-12-31;2011-08-09;;97821000;53789000;37746000;;109934000;82084000;12615000;49479000;144178000;254112000;40084000;;48816000;;29422000;78238000;43759000;0;133087000;175874000;254112000
CBOE;120616;USD;2017;Q4;2017-12-31;2018-02-22;112500000;112900000;190800000;217300000;;434700000;73900000;;4757100000;4831000000;5265700000;156400000;;334000000;1237900000;1811700000;2145700000;2624900000;-558300000;993300000;3120000000;5265700000
CBOE;120616;USD;2018;Q4;2018-12-31;2019-02-22;111400000;112000000;310800000;287300000;;683700000;71700000;;4565600000;4637300000;5321000000;202600000;299800000;595900000;915600000;1474700000;2070600000;2661400000;-720100000;1288200000;3250400000;5321000000
ACCO;120923;USD;2016;Q4;2016-12-31;2017-02-27;107600000;110200000;42900000;391000000;210000000;670700000;198400000;;1195400000;1393800000;2064500000;336900000;4800000;406400000;627700000;949400000;1355800000;2016800000;-17000000;-871700000;708700000;2064500000
ACCO;120923;USD;2015;Q4;2015-12-31;2016-02-24;106100000;110300000;55400000;369300000;203600000;653600000;209100000;;1090700000;1299800000;1953400000;296600000;0;355300000;720500000;1016900000;1372200000;1989400000;-11800000;-967200000;581200000;1953400000
ACCO;120923;USD;2014;Q4;2014-12-31;2015-02-25;112400000;117800000;53200000;420500000;229900000;778800000;235500000;;1200800000;1436300000;2215100000;314800000;800000;395400000;787700000;1138700000;1534100000;2032600000;-5900000;-1053100000;681000000;2215100000
ACCO;120923;USD;2013;Q4;2013-12-31;2014-02-25;113500000;118200000;53500000;471900000;254700000;841700000;253300000;;1287900000;1541200000;2382900000;340500000;100000;445100000;920800000;1235500000;1680600000;2036100000;-3500000;-1144700000;702300000;2382900000
ACCO;120923;USD;2012;Q4;2012-12-31;2013-02-28;113600000;117700000;50000000;498700000;265500000;874300000;273600000;;1359800000;1633400000;2507700000;316900000;100000;429400000;1070800000;1439100000;1868500000;2019600000;-2500000;-1221800000;639200000;2507700000
ACCO;120923;USD;2011;Q4;2011-12-31;2012-03-20;55400000;59900000;121200000;269500000;197700000;622900000;147200000;;346600000;493800000;1116700000;238300000;200000;306100000;668800000;872500000;1178600000;1408000000;-1700000;-1337200000;-61900000;1116700000
ACCO;120923;USD;2010;Q4;2010-12-31;2011-07-27;54800000;57200000;83200000;274800000;205900000;620700000;163200000;;365700000;528900000;1149600000;229000000;200000;327900000;727400000;901500000;1229400000;1401700000;-1500000;-1393900000;-79800000;1149600000
ACCO;120923;USD;2017;Q4;2017-12-31;2018-02-28;106500000;109000000;76900000;469300000;254200000;829600000;278500000;;1691000000;1969500000;2799100000;381400000;43200000;538400000;889200000;1486600000;2025000000;2000800000;-26400000;-739200000;774100000;2799100000
ACCO;120923;USD;2018;Q4;2018-12-31;2019-02-27;102500000;104100000;67000000;428400000;340600000;880200000;263700000;;1642500000;1906200000;2786400000;431900000;39500000;599200000;843000000;1397500000;1996700000;1942100000;-33900000;-656800000;789700000;2786400000
FB;121021;USD;2016;Q4;2016-12-31;2017-02-03;2882000000;2993000000;29449000000;3993000000;;34401000000;8591000000;;21969000000;30560000000;64961000000;2785000000;;2875000000;;2892000000;5767000000;38227000000;;21670000000;59194000000;64961000000
FB;121021;USD;2015;Q4;2015-12-31;2016-01-28;2824000000;2863000000;18434000000;2559000000;;21652000000;5687000000;;22068000000;27755000000;49407000000;1862000000;7000000;1925000000;107000000;3264000000;5189000000;34886000000;;9787000000;44218000000;49407000000
FB;121021;USD;2014;Q4;2014-12-31;2015-01-29;2764000000;2788000000;11199000000;1678000000;;13390000000;3967000000;;22609000000;26576000000;39966000000;1244000000;114000000;1424000000;119000000;2446000000;3870000000;30225000000;;6099000000;36096000000;39966000000
FB;121021;USD;2013;Q4;2013-12-31;2014-01-31;2457000000;2539000000;11449000000;1109000000;;13070000000;2882000000;;1943000000;4825000000;17895000000;823000000;239000000;1100000000;237000000;1325000000;2425000000;12297000000;;3159000000;15470000000;17895000000
FB;121021;USD;2012;Q4;2012-12-31;2013-02-01;2378000000;2838000000;9626000000;719000000;;11267000000;2391000000;;1445000000;3836000000;15103000000;657000000;365000000;1052000000;1991000000;2296000000;3348000000;10094000000;;1659000000;11755000000;15103000000
FB;121021;USD;2011;Q4;2011-12-31;2012-07-31;1327000000;1511000000;3908000000;547000000;;4604000000;1475000000;;252000000;1727000000;6331000000;530000000;279000000;899000000;398000000;533000000;1432000000;2684000000;;1606000000;4899000000;6331000000
FB;121021;USD;2017;Q4;2017-12-31;2018-02-01;2909000000;2973000000;41711000000;5832000000;;48563000000;13721000000;;22240000000;35961000000;84524000000;3662000000;;3760000000;;6417000000;10177000000;40584000000;;33990000000;74347000000;84524000000
FB;121021;USD;2018;Q4;2018-12-31;2019-01-31;2874000000;2896000000;41114000000;7587000000;;50480000000;24683000000;;22171000000;46854000000;97334000000;6870000000;;7017000000;;6190000000;13207000000;42906000000;;41981000000;84127000000;97334000000
XOM;121214;USD;2016;Q4;2016-12-31;2017-02-22;4174000000;;3657000000;21394000000;15080000000;41416000000;244224000000;35102000000;9572000000;288898000000;330314000000;31193000000;13830000000;47638000000;28932000000;108846000000;156484000000;12157000000;-230424000000;407831000000;173830000000;330314000000
XOM;121214;USD;2015;Q4;2015-12-31;2016-02-24;4183000000;;3705000000;19875000000;16245000000;42623000000;251605000000;34245000000;8285000000;294135000000;336758000000;32412000000;18762000000;53976000000;19925000000;105972000000;159948000000;11612000000;-229734000000;412444000000;176810000000;336758000000
XOM;121214;USD;2014;Q4;2014-12-31;2015-02-25;4236000000;;4616000000;28009000000;16678000000;52910000000;252668000000;35239000000;8676000000;296583000000;349493000000;42227000000;17468000000;64633000000;11653000000;103796000000;168429000000;10792000000;-225820000000;408384000000;181064000000;349493000000
XOM;121214;USD;2013;Q4;2013-12-31;2014-02-26;4363000000;4363000000;4644000000;33152000000;16135000000;59308000000;243650000000;36328000000;7522000000;287500000000;346808000000;48085000000;15808000000;71724000000;6891000000;94589000000;166313000000;10077000000;-212781000000;387432000000;180495000000;346808000000
XOM;121214;USD;2012;Q4;2012-12-31;2013-02-27;4544000000;4542000000;9582000000;34987000000;14542000000;64460000000;226949000000;34718000000;7668000000;269335000000;333795000000;50728000000;3653000000;64139000000;7928000000;97996000000;162135000000;9653000000;-197333000000;365727000000;171660000000;333795000000
XOM;121214;USD;2011;Q4;2011-12-31;2012-02-24;4772000000;4774000000;12664000000;38642000000;15024000000;72963000000;214664000000;34333000000;9092000000;258089000000;331052000000;57067000000;7711000000;77505000000;9322000000;92803000000;170308000000;9512000000;-176932000000;330939000000;160744000000;331052000000
XOM;121214;USD;2010;Q4;2010-12-31;2011-02-25;;;7825000000;32284000000;12976000000;58984000000;199548000000;35338000000;8640000000;243526000000;302510000000;50034000000;2787000000;62633000000;12227000000;87198000000;149831000000;9371000000;-156608000000;298899000000;152679000000;302510000000
XOM;121214;USD;2009;Q4;2009-12-31;2010-02-26;;;10862000000;27645000000;11553000000;55235000000;139116000000;31665000000;7307000000;178088000000;233323000000;41275000000;2476000000;52061000000;7129000000;65870000000;117931000000;5503000000;-166410000000;276937000000;115392000000;233323000000
XOM;121214;USD;2008;Q4;2008-12-31;2009-08-05;;;32007000000;24702000000;11646000000;72266000000;121346000000;28556000000;5884000000;155786000000;228052000000;36643000000;2400000000;49100000000;7025000000;61429000000;110529000000;5314000000;-148098000000;265680000000;117523000000;228052000000
XOM;121214;USD;2017;Q4;2017-12-31;2018-02-28;4259000000;;3177000000;25597000000;16992000000;47134000000;252630000000;39160000000;9767000000;301557000000;348691000000;36796000000;17930000000;57771000000;24406000000;96420000000;154191000000;14656000000;-225246000000;414540000000;194500000000;348691000000
XOM;121214;USD;2018;Q4;2018-12-31;2019-02-27;4268000000;;3042000000;24701000000;18958000000;47973000000;247101000000;40790000000;10332000000;298223000000;346196000000;37268000000;17258000000;57138000000;20538000000;90530000000;147668000000;15258000000;-225553000000;421653000000;198528000000;346196000000
BC;121407;USD;2016;Q4;2016-12-31;2017-02-17;90400000;91000000;458200000;417300000;762100000;1688500000;645300000;20700000;930200000;1596200000;3284700000;959000000;5900000;964900000;436500000;879700000;1844600000;458900000;-465200000;1881000000;1440100000;3284700000
BC;121407;USD;2015;Q4;2015-12-31;2016-02-17;92200000;93400000;668800000;398100000;685000000;1804400000;505200000;21500000;821400000;1348100000;3152500000;902100000;6000000;908100000;442500000;963100000;1871200000;484900000;-389900000;1660400000;1281300000;3152500000
BC;121407;USD;2014;Q4;2014-12-31;2015-02-20;93900000;95100000;635900000;386500000;652300000;1967800000;460300000;19000000;683400000;1162700000;3130500000;878900000;5500000;900100000;446300000;1058900000;1959000000;471900000;-287200000;1467300000;1171500000;3130500000
BC;121407;USD;2013;Q4;2013-12-31;2014-02-14;91900000;94100000;369200000;345700000;583900000;1508600000;419900000;41300000;946000000;1407200000;2915800000;827000000;6400000;883100000;453400000;994300000;1877400000;469900000;-293300000;1263300000;1038400000;2915800000
BC;121407;USD;2012;Q4;2012-12-31;2013-02-21;90200000;92400000;376600000;349200000;575800000;1360100000;581400000;94500000;388200000;1064100000;2424200000;910600000;8200000;937200000;563600000;1409300000;2346500000;517700000;-388100000;503200000;77700000;2424200000
BC;121407;USD;2011;Q4;2011-12-31;2012-02-23;89400000;91900000;414900000;329600000;501500000;1356300000;565900000;140600000;431400000;1137900000;2494200000;883900000;2400000;908100000;690400000;1555200000;2463300000;511500000;-397500000;457700000;30900000;2494200000
BC;121407;USD;2010;Q4;2010-12-31;2011-05-06;88700000;85600000;636100000;327300000;527500000;1535800000;630200000;74700000;437300000;1142200000;2678000000;949400000;2200000;951600000;828400000;1656000000;2607600000;501500000;-405900000;390300000;70400000;2678000000
BC;121407;USD;2017;Q4;2017-12-31;2018-02-20;88600000;88900000;449600000;480200000;765600000;1846700000;659500000;25000000;827000000;1511500000;3358200000;973300000;5600000;1035100000;431800000;840200000;1875300000;451300000;-575400000;1966800000;1482900000;3358200000
BC;121407;USD;2018;Q4;2018-12-31;2019-02-19;87400000;87900000;295200000;550700000;943700000;1880200000;805300000;34600000;1565600000;2405500000;4285700000;1215200000;41300000;1256500000;1179500000;1446600000;2703100000;448000000;-638000000;2135700000;1582600000;4285700000
TWX;121635;USD;2016;Q4;2016-12-31;2017-02-23;771800000;784000000;1539000000;8699000000;2062000000;13485000000;2510000000;3337000000;46634000000;52481000000;65966000000;7192000000;1947000000;9703000000;22392000000;31897000000;41600000000;146797000000;-47497000000;-73455000000;24366000000;65966000000
TWX;121635;USD;2015;Q4;2015-12-31;2016-02-25;798400000;811700000;2155000000;7411000000;1753000000;12513000000;2596000000;2617000000;46122000000;51335000000;63848000000;7188000000;198000000;8002000000;23594000000;32198000000;40200000000;148058000000;-45612000000;-77381000000;23648000000;63848000000
TWX;121635;USD;2014;Q4;2014-12-31;2015-02-26;836500000;855400000;2618000000;7720000000;1700000000;13180000000;2655000000;2326000000;44985000000;49966000000;63146000000;7507000000;1118000000;9204000000;21263000000;29466000000;38670000000;149299000000;-42445000000;-81214000000;24476000000;63146000000
TWX;121635;USD;2013;Q4;2013-12-31;2014-02-26;901800000;924400000;1816000000;7305000000;1648000000;12531000000;3291000000;2009000000;50168000000;55468000000;67999000000;6754000000;66000000;8388000000;20061000000;29707000000;38095000000;153427000000;-37630000000;-85041000000;29904000000;67999000000
TWX;121635;USD;2012;Q4;2012-12-31;2013-02-22;942100000;967000000;2841000000;7385000000;2036000000;13264000000;3942000000;1966000000;48917000000;54825000000;68089000000;8039000000;749000000;9799000000;19122000000;28493000000;38292000000;154594000000;-35077000000;-88732000000;29797000000;68089000000
TWX;121635;USD;2011;Q4;2011-12-31;2012-02-24;992200000;1010700000;3476000000;6922000000;1890000000;13432000000;3963000000;1820000000;48586000000;54369000000;67801000000;7815000000;23000000;8922000000;19501000000;28925000000;37847000000;156131000000;-33651000000;-91671000000;29954000000;67801000000
TWX;121635;USD;2010;Q4;2010-12-31;2011-02-18;1106300000;1124000000;3663000000;6596000000;1920000000;13321000000;3874000000;1796000000;47716000000;53386000000;66707000000;7809000000;26000000;8826000000;16523000000;24936000000;33762000000;157162000000;-29033000000;-94557000000;32945000000;66707000000
TWX;121635;USD;2009;Q4;2009-12-31;2010-02-19;1164800000;1181400000;4733000000;5070000000;1769000000;13692000000;3922000000;1542000000;46903000000;52367000000;66059000000;7807000000;57000000;9473000000;15346000000;23189000000;32662000000;158145000000;-27034000000;-97135000000;33397000000;66059000000
TWX;121635;USD;2008;Q4;2008-12-31;2009-07-29;1195700000;1174100000;1099000000;5171000000;1842000000;16622000000;4105000000;1027000000;92305000000;97437000000;114059000000;7779000000;2041000000;14139000000;19855000000;54250000000;68389000000;169580000000;-25836000000;-99780000000;45670000000;114059000000
TWX;121635;USD;2017;Q4;2017-12-31;2018-02-22;779000000;791800000;2621000000;9401000000;2401000000;15219000000;2707000000;3924000000;47359000000;53990000000;69209000000;7916000000;5450000000;14077000000;18294000000;26721000000;40798000000;145094000000;-47074000000;-68208000000;28411000000;69209000000
ROK;121874;USD;2016;Q4;2016-09-30;2016-11-15;128700000;129700000;2429200000;1079000000;526600000;4185000000;578300000;;2337900000;2916200000;7101200000;543100000;448600000;1975900000;1516300000;3135200000;5111100000;1769600000;-3909100000;5668400000;1990100000;7101200000
ROK;121874;USD;2015;Q4;2015-09-30;2015-11-17;133200000;134400000;2149200000;1041000000;535600000;3896800000;605600000;;1902300000;2507900000;6404700000;521700000;0;1327700000;1500900000;2820200000;4147900000;1733500000;-3459000000;5316900000;2256800000;6404700000
ROK;121874;USD;2014;Q4;2014-09-30;2014-11-18;136900000;138600000;1819800000;1215800000;588400000;3934200000;632900000;;1657200000;2290100000;6224300000;520600000;325000000;1692100000;900400000;1874100000;3566200000;1693700000;-2927200000;4839600000;2658100000;6224300000
ROK;121874;USD;2013;Q4;2013-09-30;2013-11-18;138600000;140200000;1573600000;1186100000;615400000;3679900000;616000000;;1548700000;2164700000;5844600000;546700000;179000000;1544700000;905100000;1714400000;3259100000;1637400000;-2567600000;4333400000;2585500000;5844600000
ROK;121874;USD;2012;Q4;2012-09-30;2012-11-19;140000000;141500000;1253900000;1187300000;619000000;3387500000;587100000;;1661900000;2249000000;5636500000;547600000;157000000;1531600000;905000000;2253200000;3784800000;1598100000;-2379900000;3858800000;1851700000;5636500000
ROK;121874;USD;2011;Q4;2011-09-30;2011-11-14;142200000;144100000;988900000;1063400000;641700000;3075100000;561400000;;1648400000;2209800000;5284900000;455100000;0;1329900000;905000000;2207000000;3536900000;1562800000;-2204700000;3382800000;1748000000;5284900000
ROK;121874;USD;2010;Q4;2010-09-30;2010-11-18;141600000;143600000;813400000;859000000;603300000;2586600000;536900000;;1624800000;2161700000;4748300000;435700000;;1222300000;904900000;2065600000;3287900000;1525600000;-2136400000;2912400000;1460400000;4748300000
ROK;121874;USD;2009;Q4;2009-09-30;2009-11-18;141600000;143100000;643800000;726300000;436400000;2134800000;532500000;;1638400000;2170900000;4305700000;313300000;;947200000;904700000;2042100000;2989300000;1486200000;-2109500000;2667200000;1316400000;4305700000
ROK;121874;USD;2008;Q4;2008-09-30;2009-08-04;144100000;144500000;582200000;959900000;575500000;2436600000;553800000;;1603200000;2157000000;4593600000;437300000;100100000;1303100000;904400000;1601700000;2904800000;1497300000;-3975600000;4486100000;1688800000;4593600000
ROK;121874;USD;2017;Q4;2017-09-30;2017-11-15;128200000;129700000;2535500000;1135500000;558700000;4420700000;583900000;;2157100000;2741000000;7161700000;623200000;600400000;2145800000;1243400000;2352300000;4498100000;1819400000;-4080000000;6103400000;2663600000;7161700000
ROK;121874;USD;2018;Q4;2018-09-30;2018-11-09;122100000;125100000;909700000;1190100000;581600000;2830700000;576800000;1288000000;1566500000;3431300000;6262000000;713400000;551000000;2236900000;1225200000;2407600000;4644500000;1862800000;-5501500000;6198100000;1617500000;6262000000
DVN;122079;USD;2017;Q4;2017-12-31;2018-02-21;521000000;524000000;2642000000;989000000;;4791000000;14584000000;;10866000000;25450000000;30241000000;633000000;115000000;3315000000;6749000000;12822000000;16137000000;7386000000;;702000000;14104000000;30241000000
DVN;122079;USD;2016;Q4;2016-12-31;2017-02-15;518000000;515000000;1959000000;1356000000;;3772000000;20533000000;;4370000000;24903000000;28675000000;642000000;;2616000000;10154000000;13337000000;15953000000;7289000000;;-69000000;12722000000;28675000000
DVN;122079;USD;2015;Q4;2015-12-31;2016-02-17;410000000;410000000;2310000000;1105000000;;4021000000;19068000000;;6362000000;25430000000;29451000000;906000000;976000000;3295000000;12056000000;15167000000;18462000000;5038000000;;1781000000;10989000000;29451000000
DVN;122079;USD;2014;Q4;2014-12-31;2015-02-20;408000000;410000000;1480000000;1959000000;;6498000000;36296000000;;7843000000;44139000000;50637000000;1400000000;1432000000;5935000000;9830000000;18361000000;24296000000;4129000000;;16631000000;26341000000;50637000000
DVN;122079;USD;2013;Q4;2013-12-31;2014-02-28;402000000;400000000;6066000000;1520000000;;8005000000;28447000000;;6425000000;34872000000;42877000000;1229000000;4066000000;6655000000;7956000000;15723000000;22378000000;3821000000;;15410000000;20499000000;42877000000
DVN;122079;USD;2012;Q4;2012-12-31;2013-02-21;400000000;399000000;6980000000;1245000000;;8971000000;27316000000;;7039000000;34355000000;43326000000;1451000000;3189000000;6003000000;8455000000;16045000000;22048000000;3729000000;;15778000000;21278000000;43326000000
DVN;122079;USD;2011;Q4;2011-12-31;2012-02-24;;;7058000000;1379000000;;9305000000;24774000000;;7038000000;31812000000;41117000000;1471000000;3811000000;6738000000;5969000000;12949000000;19687000000;3547000000;;16308000000;21430000000;41117000000
DVN;122079;USD;2010;Q4;2010-12-31;2011-02-25;;;3011000000;1202000000;;5555000000;19652000000;;7720000000;27372000000;32927000000;1411000000;1811000000;4583000000;3819000000;9091000000;13674000000;5644000000;-33000000;11882000000;19253000000;32927000000
DVN;122079;USD;2009;Q4;2009-12-31;2010-02-25;;;646000000;1208000000;;2992000000;18767000000;;7927000000;26694000000;29686000000;1137000000;1432000000;3802000000;5847000000;10314000000;14116000000;6572000000;;7613000000;15570000000;29686000000
DVN;122079;USD;2008;Q4;2008-12-31;2009-08-06;;;195000000;1300000000;;2684000000;22031000000;;7193000000;29224000000;31908000000;1612000000;180000000;3135000000;5661000000;11713000000;14848000000;6301000000;;10376000000;17060000000;31908000000
DVN;122079;USD;2018;Q4;2018-12-31;2019-02-20;455000000;464000000;2414000000;885000000;;4437000000;13935000000;;1194000000;15129000000;19566000000;662000000;162000000;2226000000;5785000000;8154000000;10380000000;4531000000;-22000000;3650000000;9186000000;19566000000
JLL;122208;USD;2017;Q4;2017-12-31;2018-02-23;45369000;45747000;268000000;3320200000;;4541000000;543900000;;4169500000;4713400000;9254400000;3434800000;77400000;4313700000;675300000;1558700000;5872400000;1031900000;;2649000000;3382000000;9254400000
JLL;122208;USD;2016;Q4;2016-12-31;2017-02-23;45212000;45443000;258500000;2471400000;;3299700000;501000000;;3828700000;4329700000;7629400000;1910900000;89500000;2966300000;1178100000;1841600000;4807900000;1007800000;;2333000000;2821500000;7629400000
JLL;122208;USD;2015;Q4;2015-12-31;2016-02-25;45046168;45397592;216600000;1856900000;;2650800000;423300000;;3113000000;3536300000;6187100000;1801500000;49200000;2505200000;511900000;952500000;3457700000;980900000;;2044200000;2729400000;6187100000
JLL;122208;USD;2014;Q4;2014-12-31;2015-02-27;44828887;45271455;250413000;1458347000;;2118176000;368361000;;2588799000;2957160000;5075336000;1620715000;19623000;2047011000;275000000;605756000;2652767000;955891000;;1631145000;2422569000;5075336000
JLL;122208;USD;2013;Q4;2013-12-31;2014-02-27;44446271;45028380;152726000;1237514000;;1724228000;295547000;;2577578000;2873125000;4597353000;1338930000;24522000;1658424000;430000000;748120000;2406544000;937904000;;1266967000;2190809000;4597353000
JLL;122208;USD;2012;Q4;2012-12-31;2013-02-26;44055075;44838758;152159000;1140938000;;1515529000;269338000;;2566632000;2835970000;4351499000;1183535000;32233000;1661971000;444000000;730272000;2392243000;925109000;;1017128000;1959256000;4351499000
JLL;122208;USD;2011;Q4;2011-12-31;2012-02-27;43479149;44281608;184454000;907772000;;1300884000;241415000;;2390337000;2631752000;3932636000;1091703000;65091000;1348617000;463000000;889639000;2238256000;897589000;;827297000;1694380000;3932636000
JLL;122208;USD;2010;Q4;2010-12-31;2011-02-25;42663128;44048079;251897000;721486000;;1194841000;198685000;;1956335000;2155020000;3349861000;955522000;28700000;1296312000;197500000;481614000;1777926000;877210000;;676397000;1571935000;3349861000
JLL;122208;USD;2009;Q4;2009-12-31;2010-08-06;41875622;41875622;69263000;669993000;;939918000;213708000;;1943307000;2157015000;3096933000;827278000;23399000;1095095000;175000000;619224000;1714319000;849449000;;531456000;1382614000;3096933000
CSU;122647;USD;2015;Q4;2015-12-31;2016-02-26;28750000;28749000;56087000;9254000;;97268000;890572000;;31193000;921765000;1019033000;37773000;1257000;70542000;38835000;812745000;883287000;160219000;-934000;-23539000;135746000;1019033000
CSU;122647;USD;2014;Q4;2014-12-31;2015-02-27;28389000;28389000;39209000;5903000;;112574000;747613000;;31183000;778796000;891370000;34913000;1054000;99461000;40016000;650735000;750196000;151363000;-934000;-9255000;141174000;891370000
CSU;122647;USD;2013;Q4;2013-12-31;2014-03-03;27956000;27956000;13611000;3752000;;52813000;651738000;1010000;39988000;692736000;745549000;33134000;948000;58705000;41093000;528894000;587599000;144013000;-934000;14871000;157950000;745549000
CSU;122647;USD;2012;Q4;2012-12-31;2013-03-08;27404000;27352000;18737000;5229000;;56442000;527159000;1074000;52267000;580500000;636942000;31423000;766000;62154000;42146000;406194000;468348000;138153000;-934000;31375000;168594000;636942000
CSU;122647;USD;2011;Q4;2011-12-31;2012-03-12;27068000;27102000;22283000;4526000;;60999000;365459000;1070000;34798000;401327000;462326000;21383000;50000;40213000;31000;252972000;293185000;135581000;-934000;34494000;169141000;462326000
CSU;122647;USD;2010;Q4;2010-12-31;2011-08-09;26626000;26735000;31248000;3777000;;63477000;295449000;2224000;21631000;319304000;382781000;18076000;135000;32397000;83000;186561000;218958000;133288000;-934000;31469000;163823000;382781000
CSU;122647;USD;2016;Q4;2016-12-31;2017-03-01;29000000;29000000;34026000;13675000;;82028000;1032430000;;31323000;1063753000;1145781000;44333000;1339000;81390000;37439000;947473000;1028863000;171904000;-3430000;-51556000;116918000;1145781000
CSU;122647;USD;2017;Q4;2017-12-31;2018-03-02;29534000;29534000;17646000;12307000;;64049000;1099786000;;18836000;1118622000;1182671000;48935000;3106000;87003000;48805000;1015235000;1102238000;179769000;-3430000;-95906000;80433000;1182671000
CSU;122647;USD;2018;Q4;2018-12-31;2019-03-01;29913000;29913000;31309000;10581000;;73458000;1059049000;;16637000;1075686000;1149144000;51381000;3113000;85030000;45647000;1028849000;1113879000;188197000;-3430000;-149502000;35265000;1149144000
TST;122759;USD;2017;Q4;2017-12-31;2018-03-13;4336969;4386588;11684817;4546308;;18466314;2092669;1680000;46771565;50544234;69010548;5690109;;30974372;;3089375;34063747;260138653;-13484924;-206861278;34946801;69010548
TST;122759;USD;2016;Q4;2016-12-31;2017-03-20;3525814;3525814;21371122;5119959;;28266303;3550007;1550000;45096802;50196809;78463112;7641592;;31102353;;5311303;36413656;271572814;-13211141;-210413967;42049456;78463112
TST;122759;USD;2015;Q4;2015-12-31;2016-03-09;3487472;3464344;28445416;5102464;;35704986;2773737;1590000;62822931;67186668;102891654;7656322;;33630653;;7266762;40897415;269949003;-13056541;-192899252;61994239;102891654
TST;122759;USD;2014;Q4;2014-12-31;2015-03-05;3447311;3447311;34468249;5103899;;41749524;2926825;1560000;65695978;70182803;111932327;8753819;;36423143;;7639074;44062217;272362723;-12908943;-191356249;67870110;111932327
TST;122759;USD;2013;Q4;2013-12-31;2014-02-28;3394589;3394589;54870634;4502344;;60979444;3381572;3670860;40862151;47914583;108894027;6690944;;29771448;;4959421;34730869;274272118;-12364460;-187566372;74163158;108894027
TST;122759;USD;2012;Q4;2012-12-31;2013-02-22;3289680;3289680;41941451;5750753;;50277088;5672000;17298227;38287753;61257980;111535068;9735107;;31448484;;4628749;36077233;271341706;-11974261;-183780671;75457835;111535068
TST;122759;USD;2011;Q4;2011-12-31;2012-03-07;3201609;3201609;65760429;6225424;;74424397;8494648;7894365;30599806;46988819;121413216;10276391;;28411271;;4857497;33268768;270614862;-11010149;-171065720;88144448;121413216
TST;122759;USD;2010;Q4;2010-12-31;2011-08-05;;;46592605;6623261;;55664841;10887732;30302428;32687059;73877219;129542060;10694958;;28312538;;3236181;31548719;271022412;-10478838;-162881599;97993341;129542060
GRC;122864;USD;2016;Q4;2016-12-31;2017-03-03;26092515;;57604000;71424000;69049000;203900000;122067000;;56851000;178918000;382818000;47991000;;49352000;;30578000;79930000;5312000;;318041000;302888000;382818000
GRC;122864;USD;2015;Q4;2015-12-31;2016-03-11;-52442483522;;23724000;76758000;82818000;189391000;129887000;;44923000;174810000;364201000;41719000;;43460000;;33720000;77180000;5095000;;304341000;287021000;364201000
GRC;122864;USD;2014;Q4;2014-12-31;2015-03-09;26260667;;24491000;70734000;94760000;200709000;133964000;;46231000;180195000;380904000;48180000;12000000;64346000;;34591000;98937000;8192000;;291101000;281967000;380904000
GRC;122864;USD;2013;Q4;2013-12-31;2014-03-10;26252021;;31123000;59374000;89946000;189289000;131189000;;35160000;166349000;355638000;44570000;9000000;60760000;;30738000;91498000;7953000;;264648000;264140000;355638000
GRC;122864;USD;2012;Q4;2012-12-31;2013-03-04;26246142;26246198;20373000;58712000;90898000;175675000;123066000;;36442000;159508000;335183000;42821000;22000000;64821000;;35643000;100464000;7823000;;243178000;234719000;335183000
GRC;122864;USD;2011;Q4;2011-12-31;2012-03-05;;26238730;21202000;56419000;73193000;155872000;114349000;;28479000;142828000;298700000;40873000;10000000;50873000;;33063000;83936000;7672000;;223136000;214764000;298700000
GRC;122864;USD;2010;Q4;2010-12-31;2011-08-01;;26233185;34246000;51996000;51449000;143194000;113526000;;29987000;143513000;286707000;34678000;25000000;59678000;;27195000;86873000;7527000;;201735000;199834000;286707000
GRC;122864;USD;2017;Q4;2017-12-31;2018-02-23;26106833;;79680000;67369000;74967000;227934000;117071000;;50010000;167081000;395015000;41598000;;45696000;;23824000;69520000;5626000;;332378000;325495000;395015000
GRC;122864;USD;2018;Q4;2018-12-31;2019-03-04;26117214;;46458000;67714000;87387000;208686000;113493000;;46103000;159596000;368282000;43233000;;48465000;;26685000;75150000;7641000;;308914000;293132000;368282000
EMN;122948;USD;2015;Q4;2015-12-31;2016-02-25;148500000;149900000;293000000;792000000;1479000000;2878000000;5130000000;;7572000000;12702000000;15580000000;1625000000;431000000;2056000000;6577000000;9503000000;11559000000;1865000000;-2680000000;5146000000;4021000000;15580000000
EMN;122948;USD;2014;Q4;2014-12-31;2015-02-27;148400000;149800000;214000000;936000000;1509000000;3173000000;5087000000;;7812000000;12899000000;16072000000;1721000000;301000000;2022000000;7248000000;10460000000;12482000000;1819000000;-2577000000;4545000000;3590000000;16072000000
EMN;122948;USD;2013;Q4;2013-12-31;2014-02-28;153200000;156200000;237000000;880000000;1264000000;2840000000;4290000000;;4715000000;9005000000;11845000000;1470000000;0;1470000000;4254000000;6500000000;7970000000;1780000000;-2167000000;4012000000;3875000000;11845000000
EMN;122948;USD;2012;Q4;2012-12-31;2013-02-28;153700000;158100000;249000000;846000000;1260000000;2699000000;4181000000;;4830000000;9011000000;11710000000;1360000000;4000000;1364000000;4779000000;7318000000;8682000000;1711000000;-1929000000;3038000000;3028000000;11710000000
EMN;122948;USD;2011;Q4;2011-12-31;2012-02-22;136900000;140400000;777000000;632000000;779000000;2302000000;3107000000;;775000000;3882000000;6184000000;961000000;153000000;1114000000;1445000000;3169000000;4283000000;902000000;-1930000000;2760000000;1901000000;6184000000
EMN;122948;USD;2010;Q4;2010-12-31;2011-02-23;143900000;149600000;516000000;545000000;608000000;2047000000;3219000000;;720000000;3939000000;5986000000;1012000000;6000000;1070000000;1598000000;3289000000;4359000000;795000000;-1615000000;2879000000;1627000000;5986000000
EMN;122948;USD;2009;Q4;2009-12-31;2010-02-24;;;793000000;277000000;531000000;1735000000;3110000000;;670000000;3780000000;5515000000;800000000;0;800000000;1604000000;3202000000;4002000000;662000000;-1335000000;2571000000;1513000000;5515000000
EMN;122948;USD;2008;Q4;2008-12-31;2009-07-30;;;387000000;275000000;637000000;1423000000;3198000000;;660000000;3858000000;5281000000;819000000;13000000;832000000;1442000000;2896000000;3728000000;639000000;-1314000000;2563000000;1553000000;5281000000
EMN;122948;USD;2016;Q4;2016-12-31;2017-02-27;146400000;147700000;181000000;812000000;1404000000;2866000000;5276000000;;7315000000;12591000000;15457000000;1512000000;283000000;1795000000;6311000000;9054000000;10849000000;1917000000;-2825000000;5721000000;4608000000;15457000000
EMN;122948;USD;2017;Q4;2017-12-31;2018-03-01;143400000;145300000;191000000;1026000000;1509000000;3143000000;5607000000;;7249000000;12856000000;15999000000;1589000000;393000000;1982000000;6147000000;8537000000;10519000000;1985000000;-3175000000;6802000000;5480000000;15999000000
EMN;122948;USD;2018;Q4;2018-12-31;2019-02-27;139500000;140400000;226000000;1154000000;1583000000;3365000000;5600000000;;7030000000;12630000000;15995000000;1608000000;243000000;1851000000;5925000000;8266000000;10117000000;2050000000;-3575000000;7573000000;5878000000;15995000000
KAR;123411;USD;2017;Q4;2017-12-31;2018-02-21;356141600;363539200;317200000;725500000;;3137400000;908200000;;2938700000;3846900000;6984300000;1018700000;12400000;2389200000;2667700000;3110200000;5499400000;1253100000;;257000000;1484900000;6984300000
KAR;123411;USD;2016;Q4;2016-12-31;2017-02-24;363539200;365652800;201800000;682900000;;2841200000;842500000;;2873900000;3716400000;6557600000;949500000;105200000;2335000000;2365100000;2825300000;5160300000;1372500000;;74100000;1397300000;6557600000
KAR;123411;USD;2015;Q4;2015-12-31;2016-02-18;363539200;368294800;155000000;511900000;;2446100000;766900000;;2558500000;3325400000;5771500000;871000000;153900000;2213900000;1711200000;2171500000;4385400000;1409000000;;17300000;1386100000;5771500000
KAR;123411;USD;2014;Q4;2014-12-31;2015-02-18;372257800;375692400;152900000;401200000;;2074900000;727900000;;2548700000;3276600000;5351500000;707700000;17700000;1590600000;1736600000;2213800000;3804400000;1595100000;;-46400000;1547100000;5351500000
KAR;123411;USD;2013;Q4;2013-12-31;2014-02-19;367238000;373843000;191600000;354300000;;1791500000;703800000;;2631900000;3335700000;5127200000;629700000;32500000;1434600000;1734700000;2210800000;3645400000;1535400000;;-72300000;1481800000;5127200000
KAR;123411;USD;2012;Q4;2012-12-31;2013-02-22;361425600;368294800;108700000;342400000;;1581400000;700700000;;2640200000;3340900000;4922300000;529900000;43700000;1286900000;1774600000;2191700000;3478600000;1435300000;;-26700000;1443700000;4922300000
KAR;123411;USD;2011;Q4;2011-12-31;2012-02-28;360104600;364860200;97400000;297400000;;1373200000;686700000;;2719200000;3405900000;4779100000;500000000;85900000;1196200000;1816900000;2239700000;3435900000;1407800000;;-92700000;1343200000;4779100000
KAR;123411;USD;2010;Q4;2010-12-31;2011-08-09;;;119100000;271900000;;1254700000;680500000;;2589800000;3270300000;4525000000;446700000;;966800000;1875700000;2313600000;3280400000;1383000000;;-164900000;1244600000;4525000000
KAR;123411;USD;2018;Q4;2018-12-31;2019-02-21;352707000;358783600;337100000;765600000;;3314200000;976200000;;2915800000;3892000000;7206200000;1166400000;13100000;2624800000;2654300000;3117200000;5742000000;1133200000;;392300000;1464200000;7206200000
NFX;123505;USD;2016;Q4;2016-12-31;2017-02-21;198000000;197000000;580000000;232000000;16000000;949000000;3307000000;19000000;37000000;3363000000;4312000000;531000000;;684000000;2431000000;2690000000;3374000000;3249000000;-44000000;-2265000000;938000000;4312000000
NFX;123505;USD;2015;Q4;2015-12-31;2016-02-24;165000000;165000000;5000000;262000000;34000000;625000000;3991000000;20000000;132000000;4143000000;4768000000;574000000;;647000000;2467000000;2742000000;3389000000;2438000000;-22000000;-1035000000;1379000000;4768000000
SGY;123623;USD;2016;Q4;2016-12-31;2017-02-23;1009386;1009386;190581000;48464000;;275282000;837727000;;26474000;864201000;1139483000;20790000;408000;142873000;352376000;1633892000;1776765000;1659787000;-860000;-2296209000;-637282000;1139483000
SGY;123623;USD;2015;Q4;2015-12-31;2016-02-26;995202;995202;10759000;48031000;;150421000;1241275000;;18473000;1259748000;1410169000;91229000;0;159224000;1060955000;1290734000;1449958000;1648742000;-860000;-1705623000;-39789000;1410169000
SGY;123623;USD;2014;Q4;2014-12-31;2015-02-26;989118;982422;74488000;120359000;3709000;530712000;2446342000;;32803000;2479145000;3009857000;141651000;;570131000;1032281000;1338123000;1908254000;1633856000;-860000;-614708000;1101603000;3009857000
SGY;123623;USD;2013;Q4;2013-12-31;2014-02-27;877212;878076;331224000;171971000;3723000;552417000;2645874000;;50265000;2696139000;3248556000;204699000;;761855000;1027084000;1516415000;2278270000;1398373000;-860000;-425165000;970286000;3248556000
SGY;123623;USD;2012;Q4;2012-12-31;2013-02-27;870786;871506;279526000;167288000;4207000;519843000;2204210000;;52378000;2256588000;2776431000;112907000;;530325000;914126000;1373973000;1904298000;1386959000;-860000;-542799000;872133000;2776431000
SGY;123623;USD;2011;Q4;2011-12-31;2012-02-27;865152;865872;38451000;118139000;4643000;233219000;1886220000;;46312000;1932532000;2165751000;117005000;;494336000;620000000;1003586000;1497922000;1339046000;-860000;-692225000;667829000;2165751000
SGY;123623;USD;2010;Q4;2010-12-31;2011-08-04;859446;860058;106956000;88529000;6465000;248447000;1408531000;;22112000;1430643000;1679090000;117509000;;317292000;575000000;931441000;1248733000;1331978000;-860000;-886557000;430357000;1679090000
HNI;123823;USD;2016;Q4;2016-12-31;2017-03-02;44419191;45491958;38564000;229436000;118438000;433041000;356445000;;540748000;897193000;1330234000;425046000;34017000;463473000;180000000;365752000;829225000;44079000;;461524000;501009000;1330234000
HNI;123823;USD;2015;Q4;2015-12-31;2016-02-29;44157000;45214612;32800000;243409000;125228000;438370000;341159000;;484396000;825555000;1263925000;424405000;5477000;435900000;185000000;350726000;786626000;48565000;;433575000;477299000;1263925000
HNI;123823;USD;2014;Q4;2014-12-31;2015-02-27;44289864;44998488;37196000;240053000;121791000;438249000;311008000;;490077000;801085000;1239334000;453754000;160000;457333000;197736000;367500000;824833000;45033000;;374929000;414501000;1239334000
HNI;123823;USD;2013;Q4;2013-12-31;2014-02-21;45116660;45905120;72281000;228715000;89516000;417177000;267401000;;450127000;717528000;1134705000;407799000;484000;411584000;150197000;286704000;698288000;61711000;;373652000;436417000;1134705000
HNI;123823;USD;2012;Q4;2012-12-31;2013-02-22;45049540;46362916;49032000;213490000;93515000;382963000;240490000;;453613000;694103000;1077066000;384244000;4554000;389171000;150372000;267235000;656406000;65104000;;353942000;420660000;1077066000
HNI;123823;USD;2011;Q4;2011-12-31;2012-02-24;44827992;46620112;81969000;204036000;101873000;415243000;229727000;;406752000;636479000;1051722000;351650000;30345000;382270000;150540000;250130000;632400000;69132000;;348210000;419322000;1051722000
HNI;123823;USD;2010;Q4;2010-12-31;2011-02-25;44815736;46455816;109663000;190118000;68956000;389694000;231781000;;376405000;608186000;997880000;311066000;50029000;361351000;150111000;228073000;589424000;62852000;;343474000;408456000;997880000
HNI;123823;USD;2009;Q4;2009-12-31;2010-11-04;45054236;44450236;93368000;163732000;65144000;339972000;260102000;;394252000;654354000;994326000;299718000;39000;300142000;200000000;274559000;574701000;64788000;;355270000;419625000;994326000
HNI;123823;USD;2008;Q4;2008-12-31;2010-11-04;;;49288000;238327000;84290000;401528000;315606000;;448495000;764101000;1165629000;313431000;54494000;373625000;267343000;343013000;716638000;50361000;;400379000;448991000;1165629000
HNI;123823;USD;2017;Q4;2017-12-31;2018-02-23;43445211;44122336;25363000;258551000;155683000;488880000;390321000;;512349000;902670000;1391550000;450128000;36648000;489703000;240000000;387270000;876973000;50383000;;467296000;514577000;1391550000
HNI;123823;USD;2018;Q4;2018-12-31;2019-02-26;43707618;44209176;78146000;255207000;157178000;531883000;384933000;;485028000;869961000;1401844000;428865000;679000;434308000;249355000;404277000;838585000;61623000;;504909000;563259000;1401844000
FELE;124153;USD;2016;Q4;2016-12-31;2017-03-01;46200000;46800000;104331000;145999000;203471000;483819000;196137000;;359949000;556086000;1039905000;124046000;33715000;157761000;156544000;259404000;417165000;233202000;;550095000;622740000;1039905000
FELE;124153;USD;2015;Q4;2015-12-31;2016-03-02;46300000;46900000;81561000;127251000;194594000;438121000;190039000;;367951000;557990000;996111000;111725000;32946000;144671000;187806000;285119000;429790000;221094000;;498214000;566321000;996111000
FELE;124153;USD;2014;Q4;2014-12-31;2015-03-04;47900000;48200000;59141000;143787000;220528000;469539000;209786000;;396562000;606348000;1075887000;166376000;34092000;201105000;143695000;269379000;470484000;212205000;;492548000;605403000;1075887000
FELE;124153;USD;2013;Q4;2013-12-31;2014-02-26;47600000;48100000;134553000;115127000;191561000;472354000;208596000;;370923000;579519000;1051873000;121884000;15363000;138474000;174166000;310012000;448486000;199581000;;450855000;603387000;1051873000
FELE;124153;USD;2012;Q4;2012-12-31;2013-02-27;47100000;47300000;103338000;102918000;191848000;428917000;171975000;;375487000;547462000;976379000;129290000;15176000;145639000;150729000;308491000;454130000;175602000;;395950000;522249000;976379000
FELE;124153;USD;2011;Q4;2011-12-31;2012-02-29;46400000;47400000;153337000;78435000;141693000;400483000;146409000;;282638000;429047000;829530000;110119000;13978000;124097000;150000000;249588000;373685000;146942000;;350457000;455845000;829530000
FELE;124153;USD;2010;Q4;2010-12-31;2011-03-02;46400000;47000000;140070000;70829000;140232000;379100000;143076000;;266383000;409459000;788559000;108066000;1241000;109307000;151245000;243412000;352719000;132031000;;313905000;435840000;788559000
FELE;124153;USD;2009;Q4;2009-12-31;2010-08-09;;;86875000;62847000;134404000;311593000;147171000;;259534000;406705000;718298000;82408000;735000;83143000;151242000;237552000;320695000;121446000;;285467000;397603000;718298000
FELE;124153;USD;2017;Q4;2017-12-31;2018-02-27;46600000;47000000;67233000;171007000;312325000;589131000;215694000;;380528000;596222000;1185353000;145448000;100453000;245901000;125596000;235329000;481230000;244799000;;604905000;704123000;1185353000
FELE;124153;USD;2018;Q4;2018-12-31;2019-02-28;46600000;46700000;59173000;172899000;314049000;579879000;207064000;;395422000;602486000;1182365000;143882000;111975000;255857000;94379000;190163000;446020000;262167000;;654724000;736345000;1182365000
OXFD;124252;USD;2017;Q4;2017-12-31;2018-02-27;25569124;25569124;90332000;16981000;10142000;120482000;9067000;;14687000;23754000;144236000;17976000;;22445000;29904000;34162000;56607000;294882000;;-201541000;87629000;144236000
OXFD;124252;USD;2016;Q4;2016-12-31;2017-03-01;22413466;22413466;59110000;13265000;7437000;82202000;7793000;;34017000;41810000;124012000;17483000;;18490000;29601000;32558000;51048000;249371000;;-168656000;72964000;124012000
OXFD;124252;USD;2015;Q4;2015-12-31;2016-03-01;22290799;22290799;83715000;7058000;7099000;101464000;6284000;;2104000;8388000;109852000;13748000;;15481000;386000;1679000;17160000;244276000;;-146307000;92692000;109852000
OXFD;124252;USD;2014;Q4;2014-12-31;2015-03-05;17350765;17350765;50165000;6823000;6425000;66368000;4537000;;2944000;7481000;73849000;9438000;;11568000;454000;1672000;13240000;187008000;;-121829000;60609000;73849000
OXFD;124252;USD;2013;Q4;2013-12-31;2014-05-07;8583285;8583285;76494000;4754000;5450000;89027000;2964000;;753000;3717000;92744000;9423000;;11133000;563000;859000;11992000;184155000;;-99655000;80752000;92744000
XYL;124467;USD;2015;Q4;2015-12-31;2016-02-26;179158000;179939000;680000000;749000000;433000000;2005000000;439000000;;2213000000;2652000000;4657000000;745000000;78000000;823000000;1196000000;1750000000;2573000000;1836000000;-399000000;885000000;2084000000;4657000000
XYL;124467;USD;2014;Q4;2014-12-31;2015-02-26;182140000;183276000;663000000;771000000;486000000;2064000000;461000000;;2308000000;2769000000;4833000000;814000000;89000000;903000000;1195000000;1803000000;2706000000;1798000000;-220000000;648000000;2127000000;4833000000
XYL;124467;USD;2013;Q4;2013-12-31;2014-02-27;184488000;185594000;533000000;817000000;475000000;2009000000;488000000;;2399000000;2887000000;4896000000;811000000;42000000;853000000;1199000000;1802000000;2655000000;1755000000;-86000000;405000000;2241000000;4896000000
XYL;124467;USD;2012;Q4;2012-12-31;2013-02-25;185958000;186465000;504000000;776000000;443000000;1874000000;487000000;;2318000000;2805000000;4679000000;775000000;6000000;781000000;1199000000;1824000000;2605000000;1708000000;-13000000;264000000;2074000000;4679000000
XYL;124467;USD;2011;Q4;2011-12-31;2012-02-28;186466000;187526000;318000000;756000000;433000000;1649000000;463000000;;2288000000;2751000000;4400000000;812000000;5000000;817000000;1201000000;1752000000;2569000000;1665000000;0;44000000;1831000000;4400000000
XYL;124467;USD;2010;Q4;2010-12-31;2011-11-21;;;131000000;690000000;389000000;1336000000;454000000;;1945000000;2399000000;3735000000;649000000;0;649000000;4000000;3049000000;3698000000;0;;0;37000000;3735000000
XYL;124467;USD;2016;Q4;2016-12-31;2017-02-23;179444000;180497000;308000000;843000000;522000000;1839000000;616000000;;4019000000;4635000000;6474000000;978000000;260000000;1238000000;2108000000;3029000000;4267000000;1878000000;-403000000;1033000000;2207000000;6474000000
XYL;124467;USD;2017;Q4;2017-12-31;2018-02-23;179600000;181422000;414000000;956000000;524000000;2071000000;643000000;;4146000000;4789000000;6860000000;1100000000;0;1100000000;2200000000;3241000000;4341000000;1914000000;-428000000;1227000000;2519000000;6860000000
XYL;124467;USD;2018;Q4;2018-12-31;2019-02-22;179800000;180900000;296000000;1031000000;595000000;2094000000;656000000;;4472000000;5128000000;7222000000;1132000000;257000000;1389000000;2051000000;3051000000;4440000000;1952000000;-487000000;1639000000;2782000000;7222000000
RYAM;124551;USD;2017;Q4;2017-12-31;2018-03-01;46504309;81255127;96235000;181298000;302086000;646537000;1407762000;;588312000;1996074000;2642611000;284965000;9425000;307571000;1232179000;1641284000;1948855000;392870000;;377020000;693756000;2642611000
RYAM;124551;USD;2016;Q4;2016-12-31;2017-02-24;42323675;54494621;326655000;37626000;118368000;519508000;801039000;;101392000;902431000;1421939000;103605000;9593000;126979000;773689000;1083211000;1210190000;242835000;;78977000;211749000;1421939000
RYAM;124551;USD;2015;Q4;2015-12-31;2016-02-26;42200862;42172727;101303000;68892000;125409000;327753000;803838000;;147021000;950859000;1278612000;100420000;7938000;131444000;850116000;1164307000;1295751000;70642000;;21839000;-17139000;1278612000
RYAM;124551;USD;2014;Q4;2014-12-31;2015-02-27;42146372;42355731;65977000;69263000;140209000;311716000;843375000;;148789000;992164000;1303880000;100564000;8400000;131445000;936416000;1234847000;1366292000;62508000;;-21476000;-62412000;1303880000
RYAM;124551;USD;2013;Q4;2013-12-31;2014-08-05;42176565;42176565;0;71097000;128706000;246055000;846288000;;27923000;874211000;1120266000;74607000;0;79846000;0;-335775000;-255929000;0;;1415894000;1376195000;1120266000
FET;124637;USD;2017;Q4;2017-12-31;2018-02-27;106451000;106451000;115216000;202914000;443177000;790381000;197281000;0;1207566000;1404847000;2195228000;204449000;1156000;216305000;506750000;569907000;786212000;1196502000;-134293000;438774000;1409016000;2195228000
FET;124637;USD;2016;Q4;2016-12-31;2017-02-28;92860000;92860000;234422000;105268000;338583000;749716000;152212000;59140000;874124000;1085476000;1835192000;129379000;124000;141845000;396747000;457586000;599431000;999206000;-133941000;498174000;1235761000;1835192000
FET;124637;USD;2015;Q4;2015-12-31;2016-02-29;90325000;84592000;109249000;138597000;424121000;717812000;186667000;57719000;923844000;1168230000;1886042000;135386000;253000;151553000;396016000;477072000;628625000;892234000;-133318000;580152000;1257417000;1886042000
FET;124637;USD;2014;Q4;2014-12-31;2015-02-27;92403000;94148000;76579000;287045000;461515000;895159000;189974000;49675000;1079294000;1318943000;2214102000;254647000;840000;282191000;420484000;535990000;818181000;865292000;-132480000;699505000;1395921000;2214102000
FET;124637;USD;2013;Q4;2013-12-31;2014-02-28;91780000;94720000;39582000;250272000;441049000;809468000;180292000;60292000;1118817000;1359401000;2168869000;196750000;998000;219983000;512077000;618607000;838590000;826992000;-30249000;525140000;1330279000;2168869000
FET;124637;USD;2012;Q4;2012-12-31;2013-03-05;84996000;90874000;41063000;228947000;455129000;774877000;152983000;0;965120000;1118103000;1892980000;184883000;20504000;273067000;400201000;484152000;757219000;765510000;-25933000;395601000;1135761000;1892980000
FET;124637;USD;2011;Q4;2011-12-31;2012-05-04;67632000;72410000;20548000;228686000;324638000;618586000;124840000;;863889000;988729000;1607315000;189893000;5176000;254652000;660379000;724628000;979280000;425145000;-25877000;244145000;628035000;1607315000
FET;124637;USD;2018;Q4;2018-12-31;2019-02-28;109091000;106657000;47241000;206055000;479023000;766017000;177358000;44982000;841295000;1063635000;1829652000;224218000;1167000;236930000;517544000;562596000;799526000;1216102000;-134434000;63688000;1030126000;1829652000
LKQ;124743;USD;2017;Q4;2017-12-31;2018-02-28;309084000;311121000;279766000;1027106000;2380783000;3822134000;913089000;208404000;4423245000;5544738000;9366872000;1150637000;126360000;1322724000;3277620000;3837495000;5160219000;1144542000;;3124103000;4206653000;9366872000
LKQ;124743;USD;2016;Q4;2016-12-31;2017-02-27;307523000;310129000;227400000;860549000;1935237000;3567594000;811576000;183467000;3740562000;4735605000;8303199000;961629000;66109000;1210785000;3275662000;3649465000;4860250000;1119765000;;2590359000;3442949000;8303199000
LKQ;124743;USD;2015;Q4;2015-12-31;2016-02-25;305540000;308048000;87397000;590160000;1556552000;2340712000;696567000;2755000;2607803000;3307125000;5647837000;626581000;56034000;751970000;1528668000;1781185000;2533155000;1093768000;;2126384000;3114682000;5647837000
LKQ;124743;USD;2014;Q4;2014-12-31;2015-03-02;303212000;306623000;114605000;601422000;1433847000;2235673000;629987000;;2610079000;3240066000;5475739000;613997000;61938000;744504000;1784210000;2010578000;2755082000;1057721000;;1703161000;2720657000;5475739000
LKQ;124743;USD;2013;Q4;2013-12-31;2014-03-03;300688000;305245000;150488000;458094000;1076952000;1799817000;546651000;;2172306000;2718957000;4518774000;547838000;41535000;677953000;1264246000;1490076000;2168029000;1009092000;;1321642000;2350745000;4518774000
LKQ;124743;USD;2012;Q4;2012-12-31;2013-03-01;297235000;302106000;59770000;311808000;900803000;1384351000;494379000;;1844726000;2339105000;3723456000;356905000;71716000;487944000;1046762000;1271418000;1759362000;953316000;;1010019000;1964094000;3723456000
LKQ;124743;USD;2011;Q4;2011-12-31;2012-02-27;293302000;298094000;48247000;281764000;736846000;1149735000;424098000;;1625871000;2049969000;3199704000;349162000;29524000;397693000;926552000;1157926000;1555619000;904252000;;748794000;1644085000;3199704000
LKQ;124743;USD;2010;Q4;2010-12-31;2011-02-25;289580000;294020000;95689000;191085000;492688000;836876000;331312000;;1131321000;1462633000;2299509000;143645000;52888000;225321000;548066000;660027000;885348000;871253000;;538530000;1414161000;2299509000
LKQ;124743;USD;2009;Q4;2009-12-31;2010-07-30;282786000;289906000;108906000;152443000;385686000;702868000;289902000;;1027351000;1317253000;2020121000;114959000;10063000;168481000;592982000;672206000;840687000;817372000;;369459000;1179434000;2020121000
ETN;124922;USD;2017;Q4;2017-12-31;2018-02-28;440300000;443200000;1095000000;3943000000;2620000000;8337000000;3502000000;;20784000000;24286000000;32623000000;2619000000;584000000;5075000000;7167000000;10258000000;15333000000;;;;17290000000;32623000000
ETN;124922;USD;2016;Q4;2016-12-31;2016-11-01;450500000;452300000;746000000;3560000000;2346000000;7033000000;3443000000;;20000000000;23443000000;30476000000;2097000000;1566000000;5485000000;6711000000;9990000000;15475000000;11850000000;;7555000000;15001000000;30476000000
ETN;124922;USD;2015;Q4;2015-12-31;2016-02-24;461400000;462800000;445000000;3479000000;2323000000;6616000000;3565000000;;20815000000;24380000000;30996000000;2124000000;668000000;4625000000;7746000000;11137000000;15762000000;11706000000;;7346000000;15234000000;30996000000
ETN;124922;USD;2014;Q4;2014-12-31;2015-02-26;469900000;472700000;1026000000;3667000000;2428000000;8100000000;3750000000;;21679000000;25429000000;33529000000;2360000000;1010000000;5355000000;8024000000;12332000000;17687000000;11610000000;;7078000000;15842000000;33529000000
ETN;124922;USD;2013;Q4;2013-12-31;2014-02-26;474700000;478200000;1709000000;3648000000;2382000000;8731000000;3833000000;;22927000000;26760000000;35491000000;2421000000;580000000;4914000000;8969000000;13711000000;18625000000;11488000000;;6866000000;16866000000;35491000000
ETN;124922;USD;2012;Q4;2012-12-31;2013-02-28;381200000;384500000;1104000000;3474000000;2336000000;7900000000;3786000000;;24124000000;27910000000;35810000000;2341000000;1071000000;5515000000;9765000000;15113000000;20628000000;11276000000;;5805000000;15182000000;35810000000
ETN;124922;USD;2011;Q4;2011-12-31;2012-11-14;;;1084000000;2444000000;1701000000;5826000000;2602000000;;9445000000;12047000000;17873000000;1911000000;407000000;3637000000;3366000000;6738000000;10375000000;4336000000;;5103000000;7498000000;17873000000
ETN;124922;USD;2018;Q4;2018-12-31;2019-02-27;429700000;432300000;440000000;3858000000;2785000000;7590000000;3467000000;;20035000000;23502000000;31092000000;2587000000;753000000;5154000000;6768000000;9793000000;14947000000;12094000000;;8161000000;16145000000;31092000000
DNB;125293;USD;2016;Q4;2016-12-31;2017-02-23;36900000;37600000;352600000;543600000;;944400000;39400000;;1225400000;1264800000;2209200000;204800000;22500000;855400000;1594500000;2341600000;3197000000;318400000;-3330400000;2959600000;-987800000;2209200000
DNB;125293;USD;2015;Q4;2015-12-31;2016-02-26;36200000;36400000;365700000;523500000;;959600000;27200000;;1279700000;1306900000;2266500000;168800000;20000000;836600000;1797000000;2535200000;3371800000;293000000;-3377100000;2932800000;-1105300000;2266500000
DNB;125293;USD;2014;Q4;2014-12-31;2015-02-26;35800000;36500000;316300000;503000000;;932600000;22000000;;1031600000;1053600000;1986200000;147100000;301100000;1048400000;1352200000;2132400000;3180800000;280100000;-3392400000;2831100000;-1194600000;1986200000
DNB;125293;USD;2013;Q4;2013-12-31;2014-02-28;37900000;38400000;235900000;518500000;;822400000;39600000;;1028300000;1067900000;1890300000;135300000;100000;736200000;1516000000;2196400000;2932600000;270800000;-3181300000;2600900000;-1042300000;1890300000
DNB;125293;USD;2012;Q4;2012-12-31;2013-02-28;43200000;43700000;149100000;514300000;;747400000;40600000;;1203800000;1244400000;1991800000;146900000;200000;757800000;1290700000;2248300000;3006100000;262500000;-2833300000;2405500000;-1014300000;1991800000
DNB;125293;USD;2011;Q4;2011-12-31;2012-02-29;47900000;48400000;84400000;507500000;;726900000;45700000;;1204500000;1250200000;1977100000;171500000;1100000;799900000;963900000;1917400000;2717300000;239800000;-2356300000;2179300000;-740200000;1977100000
DNB;125293;USD;2010;Q4;2010-12-31;2011-03-01;49500000;50100000;78500000;504300000;;668300000;53100000;;1198100000;1251200000;1919500000;182400000;1500000;799200000;972000000;1789100000;2588300000;228100000;-2214100000;1989500000;-668800000;1919500000
DNB;125293;USD;2009;Q4;2009-12-31;2010-08-04;51400000;52000000;222900000;464100000;;759600000;53600000;;936200000;989800000;1749400000;144300000;1700000;685700000;961800000;1797700000;2483400000;210300000;-2097700000;1830700000;-734000000;1749400000
DNB;125293;USD;2017;Q4;2017-12-31;2018-02-22;36900000;37400000;442400000;596800000;;1093700000;38900000;;1348300000;1387200000;2480900000;201900000;32500000;918800000;1645600000;2373300000;3292100000;332800000;-3319500000;3176300000;-811200000;2480900000
TUP;125534;USD;2015;Q4;2015-12-31;2016-03-04;50200000;50600000;79800000;188200000;254600000;550500000;253600000;13200000;780900000;1047700000;1598200000;451500000;162500000;614000000;608200000;823200000;1437200000;206100000;-894300000;1371200000;161000000;1598200000
TUP;125534;USD;2014;Q4;2014-12-31;2015-02-24;49800000;50800000;77000000;229900000;306000000;634500000;290300000;17300000;827700000;1135300000;1769800000;518100000;221400000;739500000;612100000;844500000;1584000000;191300000;-945000000;1348200000;185800000;1769800000
TUP;125534;USD;2013;Q4;2013-12-31;2014-02-25;50400000;51800000;127300000;218900000;313400000;779000000;300900000;23100000;740900000;1064900000;1843900000;502100000;235400000;737500000;619900000;853500000;1591000000;178900000;-898400000;1289200000;252900000;1843900000
TUP;125534;USD;2012;Q4;2012-12-31;2013-02-26;54600000;55800000;119800000;212400000;313900000;766500000;298800000;24800000;731700000;1055300000;1821800000;491100000;203400000;694500000;414400000;648200000;1342700000;151800000;-573800000;1172400000;479100000;1821800000
TUP;125534;USD;2011;Q4;2011-12-31;2012-02-28;56900000;58500000;138200000;211200000;302500000;769400000;273100000;23200000;756900000;1053200000;1822600000;477700000;195700000;673400000;415200000;648400000;1321800000;127400000;-422800000;1091700000;500800000;1822600000
TUP;125534;USD;2010;Q4;2010-12-31;2011-02-22;62700000;63600000;248700000;221300000;279100000;849200000;258000000;22800000;885800000;1166600000;2015800000;498500000;1900000;500400000;426800000;725600000;1226000000;108600000;-41500000;969200000;789800000;2015800000
TUP;125534;USD;2009;Q4;2009-12-31;2010-08-04;63000000;64300000;112400000;222000000;265500000;696800000;254600000;22600000;844800000;1122000000;1818800000;458600000;1900000;460500000;426200000;720600000;1181100000;91700000;-26800000;836100000;637700000;1818800000
TUP;125534;USD;2016;Q4;2016-12-31;2017-02-28;50600000;50700000;93200000;190200000;240400000;545300000;259800000;13200000;769500000;1042500000;1587800000;441700000;105900000;547600000;606000000;827400000;1375000000;209200000;-880200000;1455300000;212800000;1587800000
TUP;125534;USD;2017;Q4;2017-12-31;2018-02-27;50800000;50100000;144100000;203000000;262200000;630500000;278200000;19300000;460000000;757500000;1388000000;525800000;133000000;658800000;605100000;848600000;1507400000;218400000;-851500000;1043100000;-119400000;1388000000
TUP;125534;USD;2018;Q4;2018-12-31;2019-02-26;48700000;49400000;149000000;194600000;257700000;620600000;276000000;18700000;393500000;688200000;1308800000;473600000;285500000;759100000;603400000;784900000;1544000000;219900000;-939800000;1086800000;-235200000;1308800000
GM;125620;USD;2017;Q4;2017-12-31;2018-02-06;1413000000;1445000000;23825000000;8164000000;10663000000;68744000000;79135000000;;64603000000;143738000000;212482000000;49925000000;26965000000;76890000000;67254000000;99392000000;176282000000;25385000000;;17627000000;36200000000;212482000000
GM;125620;USD;2018;Q4;2018-12-31;2019-02-06;1414000000;1432000000;26810000000;6549000000;9816000000;75293000000;82317000000;;69729000000;152046000000;227339000000;50346000000;31891000000;82237000000;73060000000;102325000000;184562000000;25577000000;;22322000000;42777000000;227339000000
CCOI;125781;USD;2016;Q4;2016-12-31;2017-02-24;45197957;45513019;274319000;33598000;;327623000;361641000;;48628000;410269000;737892000;58700000;6626000;67913000;695190000;723233000;791146000;442844000;;-478905000;-53254000;737892000
CCOI;125781;USD;2015;Q4;2015-12-31;2016-02-24;45147087;45723072;203591000;30718000;;251339000;360136000;;51341000;411477000;662816000;50756000;6247000;68904000;575206000;606183000;675087000;434206000;;-431784000;-12271000;662816000
CCOI;125781;USD;2014;Q4;2014-12-31;2015-02-27;-137752420120;46567275;287790000;33089000;;335637000;360761000;;58516000;419277000;754914000;45438000;14594000;60032000;589313000;611088000;671120000;460622000;;-370366000;83794000;754914000
CCOI;125781;USD;2013;Q4;2013-12-31;2014-02-28;47397447;47959588;304866000;30628000;;354271000;341193000;;59637000;400830000;755101000;45563000;98131000;143694000;397950000;417915000;561609000;508303000;;-316947000;193492000;755101000
CCOI;125781;USD;2012;Q4;2012-12-31;2013-02-27;46126422;46126422;247285000;23990000;;281253000;311175000;;14103000;325278000;606531000;41253000;10487000;51740000;384945000;395012000;446752000;497396000;;-338284000;159779000;606531000
CCOI;125781;USD;2011;Q4;2011-12-31;2012-02-27;45887716;46975653;238207000;25029000;;273287000;307978000;;16386000;324364000;597651000;36143000;11700000;47843000;374608000;385807000;433650000;489067000;;-324484000;164001000;597651000
CCOI;125781;USD;2010;Q4;2010-12-31;2011-08-08;44959828;45587328;56283000;23702000;;88639000;280455000;;7009000;287464000;376103000;35517000;6143000;41660000;176782000;182642000;224302000;482783000;;-332026000;151801000;376103000
CCOI;125781;USD;2017;Q4;2017-12-31;2018-02-23;45286872;45712536;247011000;39096000;;306118000;381282000;;23188000;404470000;710588000;59539000;7171000;74526000;711010000;738606000;813132000;456742000;;-554686000;-102544000;710588000
CCOI;125781;USD;2018;Q4;2018-12-31;2019-02-22;46074074;46593011;276093000;41709000;;350337000;375325000;;14188000;389513000;739850000;59950000;7074000;75307000;788165000;813545000;888852000;471377000;;-609451000;-149002000;739850000
SNHY;126033;USD;2017;Q4;2017-12-31;2018-02-27;27073000;27073000;63882000;37503000;41545000;146776000;91931000;;221059000;312990000;459766000;28761000;;45863000;116000000;141230000;187093000;95381000;;183770000;272673000;459766000
SNHY;126033;USD;2016;Q4;2016-12-31;2017-02-28;26933000;26933000;81046000;25730000;30000000;141268000;80515000;;222994000;303509000;444777000;20311000;;31076000;140000000;177304000;208380000;89745000;;162485000;236397000;444777000
SNHY;126033;USD;2015;Q4;2015-12-31;2016-03-01;26764000;26764000;126106000;13531000;13047000;157018000;74121000;;10401000;84522000;241540000;11682000;;11682000;0;7671000;19353000;82292000;;149938000;222187000;241540000
SNHY;126033;USD;2014;Q4;2014-12-31;2015-02-24;26551000;26551000;100196000;17501000;14098000;135547000;77716000;;9501000;87217000;222764000;15732000;;15732000;;8773000;24505000;73526000;;128818000;198259000;222764000
SNHY;126033;USD;2013;Q4;2013-12-31;2014-03-07;26210000;26209000;93641000;16984000;13853000;129056000;75731000;;8691000;84422000;213478000;14018000;;14018000;;8032000;22050000;65417000;;123420000;191428000;213478000
SNHY;126033;USD;2012;Q4;2012-12-31;2013-03-12;26065000;26076000;72178000;13754000;12559000;102445000;64672000;;8004000;72676000;175121000;12247000;;12247000;;7601000;19848000;57428000;;97242000;155273000;175121000
SNHY;126033;USD;2011;Q4;2011-12-31;2012-03-14;76969710;77082625;73094000;16227000;12829000;103930000;56959000;;6639000;63598000;167528000;14186000;;14186000;;8066000;22252000;48970000;;98426000;145276000;167528000
SNHY;126033;USD;2010;Q4;2010-12-31;2011-08-10;25428000;25478000;44820000;16399000;10773000;76279000;53127000;;2628000;55755000;132034000;10129000;;10129000;;6881000;17010000;44027000;;71132000;115024000;132034000
SNHY;126033;USD;2018;Q4;2018-12-31;2019-02-26;31985000;31985000;23477000;72806000;85989000;196856000;126868000;;718441000;845309000;1042165000;69655000;5215000;92990000;347470000;418407000;511397000;357965000;;219056000;530768000;1042165000
ANSS;126145;USD;2015;Q4;2015-12-31;2016-02-25;88625000;90549000;784614000;91579000;;1076426000;61924000;;1591554000;1653478000;2729904000;119502000;;484146000;;51331000;535477000;895401000;-440839000;1792029000;2194427000;2729904000
ANSS;126145;USD;2014;Q4;2014-12-31;2015-02-26;91596000;93584000;788778000;101229000;;1082315000;64643000;;1605921000;1670564000;2752879000;132411000;;465075000;;70303000;535378000;905757000;-196010000;1539508000;2217501000;2752879000
ANSS;126145;USD;2013;Q4;2013-12-31;2014-02-27;92455000;95085000;742986000;97845000;;1067596000;60538000;;1594248000;1654786000;2722382000;130607000;;440431000;;145705000;586136000;926963000;-72891000;1284818000;2136246000;2722382000
ANSS;126145;USD;2012;Q4;2012-12-31;2013-02-28;92597000;94943000;577155000;96598000;;913359000;52253000;;1641805000;1694058000;2607417000;117036000;53149000;477387000;;189739000;667126000;928300000;-36151000;1039491000;1940291000;2607417000
ANSS;126145;USD;2011;Q4;2011-12-31;2012-02-23;92496000;94720000;472404000;84602000;;740033000;45638000;;1662799000;1708437000;2448470000;105173000;74423000;438751000;53149000;255246000;693997000;906589000;0;836008000;1754473000;2448470000
ANSS;126145;USD;2010;Q4;2010-12-31;2011-02-25;91278000;93704000;472934000;76604000;;714633000;36921000;;1375322000;1412243000;2126876000;79386000;31962000;311369000;127563000;285578000;596947000;857634000;;655333000;1529929000;2126876000
ANSS;126145;USD;2009;Q4;2009-12-31;2010-08-05;89068000;92277000;343844000;67084000;;515490000;35131000;;1369561000;1404692000;1920182000;70590000;26758000;266766000;198668000;340785000;607551000;802471000;-853000;502201000;1312631000;1920182000
ANSS;126145;USD;2016;Q4;2016-12-31;2017-02-23;86197000;87811000;822860000;107192000;;1169401000;54677000;;1576448000;1631125000;2800526000;135821000;;539100000;;53021000;592121000;883942000;-675550000;2057665000;2208405000;2800526000
ANSS;126145;USD;2017;Q4;2017-12-31;2018-02-22;84555000;86709000;881787000;124659000;;1270266000;57096000;;1614261000;1671357000;2941623000;168062000;;608553000;;87239000;695792000;874289000;-907530000;2316916000;2245831000;2941623000
ANSS;126145;USD;2018;Q4;2018-12-31;2019-02-28;83698000;85471000;777364000;317700000;;1311177000;61655000;;1893132000;1954787000;3265964000;196183000;;524767000;;91650000;616417000;868394000;-1075879000;2919411000;2649547000;3265964000
SGM;126240;USD;2015;Q4;2015-12-31;2016-03-15;25787000;25787000;32463000;30000000;;943375000;22923000;;314328000;337251000;1280626000;23544000;497799000;1011098000;;7900000;1018998000;271170000;;-9542000;261628000;1280626000
SGM;126240;USD;2014;Q4;2014-12-31;2015-03-06;25773000;25773000;45382000;30000000;;1356180000;17047000;;223324000;240371000;1596551000;28350000;594798000;1299678000;;16798000;1316476000;267347000;;12728000;280075000;1596551000
SGM;126240;USD;2013;Q4;2013-12-31;2014-03-14;25254000;25127000;43104000;0;;921058000;12640000;;56191000;68831000;989889000;25097000;348892000;650300000;;32088000;682388000;264094000;;43407000;307501000;989889000
SGM;126240;USD;2012;Q4;2012-12-31;2013-11-14;3145000;9740000;15056000;222000;;292476000;4026000;740000;12364000;17130000;309606000;18606000;107806000;238059000;;16298000;254357000;3233000;-1820000;20836000;55249000;309606000
SGM;126240;USD;2016;Q4;2016-12-31;2017-03-09;26129000;26129000;26258000;30000000;;893315000;14839000;;268588000;283427000;1176742000;23657000;287717000;908802000;;7991000;916793000;272573000;;-12624000;259949000;1176742000
SMP;126577;USD;2016;Q4;2016-12-31;2017-02-21;22826167;23268936;19796000;134630000;312477000;474221000;78499000;;215977000;294476000;768697000;198328000;43000;283841000;120000;43828000;327669000;144722000;-29130000;336464000;441028000;768697000
SMP;126577;USD;2015;Q4;2015-12-31;2016-02-26;22647976;22936563;18800000;123853000;285793000;479740000;68882000;;132442000;201324000;681064000;179425000;16000;243916000;62000;45169000;289085000;141119000;-34147000;291481000;391979000;681064000
SMP;126577;USD;2014;Q4;2014-12-31;2015-02-27;22891882;23369116;13728000;126524000;278051000;466033000;64611000;;142907000;207518000;673551000;176783000;175000;250829000;83000;48569000;299398000;139283000;-21638000;259160000;374153000;673551000
SMP;126577;USD;2013;Q4;2013-12-31;2014-02-27;23064097;23484651;5559000;125201000;269447000;446077000;63646000;;105800000;169446000;615523000;173630000;59000;220316000;16000;45775000;266091000;135435000;-15825000;228036000;349432000;615523000
SMP;126577;USD;2012;Q4;2012-12-31;2013-03-08;22816293;23115213;13074000;98565000;267468000;418553000;64422000;;93619000;158041000;576594000;160388000;120000;222172000;75000;46835000;269007000;130220000;-13205000;186693000;307587000;576594000
SMP;126577;USD;2011;Q4;2011-12-31;2012-03-09;22741591;23817623;10871000;104115000;248097000;400987000;64039000;;85696000;149735000;550722000;131736000;109000;228881000;190000;49888000;278769000;127661000;-12562000;153555000;271953000;550722000
SMP;126577;USD;2010;Q4;2010-12-31;2011-08-02;22643108;22723216;12135000;104986000;241158000;384706000;60666000;;47429000;108095000;492801000;126074000;12402000;214831000;307000;68087000;282918000;125343000;-13711000;97535000;209883000;492801000
SMP;126577;USD;2017;Q4;2017-12-31;2018-02-22;22579133;22976013;17323000;140057000;326411000;496091000;89103000;;202373000;291476000;787567000;201163000;4699000;285897000;79000;48016000;333913000;147929000;-47319000;357153000;453654000;787567000
SMP;126577;USD;2018;Q4;2018-12-31;2019-02-20;22431020;22862217;11138000;157535000;349811000;546224000;90754000;;206154000;296908000;843132000;242956000;5377000;312586000;153000;63345000;375931000;150342000;-53660000;380113000;467201000;843132000
AMOT;126799;USD;2016;Q4;2016-12-31;2017-03-13;8078000;8454000;15483000;26104000;31098000;75805000;37474000;;66640000;104114000;179919000;23882000;936000;24818000;70483000;82815000;107633000;29503000;;54786000;72286000;179919000
AMOT;126799;USD;2015;Q4;2015-12-31;2016-03-09;9174000;9214000;21278000;22710000;26175000;73912000;35315000;;52920000;88235000;162147000;24121000;9860000;33981000;57518000;63569000;97550000;27824000;;46650000;64597000;162147000
AMOT;126799;USD;2014;Q4;2014-12-31;2015-03-12;9141000;9221000;13113000;27745000;25371000;68896000;37041000;;61144000;98185000;167081000;28233000;7723000;35956000;67125000;75174000;111130000;25129000;;36505000;55951000;167081000
AMOT;126799;USD;2013;Q4;2013-12-31;2014-03-18;8986000;9014000;8371000;27123000;24430000;64326000;40111000;;66540000;106651000;170977000;28105000;14145000;42250000;73500000;80724000;122974000;23771000;;23608000;48003000;170977000
AMOT;126799;USD;2012;Q4;2012-12-31;2013-03-11;8551000;8551000;9728000;10806000;14701000;37390000;8631000;;14946000;23577000;60967000;11674000;397000;12071000;;6744000;18815000;22547000;;20528000;42152000;60967000
AMOT;126799;USD;2011;Q4;2011-12-31;2012-03-13;8495000;8771000;9155000;11689000;14429000;36466000;7352000;;14869000;22221000;58687000;15712000;157000;17182000;;5183000;22365000;21568000;;15970000;36322000;58687000
AMOT;126799;USD;2010;Q4;2010-12-31;2011-08-12;7987000;8413000;3553000;11753000;11787000;28508000;6923000;;15575000;22498000;51006000;13716000;795000;14511000;;6551000;21062000;20473000;;9342000;29944000;51006000
AMOT;126799;USD;2017;Q4;2017-12-31;2018-03-14;9206000;9312000;15590000;31822000;32568000;83440000;38403000;;66079000;104482000;187922000;29621000;461000;30082000;52694000;70493000;100575000;31051000;;61882000;87347000;187922000
AMOT;126799;USD;2018;Q4;2018-12-31;2019-03-13;9268000;9428000;8673000;43247000;54971000;110894000;48035000;;126372000;174407000;285301000;44589000;;44589000;122516000;138899000;183488000;0;;76718000;101813000;285301000
PGTI;127570;USD;2016;Q4;2017-01-31;2016-03-11;49079000;50697000;39210000;41646000;30511000;122377000;84209000;;230062000;314271000;436648000;22803000;;22803000;247873000;280993000;303796000;250166000;-12759000;-104555000;132852000;436648000
PGTI;127570;USD;2015;Q4;2016-01-31;2015-03-19;48694000;50594000;61493000;31783000;23053000;126972000;71503000;;145553000;217056000;344028000;19578000;1949000;21527000;188818000;215540000;237067000;245455000;-10037000;-128457000;106961000;344028000
PGTI;127570;USD;2014;Q4;2015-01-31;2015-03-19;47690000;49883000;30204000;20821000;12908000;71400000;44123000;;41109000;85232000;156632000;15522000;4890000;20412000;72365000;87145000;107557000;229758000;-10046000;-168414000;49075000;156632000
PGTI;127570;USD;2013;Q4;2014-01-31;2014-02-28;46822000;49552000;30204000;20821000;12908000;71400000;44123000;;41109000;85232000;156632000;15522000;4890000;20412000;72365000;87145000;107557000;229758000;-10046000;-168414000;49075000;156632000
PGTI;127570;USD;2012;Q4;2013-01-31;2012-05-07;53460000;56756000;18743000;13997000;11529000;53330000;41220000;;46767000;87987000;141317000;13325000;;13325000;37500000;53782000;67107000;274812000;-3955000;-195233000;74210000;141317000
PGTI;127570;USD;2011;Q4;2012-01-31;2012-03-15;53662000;53359000;10940000;13830000;11602000;40114000;48606000;;54115000;102721000;142835000;12706000;50000;12756000;45500000;62717000;75473000;273357000;-9000;-204188000;67362000;142835000
PGTI;127570;USD;2017;Q4;2018-01-31;2018-03-14;49723000;51811000;34029000;60308000;37816000;144516000;84133000;;224470000;308603000;453119000;41085000;294000;41379000;212679000;236415000;277794000;252800000;-12759000;-64716000;175325000;453119000
PGTI;127570;USD;2018;Q4;2019-01-31;2019-02-27;57987000;59302000;52650000;80717000;44666000;195561000;115707000;;550885000;666592000;862153000;68557000;163000;68720000;366614000;407889000;476609000;410268000;-12759000;-8900000;385544000;862153000
SLG;127650;USD;2016;Q4;2016-12-31;2017-02-21;100322000;105330000;279443000;53772000;;439595000;10478638000;1975296000;2964258000;15418192000;15857787000;277854000;;704630000;6523798000;6626354000;7330984000;5625562000;-124049000;1578893000;8526803000;15857787000
SLG;127650;USD;2015;Q4;2015-12-31;2016-02-29;99778000;108409000;255399000;63491000;;598099000;14620896000;1248996000;3259655000;19129547000;19727646000;276003000;;874365000;10316813000;10427242000;11301607000;5440736000;-10000000;1643546000;8426039000;19727646000
SLG;127650;USD;2014;Q4;2014-12-31;2015-02-24;96790000;100878000;281409000;57369000;;962119000;12163976000;1211449000;2759043000;16134468000;17096587000;237639000;;692875000;8199609000;8403857000;9096732000;5114733000;0;1607689000;7999855000;17096587000
SLG;127650;USD;2013;Q4;2013-12-31;2014-02-25;94029000;97210000;206692000;60393000;;417666000;10687540000;1145267000;2708528000;14541335000;14959001000;198144000;;483590000;6967579000;7143509000;7627099000;5016890000;-317356000;1619150000;7331902000;14959001000
SLG;127650;USD;2012;Q4;2012-12-31;2013-02-27;90502000;94077000;189984000;55855000;;394342000;10269630000;1053672000;2668652000;13991954000;14386296000;197437000;;531465000;6557938000;6685271000;7216736000;4668850000;-322858000;1701092000;7169560000;14386296000
SLG;127650;USD;2011;Q4;2011-12-31;2012-02-28;86373000;89242000;138192000;32107000;;337446000;10010548000;919256000;2216602000;13146406000;13483852000;170826000;;608502000;6052509000;6225011000;6833513000;4237851000;-308708000;1704506000;6650339000;13483852000
SLG;127650;USD;2010;Q4;2010-12-31;2011-02-28;78308000;79712000;332830000;27054000;;503852000;7973771000;665622000;2157049000;10796442000;11300294000;147571000;;473516000;5268057000;5344896000;5818412000;3661659000;-303222000;1172963000;5481882000;11300294000
SLG;127650;USD;2009;Q4;2009-12-31;2010-08-09;77352000;79436000;343715000;22483000;;470255000;7518678000;1117154000;1381490000;10017322000;10487577000;137988000;;505670000;4909571000;4984160000;5489830000;3526710000;-302705000;949669000;4997747000;10487577000
SLG;127650;USD;2017;Q4;2017-12-31;2018-02-23;95958000;100756000;127888000;57644000;;669063000;7906006000;2391568000;3016267000;13313841000;13982904000;222280000;;625717000;5897975000;6004044000;6629761000;4969277000;-124049000;1139329000;7353143000;13982904000
SLG;127650;USD;2018;Q4;2018-12-31;2019-02-27;83750000;88353000;129475000;41589000;;348735000;6414798000;3047658000;2940167000;12402623000;12751358000;227490000;;442112000;5585317000;5673159000;6115271000;4509532000;-124049000;1278998000;6636087000;12751358000
GRA;127797;USD;2018;Q4;2018-12-31;2019-02-28;66800000;66900000;200500000;288500000;281100000;857300000;1011700000;156100000;1540200000;2708000000;3565300000;248600000;22300000;514400000;1961000000;2713900000;3228300000;481800000;-895500000;676700000;337000000;3565300000
CTSH;128066;USD;2016;Q4;2016-12-31;2017-03-01;607700000;610900000;5169000000;2556000000;;8600000000;1311000000;62000000;4289000000;5662000000;14262000000;2031000000;81000000;2418000000;797000000;1116000000;3534000000;364000000;;10478000000;10728000000;14262000000
CTSH;128066;USD;2015;Q4;2015-12-31;2016-02-25;608100000;612700000;4949000000;2253000000;;7909000000;1271000000;0;3881000000;5152000000;13061000000;1984000000;406000000;2714000000;877000000;1069000000;3783000000;459000000;;8925000000;9278000000;13061000000
CTSH;128066;USD;2014;Q4;2014-12-31;2015-02-27;608700000;612800000;3774700000;1968700000;;6420600000;1247200000;;3811200000;5058400000;11479000000;1668000000;700000000;2592100000;937500000;1146700000;3738800000;561700000;;7301600000;7740200000;11479000000
CTSH;128066;USD;2013;Q4;2013-12-31;2014-02-25;605688000;611006000;3747473000;1648785000;;6147882000;1081164000;;905672000;1986836000;8134718000;1591615000;0;1774508000;0;224419000;1998927000;549683000;;5862367000;6135791000;8134718000
CTSH;128066;USD;2012;Q4;2012-12-31;2013-02-26;600906000;607556000;2863758000;1345661000;;4814294000;971486000;;735791000;1707277000;6521571000;1227634000;;1377330000;;289858000;1667188000;460277000;;4633789000;4854383000;6521571000
CTSH;128066;USD;2011;Q4;2011-12-31;2012-02-27;604710000;617654000;2432264000;1179043000;;4085506000;758034000;;664393000;1422427000;5507933000;1103992000;;1209705000;;345342000;1555047000;695754000;;3582526000;3952886000;5507933000
CTSH;128066;USD;2010;Q4;2010-12-31;2011-02-23;607266000;623556000;2226388000;901308000;;3518234000;570448000;;494392000;1064840000;4583074000;846136000;;930726000;;67917000;998643000;849925000;;2698908000;3584431000;4583074000
CTSH;128066;USD;2009;Q4;2009-12-31;2010-02-25;591204000;609226000;1399332000;626288000;;2307568000;481516000;151131000;398025000;1030672000;3338240000;595003000;;646608000;;38455000;685063000;667532000;;1965368000;2653177000;3338240000
CTSH;128066;USD;2008;Q4;2008-12-31;2009-08-07;582528000;595144000;762579000;517481000;;1468119000;455254000;161693000;289494000;906441000;2374560000;349454000;;387577000;;21405000;408982000;544652000;;1430405000;1965578000;2374560000
CTSH;128066;USD;2017;Q4;2017-12-31;2018-02-27;588000000;590000000;5056000000;2865000000;;9111000000;1324000000;235000000;4551000000;6110000000;15221000000;2281000000;175000000;2839000000;698000000;1713000000;4552000000;55000000;;10544000000;10669000000;15221000000
CTSH;128066;USD;2018;Q4;2018-12-31;2019-02-19;577000000;581000000;4511000000;3257000000;;8677000000;1394000000;80000000;5762000000;7236000000;15913000000;2482000000;9000000;2777000000;736000000;1712000000;4489000000;53000000;;11485000000;11424000000;15913000000
CROX;128143;USD;2015;Q4;2015-12-31;2016-02-29;;72067000;143341000;83616000;168192000;445949000;49490000;;112581000;162071000;608020000;162325000;4772000;167097000;1627000;19294000;186391000;353335000;-283913000;227463000;421629000;608020000
CROX;128143;USD;2014;Q4;2014-12-31;2015-03-02;;77785000;267512000;101217000;171012000;595408000;68288000;;143235000;211523000;806931000;132217000;5288000;153885000;6381000;27849000;181734000;345824000;-200424000;325470000;625197000;806931000
CROX;128143;USD;2013;Q4;2013-12-31;2014-02-25;;356089583;317144000;104405000;162341000;640077000;86971000;;148111000;235082000;875159000;170553000;5176000;186928000;11670000;63487000;250415000;321624000;-55964000;344432000;624744000;875159000
CROX;128143;USD;2012;Q4;2012-12-31;2013-02-25;;-271581332;294348000;92278000;164804000;613115000;82241000;;134282000;216523000;829638000;153494000;2039000;157938000;4596000;54300000;212238000;307914000;-44214000;334012000;617400000;829638000
CROX;128143;USD;2011;Q4;2011-12-31;2012-02-23;;359655873;257587000;84760000;129627000;525343000;67684000;;102426000;170110000;695453000;151296000;1118000;155303000;;48370000;203673000;294049000;-19759000;202669000;491780000;695453000
CROX;128143;USD;2010;Q4;2010-12-31;2011-08-03;;;145583000;64260000;121155000;381014000;70014000;;98453000;168467000;549481000;118241000;1901000;137762000;;35613000;173375000;277381000;-22008000;89881000;376106000;549481000
CROX;128143;USD;2016;Q4;2016-12-31;2017-03-01;;71715000;147565000;78297000;147029000;425475000;44090000;;96825000;140915000;566390000;146802000;2338000;149140000;40000;17966000;167106000;364491000;-284237000;195725000;399284000;566390000
CROX;128143;USD;2017;Q4;2017-12-31;2018-02-28;;67992000;172128000;83518000;130347000;425049000;35032000;;83614000;118646000;543695000;156342000;676000;157018000;;18379000;175397000;373140000;-334312000;190431000;368298000;543695000
CROX;128143;USD;2018;Q4;2018-12-31;2019-02-28;;57775000;123367000;97627000;124491000;380298000;22211000;;66392000;88603000;468901000;184491000;;184491000;120000000;134102000;318593000;481236000;-397491000;121215000;150308000;468901000
ALG;128246;USD;2016;Q4;2016-12-31;2017-03-07;11465000;11608000;16793000;170329000;135760000;327618000;97599000;;127559000;225158000;552776000;78627000;73000;78700000;70017000;86359000;165059000;100911000;-426000;334988000;387717000;552776000
ALG;128246;USD;2015;Q4;2015-12-31;2016-03-04;11384000;11498000;26922000;178305000;150758000;362886000;108514000;;132103000;240617000;603503000;84947000;77000;85024000;144006000;158010000;243034000;97917000;-426000;299057000;360469000;603503000
ALG;128246;USD;2014;Q4;2014-12-31;2015-03-06;11269000;11405000;39533000;175008000;166088000;393302000;104801000;;134783000;239584000;632886000;88795000;551000;89367000;190024000;205849000;295216000;94979000;-426000;259476000;337670000;632886000
ALG;128246;USD;2013;Q4;2013-12-31;2014-03-11;12081000;12261000;63960000;151396000;109104000;336953000;61904000;;39619000;101523000;438476000;80201000;420000;80621000;8000;7390000;88011000;92650000;-426000;255203000;350465000;438476000
ALG;128246;USD;2012;Q4;2012-12-31;2013-03-11;11936000;48195859;48291000;140268000;108758000;306800000;56801000;;40738000;97539000;404339000;77287000;588000;78128000;118000;15925000;94053000;89863000;-426000;222480000;310286000;404339000
ALG;128246;USD;2011;Q4;2011-12-31;2012-03-12;11858000;47828107;10288000;143934000;114523000;276341000;62126000;;43198000;105324000;381665000;73972000;1190000;75805000;8621000;28584000;104389000;86894000;-426000;196431000;277276000;381665000
ALG;128246;USD;2010;Q4;2010-12-31;2011-08-05;11821000;11950000;30243000;127388000;99304000;265060000;61184000;;44739000;105923000;370983000;76532000;2319000;79189000;23106000;38534000;117723000;85564000;-426000;166589000;253260000;370983000
ALG;128246;USD;2017;Q4;2017-12-31;2018-03-01;11591000;11729000;25373000;205767000;155568000;392527000;105157000;;141987000;247144000;639671000;101281000;82000;101363000;60000000;89200000;190563000;105022000;-426000;374678000;449108000;639671000
ALG;128246;USD;2018;Q4;2018-12-31;2019-03-01;11693000;11769000;34043000;228098000;176630000;452843000;131208000;;137582000;268790000;721633000;100733000;119000;100852000;85179000;113410000;214262000;109588000;-426000;443040000;507371000;721633000
RMD;129653;USD;2018;Q4;2018-06-30;2018-08-17;143196000;144628000;188701000;483681000;268701000;1065717000;386550000;;1611656000;1998206000;3063923000;438955000;11466000;511249000;269988000;493694000;1004943000;1451392000;-1600412000;2432328000;2058980000;3063923000
RMD;129653;USD;2017;Q4;2017-06-30;2017-08-04;141631000;142901000;821935000;450530000;268319000;1644003000;394241000;;1430243000;1824484000;3468487000;308208000;;360126000;1078611000;1148095000;1508221000;1379699000;-1546611000;2316237000;1960266000;3468487000
RMD;129653;USD;2016;Q4;2016-06-30;2016-08-05;140546000;142542000;731434000;382086000;224456000;1419719000;384276000;;1452710000;1836986000;3256705000;288542000;299438000;637989000;873332000;923885000;1561874000;1303801000;-1546611000;2160299000;1694831000;3256705000
RMD;129653;USD;2015;Q4;2015-06-30;2015-08-07;140905000;143050000;717249000;362568000;246859000;1407844000;387758000;;386172000;773930000;2181774000;230366000;;266463000;300594000;328004000;594467000;1229357000;-1444554000;1976020000;1587307000;2181774000
RMD;129653;USD;2014;Q4;2014-06-30;2014-08-08;140730000;143270000;905730000;359593000;165418000;1556209000;434277000;;370476000;804753000;2360962000;226453000;18000;269558000;300770000;333156000;602714000;1118205000;-1291910000;1780396000;1758248000;2360962000
RMD;129653;USD;2013;Q4;2013-06-30;2013-08-13;142658000;146253000;876048000;318349000;145847000;1448849000;411433000;;350439000;761872000;2210721000;228452000;300017000;574049000;769000;26156000;600205000;1025632000;-1083845000;1576641000;1610516000;2210721000
RMD;129653;USD;2012;Q4;2012-06-30;2012-08-14;142845000;146541000;809541000;283160000;174351000;1361151000;434363000;;342355000;776718000;2137869000;210164000;52000;252852000;250783000;277390000;530242000;900285000;-895826000;1366712000;1607627000;2137869000
RMD;129653;USD;2011;Q4;2011-06-30;2011-08-17;152739000;156819000;735267000;274352000;200777000;1292452000;462107000;;314363000;776470000;2068922000;162912000;163000;208840000;100000000;129345000;338185000;799068000;-504625000;1111862000;1730737000;2068922000
RMD;129653;USD;2010;Q4;2010-06-30;2010-11-03;302447124;312644340;488776000;226911000;185642000;985341000;387148000;;253908000;641056000;1626397000;161074000;121689000;312672000;0;26189000;338861000;660790000;-344505000;884876000;1287536000;1626397000
RMD;129653;USD;2019;Q4;2019-06-30;2019-08-08;143537000;145224000;147128000;528484000;349641000;1145366000;387460000;;2574856000;2962316000;4107682000;455332000;11992000;555991000;1258861000;1479498000;2035489000;1512048000;-1623256000;2436410000;2072193000;4107682000
SEV;129956;USD;2016;Q4;2016-09-30;2016-12-23;5182000;5035000;14127000;11499000;13666000;43588000;3843000;;21542000;25385000;68973000;15817000;;15817000;15512000;31385000;47202000;30770000;;4344000;21771000;68973000
SEV;129956;USD;2015;Q4;2015-09-30;2015-12-24;3497000;7714000;8048000;8995000;6790000;26637000;2625000;;6354000;8979000;35616000;8357000;;8357000;500000;11463000;19820000;16064000;;10607000;15796000;35616000
SEV;129956;USD;2014;Q4;2014-09-30;2014-12-23;3410000;9023000;11238000;6694000;6258000;26120000;2105000;;5742000;7847000;33967000;6248000;28000;6276000;;11229000;17505000;15630000;;9495000;16462000;33967000
SEV;129956;USD;2013;Q4;2013-09-30;2013-12-20;3058990;3082270;2062000;6746000;5723000;16750000;1969000;;4641000;6610000;23360000;6014000;46000;6060000;;10082000;16142000;6046000;;8591000;7218000;23360000
SEV;129956;USD;2012;Q4;2012-09-30;2012-12-20;6834758;6931527;2823000;5289000;6346000;16949000;2145000;;4467000;6612000;23561000;5001000;43000;5044000;;12038000;17082000;5840000;;9662000;6479000;23561000
SEV;129956;USD;2011;Q4;2011-09-30;2011-12-20;13598160;13738138;1797000;5315000;7478000;16508000;2247000;;4192000;6439000;22947000;5971000;39000;6010000;;9447000;15457000;5631000;;8467000;7490000;22947000
SEV;129956;USD;2010;Q4;2010-09-30;2011-08-10;;;803000;4678000;5048000;12538000;3094000;;4252000;7346000;19884000;5348000;84000;5432000;;8356000;13788000;5466000;;7755000;6096000;19884000
EXR;130051;USD;2015;Q4;2015-12-31;2016-02-29;123642842;130205757;75799000;;;108742000;5689309000;;273356000;5962665000;6071407000;2958451000;36000000;3074940000;623863000;623863000;3698803000;2432995000;;-337566000;2372604000;6071407000
EXR;130051;USD;2014;Q4;2014-12-31;2015-03-02;116036503;121806447;47663000;;;84686000;4135696000;;161605000;4297301000;4381987000;2041561000;138000000;2234280000;235724000;235724000;2470004000;1996647000;;-257738000;1911983000;4381987000
EXR;130051;USD;2013;Q4;2013-12-31;2014-03-03;113523830;108013163;126723000;;;155716000;3636544000;;184880000;3821424000;3977140000;180191000;1588596000;1795245000;250000000;250000000;2045245000;1974316000;;-226002000;1931895000;3977140000
EXR;130051;USD;2012;Q4;2012-12-31;2013-02-28;105817700;99732827;30785000;;;58839000;2991722000;;172916000;3164638000;3223477000;171889000;1454690000;1678146000;;0;1678146000;1741144000;;-235064000;1545331000;3223477000
EXR;130051;USD;2011;Q4;2011-12-31;2012-02-29;91405638;86843574;26484000;;;70769000;2263795000;;182960000;2446755000;2517524000;165943000;1152001000;1356100000;87663000;87663000;1443763000;1290969000;;-264086000;1073761000;2517524000
EXR;130051;USD;2010;Q4;2010-12-31;2011-02-25;87570246;92041053;46750000;;;87309000;1972402000;;190109000;2162511000;2249820000;154832000;1041870000;1223086000;87663000;87663000;1310749000;1149696000;;-262508000;939071000;2249820000
EXR;130051;USD;2009;Q4;2009-12-31;2010-08-06;86590790;90366827;131950000;;;176272000;2049859000;;181425000;2231284000;2407556000;152976000;1287256000;1461337000;;;1461337000;1139110000;;-253875000;946219000;2407556000
EXR;130051;USD;2016;Q4;2016-12-31;2017-02-27;124929284;106046823;43858000;;;74353000;6770447000;;246646000;7017093000;7091446000;3432297000;365000000;3884966000;610314000;610314000;4495280000;2567379000;;-339257000;2596166000;7091446000
EXR;130051;USD;2017;Q4;2017-12-31;2018-03-01;126875248;138176565;55683000;;;86044000;7132431000;;242478000;7374909000;7460953000;3952028000;94000000;4127054000;604276000;610092000;4737146000;2570745000;;-253284000;2723807000;7460953000
EXR;130051;USD;2018;Q4;2018-12-31;2019-02-26;126236542;132940070;57496000;;;72690000;7491831000;;283457000;7775288000;7847978000;4269602000;81000000;4454985000;562374000;607571000;5062556000;2641976000;;-262902000;2785422000;7847978000
FTNT;130256;USD;2015;Q4;2015-12-31;2016-02-26;171885000;176713000;891351000;259563000;83868000;1270543000;91067000;272959000;155941000;519967000;1790510000;164018000;;678670000;;356463000;1035133000;687829000;;68481000;755377000;1790510000
FTNT;130256;USD;2014;Q4;2014-12-31;2015-03-02;165478000;170970000;720020000;184741000;69477000;1005381000;58919000;271724000;88750000;419393000;1424774000;127527000;;496456000;;252352000;748808000;562670000;;113645000;675966000;1424774000
FTNT;130256;USD;2013;Q4;2013-12-31;2014-03-03;163305000;168201000;491370000;130471000;48672000;735546000;36652000;351675000;44591000;432918000;1168464000;119397000;;413061000;;169643000;582704000;462805000;;121863000;585760000;1168464000
FTNT;130256;USD;2012;Q4;2012-12-31;2013-02-27;160061000;166713000;413694000;107642000;21060000;569274000;25638000;325892000;54693000;406223000;975497000;72036000;;319304000;;145259000;464563000;400237000;-2995000;110601000;510934000;975497000
FTNT;130256;USD;2011;Q4;2011-12-31;2012-03-28;154484000;164504000;390273000;95522000;16249000;523570000;7966000;148414000;54797000;211177000;734747000;59936000;;266864000;;109529000;376393000;317182000;-2995000;43765000;358354000;734747000
FTNT;130256;USD;2010;Q4;2010-12-31;2011-08-04;147776000;165754000;313510000;72336000;13517000;420158000;7056000;73950000;44258000;125264000;545422000;48734000;;218382000;;94586000;312968000;251995000;-2995000;-18727000;232454000;545422000
FTNT;130256;USD;2016;Q4;2016-12-31;2017-03-01;173329000;183594000;1085525000;312998000;106887000;1538716000;137249000;224983000;238993000;601225000;2139941000;184098000;;829440000;;472820000;1302260000;800826000;;37620000;837681000;2139941000
FTNT;130256;USD;2017;Q4;2017-12-31;2018-02-26;171511000;175364000;1251300000;348200000;77300000;1716800000;245400000;98000000;197700000;541100000;2257900000;233400000;;1027200000;;641300000;1668500000;909800000;;-319600000;589400000;2257900000
FTNT;130256;USD;2018;Q4;2018-12-31;2019-02-27;170300000;175800000;1649600000;444500000;90000000;2220900000;271400000;67000000;518700000;857100000;3078000000;290500000;;1256400000;;811400000;2067800000;1068500000;;-57500000;1010200000;3078000000
BIO;130356;USD;2017;Q4;2017-12-31;2018-04-16;29767000;30167000;754978000;464847000;594804000;1976649000;493496000;1027736000;775131000;2296363000;4273012000;346755000;;502696000;434581000;840066000;1342762000;361234000;-217000;1830439000;2930250000;4273012000
BIO;130356;USD;2016;Q4;2016-12-31;2017-03-01;29554000;29818000;839440000;372348000;524961000;1844524000;488614000;830790000;686576000;2005980000;3850504000;324597000;;471322000;434186000;800022000;1271344000;332914000;-101000;1828581000;2579160000;3850504000
BIO;130356;USD;2015;Q4;2015-12-31;2016-02-29;29321000;29527000;786267000;391485000;490224000;1777596000;437690000;719840000;774592000;1932122000;3709718000;309587000;;441351000;433883000;777864000;1219215000;300411000;-101000;1808055000;2490503000;3709718000
BIO;130356;USD;2014;Q4;2014-12-31;2015-03-02;29003000;29240000;697635000;377640000;470997000;1716367000;428836000;389309000;806766000;1624911000;3341278000;317199000;;446761000;435710000;709362000;1156123000;271349000;-101000;1694962000;2185155000;3341278000
BIO;130356;USD;2013;Q4;2013-12-31;2014-03-18;28709000;29336000;608920000;422660000;516245000;1757479000;414401000;377870000;839040000;1631311000;3388790000;342723000;;487472000;435615000;714596000;1202068000;239989000;-101000;1606117000;2186722000;3388790000
BIO;130356;USD;2012;Q4;2012-12-31;2013-03-18;28397000;28760000;921073000;398739000;455120000;1936682000;416938000;293613000;796270000;1506821000;3443503000;331319000;;472400000;732414000;955563000;1427963000;212247000;-101000;1528327000;2015540000;3443503000
BIO;130356;USD;2011;Q4;2011-12-31;2012-02-29;28134000;28532000;813115000;398674000;433510000;1798155000;349501000;;949147000;1298648000;3096803000;319192000;;459115000;731698000;893306000;1352421000;185337000;;1359910000;1744382000;3096803000
BIO;130356;USD;2010;Q4;2010-12-31;2011-02-28;27812000;28304000;1025187000;387996000;398100000;1975346000;333617000;;753801000;1087418000;3062764000;319700000;;666627000;731100000;855618000;1522245000;156989000;;1181687000;1540519000;3062764000
BIO;130356;USD;2009;Q4;2009-12-31;2010-08-06;27491000;28065000;744814000;345734000;351206000;1562674000;302417000;;670762000;973179000;2535853000;308704000;;419972000;737919000;836668000;1256640000;130447000;;996197000;1279213000;2535853000
BIO;130356;USD;2018;Q4;2018-12-31;2019-04-01;29880000;30230000;844796000;392443000;583815000;2023478000;508690000;2655709000;423191000;3587590000;5611068000;322148000;;450795000;438937000;1139942000;1590737000;394345000;-49129000;3722073000;4020331000;5611068000
IMPV;131347;USD;2016;Q4;2016-12-31;2017-02-27;32685000;32685000;261092000;62571000;590000;332243000;21496000;;55080000;76576000;408819000;34052000;;138094000;;38762000;176856000;510260000;;-276819000;231963000;408819000
IMPV;131347;USD;2015;Q4;2015-12-31;2016-02-26;31339000;31339000;264807000;61051000;815000;334717000;12164000;;50788000;62952000;397669000;41412000;;120544000;;36924000;157468000;448072000;;-206540000;240201000;397669000
IMPV;131347;USD;2014;Q4;2014-12-31;2015-03-02;26219839;26219839;109720000;47446000;259000;161822000;7618000;;51205000;58823000;220645000;27501000;;83578000;;39824000;123402000;256390000;;-157658000;97243000;220645000
IMPV;131347;USD;2013;Q4;2013-12-31;2014-02-28;24670973;24670973;115085000;44446000;512000;164390000;5475000;;6626000;12101000;176491000;20839000;;61176000;;29093000;90269000;187959000;;-98695000;86222000;176491000
IMPV;131347;USD;2012;Q4;2012-12-31;2013-03-15;69315964;69315964;102327000;35576000;328000;143775000;5515000;;4667000;10182000;153957000;17370000;;50979000;;18747000;69726000;157991000;;-73517000;84231000;153957000
IMPV;131347;USD;2011;Q4;2011-12-31;2012-05-11;14694473;14694473;97612000;25736000;442000;126075000;4026000;;3441000;7467000;133542000;15433000;;37415000;;16559000;53974000;147087000;;-66130000;79568000;133542000
IMPV;131347;USD;2017;Q4;2017-12-31;2018-02-23;34142000;35634000;359531000;75535000;617000;450629000;25407000;;52026000;77433000;528062000;40199000;;166373000;;46572000;212945000;572109000;;-256537000;315117000;528062000
CTXS;131663;USD;2017;Q4;2017-12-31;2018-02-16;147501000;152980000;1747646000;712535000;13912000;2621423000;252932000;984328000;1961493000;3198753000;5820176000;378605000;;1687079000;2127474000;3140636000;4827715000;4883976000;-7390193000;3509484000;992461000;5820176000
CTXS;131663;USD;2016;Q4;2016-12-31;2017-02-16;37103878;37930421;1563018000;681206000;12522000;2561277000;261954000;980142000;2586854000;3828950000;6390227000;369294000;;1577523000;1348156000;2203977000;3781500000;4761891000;-6135197000;4010737000;2608727000;6390227000
CTXS;131663;USD;2015;Q4;2015-12-31;2016-02-18;193052878;195412526;871370000;669276000;10521000;1683951000;373817000;891964000;2517785000;3783566000;5467517000;431215000;;1680969000;1311071000;1813102000;3494071000;4567218000;-6039870000;3474625000;1973446000;5467517000
CTXS;131663;USD;2014;Q4;2014-12-31;2015-02-19;202581889;204437961;789409000;674401000;12617000;1688324000;367779000;1073110000;2382794000;3823683000;5512007000;390016000;;1590109000;1292953000;1748253000;3338362000;4293001000;-5237830000;3155264000;2173645000;5512007000
CTXS;131663;USD;2013;Q4;2013-12-31;2014-02-20;232752484;234210467;734716000;654821000;14107000;1563095000;338996000;855700000;2454458000;3649154000;5212249000;365380000;;1464061000;0;428381000;1892442000;3974588000;-3563273000;2903541000;3319807000;5212249000
CTXS;131663;USD;2012;Q4;2012-12-31;2013-02-21;235992448;236946856;928631000;630956000;10723000;1713735000;303294000;595313000;2184060000;3082667000;4796402000;377597000;;1342873000;;331752000;1674625000;3691398000;-3125934000;2564018000;3121777000;4796402000
CTXS;131663;USD;2011;Q4;2011-12-31;2012-02-23;234858460;238504048;739757000;484431000;8507000;1373030000;277429000;737844000;1711238000;2726511000;4099541000;281170000;;1179130000;;189921000;1369051000;3385336000;-2854756000;2211471000;2730490000;4099541000
CTXS;131663;USD;2010;Q4;2010-12-31;2011-02-24;236095423;241384853;893805000;378395000;6980000;1470479000;250482000;791854000;1190785000;2233121000;3703600000;355680000;;1020012000;;123000000;1143012000;3112464000;-2416645000;1855149000;2560588000;3703600000
CTXS;131663;USD;2009;Q4;2009-12-31;2010-02-24;229528845;234197909;599611000;304912000;8664000;1039295000;247703000;607646000;1196503000;2051852000;3091147000;278850000;;834364000;;68276000;902640000;2587992000;-1975509000;1578084000;2188507000;3091147000
CTXS;131663;USD;2008;Q4;2008-12-31;2009-08-07;227048640;229899306;575296000;231296000;11226000;940140000;254334000;275585000;1224247000;1754166000;2694306000;242222000;;730917000;;45524000;776441000;2305443000;-1758793000;1387067000;1917865000;2694306000
CTXS;131663;USD;2018;Q4;2018-12-31;2019-02-15;133824000;144333000;1202381000;688420000;21905000;2086901000;243396000;574319000;2231433000;3049148000;5136049000;410452000;;1755695000;1897270000;2828835000;4584530000;5404810000;-9014156000;4169019000;551519000;5136049000
OPHT;131911;USD;2016;Q4;2016-12-31;2017-02-28;35702000;35702000;289278000;;;295887000;3281000;;462000;3743000;299630000;59272000;;65918000;;328330000;394248000;504553000;;-598959000;-94618000;299630000
OPHT;131911;USD;2015;Q4;2015-12-31;2016-02-26;35031000;33946000;296592000;;;306485000;3466000;95298000;23602000;122366000;428851000;30838000;;37505000;;331399000;368904000;465959000;;-405539000;59947000;428851000
OPHT;131911;USD;2014;Q4;2014-12-31;2015-07-28;33846000;32518000;463560000;;;473332000;1555000;;4899000;6454000;479786000;16625000;;19831000;;331418000;351249000;428424000;;-299822000;128537000;479786000
OPHT;131911;USD;2013;Q4;2013-12-31;2014-03-11;31277000;31277000;210596000;;;217400000;27000;;255000;282000;217682000;6295000;;6295000;;41667000;47962000;352770000;;-183050000;169720000;217682000
OPHT;131911;USD;2012;Q4;2012-12-31;2013-11-13;5803659;5803659;4304000;;;4837000;42000;;0;42000;4879000;2404000;11040000;14410000;;-12532000;1878000;1000;;;3001000;4879000
OPHT;131911;USD;2017;Q4;2017-12-31;2018-03-05;36043000;36319000;166972000;;;171505000;518000;;3553000;4071000;175576000;12535000;;12535000;;125000000;137535000;522795000;;-484754000;38041000;175576000
OPHT;131911;USD;2018;Q4;2018-12-31;2019-02-28;39701000;39809000;131201000;;;133287000;335000;;3543000;3878000;137165000;13206000;;13206000;;0;13206000;545626000;;-421667000;123959000;137165000
SBGI;132115;USD;2016;Q4;2016-12-31;2017-02-28;90593000;91418000;259984000;513954000;;905088000;717576000;;4340504000;5058080000;5963168000;345996000;171131000;636473000;4014932000;4768759000;5405232000;844594000;;-255804000;557936000;5963168000
SBGI;132115;USD;2015;Q4;2015-12-31;2016-02-26;94572000;95399000;149972000;424608000;;701763000;717137000;;4013415000;4730552000;5432315000;251313000;164184000;535003000;3669160000;4397634000;4932637000;963673000;;-437029000;499678000;5432315000
SBGI;132115;USD;2014;Q4;2014-12-31;2015-03-02;95304000;96014000;17682000;383503000;;526165000;752538000;;4131625000;4884163000;5410328000;260848000;113116000;487317000;3754822000;4517668000;5004985000;980157000;;-545820000;405343000;5410328000
SBGI;132115;USD;2013;Q4;2013-12-31;2014-03-03;100081000;99473000;280104000;308974000;;697871000;596071000;;2853530000;3449601000;4147472000;198678000;46346000;343381000;2966402000;3398387000;3741768000;1095919000;;-696996000;405704000;4147472000
SBGI;132115;USD;2012;Q4;2012-12-31;2013-03-12;81111000;81440000;22865000;183480000;;304448000;439713000;;1985536000;2425249000;2729697000;163756000;47622000;307600000;2210866000;2522150000;2829750000;601740000;;-713697000;-100053000;2729697000
SBGI;132115;USD;2011;Q4;2011-12-31;2012-03-02;79003000;79342000;12967000;132915000;;209717000;281521000;;1080179000;1361700000;1571417000;88570000;38195000;195582000;1148271000;1487197000;1682779000;618184000;;-734511000;-111362000;1571417000
SBGI;132115;USD;2010;Q4;2010-12-31;2011-08-05;80368000;92984000;21974000;121283000;;204281000;272231000;;1009412000;1281643000;1485924000;74321000;19556000;167896000;1169740000;1475110000;1643006000;610444000;;-771953000;-157082000;1485924000
SBGI;132115;USD;2017;Q4;2017-12-31;2018-03-01;101852000;102744000;681326000;566464000;;1714747000;738298000;;4331425000;5069723000;6784470000;372906000;159382000;726349000;3875116000;4523755000;5250104000;1321316000;;248845000;1534366000;6784470000
SBGI;132115;USD;2018;Q4;2018-12-31;2019-03-01;97446000;98180000;1060330000;598597000;;1783906000;683134000;;4105052000;4788186000;6572092000;436541000;42564000;572585000;3849891000;4399187000;4971772000;1122000000;;517620000;1600320000;6572092000
LFUS;132253;USD;2016;Q4;2016-12-31;2017-02-27;22692000;22879000;278814000;176032000;114063000;612081000;217175000;13933000;648005000;879113000;1491194000;181291000;6250000;187541000;447892000;488722000;676263000;291486000;-36510000;634391000;814931000;1491194000
LFUS;132253;USD;2015;Q4;2015-12-31;2016-03-01;22388000;22567000;332965000;142882000;98629000;583929000;162568000;15197000;303781000;481546000;1065475000;124048000;87000000;211048000;83753000;115175000;326223000;259777000;-32766000;557771000;739254000;1065477000
LFUS;132253;USD;2014;Q4;2014-12-31;2015-02-24;22565000;22752000;301873000;135356000;97391000;554024000;158640000;12056000;346106000;516802000;1070826000;104198000;88500000;215542000;106658000;127619000;343161000;;;;727665000;1070826000
LFUS;132253;USD;2013;Q4;2013-12-31;2014-07-23;22441000;22658000;312078000;127887000;92591000;555136000;150173000;12286000;306778000;469237000;1024373000;82509000;126000000;208738000;93750000;128719000;337457000;223650000;-2353000;445059000;686916000;1024373000
LFUS;132253;USD;2012;Q4;2012-12-31;2013-02-27;21979000;22227000;235404000;100559000;75580000;433575000;120911000;18993000;204249000;344153000;777728000;71420000;84000000;155420000;;34750000;190170000;196023000;-60496000;435340000;587558000;777728000
LFUS;132253;USD;2011;Q4;2011-12-31;2012-02-24;21535000;21815000;178013000;92088000;75575000;366487000;118884000;14867000;178186000;311937000;678424000;64277000;85000000;149277000;;28044000;177321000;174591000;-58834000;376572000;501103000;678424000
LFUS;132253;USD;2017;Q4;2017-12-31;2018-02-23;22465000;22759000;429711000;182699000;140789000;792340000;250577000;10993000;686192000;947762000;1740102000;218544000;6250000;224794000;489361000;587752000;812546000;310241000;-41294000;722140000;927556000;1740102000
SKY;132365;USD;2017;Q4;2018-03-31;2017-08-11;-27641512;8768816;113731000;41984000;98022000;263104000;67960000;;64334000;132294000;395398000;66598000;404000;167114000;58927000;74987000;242101000;140076000;;22514000;153297000;395398000
SKY;132365;USD;2016;Q4;2017-03-31;2016-08-05;8391244;8391244;7659000;15153000;11381000;35818000;11645000;;7515000;19160000;54978000;16510000;;18031000;4312000;11814000;29845000;5322000;-65744000;85555000;25133000;54978000
SKY;132365;USD;2015;Q4;2016-03-31;2015-08-26;8391244;;4995000;15288000;9119000;31581000;11569000;;7289000;18858000;50439000;14620000;;15117000;4312000;11949000;27066000;5240000;-65744000;83877000;23373000;50439000
SKY;132365;USD;2014;Q4;2015-03-31;2014-08-22;8391244;;6031000;16259000;8627000;41670000;14042000;;10042000;24084000;65754000;15223000;;18247000;6334000;13720000;31967000;5240000;-65744000;94291000;33787000;65754000
SKY;132365;USD;2013;Q4;2014-03-31;2013-07-26;-8374461512;;16438000;13472000;8732000;41637000;18342000;;7948000;26290000;67927000;14207000;;14207000;;8069000;22276000;5240000;-65744000;106155000;45651000;67927000
SKY;132365;USD;2012;Q4;2013-03-31;2012-07-27;8391244;;29009000;11199000;8359000;51470000;21196000;;6190000;27386000;78856000;14681000;;14681000;;8011000;22692000;5240000;-65744000;116668000;56164000;78856000
SKY;132365;USD;2011;Q4;2012-03-31;2011-10-07;8391244;;44721000;11477000;8720000;68381000;24802000;;5916000;30718000;99099000;14716000;;14716000;;7344000;22060000;5240000;-65744000;137543000;77039000;99099000
SKY;132365;USD;2018;Q4;2019-03-31;2019-05-23;149719512;188289834;126634000;57649000;122638000;318290000;108587000;;273077000;381664000;699954000;76742000;;206303000;54330000;81679000;287982000;480795000;;-58208000;411972000;699954000
SHPGF;132453;USD;2016;Q4;2016-12-31;2017-02-22;905700000;928500000;528800000;2616500000;3562300000;7539500000;6469600000;191600000;52834700000;59495900000;67035400000;4312400000;3068000000;7743300000;19899800000;30344100000;38087400000;24822200000;-301900000;5925300000;28948000000;67035400000
SHPGF;132453;USD;2015;Q4;2015-12-31;2016-02-23;591100000;593100000;135500000;1201200000;635400000;2255500000;828100000;50800000;13475400000;14354300000;16609800000;2050600000;1512700000;3706100000;82100000;3074600000;6780700000;4545200000;-320600000;5788300000;9829100000;16609800000
SHPGF;132453;USD;2014;Q4;2014-12-31;2015-02-24;588500000;593500000;2982400000;1035100000;544800000;5183100000;837500000;43700000;7567800000;8449000000;13632100000;1909400000;850000000;3021900000;0;1947300000;4969200000;4396700000;-345900000;4643600000;8662900000;13632100000
SHPGF;132453;USD;2013;Q4;2013-12-31;2014-02-24;558500000;600600000;2239400000;961200000;455300000;4288300000;891800000;31800000;3111100000;4034700000;8323000000;1688400000;0;1807900000;;1149100000;2957000000;4244900000;-450600000;1461500000;5366000000;8323000000
SHPGF;132453;USD;2012;Q4;2012-12-31;2013-02-25;555200000;590400000;1482200000;824200000;436900000;3212100000;955800000;38700000;3110600000;4105100000;7317200000;1501500000;;1645600000;1100000000;1862400000;3508000000;3037200000;-310400000;995500000;3809200000;7317200000
SHPGF;132453;USD;2011;Q4;2011-12-31;2012-02-23;1654898897;599100000;620000000;845000000;340100000;2208200000;932100000;29900000;3210000000;4172000000;6380200000;1370500000;1100000000;2534300000;0;660900000;3195200000;2909000000;-287200000;502900000;3185000000;6380200000
SHPGF;132453;USD;2010;Q4;2010-12-31;2011-02-23;547300000;628400000;550600000;692500000;260000000;1880300000;853400000;101600000;2552300000;3507300000;5387600000;1239300000;0;1293300000;1100000000;1642900000;2936200000;2802100000;-276100000;-160300000;2451400000;5387600000
SHPGF;132453;USD;2009;Q4;2009-12-31;2010-02-26;;523100000;498900000;597500000;189700000;1570200000;676800000;105700000;2264800000;3047300000;4617500000;929100000;;1020000000;1143600000;1685000000;2705000000;2733200000;-347400000;-622400000;1912500000;4617500000
SHPGF;132453;USD;2008;Q4;2008-12-31;2009-08-28;;545700000;218200000;395000000;154500000;1044400000;534200000;42900000;2312200000;2889300000;3933700000;708600000;;823800000;1143100000;1782400000;2606200000;2650100000;-397200000;-1022700000;1327500000;3933700000
SHPGF;132453;USD;2017;Q4;2017-12-31;2018-02-20;908300000;911900000;472400000;3009800000;3291500000;7608400000;6635400000;241100000;53272000000;60148500000;67756900000;4184500000;2788700000;7882000000;16752400000;23698500000;31580500000;25163800000;-283000000;9920600000;36176400000;67756900000
KLAC;132518;USD;2017;Q4;2017-06-30;2017-08-04;156659000;158034000;3016740000;571117000;732988000;4392066000;283975000;;856132000;1140107000;5532173000;147380000;249983000;1293162000;2680474000;2912594000;4205756000;529283000;;848457000;1326417000;5532173000
KLAC;132518;USD;2016;Q4;2016-06-30;2016-08-05;155714000;156707000;2491294000;613233000;698635000;3868032000;278014000;;816386000;1094400000;4962432000;106517000;0;1002423000;3057936000;3270895000;4273318000;452974000;;284825000;689114000;4962432000
KLAC;132518;USD;2015;Q4;2015-06-30;2015-08-07;158688000;160113000;2387111000;585494000;617904000;3668323000;314591000;;843098000;1157689000;4826012000;103342000;16981000;1001763000;3173435000;3402810000;4404573000;474374000;;-12362000;421439000;4826012000
KLAC;132518;USD;2014;Q4;2014-06-30;2014-08-08;165511000;167543000;3152637000;492863000;656457000;4370419000;330263000;;835164000;1165427000;5535846000;103422000;0;895611000;745101000;970889000;1866500000;1220504000;;2479113000;3669346000;5535846000
KLAC;132518;USD;2013;Q4;2013-06-30;2013-08-08;165323000;168960000;2918881000;524610000;634448000;4152978000;305281000;;829098000;1134379000;5287357000;115680000;;861532000;747376000;943673000;1805205000;1159565000;;2359233000;3482152000;5287357000
KLAC;132518;USD;2012;Q4;2012-06-30;2012-08-06;167083000;171504000;2534444000;701280000;650802000;3979373000;277686000;;843249000;1120935000;5100308000;139183000;;862907000;746833000;921806000;1784713000;1089480000;;2247258000;3315595000;5100308000
KLAC;132518;USD;2011;Q4;2011-06-30;2011-08-05;167342000;170743000;2038535000;583270000;575730000;3344613000;257358000;;1073550000;1330908000;4675521000;142945000;;878861000;746290000;935767000;1814628000;1010659000;;1852633000;2860893000;4675521000
KLAC;132518;USD;2010;Q4;2010-06-30;2010-11-24;168996000;172253000;1534044000;440125000;401730000;2506943000;236752000;;1163361000;1400113000;3907056000;107938000;;771787000;745747000;888658000;1660445000;921460000;;1356454000;2246611000;3907056000
KLAC;132518;USD;2018;Q4;2018-06-30;2018-08-06;155750000;157878000;2880318000;651678000;931845000;4549000000;286306000;;784050000;1070356000;5619356000;169354000;0;1218083000;2237402000;2780762000;3998845000;617999000;;1056445000;1620511000;5619356000
KLAC;132518;USD;2019;Q4;2019-06-30;2019-08-16;160494000;161883000;1739385000;990113000;1262500000;4315075000;448799000;;4244642000;4693441000;9008516000;202416000;249999000;2470771000;3173383000;3860052000;6330823000;2017312000;;714825000;2677693000;9008516000
GUID;132676;USD;2016;Q4;2016-12-31;2017-03-01;28159000;28159000;12619000;22236000;2206000;41911000;11044000;;21461000;32505000;74416000;17363000;;61072000;;13399000;74471000;128195000;-11479000;-116771000;-55000;74416000
GUID;132676;USD;2015;Q4;2015-12-31;2016-02-25;28093000;28093000;18967000;21434000;2543000;46279000;13513000;;22498000;36011000;82290000;13219000;;54772000;;16280000;71052000;118739000;-11479000;-96022000;11238000;82290000
GUID;132676;USD;2014;Q4;2014-12-31;2015-02-24;26841000;26841000;18355000;20255000;2684000;46501000;14558000;;24768000;39326000;85827000;14326000;67000;53521000;;15122000;68643000;110290000;-11479000;-81627000;17184000;85827000
GUID;132676;USD;2013;Q4;2013-12-31;2014-02-24;102950776;102950776;19919000;19027000;1928000;45022000;18464000;;25745000;44209000;89231000;15665000;182000;53163000;;12028000;65191000;102417000;-11479000;-66898000;24040000;89231000
GUID;132676;USD;2012;Q4;2012-12-31;2013-02-21;24699;24054;32606000;23558000;2008000;61278000;10227000;;29069000;39296000;100574000;15987000;393000;53717000;;7837000;61554000;93062000;-8644000;-45398000;39020000;100574000
GUID;132676;USD;2011;Q4;2011-12-31;2012-02-16;92938356;92937210;37048000;19505000;1394000;60156000;9273000;;7899000;17172000;77328000;12669000;58000;46357000;55000;6660000;53017000;74320000;-6594000;-43415000;24311000;77328000
GUID;132676;USD;2010;Q4;2010-12-31;2011-08-04;92026856;92026856;27621000;16344000;987000;46886000;11351000;;9203000;20554000;67440000;9823000;76000;40178000;116000;4733000;44911000;68334000;-4039000;-41766000;22529000;67440000
ALB;132877;USD;2017;Q4;2017-12-31;2018-02-28;110508000;112151000;1137303000;534326000;592781000;2477563000;2493310000;534064000;2245835000;5273209000;7750772000;776975000;422012000;1200925000;1415360000;2732151000;3933076000;1865054000;;2035163000;3817696000;7750772000
ALB;132877;USD;2016;Q4;2016-12-31;2016-11-08;112488000;113563000;2269756000;486035000;450263000;3306618000;2360140000;457533000;2036916000;4854589000;8161207000;892559000;247544000;1140103000;2121718000;3078500000;4218603000;2085543000;;2121931000;3942604000;8161207000
ALB;132877;USD;2015;Q4;2015-12-31;2016-02-29;112207000;112609000;213734000;397912000;439513000;1831002000;2321095000;435584000;5010273000;7766952000;9597954000;612093000;674994000;1616685000;3142163000;4579956000;6196641000;2060273000;;1615407000;3401313000;9597954000
ALB;132877;USD;2014;Q4;2014-12-31;2015-03-02;78143000;78546000;2489768000;385212000;358361000;3348850000;1231868000;194042000;448343000;1874253000;5223103000;428790000;711096000;1139886000;2223035000;2594582000;3734468000;11227000;;1410651000;1488635000;5223103000
ALB;132877;USD;2013;Q4;2013-12-31;2014-02-25;81224000;81711000;477239000;446864000;436049000;1482915000;1357069000;212178000;532635000;2101882000;3584797000;411809000;24554000;436363000;1054310000;1405658000;1842021000;10758000;;1500358000;1742776000;3584797000
ALB;132877;USD;2012;Q4;2012-12-31;2013-02-15;89018000;89659000;477696000;378973000;428145000;1407313000;1296571000;207141000;526266000;2029978000;3437291000;372309000;12700000;385009000;686588000;1120274000;1505283000;3650000;;1744684000;1932008000;3437291000
ALB;132877;USD;2011;Q4;2011-12-31;2012-02-22;88807000;89818000;469416000;355372000;431495000;1355620000;1129480000;198427000;520297000;1848204000;3203824000;386762000;14416000;401178000;749257000;1123819000;1524997000;16082000;;1514866000;1678827000;3203824000
ALB;132877;USD;2010;Q4;2010-12-31;2011-02-25;91566000;92350000;529650000;340888000;389210000;1348198000;1006313000;180690000;532880000;1719883000;3068081000;355194000;8983000;364177000;851927000;1228158000;1592335000;19751000;;1560519000;1475746000;3068081000
ALB;132877;USD;2009;Q4;2009-12-31;2010-08-06;91605000;92319000;308791000;294192000;347506000;1032087000;1026883000;146084000;566503000;1739470000;2771557000;316954000;36310000;353264000;776403000;1164975000;1518239000;9573000;;1287983000;1253318000;2771557000
ALB;132877;USD;2018;Q4;2018-12-31;2019-02-27;106041000;107004000;555320000;605712000;700540000;1998421000;3021084000;528722000;2033447000;5583253000;7581674000;875879000;307294000;1183173000;1397916000;2639393000;3822566000;1369953000;;2566050000;3759108000;7581674000
BFAM;132997;USD;2018;Q4;2018-12-31;2019-02-27;57726263;58868993;15450000;131178000;;193891000;597141000;;1733274000;2330415000;2524306000;154195000;10750000;483785000;1036870000;1261044000;1744829000;648708000;;193124000;779477000;2524306000
BFAM;132997;USD;2017;Q4;2017-12-31;2018-02-28;58372991;59643752;23227000;117138000;;192461000;575185000;;1700998000;2276183000;2468644000;132897000;10750000;460655000;1046011000;1258929000;1719584000;747213000;;35143000;749060000;2468644000
BFAM;132997;USD;2016;Q4;2016-12-31;2017-03-01;58936702;60168028;14633000;97212000;;154399000;529432000;;1675186000;2204618000;2359017000;125400000;10750000;387580000;1054009000;1283570000;1671150000;899135000;;-121820000;687867000;2359017000
BFAM;132997;USD;2015;Q4;2015-12-31;2016-02-29;60005507;61548783;11539000;97295000;;152713000;429736000;;1568092000;1997828000;2150541000;114776000;9550000;305343000;905661000;1117590000;1422933000;983458000;;-216580000;727608000;2150541000
BFAM;132997;USD;2014;Q4;2014-12-31;2015-03-02;65182555;66674773;87886000;83066000;;223158000;398947000;;1518971000;1917918000;2141076000;116425000;9550000;279423000;911627000;1110694000;1390117000;1083153000;;-310507000;750959000;2141076000
BFAM;132997;USD;2013;Q4;2013-12-31;2014-03-25;65190234;68771713;29585000;78691000;;165170000;390894000;;1546606000;1937500000;2102670000;107626000;7900000;255088000;756323000;958445000;1213533000;1270263000;;-382542000;889137000;2102670000
BFAM;132997;USD;2012;Q4;2012-12-31;2013-05-10;-12866560;6062664;34109000;62714000;;136017000;340376000;;1439715000;1780091000;1916108000;97207000;2036000;201893000;904607000;1959976000;2161869000;150094000;;-395165000;-245761000;1916108000
PG;133209;USD;2017;Q4;2017-06-30;2017-08-07;2557800000;2695600000;15137000000;4594000000;4624000000;26494000000;19893000000;;74019000000;93912000000;120406000000;16656000000;13554000000;30210000000;18038000000;34418000000;64628000000;66401000000;-93715000000;96124000000;55778000000;120406000000
PG;133209;USD;2016;Q4;2016-06-30;2016-08-09;2667900000;2810500000;13348000000;4373000000;4716000000;33782000000;19385000000;;73969000000;93354000000;127136000000;16774000000;11653000000;30770000000;18945000000;38383000000;69153000000;66433000000;-82176000000;87953000000;57983000000;127136000000
PG;133209;USD;2015;Q4;2015-06-30;2015-08-07;2718800000;2878700000;11603000000;4568000000;4979000000;29646000000;19655000000;;80194000000;99849000000;129495000000;16229000000;12018000000;29790000000;18327000000;36655000000;66445000000;66541000000;-77226000000;84807000000;63050000000;129495000000
PG;133209;USD;2014;Q4;2014-06-30;2014-08-08;2711700000;2891900000;10686000000;6386000000;6759000000;31617000000;22304000000;;90345000000;112649000000;144266000000;17460000000;15606000000;33726000000;19811000000;40564000000;74290000000;66580000000;-75805000000;84990000000;69976000000;144266000000
PG;133209;USD;2013;Q4;2013-06-30;2013-08-08;;2940900000;5947000000;6508000000;6909000000;23990000000;21666000000;;93607000000;115273000000;139263000000;17605000000;12432000000;30037000000;19111000000;40517000000;70554000000;66195000000;-71966000000;80197000000;68709000000;139263000000
PG;133209;USD;2012;Q4;2012-06-30;2012-08-08;;2931500000;4436000000;6068000000;6721000000;21910000000;20377000000;;89957000000;110334000000;132244000000;16209000000;8698000000;24907000000;21080000000;43302000000;68209000000;65832000000;-69604000000;75349000000;64035000000;132244000000
PG;133209;USD;2011;Q4;2011-06-30;2011-08-10;;2982500000;2768000000;6275000000;7379000000;21970000000;21293000000;;95091000000;116384000000;138354000000;17312000000;9981000000;27293000000;22033000000;43060000000;70353000000;65056000000;-67278000000;70682000000;68001000000;138354000000
PG;133209;USD;2010;Q4;2010-06-30;2010-08-13;;3065200000;2879000000;5335000000;6384000000;18782000000;19244000000;;90146000000;109390000000;128172000000;15810000000;8472000000;24282000000;21360000000;42451000000;66733000000;64355000000;-61309000000;64614000000;61439000000;128172000000
PG;133209;USD;2009;Q4;2009-06-30;2009-10-29;;3101500000;4781000000;5836000000;6880000000;21905000000;19462000000;;93466000000;112928000000;134833000000;14581000000;16320000000;30901000000;20652000000;40550000000;71451000000;63785000000;-55961000000;57309000000;63382000000;134833000000
PG;133209;USD;2018;Q4;2018-06-30;2018-08-07;2510100000;2621000000;11850000000;4686000000;4738000000;23320000000;20600000000;;74390000000;94990000000;118310000000;17814000000;10423000000;28237000000;20863000000;37190000000;65427000000;66651000000;-99217000000;98641000000;52883000000;118310000000
H;133448;USD;2017;Q4;2017-12-31;2018-02-15;120085787;122177628;552000000;350000000;14000000;1327000000;4034000000;212000000;1999000000;6245000000;7572000000;633000000;11000000;992000000;1440000000;2727000000;3719000000;968000000;;3054000000;3853000000;7572000000
H;133448;USD;2016;Q4;2016-12-31;2017-02-16;130684900;131872329;538000000;304000000;28000000;1139000000;4270000000;186000000;2154000000;6610000000;7749000000;805000000;119000000;924000000;1445000000;2917000000;3841000000;1687000000;;2493000000;3908000000;7749000000
H;133448;USD;2015;Q4;2015-12-31;2016-02-18;137824018;138846955;503000000;298000000;12000000;1124000000;4031000000;327000000;2109000000;6467000000;7591000000;779000000;328000000;1107000000;1042000000;2489000000;3596000000;1932000000;;2289000000;3995000000;7591000000
H;133448;USD;2014;Q4;2014-12-31;2015-02-18;150021056;151820929;815000000;274000000;17000000;1709000000;4186000000;334000000;1914000000;6434000000;8143000000;718000000;9000000;730000000;1381000000;2782000000;3512000000;2623000000;-1000000;2165000000;4631000000;8143000000
H;133448;USD;2013;Q4;2013-12-31;2014-02-18;156091761;157107868;484000000;273000000;77000000;1163000000;4671000000;329000000;2014000000;7014000000;8177000000;677000000;194000000;871000000;1289000000;2529000000;3400000000;3017000000;-1000000;1821000000;4777000000;8177000000
H;133448;USD;2012;Q4;2012-12-31;2013-02-13;163204140;163768412;927000000;531000000;80000000;1758000000;4139000000;283000000;1450000000;5872000000;7630000000;613000000;4000000;618000000;1229000000;2191000000;2809000000;3265000000;-1000000;1614000000;4821000000;7630000000
H;133448;USD;2011;Q4;2011-12-31;2012-02-16;165412235;166675637;1122000000;225000000;87000000;1591000000;4043000000;280000000;1593000000;5916000000;7507000000;564000000;4000000;568000000;1221000000;2111000000;2679000000;3382000000;-1000000;1517000000;4828000000;7507000000
H;133448;USD;2010;Q4;2010-12-31;2011-05-20;174228695;174924411;1634000000;199000000;100000000;2165000000;3453000000;245000000;1380000000;5078000000;7243000000;539000000;57000000;596000000;714000000;1516000000;2112000000;3753000000;-1000000;1404000000;5131000000;7243000000
MO;133574;USD;2018;Q4;2018-12-31;2019-02-26;1875000000;1879000000;1333000000;142000000;2331000000;4299000000;1938000000;30496000000;18905000000;51339000000;55638000000;2488000000;13848000000;21193000000;11898000000;19617000000;40810000000;6896000000;-33524000000;43962000000;14828000000;55638000000
MO;133574;USD;2017;Q4;2017-12-31;2018-02-27;1902000000;1902000000;1253000000;142000000;2225000000;4344000000;1914000000;17952000000;18992000000;38858000000;43202000000;2327000000;864000000;6792000000;13030000000;20992000000;27784000000;6887000000;-31864000000;42251000000;15418000000;43202000000
MO;133574;USD;2016;Q4;2016-12-31;2017-02-27;1946000000;1946000000;4569000000;151000000;2051000000;7260000000;1958000000;17852000000;18862000000;38672000000;45932000000;2360000000;0;7375000000;13881000000;25746000000;33121000000;6828000000;-28912000000;36906000000;12811000000;45932000000
MO;133574;USD;2015;Q4;2015-12-31;2016-02-25;1958000000;1958000000;2369000000;124000000;2031000000;4911000000;1982000000;5483000000;19083000000;26548000000;31459000000;2205000000;4000000;7070000000;12843000000;21479000000;28549000000;6748000000;-27845000000;27257000000;2910000000;31459000000
MO;133574;USD;2014;Q4;2014-12-31;2015-02-25;1970000000;1970000000;3321000000;124000000;2040000000;6878000000;1983000000;6183000000;19431000000;27597000000;34475000000;2062000000;1000000000;7673000000;13693000000;23757000000;31430000000;6670000000;-27251000000;26277000000;3045000000;34475000000
MO;133574;USD;2013;Q4;2013-12-31;2014-02-26;1993000000;1993000000;3175000000;115000000;1879000000;6590000000;2028000000;6455000000;19786000000;28269000000;34859000000;1880000000;525000000;7058000000;13992000000;23648000000;30706000000;6649000000;-26320000000;25168000000;4153000000;34859000000
MO;133574;USD;2012;Q4;2012-12-31;2013-02-27;2011000000;2011000000;2900000000;193000000;1746000000;6315000000;2102000000;6637000000;20275000000;29014000000;35329000000;1907000000;1459000000;8259000000;12419000000;23866000000;32125000000;6623000000;-25731000000;24316000000;3204000000;35329000000
MO;133574;USD;2011;Q4;2011-12-31;2012-02-16;2042000000;2042000000;3270000000;268000000;1779000000;6920000000;2216000000;5509000000;22106000000;29831000000;36751000000;1774000000;600000000;7432000000;13089000000;25604000000;33036000000;6609000000;-24625000000;23583000000;3715000000;36751000000
MO;133574;USD;2010;Q4;2010-12-31;2011-02-25;2080000000;2080000000;2314000000;85000000;1803000000;5981000000;2380000000;5367000000;23674000000;31421000000;37402000000;2004000000;;6840000000;12194000000;25335000000;32175000000;6686000000;-23469000000;23459000000;5227000000;37402000000
MO;133574;USD;2009;Q4;2009-12-31;2010-02-24;2072000000;2074000000;1871000000;96000000;1810000000;5773000000;2684000000;4980000000;23240000000;30904000000;36677000000;1989000000;775000000;7992000000;11185000000;24581000000;32573000000;6932000000;-23901000000;22599000000;4104000000;36677000000
MO;133574;USD;2008;Q4;2008-12-31;2009-08-04;;;7916000000;44000000;1069000000;11076000000;2199000000;4261000000;9679000000;16139000000;27215000000;1647000000;135000000;7142000000;7339000000;17245000000;24387000000;7285000000;-24407000000;22131000000;2828000000;27215000000
SRNE;133865;USD;2015;Q4;2015-12-31;2016-03-15;37787000;37787000;136404000;903000;;141018000;7246000;170127000;25128000;202501000;343519000;7627000;4835000;141773000;4394000;60808000;202581000;184902000;0;-113329000;140938000;343519000
SRNE;133865;USD;2014;Q4;2014-12-31;2015-03-16;29791000;29791000;71902000;732000;;73915000;2277000;10000000;55349000;67626000;141541000;4348000;3316000;10581000;8830000;22247000;32828000;176231000;;-67518000;108713000;141541000
SRNE;133865;USD;2013;Q4;2013-12-31;2014-04-01;20294000;20294000;31667000;394000;;32632000;2440000;0;57510000;59950000;92582000;4202000;374000;5480000;4431000;20293000;25773000;99670000;;-32861000;66809000;92582000
SRNE;133865;USD;2012;Q4;2012-12-31;2013-03-25;-33578804;-33578804;5091312;79760;;5251990;1480989;;48625;1529614;6781604;584173;;584173;;0;584173;17147730;;-10950299;6197431;6781604
SRNE;133865;USD;2011;Q4;2011-12-31;2012-03-30;;;3466549;61238;;3557656;988445;;22727;1011172;4568828;359339;;359339;;0;359339;10314480;;-6104991;4209489;4568828
SRNE;133865;USD;2010;Q4;2010-12-31;2011-08-12;;;5277578;246045;;5553434;95927;;38420;134347;5687781;403957;;603957;;0;603957;7952324;;-2868500;5083824;5687781
TA;133962;USD;2017;Q4;2017-12-31;2018-02-28;7544600;7544600;35526000;125501000;186867000;398518000;613196000;;606418000;1219614000;1618132000;155581000;;324987000;319634000;726650000;1051637000;690688000;;-126220000;566495000;1618132000
TA;133962;USD;2016;Q4;2016-12-31;2017-02-28;7427800;7427800;61312000;107246000;204145000;402061000;1082022000;;175758000;1257780000;1659841000;157964000;;330332000;318739000;776430000;1106762000;686348000;;-134678000;553079000;1659841000
TA;133962;USD;2015;Q4;2015-12-31;2016-03-14;7327426;7327426;172087000;91580000;183492000;495340000;989606000;;136595000;1126201000;1621541000;125079000;;295622000;316447000;776600000;1072222000;682219000;;-132660000;549319000;1621541000
NE;134105;USD;2015;Q4;2015-12-31;2016-02-25;241963000;241963000;512245000;498931000;;1240618000;11483623000;;141404000;11625027000;12865645000;465586000;299924000;863584000;4162638000;4579831000;5443415000;630903000;;6131501000;7422230000;12865645000
NE;134105;USD;2014;Q4;2014-12-31;2015-02-27;249616000;249277000;68510000;569096000;;928562000;12112509000;;245751000;12358260000;13286822000;524103000;;668674000;4869020000;5331114000;5999788000;698113000;;5936035000;7287034000;13286822000
NE;134105;USD;2013;Q4;2013-12-31;2014-02-28;216984488;217191896;114458000;949069000;;1390935000;14558090000;;268932000;14827022000;16217957000;751743000;;1051915000;5556251000;6116014000;7167929000;812820000;;7591927000;9050028000;16217957000
NE;134105;USD;2012;Q4;2012-12-31;2013-02-25;143714840;143804936;282092000;743673000;;1305325000;13025972000;;276477000;13302449000;14607774000;684501000;;911449000;4634375000;5208035000;6119484000;793661000;-21069000;7066023000;8488290000;14607774000
NE;134105;USD;2011;Q4;2011-12-31;2012-02-27;287883024;288354352;239196000;587163000;;1059612000;12130345000;;305202000;12435547000;13495159000;703252000;;827180000;4071964000;4570127000;5397307000;814951000;-10553000;6676444000;8097852000;13495159000
NE;134105;USD;2010;Q4;2010-12-31;2011-02-25;286724152;287504360;337871000;387414000;;911794000;10048087000;;342506000;10390593000;11302387000;637185000;80213000;801447000;2686484000;3213306000;4014753000;956690000;-373967000;6630500000;7287634000;11302387000
NE;134105;USD;2009;Q4;2009-12-31;2010-08-09;293424560;294671520;735493000;647454000;;1483190000;6634452000;;279254000;6913706000;8396896000;377985000;0;433947000;750946000;1174517000;1608464000;1130607000;-143031000;5855737000;6788432000;8396896000
NE;134105;USD;2016;Q4;2016-12-31;2017-02-24;243241000;243241000;725722000;319152000;;1192614000;10061948000;;185555000;10247503000;11440117000;264467000;299882000;633293000;4040229000;4339379000;4972672000;656600000;;5154221000;6467445000;11440117000
NE;134105;USD;2017;Q4;2017-12-31;2018-02-23;244982000;244982000;662829000;204696000;;1038975000;9489240000;;266444000;9755684000;10794659000;271516000;249843000;593024000;3795867000;4251007000;4844031000;681372000;;4637677000;5950628000;10794659000
NE;134105;USD;2018;Q4;2018-12-31;2019-02-22;246761000;246761000;375232000;200722000;;659056000;8480718000;;125149000;8605867000;9264923000;305327000;0;365457000;3877402000;4244892000;4610349000;701877000;;3608366000;4654574000;9264923000
SXT;134902;USD;2016;Q4;2016-12-31;2017-02-23;44280000;44753000;25865000;194509000;404320000;717061000;476523000;;474276000;950799000;1667860000;187784000;20578000;213675000;582780000;618444000;832119000;113082000;-442799000;1378923000;835741000;1667860000
SXT;134902;USD;2015;Q4;2015-12-31;2016-02-25;44902000;45169000;11997000;232047000;409159000;728905000;469678000;;505149000;974827000;1703732000;188177000;20655000;212922000;613502000;645683000;858605000;115370000;-402483000;1302302000;845127000;1703732000
SXT;134902;USD;2014;Q4;2014-12-31;2015-02-26;47680000;48014000;20329000;228907000;449409000;737654000;495567000;;531985000;1027552000;1765206000;209017000;15888000;224905000;451011000;493366000;718271000;116365000;-227929000;1243627000;1046935000;1765206000
SXT;134902;USD;2013;Q4;2013-12-31;2014-02-28;49797000;50006000;19836000;233751000;474452000;766118000;565308000;;539308000;1104616000;1870734000;215843000;7050000;222893000;348124000;405157000;628050000;110515000;-91707000;1217874000;1242684000;1870734000
SXT;134902;USD;2012;Q4;2012-12-31;2013-02-27;49516000;49716000;15062000;237626000;442714000;737201000;514708000;;524734000;1039442000;1776643000;184188000;20048000;204236000;333979000;418509000;622745000;103649000;-95258000;1150092000;1153898000;1776643000
SXT;134902;USD;2011;Q4;2011-12-31;2012-02-27;99521247;99913053;22855000;219494000;414449000;692097000;451539000;;510528000;962067000;1654164000;184301000;22974000;207275000;312422000;397679000;604954000;99583000;-80935000;1069610000;1049210000;1654164000
SXT;134902;USD;2010;Q4;2010-12-31;2011-02-25;49403000;49645000;14255000;218614000;392166000;659711000;432536000;;507021000;939557000;1599268000;179613000;25450000;205063000;324360000;410420000;615483000;94423000;-87102000;991094000;983785000;1599268000
SXT;134902;USD;2009;Q4;2009-12-31;2010-08-06;48619000;48905000;12219000;200186000;390011000;645084000;425617000;;520990000;946607000;1591691000;176964000;39181000;216145000;388852000;466851000;682996000;90900000;-103878000;922963000;908695000;1591691000
SXT;134902;USD;2017;Q4;2017-12-31;2018-02-23;43271000;43491000;29344000;195439000;463517000;733475000;498523000;;492342000;990865000;1724340000;196193000;20130000;216323000;604159000;655716000;872039000;112572000;-525422000;1414485000;852301000;1724340000
SXT;134902;USD;2018;Q4;2018-12-31;2019-02-22;42216000;42278000;31901000;255350000;490757000;822865000;491056000;;511019000;1002075000;1824940000;194654000;20046000;214700000;689553000;750293000;964993000;107059000;-597800000;1516243000;859947000;1824940000
MMI;134979;USD;2015;Q4;2015-12-31;2016-03-15;38603000;39279000;176045000;;;196114000;11579000;54395000;59137000;125111000;321225000;74072000;939000;75011000;9671000;57220000;132231000;80595000;;107942000;188994000;321225000
MMI;134979;USD;2014;Q4;2014-12-31;2015-03-09;38863000;39068000;149159000;;;164873000;7693000;14752000;46286000;68731000;233604000;66310000;894000;67204000;10610000;49587000;116791000;75062000;;41592000;116813000;233604000
MMI;134979;USD;2013;Q4;2013-12-31;2014-03-21;;;100952000;;;119831000;8560000;;38918000;47478000;167309000;55909000;851000;56760000;11504000;48039000;104799000;70449000;;-7939000;62510000;167309000
MMI;134979;USD;2012;Q4;2012-12-31;2013-11-22;;;3107000;;;12581000;6688000;;70464000;77152000;89733000;54453000;;54453000;;13500000;67953000;24952000;;-3182000;21780000;89733000
MMI;134979;USD;2016;Q4;2016-12-31;2017-03-16;38848000;39008000;214825000;;;234012000;16355000;77475000;66174000;160004000;394016000;77190000;986000;78176000;8686000;56982000;135158000;85449000;;172599000;258858000;394016000
MMI;134979;USD;2017;Q4;2017-12-31;2018-03-16;38969000;38956000;294346000;;;320430000;17153000;52099000;69982000;139234000;459664000;82224000;1035000;83259000;7651000;61513000;144772000;89881000;;224071000;314892000;459664000
MMI;134979;USD;2018;Q4;2018-12-31;2019-03-01;39156000;39413000;352119000;;;409683000;19550000;83209000;53938000;156697000;566380000;43859000;1087000;44946000;6564000;111856000;156802000;97462000;;311341000;409578000;566380000
BMRN;135371;USD;2017;Q4;2017-12-31;2018-02-26;175521000;175521000;1395968000;261365000;475775000;2207144000;896700000;385785000;1143496000;2425981000;4633125000;401921000;360949000;816518000;813521000;1007944000;1824462000;4469172000;;-1637548000;2808663000;4633125000
BMRN;135371;USD;2016;Q4;2016-12-31;2017-02-27;172091000;173027000;789677000;215280000;355126000;1421791000;798768000;572711000;1230420000;2601899000;4023690000;370505000;22478000;439310000;660761000;818105000;1257415000;4273965000;;-1520506000;2766275000;4023690000
BMRN;135371;USD;2015;Q4;2015-12-31;2016-02-29;161196000;160948000;592619000;164959000;271683000;1089639000;704207000;425652000;1509870000;2639729000;3729368000;392511000;0;445457000;662286000;883064000;1328521000;3401383000;;-1021569000;2400847000;3729368000
BMRN;135371;USD;2014;Q4;2014-12-31;2015-03-02;148277000;135584000;945192000;144472000;199452000;1397640000;523516000;97856000;456367000;1077739000;2475379000;231844000;;235739000;642902000;711746000;947485000;2350198000;;-849770000;1527894000;2475379000
BMRN;135371;USD;2013;Q4;2013-12-31;2014-02-26;142855000;142659000;784723000;117822000;162605000;1137418000;319316000;267700000;519626000;1106642000;2244060000;183271000;;183271000;655566000;719748000;903019000;2051824000;;-715801000;1341041000;2244060000
BMRN;135371;USD;2012;Q4;2012-12-31;2013-02-26;124668000;124668000;447805000;109066000;128695000;743431000;284473000;115993000;424450000;824916000;1568347000;147068000;23365000;170433000;324859000;382151000;552584000;1555413000;;-539448000;1015763000;1568347000
BMRN;135371;USD;2011;Q4;2011-12-31;2012-02-22;114432000;114341000;195092000;104839000;130118000;469802000;268971000;94385000;472551000;835907000;1305709000;94125000;0;94125000;348329000;438536000;532661000;1193262000;;-425101000;773048000;1305709000
BMRN;135371;USD;2010;Q4;2010-12-31;2011-02-24;107406000;165864000;274112000;86576000;109698000;504260000;221866000;128171000;408326000;758363000;1262623000;83844000;;83844000;377521000;461522000;545366000;1088334000;;-371265000;717257000;1262623000
BMRN;135371;USD;2009;Q4;2009-12-31;2010-08-04;100790000;100790000;300677000;73540000;78662000;467727000;199141000;169849000;80446000;449436000;917163000;78068000;;78154000;497083000;516824000;594978000;898336000;;-577084000;322185000;917163000
BMRN;135371;USD;2018;Q4;2018-12-31;2019-02-28;177958000;178568000;1084308000;342633000;530871000;2056215000;948682000;235864000;1186367000;2370913000;4427128000;437290000;;523241000;830417000;935947000;1459188000;4656803000;;-1694134000;2967940000;4427128000
VSTM;135964;USD;2015;Q4;2015-12-31;2016-03-03;36985000;36985000;110258000;;;110843000;2048000;;203000;2251000;113094000;10040000;;10109000;;516000;10625000;301309000;;-198883000;102469000;113094000
VSTM;135964;USD;2014;Q4;2014-12-31;2015-03-10;26258000;26258000;92675000;;;95316000;2825000;;508000;3333000;98649000;8735000;;9204000;;679000;9883000;229773000;;-141018000;88766000;98649000
VSTM;135964;USD;2013;Q4;2013-12-31;2014-03-06;25381000;25381000;101312000;;;101955000;631000;22344000;331000;23306000;125261000;7087000;;7804000;;11000;7815000;205071000;;-87653000;117446000;125261000
VSTM;135964;USD;2012;Q4;2012-12-31;2013-03-26;20344000;20344000;56576000;;;57082000;811000;34944000;86000;35841000;92923000;2399000;;2399000;;58000;2457000;136895000;;-46451000;90466000;92923000
VSTM;135964;USD;2011;Q4;2011-12-31;2012-05-14;1505000;1505000;47811000;;;47941000;709000;8994000;1393000;11096000;59037000;3146000;;3146000;;68657000;71803000;1703000;;-14467000;-12766000;59037000
VSTM;135964;USD;2016;Q4;2016-12-31;2017-03-23;36993000;36993000;80897000;;;81295000;1417000;;917000;2334000;83629000;10991000;;10991000;;341000;11332000;307591000;;-235323000;72297000;83629000
VSTM;135964;USD;2017;Q4;2017-12-31;2018-03-13;42074000;42074000;86672000;;;87787000;861000;;1143000;2004000;89791000;17128000;;17128000;14828000;14979000;32107000;360828000;;-303142000;57684000;89791000
VSTM;135964;USD;2018;Q4;2018-12-31;2019-03-12;74113000;91549000;249653000;306000;327000;253259000;1369000;;22608000;23977000;277236000;31361000;5716000;37077000;114737000;115860000;152937000;499748000;;-375576000;124299000;277236000
ON;136025;USD;2016;Q4;2016-12-31;2017-02-28;417500000;427100000;1028100000;629800000;1030200000;2869100000;2159100000;;1896200000;4055300000;6924400000;839000000;553800000;1502600000;3068500000;3576800000;5079400000;3478700000;-1078000000;-527300000;1845000000;6924400000
ON;136025;USD;2015;Q4;2015-12-31;2016-02-24;412800000;417500000;617600000;426400000;750400000;1891500000;1274100000;;704000000;1978100000;3869600000;583900000;543400000;1239300000;850500000;998400000;2237700000;3425600000;-1065700000;-709400000;1631900000;3869600000
ON;136025;USD;2014;Q4;2014-12-31;2015-02-27;435800000;440100000;517800000;417500000;729900000;1805800000;1203900000;;812400000;2016300000;3822100000;666100000;209600000;1040800000;982100000;1133900000;2174700000;3286400000;-702800000;-915600000;1647400000;3822100000
ON;136025;USD;2013;Q4;2013-12-31;2014-02-21;442100000;444900000;625700000;383400000;608800000;1707200000;1074200000;;512400000;1586600000;3293800000;497100000;181600000;819200000;760600000;951000000;1770200000;3216000000;-572500000;-1105300000;1523600000;3293800000
ON;136025;USD;2012;Q4;2012-12-31;2013-02-26;-134349600000;-135619600000;631700000;357800000;581700000;1693400000;1103300000;;531700000;1635000000;3328400000;536200000;353600000;1024300000;658300000;913400000;1937700000;3161500000;-466400000;-1292900000;1390700000;3328400000
ON;136025;USD;2011;Q4;2011-12-31;2012-02-22;45040000000;46250000000;901500000;457200000;637400000;2127700000;1109500000;;646300000;1755800000;3883500000;699800000;370100000;1275500000;836900000;1114500000;2390000000;3118500000;-401300000;-1202300000;1493500000;3883500000
ON;136025;USD;2010;Q4;2010-12-31;2011-02-24;43400000000;45730000000;623300000;294600000;360800000;1358000000;864300000;;696900000;1561200000;2919200000;425400000;136000000;710900000;752800000;820300000;1531200000;3021000000;-382000000;-1213900000;1388000000;2919200000
ON;136025;USD;2009;Q4;2009-12-31;2010-08-05;42560000000;47080000000;571200000;260900000;269900000;1168600000;705500000;;540200000;1245700000;2414300000;314300000;205900000;619000000;727600000;790700000;1409700000;2921300000;-367000000;-1504400000;1004600000;2414300000
ON;136025;USD;2017;Q4;2017-12-31;2018-02-21;424800000;434000000;949200000;701500000;1089500000;2933200000;2279100000;;1982800000;4261900000;7195100000;1160800000;248100000;1408900000;2703700000;2985200000;4394100000;3599000000;-1131100000;351500000;2801000000;7195100000
ON;136025;USD;2018;Q4;2018-12-31;2019-02-20;416800000;419800000;1069600000;686000000;1225200000;3167800000;2549600000;;1870200000;4419800000;7587600000;1330800000;138500000;1469300000;2627600000;2924200000;4393500000;3707900000;-1478000000;979600000;3194100000;7587600000
BID;136608;USD;2017;Q4;2017-12-31;2018-03-01;52472000;53802000;544432000;795239000;74483000;1902089000;352035000;;833183000;1185218000;3087307000;192735000;308932000;1516626000;849503000;953741000;2470367000;454073000;-554551000;779699000;616940000;3087307000
BID;136608;USD;2016;Q4;2016-12-31;2017-02-27;52957000;54865000;496031000;433614000;159043000;1268853000;347182000;;888391000;1235573000;2504426000;181294000;6629000;742975000;1163941000;1255849000;1998824000;445314000;-509885000;660347000;505602000;2504426000
BID;136608;USD;2015;Q4;2015-12-31;2016-02-26;66116000;67441000;848697000;875265000;215020000;2109739000;354494000;;799080000;1153574000;3263313000;203144000;6292000;1196573000;1146461000;1260036000;2456609000;436396000;-150000000;586235000;806704000;3263313000
BID;136608;USD;2014;Q4;2014-12-31;2015-03-02;68993000;70800000;693829000;913743000;217132000;2039522000;364382000;10210000;720706000;1095298000;3134820000;214023000;218728000;1429207000;745000000;827375000;2256582000;409569000;-25000000;569894000;878238000;3134820000
BID;136608;USD;2013;Q4;2013-12-31;2014-02-27;68878000;71499000;721315000;812582000;192140000;1972273000;379399000;11040000;530834000;921273000;2893546000;202749000;3630000;1142489000;515148000;611392000;1753881000;388168000;0;790603000;1139665000;2893546000
BID;136608;USD;2012;Q4;2012-12-31;2013-02-28;67783000;70464000;768347000;597487000;92187000;1671123000;375031000;15136000;513805000;903972000;2575095000;176686000;181250000;964879000;515197000;617390000;1582269000;368850000;;674351000;992826000;2575095000
BID;136608;USD;2011;Q4;2011-12-31;2012-02-29;67345000;69492000;890633000;553502000;113606000;1693296000;370721000;14942000;320455000;706118000;2399414000;180327000;2976000;964312000;464552000;531435000;1495747000;356303000;;601282000;903667000;2399414000
BID;136608;USD;2010;Q4;2010-12-31;2011-02-28;66563000;69875000;483663000;681800000;126534000;1450404000;372692000;15154000;340378000;728224000;2178628000;192426000;;877384000;472862000;529736000;1407120000;345739000;;444717000;771508000;2178628000
BID;136608;USD;2009;Q4;2009-12-31;2010-08-05;65376000;65376000;321579000;373717000;142565000;968367000;370224000;17121000;230411000;617756000;1586123000;85741000;;442475000;512939000;566663000;1009138000;317753000;;297579000;576985000;1586123000
BID;136608;USD;2018;Q4;2018-12-31;2019-02-28;48317000;49511000;178579000;978140000;43635000;1351008000;386736000;;951344000;1338080000;2689088000;224754000;13604000;1248789000;918786000;998805000;2247594000;464334000;-839284000;888333000;441494000;2689088000
ASH;136913;USD;2014;Q4;2014-09-30;2014-11-24;153300000;157388000;1393000000;1202000000;765000000;3561000000;2414000000;81000000;4864000000;7359000000;10920000000;1349000000;338000000;1687000000;2911000000;5650000000;7337000000;1000000;;3475000000;3583000000;10920000000
ASH;136913;USD;2013;Q4;2013-09-30;2013-11-27;153300000;163520000;346000000;1113000000;758000000;2873000000;2507000000;213000000;6495000000;9215000000;12088000000;1213000000;320000000;1727000000;2947000000;5808000000;7535000000;507000000;;3758000000;4553000000;12088000000
SQBG;137237;USD;2016;Q4;2016-12-31;2017-03-14;62200358;61310301;26806000;53195000;;85888000;7674000;;1341301000;1348975000;1434863000;18915000;28300000;57589000;625440000;839706000;897295000;503188000;-638000;-39651000;537568000;1434863000
SQBG;137237;USD;2015;Q4;2015-12-31;2016-03-14;46565975;42094322;47171000;42026000;;94586000;6547000;;1188704000;1195251000;1289837000;23722000;19000000;44879000;533751000;719309000;764188000;496784000;0;-38830000;525649000;1289837000
SQBG;137237;USD;2014;Q4;2014-12-31;2016-03-14;;;22521000;15720000;;44084000;2255000;;480024000;482279000;526363000;6691000;13253000;20574000;163133000;240889000;261463000;295758000;-1643000;-35959000;264900000;526363000
SQBG;137237;USD;2017;Q4;2017-12-31;2018-03-16;63062752;63007809;18902000;60102000;;89170000;7035000;;1001006000;1008041000;1097211000;19126000;28300000;55528000;608501000;688145000;743673000;509079000;-1799000;-225369000;353538000;1097211000
SQBG;137237;USD;2018;Q4;2018-12-31;2019-03-14;64073425;63626733;14106000;49600000;;93564000;8391000;;976713000;985104000;1078668000;11600000;28300000;63522000;591647000;670502000;734024000;514421000;-4226000;-234723000;344644000;1078668000
RESI;137841;USD;2017;Q4;2017-12-31;2018-03-01;53444833;53444833;113666000;31032000;;268238000;1693553000;;12758000;1706311000;1974549000;55639000;1270157000;1329947000;;0;1329947000;1181861000;;-537259000;644602000;1974549000
RESI;137841;USD;2016;Q4;2016-12-31;2017-03-01;53789446;53789446;106276000;495375000;;865961000;1408720000;;10166000;1418886000;2284847000;51442000;1365071000;1421779000;;0;1421779000;1182782000;;-319714000;863068000;2284847000
RESI;137841;USD;2015;Q4;2015-12-31;2016-02-29;55906325;55501023;116702000;1006437000;;1711598000;735869000;;3306000;739175000;2450773000;32448000;1265968000;1298416000;;0;1298416000;1202974000;;-50617000;1152357000;2450773000
RESI;137841;USD;2014;Q4;2014-12-31;2015-03-02;57240551;57457311;66166000;1969357000;;2153570000;532377000;;40115000;572492000;2726062000;11678000;1354082000;1399151000;;0;1399151000;1227663000;0;99248000;1326911000;2726062000
RESI;137841;USD;2013;Q4;2013-12-31;2014-02-20;42675440;44464799;115988000;1208591000;;1331643000;35902000;;31095000;66997000;1398640000;4952000;602382000;613213000;;0;613213000;759007000;;26420000;785427000;1398640000
RESI;137841;USD;2018;Q4;2018-12-31;2019-02-27;53632679;53632679;44186000;19663000;;247744000;1966086000;;56421000;2022507000;2270251000;76640000;1722219000;1798859000;;0;1798859000;1184668000;;-700623000;471392000;2270251000
TSN;138054;USD;2016;Q4;2016-09-30;2016-11-21;375000000;379000000;349000000;1542000000;2732000000;4888000000;5170000000;;12315000000;17485000000;22373000000;1511000000;79000000;2762000000;6200000000;9987000000;12749000000;4398000000;-3093000000;8348000000;9624000000;22373000000
TSN;138054;USD;2015;Q4;2015-09-30;2015-11-23;405000000;407000000;688000000;1620000000;2878000000;5381000000;5176000000;;12412000000;17588000000;22969000000;1662000000;715000000;3535000000;5975000000;9728000000;13263000000;4349000000;-1381000000;6813000000;9706000000;22969000000
TSN;138054;USD;2014;Q4;2014-09-30;2014-11-17;382000000;390000000;438000000;1684000000;3274000000;6221000000;5130000000;;12605000000;17735000000;23956000000;1806000000;643000000;3797000000;7535000000;11255000000;15052000000;4299000000;-1010000000;5748000000;8904000000;23956000000
TSN;138054;USD;2013;Q4;2013-09-30;2013-11-18;347000000;371000000;1145000000;1497000000;2817000000;5604000000;4053000000;;2520000000;6573000000;12177000000;1359000000;513000000;3010000000;1895000000;2934000000;5944000000;2331000000;-1021000000;4999000000;6233000000;12177000000
TSN;138054;USD;2012;Q4;2012-09-30;2012-11-19;360000000;362000000;1071000000;1378000000;2809000000;5403000000;4022000000;;2471000000;6493000000;11896000000;1372000000;515000000;2830000000;1917000000;3024000000;5854000000;2317000000;-569000000;4327000000;6042000000;11896000000
TSN;138054;USD;2011;Q4;2011-09-30;2011-11-21;369000000;375000000;716000000;1321000000;2587000000;4780000000;3823000000;;2468000000;6291000000;11071000000;1264000000;70000000;2374000000;2112000000;3012000000;5386000000;2300000000;-365000000;3801000000;5685000000;11071000000
TSN;138054;USD;2010;Q4;2010-09-30;2010-11-22;372000000;379000000;978000000;1198000000;2274000000;4618000000;3674000000;;2460000000;6134000000;10752000000;1110000000;401000000;2545000000;2135000000;2942000000;5487000000;2282000000;-229000000;3113000000;5265000000;10752000000
TSN;138054;USD;2009;Q4;2009-09-30;2010-08-09;369000000;369000000;1004000000;1100000000;2009000000;4375000000;3576000000;;2644000000;6220000000;10595000000;1013000000;219000000;1993000000;3258000000;4106000000;6099000000;2275000000;-242000000;2399000000;4496000000;10595000000
TSN;138054;USD;2017;Q4;2017-09-30;2017-11-13;366000000;367000000;318000000;1675000000;3239000000;6258000000;5568000000;;16240000000;21808000000;28066000000;1698000000;906000000;4032000000;9297000000;13475000000;17507000000;4423000000;-3674000000;9776000000;10559000000;28066000000
TSN;138054;USD;2018;Q4;2018-09-30;2018-11-13;363000000;366000000;270000000;1723000000;3513000000;5688000000;6169000000;;17252000000;23421000000;29109000000;1694000000;1911000000;5031000000;7962000000;11267000000;16298000000;4432000000;-3943000000;12329000000;12811000000;29109000000
NEPH;138152;USD;2017;Q4;2017-12-31;2018-02-26;54371893;54371893;2194000;836000;674000;3809000;52000;39000;1083000;1174000;4983000;1090000;0;1871000;954000;1162000;3033000;122979000;;-121106000;1950000;4983000
NEPH;138152;USD;2016;Q4;2016-12-31;2017-03-20;48830322;48830322;275000;388000;479000;1264000;70000;61000;1283000;1414000;2678000;825000;0;895000;838000;1116000;2011000;120885000;;-120285000;667000;2678000
NEPH;138152;USD;2015;Q4;2015-12-31;2016-03-30;45049110;38226434;1248000;397000;591000;2464000;12000;0;1494000;1506000;3970000;889000;;959000;0;347000;1306000;119846000;;-117253000;2664000;3970000
NEPH;138152;USD;2014;Q4;2014-12-31;2015-04-15;17794049;17794049;1284000;110000;186000;1684000;1000;;1684000;1685000;3369000;1177000;;1247000;;7803000;9050000;108412000;;-114165000;-5681000;3369000
NEPH;138152;USD;2013;Q4;2013-12-31;2014-03-28;12523230;33064874;579000;122000;162000;988000;7000;;1894000;1901000;2889000;1438000;;3499000;;3109000;6608000;103001000;;-106794000;-3719000;2889000
NEPH;138152;USD;2012;Q4;2012-12-31;2013-03-04;11802724;11802724;47000;935000;312000;1403000;16000;;2109000;2125000;3528000;1391000;;3416000;;707000;4123000;96859000;;-97530000;-595000;3528000
NEPH;138152;USD;2011;Q4;2011-12-31;2012-03-22;10365420;10365420;1669000;1170000;247000;3199000;17000;778000;;795000;3994000;479000;;1177000;;1396000;2573000;95640000;;-94268000;1421000;3994000
NEPH;138152;USD;2010;Q4;2010-12-31;2011-08-15;;;240000;326000;726000;1482000;108000;;;108000;1590000;922000;500000;1455000;;0;1455000;92021000;;-91908000;135000;1590000
NEPH;138152;USD;2018;Q4;2018-12-31;2019-03-12;64289461;64289461;4581000;1452000;1864000;8173000;91000;;2294000;2385000;10558000;1232000;236000;2654000;843000;1106000;3760000;127880000;;-124153000;6798000;10558000
EPZM;138374;USD;2015;Q4;2015-12-31;2016-03-09;41816000;41816000;208323000;262000;;213063000;4089000;;751000;4840000;217903000;15988000;561000;18449000;730000;29922000;48371000;412993000;;-243461000;169532000;217903000
EPZM;138374;USD;2014;Q4;2014-12-31;2015-03-12;34317000;34317000;190095000;2075000;;195010000;3620000;;573000;4193000;199203000;15343000;;17045000;;21876000;38921000;271367000;;-111085000;160282000;199203000
EPZM;138374;USD;2013;Q4;2013-12-31;2014-02-28;28853000;28853000;123564000;33667000;;159652000;2157000;;1179000;3336000;162988000;11330000;;34573000;;24102000;58675000;160393000;;-56080000;104313000;162988000
EPZM;138374;USD;2012;Q4;2012-12-31;2013-08-01;1670000;-973000;97981000;1829000;;100625000;2140000;;746000;2886000;103511000;7295000;;35503000;;42978000;78481000;1471000;0;-52597000;25030000;103511000
EPZM;138374;USD;2016;Q4;2016-12-31;2017-03-13;58033000;58033000;242192000;23000;;248672000;3124000;;645000;3769000;252441000;21001000;620000;21621000;110000;29120000;50741000;555479000;;-353673000;201700000;252441000
EPZM;138374;USD;2017;Q4;2017-12-31;2018-03-13;69389000;69389000;276439000;382000;;285804000;2527000;;1028000;3555000;289359000;24550000;110000;24664000;;29324000;53988000;723517000;;-488097000;235371000;289359000
DVAX;138695;USD;2018;Q4;2018-12-31;2019-02-27;62708000;62708000;145536000;3704000;19022000;174364000;17064000;;19456000;36520000;210884000;31033000;;38033000;100871000;109786000;147819000;1131304000;;-1066224000;63065000;210884000
DVAX;138695;USD;2017;Q4;2017-12-31;2018-03-08;61272000;61272000;191854000;854000;312000;196717000;16619000;;5449000;22068000;218785000;18593000;;18593000;;643000;19236000;1107755000;;-907325000;199549000;218785000
DVAX;138695;USD;2016;Q4;2016-12-31;2017-03-13;38544000;38544000;81415000;1342000;;89599000;17174000;;2907000;20081000;109680000;20036000;;20036000;;443000;20479000;904996000;;-812171000;89201000;109680000
DVAX;138695;USD;2015;Q4;2015-12-31;2016-03-08;38592000;38592000;196125000;1394000;;199946000;13804000;;2883000;16687000;216633000;26131000;;28785000;;769000;29554000;889736000;;-699727000;187079000;216633000
DVAX;138695;USD;2014;Q4;2014-12-31;2015-03-05;26296000;26296000;122652000;727000;;127437000;7924000;;2929000;10853000;138290000;14414000;;20279000;9559000;17529000;37808000;695084000;;-592933000;100482000;138290000
DVAX;138695;USD;2013;Q4;2013-12-31;2014-03-10;23634000;23634000;189376000;1627000;;192378000;8706000;;3538000;12244000;204622000;10067000;;16192000;;2136000;18328000;688653000;;-502211000;186294000;204622000
DVAX;138695;USD;2012;Q4;2012-12-31;2013-03-08;18088200;18088200;125130000;1005000;;128187000;7965000;;3600000;11565000;139752000;12229000;;19014000;;5912000;24926000;550912000;;-435491000;114826000;139752000
DVAX;138695;USD;2011;Q4;2011-12-31;2012-03-12;14274500;14274500;113961000;9527000;;124618000;6163000;;3321000;9484000;134102000;10199000;12810000;27219000;;7003000;34222000;466431000;;-365542000;99880000;134102000
DVAX;138695;USD;2010;Q4;2010-12-31;2011-08-03;;;72154000;1001000;;74515000;6404000;;3330000;9734000;84249000;12488000;;13917000;10939000;18221000;32138000;369802000;;-316945000;52111000;84249000
SOHU;138944;USD;2015;Q4;2015-12-31;2016-02-26;38647000;38615000;1419720000;273617000;;2079512000;508692000;62093000;391897000;962682000;3042194000;605793000;344500000;1264579000;;46863000;1311442000;798402000;-143858000;536327000;1730752000;3042194000
SOHU;138944;USD;2014;Q4;2014-12-31;2015-03-02;38501000;38501000;1067917000;230401000;;1697208000;540778000;24067000;604956000;1169801000;2867009000;509110000;25500000;794285000;344500000;383818000;1178103000;650192000;-143858000;585925000;1688906000;2867009000
SOHU;138944;USD;2013;Q4;2013-12-31;2014-02-28;38304000;38565000;1372124000;154342000;;2051555000;564442000;0;382718000;947160000;2998715000;492139000;410331000;1114409000;0;47586000;1161995000;601677000;-143858000;752582000;1836720000;2998715000
SOHU;138944;USD;2012;Q4;2012-12-31;2013-02-28;38044000;38392000;967984000;98398000;;1238283000;178951000;;665403000;844354000;2082637000;278800000;113000000;556793000;126353000;148817000;705610000;378355000;-143858000;770184000;1377027000;2082637000
SOHU;138944;USD;2011;Q4;2011-12-31;2012-02-28;38078000;38573000;829521000;87066000;;970481000;152652000;;510161000;662813000;1633294000;218764000;0;330865000;0;26104000;356969000;366254000;-131292000;697244000;1276325000;1633294000
SOHU;138944;USD;2010;Q4;2010-12-31;2011-02-28;37984000;38671000;753918000;62603000;;836167000;120627000;;230796000;351423000;1187590000;138750000;;211672000;;1359000;213031000;338076000;-114690000;534503000;974559000;1187590000
SOHU;138944;USD;2009;Q4;2009-12-31;2010-08-17;38318000;38921000;563782000;46610000;;621173000;115088000;;92012000;207100000;828273000;96518000;;150497000;;0;150497000;317095000;-114690000;385874000;677776000;828273000
SOHU;138944;USD;2016;Q4;2016-12-31;2017-02-27;38739000;38739000;1298883000;189167000;;1851262000;503631000;74273000;134524000;712428000;2563690000;650574000;0;932742000;;73153000;1005895000;821912000;-143858000;312306000;1557795000;2563690000
SOHU;138944;USD;2017;Q4;2017-12-31;2018-02-28;38889000;38889000;2183030000;250468000;;2630101000;529717000;90145000;139276000;759138000;3389239000;830128000;61216000;1155402000;122433000;416600000;1572002000;1098500000;-143858000;-242220000;1817237000;3389239000
ALR;139220;USD;2011;Q4;2011-12-31;2012-02-29;78961000;;300259000;475824000;320269000;1293727000;491205000;2254000;4885515000;5378974000;6672701000;551037000;73415000;624452000;3280080000;3814178000;4438630000;3324798000;-184971000;-1486791000;2234071000;6672701000
MGM;139431;USD;2017;Q4;2017-12-31;2018-03-01;566151000;572283000;1499995000;542273000;102292000;2376355000;19635459000;;7148228000;26783687000;29160042000;2505448000;158042000;3138297000;12751052000;14330843000;17469140000;5363372000;;2217299000;11690902000;29160042000
MGM;139431;USD;2016;Q4;2016-12-31;2017-03-01;573896000;579239000;1446581000;542924000;97733000;2229587000;18425023000;;7518691000;25943714000;28173301000;2014685000;8375000;2293421000;12979220000;15856429000;18149850000;5659316000;;545811000;10023451000;28173301000
MGM;139431;USD;2015;Q4;2015-12-31;2016-02-29;565425000;456746000;1670312000;480559000;104200000;2408749000;15371795000;;7434634000;22806429000;25215178000;1659389000;328442000;2237951000;12368311000;15206550000;17444501000;5661534000;;-555629000;7770677000;25215178000
MGM;139431;USD;2014;Q4;2014-12-31;2015-03-02;491258000;446071000;1713715000;473345000;104011000;3027160000;14441542000;;9125212000;23566754000;26593914000;1930024000;1245320000;3407925000;12805285000;15557715000;18965640000;4185835000;;-107909000;7628274000;26593914000
MGM;139431;USD;2013;Q4;2013-12-31;2014-03-03;490197000;487183000;1803669000;488217000;107907000;2719439000;14055212000;;9309959000;23365171000;26084610000;2119126000;;2215328000;13447230000;16008787000;18224115000;4161584000;;41964000;7860495000;26084610000
MGM;139431;USD;2012;Q4;2012-12-31;2013-03-01;489215000;489215000;1543509000;443677000;107577000;2507092000;14194652000;;9582994000;23777646000;26284738000;1925671000;;1925671000;13589283000;16243051000;18168722000;4137547000;;213698000;8116016000;26284738000
MGM;139431;USD;2011;Q4;2011-12-31;2012-02-29;488824000;711515000;1865913000;491730000;112735000;2812720000;14866644000;;10086912000;24953556000;27766276000;1744764000;;1744764000;13470167000;16139290000;17884054000;4099211000;;1981389000;9882222000;27766276000
MGM;139431;USD;2010;Q4;2010-12-31;2011-02-28;477929000;477929000;498964000;321894000;96392000;1455645000;14554350000;;2941853000;17496203000;18951848000;1246221000;;1246221000;12047698000;14773465000;16019686000;4065711000;;-1133248000;2932162000;18951848000
MGM;139431;USD;2009;Q4;2009-12-31;2010-08-09;;;2056207000;368474000;101809000;3053501000;15069952000;;4394757000;19464709000;22518210000;1303777000;1079824000;2383601000;12976037000;16264177000;18647778000;3501837000;;370532000;3870432000;22518210000
MGM;139431;USD;2018;Q4;2018-12-31;2019-02-27;528617000;531439000;1526762000;657206000;110831000;2526778000;20729888000;;6954040000;27683928000;30210706000;2593678000;43411000;2948882000;15088005000;16689783000;19638665000;4097360000;;2423479000;10572041000;30210706000
REXR;139560;USD;2017;Q4;2017-12-31;2018-02-21;77912318;78369062;6620000;3664000;;10534000;1988424000;;112415000;2100839000;2111373000;32861000;;39590000;687008000;706529000;746119000;1240592000;;;1365254000;2111373000
REXR;139560;USD;2016;Q4;2016-12-31;2017-02-23;65851673;64155379;15525000;8683000;;24208000;1416989000;;73811000;1490800000;1515008000;22867000;;28367000;509314000;524501000;552868000;908496000;;;962140000;1515008000
REXR;139560;USD;2015;Q4;2015-12-31;2016-02-25;55307108;55307108;5201000;3040000;;8241000;1085143000;4087000;55780000;1145010000;1153251000;20437000;;26427000;421541000;433080000;459507000;723275000;;;693744000;1153251000
REXR;139560;USD;2014;Q4;2014-12-31;2015-03-09;43447666;43447666;8606000;14949000;;23555000;853578000;4018000;51034000;908630000;932185000;15297000;;18162000;359378000;368146000;386308000;542752000;;;545877000;932185000
REXR;139560;USD;2013;Q4;2013-12-31;2014-03-20;;;8997000;14056000;;23378000;481673000;5687000;43937000;531297000;554675000;11151000;;13173000;193634000;199733000;212906000;312191000;;;341769000;554675000
REXR;139560;USD;2018;Q4;2018-12-31;2019-02-19;94214977;94706905;180601000;4944000;;185545000;2487341000;;114799000;2602140000;2787685000;37012000;;45902000;810098000;833360000;879262000;1799079000;;;1908423000;2787685000
RATE;140381;USD;2016;Q4;2016-12-31;2017-03-22;87929747;86359031;176680000;52211000;;270932000;15440000;;797488000;812928000;1083860000;45965000;;53845000;295721000;340637000;394482000;904209000;-142983000;-71119000;689378000;1083860000
RATE;140381;USD;2015;Q4;2015-12-31;2016-03-09;90685176;97940283;237204000;56265000;;320340000;10189000;;796437000;806626000;1126966000;42875000;;59064000;293284000;306707000;365771000;887300000;-88616000;-36985000;761195000;1126966000
RATE;140381;USD;2014;Q4;2014-12-31;2015-06-18;98219298;104085185;119028000;48307000;;473766000;6203000;;778460000;784663000;1258429000;51907000;;104277000;297598000;330866000;435143000;905763000;-58472000;-23639000;823286000;1258429000
RATE;140381;USD;2013;Q4;2013-12-31;2014-02-27;100207176;100201510;229674000;61859000;;315854000;11258000;;971783000;983041000;1298895000;53209000;;81615000;297021000;381707000;463322000;865169000;-592000;-28811000;835573000;1298895000
RATE;140381;USD;2012;Q4;2012-12-31;2013-03-01;100248457;99983016;83262000;52293000;;163147000;8324000;;989986000;998310000;1161457000;40869000;;49836000;193943000;285672000;335508000;844407000;-592000;-17615000;825950000;1161458000
RATE;140381;USD;2011;Q4;2011-12-31;2012-03-12;100080076;99532550;55588000;61595000;;130048000;7997000;;980757000;988754000;1118802000;45500000;;54134000;193613000;276156000;330290000;833797000;;-44660000;788512000;1118802000
RATE;140381;USD;2010;Q4;2010-12-31;2011-08-15;87258692;87258692;115630000;42731000;;180176000;6321000;;939130000;945451000;1125627000;45101000;;115035000;297417000;384536000;499571000;657969000;;-31173000;626056000;1125627000
TESO;141183;USD;2016;Q4;2016-12-31;2017-03-03;46535000;46535000;91489000;33320000;76226000;220975000;120743000;;2561000;123304000;344279000;26206000;;32710000;;1986000;34696000;264940000;;9142000;309583000;344279000
TESO;141183;USD;2015;Q4;2015-12-31;2016-03-04;39078000;39078000;51507000;64270000;95459000;237084000;177716000;;6894000;184610000;421694000;32383000;;42913000;;3827000;46740000;212383000;;127070000;374954000;421694000
TESO;141183;USD;2014;Q4;2014-12-31;2015-03-31;39707000;40185000;72466000;128663000;114682000;360689000;202505000;;56072000;258577000;619266000;44960000;25000;91702000;0;14437000;106139000;208999000;;268627000;513127000;619266000
TESO;141183;USD;2013;Q4;2013-12-31;2014-03-04;39364000;40249000;97277000;141200000;96874000;378216000;204456000;;52003000;256459000;634675000;50010000;503000;110802000;27000;10511000;121313000;224666000;;253195000;513362000;634675000
TESO;141183;USD;2012;Q4;2012-12-31;2013-03-05;38836000;39184000;22014000;130769000;124506000;322877000;209933000;;50962000;260895000;583772000;50497000;119000;103219000;142000;11045000;114264000;213460000;;220547000;469508000;583772000
TESO;141183;USD;2011;Q4;2011-12-31;2012-03-02;38397000;38870000;23069000;117711000;111769000;293804000;203068000;;52343000;255411000;549215000;59779000;2793000;125668000;3832000;10740000;136408000;206573000;;170733000;412807000;549215000
TESO;141183;USD;2010;Q4;2010-12-31;2011-08-09;37961000;37007000;60603000;72971000;59190000;225985000;182686000;;46237000;228923000;454908000;27218000;0;73192000;0;6047000;79239000;196431000;;143737000;375669000;454908000
NICK;141389;USD;2016;Q4;2017-03-31;2016-06-14;7627070;7501354;2855000;317205000;;323906000;1184000;;8522000;9706000;333612000;7783000;;224752000;;;224752000;33889000;-70459000;145430000;108860000;333612000
NICK;141389;USD;2015;Q4;2016-03-31;2015-06-15;11485782;11664756;1849000;311837000;;317404000;1290000;;6615000;7905000;325309000;7338000;;222460000;;0;222460000;33287000;-70459000;140021000;102849000;325309000
NICK;141389;USD;2014;Q4;2015-03-31;2014-06-16;12117754;12363088;2635036;269343595;;275659687;869693;;6900199;7769892;283429579;11263480;;141492024;;0;141492024;31151781;;110785774;141937555;283429579
NICK;141389;USD;2013;Q4;2014-03-31;2013-06-14;12023273;12319301;2797716;249825801;;254666926;741581;;8426961;9168542;263835468;9501890;;136870372;;0;136870372;30031548;;96933548;126965096;263835468
NICK;141389;USD;2012;Q4;2013-03-31;2012-06-14;11781811;12090038;2803054;241253430;;246678060;758784;;9123300;9882084;256560144;8214508;;121296983;;0;121296983;28426043;;106837118;135263161;256560144
NICK;141389;USD;2011;Q4;2012-03-31;2011-08-09;;;2017540;230163854;;233917149;771311;;8954665;9725976;243643125;9321750;;128429657;;0;128429657;26337731;;88875737;115213468;243643125
NICK;141389;USD;2017;Q4;2018-03-31;2018-06-27;7663000;7558000;2626000;269876000;;277030000;843000;;6289000;7132000;284162000;6672000;;175725000;;0;175725000;34564000;-70459000;144332000;108437000;284162000
NICK;141389;USD;2018;Q4;2019-03-31;2019-06-28;8099000;8077000;35595000;202042000;;244640000;656000;;7124000;7780000;252420000;4916000;;149916000;-2381000;-2381000;147535000;34660000;-70459000;140684000;104885000;252420000
ITG;142922;USD;2015;Q4;2015-12-31;2016-02-29;33425000;35186000;330653000;1085953000;;1570423000;55496000;;83103000;138599000;1709022000;1157063000;81934000;1241634000;12567000;12567000;1254201000;239613000;-336923000;571626000;454821000;1709022000
ITG;142922;USD;2014;Q4;2014-12-31;2015-03-13;34502000;35608000;275210000;752549000;;1188877000;60306000;;101666000;161972000;1350849000;830156000;78360000;916769000;17781000;18484000;935253000;240657000;-306629000;487462000;415596000;1350849000
ITG;142922;USD;2013;Q4;2013-12-31;2014-03-17;36274000;38060000;261897000;938931000;;1392183000;66171000;;81118000;147289000;1539472000;1014853000;73539000;1091345000;30332000;30695000;1122040000;240579000;-268253000;436570000;417432000;1539472000
ITG;142922;USD;2012;Q4;2012-12-31;2013-03-06;37652000;35510000;245875000;1653944000;;2051625000;54989000;;90145000;145134000;2196759000;1740021000;22154000;1767424000;19272000;19565000;1786989000;245522000;-253111000;405485000;409770000;2196759000
ITG;142922;USD;2011;Q4;2011-12-31;2012-02-28;39602000;38201000;284188000;1343824000;;1788419000;43023000;;346627000;389650000;2178069000;1480195000;1606000;1482239000;23997000;24716000;1506955000;249988000;-240559000;653344000;671114000;2178069000
ITG;142922;USD;2010;Q4;2010-12-31;2011-02-28;41608000;42924000;317010000;1471507000;;1960991000;39373000;;530489000;569862000;2530853000;1623309000;;1642671000;;18114000;1660785000;246603000;-220161000;833133000;870068000;2530853000
ITG;142922;USD;2009;Q4;2009-12-31;2010-08-05;43715000;44495000;330879000;662778000;;1193913000;41437000;;467753000;509190000;1703103000;771473000;;771504000;46900000;63899000;835403000;233891000;-182743000;809153000;867700000;1703103000
ITG;142922;USD;2016;Q4;2016-12-31;2017-03-01;32604000;32604000;277977000;206780000;;629702000;59333000;;86250000;145583000;775285000;291355000;72150000;363754000;6367000;6367000;370121000;249273000;-346482000;536350000;405164000;775285000
ITG;142922;USD;2017;Q4;2017-12-31;2018-03-01;32857000;30579000;287452000;268602000;;678776000;53960000;;52120000;106080000;784856000;315344000;101422000;416767000;3104000;4854000;421621000;250742000;-353067000;486957000;363235000;784856000
ITG;142922;USD;2018;Q4;2018-12-31;2019-03-14;66053998;70565579;267843000;501604000;;900925000;48055000;;72095000;120150000;1021075000;580533000;78029000;658568000;1967000;3836000;662404000;260833000;-347710000;478348000;358671000;1021075000
LAMR;143321;USD;2016;Q4;2016-12-31;2017-02-24;97349468;97782216;35530000;189935000;;314253000;1182715000;;2401916000;3584631000;3898884000;152086000;33916000;277324000;2315267000;2552032000;2829356000;1713410000;-12303000;-630955000;1069528000;3898884000
LAMR;143321;USD;2015;Q4;2015-12-31;2016-02-25;96634591;96673024;22327000;174398000;;281732000;1095137000;;1986875000;3082012000;3363744000;132660000;16509000;236830000;1874941000;2105855000;2342685000;1664135000;-6099000;-635799000;1021059000;3363744000
LAMR;143321;USD;2014;Q4;2014-12-31;2015-02-26;95461481;94886742;26035000;169610000;;273144000;1083640000;;1962034000;3045674000;3318818000;125158000;15625000;225341000;1884270000;2112011000;2337352000;1611871000;;-632859000;981466000;3318818000
LAMR;143321;USD;2013;Q4;2013-12-31;2014-02-27;94707120;95266897;33212000;161741000;;282058000;1121929000;;1997631000;3119560000;3401618000;112265000;55935000;245353000;1882867000;2223319000;2468672000;2470487000;-893831000;-647577000;932946000;3401618000
LAMR;143321;USD;2012;Q4;2012-12-31;2013-02-28;-279421469016;-280012441436;58911000;159829000;;301235000;1180359000;;2032436000;3212795000;3514030000;113000000;33134000;219108000;2127720000;2433297000;2652405000;2432629000;-889631000;-687351000;861625000;3514030000
LAMR;143321;USD;2011;Q4;2011-12-31;2012-02-27;278317276386;279432642844;33503000;147436000;;256625000;1193617000;;1977111000;3170728000;3427353000;107317000;17310000;161344000;2141218000;2427011000;2588355000;2405789000;-888518000;-683599000;838998000;3427353000
LAMR;143321;USD;2010;Q4;2010-12-31;2011-02-25;368768127001;368767713184;91679000;141166000;;309409000;1257451000;;2082101000;3339552000;3648961000;109750000;5694000;153580000;2403446000;2676858000;2830438000;2389234000;-885037000;-691784000;818523000;3648961000
LAMR;143321;USD;2009;Q4;2009-12-31;2010-08-06;91881819;91881819;112253000;142518000;;367936000;1406911000;;2168694000;3575605000;3943541000;106294000;121282000;263707000;2553630000;2848036000;3111743000;2361275000;-883408000;-651317000;831798000;3943541000
LAMR;143321;USD;2017;Q4;2017-12-31;2018-02-27;98160450;98396349;115471000;201699000;;420519000;1214138000;;2579688000;3793826000;4214345000;215636000;17664000;325994000;2539026000;2784858000;3110852000;1762597000;-21300000;-639106000;1103493000;4214345000
LAMR;143321;USD;2018;Q4;2018-12-31;2019-02-25;99492904;99530110;21494000;235576000;;363669000;1295048000;;2885924000;4180972000;4544641000;143713000;204120000;455035000;2684568000;2957822000;3412857000;1852521000;-25412000;-695337000;1131784000;4544641000
FOLD;143587;USD;2016;Q4;2016-12-31;2017-03-03;142649551;142649551;330351000;1304000;3416000;340064000;9816000;;686965000;696781000;1036845000;41008000;;110959000;154464000;581811000;692770000;1121636000;;-779608000;344075000;1036845000
FOLD;143587;USD;2015;Q4;2015-12-31;2016-02-29;125232837;125232837;214033000;;0;216601000;6178000;;685605000;691783000;908384000;32216000;;73616000;;495689000;569305000;918760000;;-579566000;339079000;908384000
FOLD;143587;USD;2014;Q4;2014-12-31;2015-03-03;87320566;87320566;151675000;;;154577000;2811000;17464000;35115000;55390000;209967000;16345000;3840000;20185000;10510000;67604000;87789000;569758000;;-447448000;122178000;209967000
FOLD;143587;USD;2017;Q4;2017-12-31;2018-03-01;166852388;166852388;358562000;9464000;4623000;391965000;9062000;0;225997000;235059000;627024000;53890000;;70040000;164167000;220210000;290250000;1402479000;;-1063610000;336774000;627024000
FOLD;143587;USD;2018;Q4;2018-12-31;2019-02-28;189398120;189398120;504152000;21962000;8390000;551096000;11375000;;227480000;238855000;789951000;80625000;;86125000;321740000;373977000;460102000;1742003000;;-1412222000;329849000;789951000
NSPR;143799;USD;2018;Q4;2018-12-31;2019-02-19;850886;850886;9384000;716000;1134000;11419000;421000;;448000;869000;12288000;2895000;;2920000;;605000;3525000;156355000;;-147592000;8763000;12288000
RDNT;143984;USD;2016;Q4;2016-12-31;2017-03-31;45967317;46822254;20638000;164210000;;217914000;247725000;;383837000;631562000;849476000;111166000;26557000;155341000;612175000;642082000;797423000;198391000;;-150211000;52053000;849476000
RDNT;143984;USD;2015;Q4;2015-12-31;2016-03-30;45469176;48500488;;5671000;;11469000;13752000;;10273000;24025000;35494000;837000;208000;1319000;357000;1385000;2704000;;;;32790000;35494000
RDNT;143984;USD;2014;Q4;2014-12-31;2015-03-31;41808308;45289784;3000;7439000;;13078000;13845000;;10393000;24238000;37316000;1483000;692000;2406000;565000;1734000;4140000;;;;33176000;37316000
RDNT;143984;USD;2013;Q4;2013-12-31;2014-03-31;38794920;40878140;288000;8603000;;12346000;17794000;;10512000;28306000;40652000;1942000;835000;2984000;1257000;2656000;5640000;;;;35012000;40652000
RDNT;143984;USD;2012;Q4;2012-12-31;2013-04-01;37233680;40016744;1778000;8597000;;12098000;19358000;;10647000;30005000;42103000;2043000;1179000;3389000;1150000;2744000;6133000;;;;35970000;42103000
RDNT;143984;USD;2011;Q4;2011-12-31;2012-03-13;37428944;39594700;2089000;8326000;;13166000;22074000;;8660000;30734000;43900000;3612000;2976000;6722000;2330000;4079000;10801000;;;;33099000;43900000
RDNT;143984;USD;2010;Q4;2010-12-31;2011-08-09;37146565;37146565;627000;96094000;;111025000;194230000;;234259000;428489000;539514000;82619000;17357000;105264000;487217000;516723000;621987000;162448000;;-242841000;-82473000;539514000
RDNT;143984;USD;2017;Q4;2017-12-31;2018-03-19;47253102;48274019;51322000;155518000;;235351000;244301000;;389327000;633628000;868979000;135809000;34090000;191606000;575037000;607448000;799054000;212266000;;-150158000;69925000;868979000
RDNT;143984;USD;2018;Q4;2018-12-31;2019-03-18;48654753;49751953;10389000;148919000;;208690000;345729000;;554911000;900640000;1109330000;181028000;39267000;239517000;633012000;669560000;909077000;242840000;;-117915000;200253000;1109330000
SRT;144111;USD;2017;Q4;2017-12-31;2018-03-16;16156000;13645000;1456000;53052000;;58149000;19943000;;17906000;37849000;95998000;21974000;2725000;25948000;22206000;23111000;49059000;82756000;;-37201000;46939000;95998000
SRT;144111;USD;2016;Q4;2016-12-31;2017-02-22;15771000;17107000;1039000;60179000;;65028000;23276000;;18504000;41780000;106808000;23462000;2740000;54364000;5500000;7700000;62064000;80718000;;-35925000;44744000;106808000
SRT;144111;USD;2015;Q4;2015-12-31;2016-03-14;15607000;15607000;2626000;57940000;;64018000;30364000;;20422000;50786000;114804000;24639000;3497000;62434000;8189000;10445000;72879000;78596000;;-36320000;41925000;114804000
SRT;144111;USD;2014;Q4;2014-12-31;2015-03-06;15408000;15408000;5306000;46103000;;54508000;28180000;;11105000;39285000;93793000;21305000;2170000;30707000;4770000;8405000;39112000;76210000;;-20704000;54681000;93793000
SRT;144111;USD;2013;Q4;2013-12-31;2014-03-10;15368000;15368000;10989000;43708000;;60064000;22210000;;7443000;29653000;89717000;22043000;;27732000;;3811000;31543000;74427000;;-15244000;58174000;89717000
SRT;144111;USD;2012;Q4;2012-12-31;2013-03-08;15273000;15273000;9183000;41070000;;60280000;26310000;;6542000;32852000;93132000;18950000;;21489000;;5364000;26853000;72588000;;-8838000;66279000;93132000
SRT;144111;USD;2011;Q4;2011-12-31;2012-03-09;30234892;30234892;9719000;37736000;;56327000;38475000;;6631000;45106000;101433000;18941000;;22122000;;4949000;27071000;71210000;;1650000;74362000;101433000
SRT;144111;USD;2010;Q4;2010-12-31;2011-08-08;14948000;14948000;18740000;46989000;;77834000;46985000;;7936000;54921000;132755000;22890000;;25597000;;6511000;32108000;69373000;;28112000;100647000;132755000
FTEK;144208;USD;2015;Q4;2015-12-31;2016-03-24;23170000;23170000;21703000;23060000;1653000;52401000;12001000;;11609000;23610000;76011000;14891000;;16536000;;501000;17037000;135628000;-1042000;-74132000;58974000;76011000
FTEK;144208;USD;2014;Q4;2014-12-31;2015-03-16;22838000;22457000;18673000;31910000;1111000;58338000;13527000;;19606000;33133000;91471000;15018000;1625000;18650000;;520000;19170000;135215000;-790000;-61752000;72301000;91471000
FTEK;144208;USD;2013;Q4;2013-12-31;2014-03-10;22459000;22375000;27768000;36974000;443000;69265000;13027000;;27766000;40793000;110058000;14550000;1636000;20646000;;789000;21435000;133023000;-486000;-44027000;88623000;110058000
FTEK;144208;USD;2012;Q4;2012-12-31;2013-04-01;22033000;22873000;24497000;30169000;513000;59864000;13749000;;32284000;46033000;105897000;17771000;0;20946000;;715000;21661000;133719000;-39000;-49128000;84236000;105897000
FTEK;144208;USD;2011;Q4;2011-12-31;2012-03-05;23575000;24104000;28286000;34346000;311000;66256000;13625000;;33109000;46734000;112990000;16547000;1181000;22630000;;1347000;23977000;132587000;;-44031000;89013000;112990000
FTEK;144208;USD;2010;Q4;2010-12-31;2011-08-08;24213000;24417000;30524000;21175000;807000;54456000;14384000;;34363000;48747000;103203000;12679000;2269000;17811000;;1482000;19293000;129666000;;-46075000;83910000;103203000
FTEK;144208;USD;2016;Q4;2016-12-31;2017-03-14;23449000;23449000;11835000;18790000;1012000;40635000;10517000;;6636000;17153000;57788000;12660000;;14050000;;346000;14396000;137618000;-1214000;-91520000;43392000;57788000
FTEK;144208;USD;2017;Q4;2017-12-31;2018-03-12;24145000;24145000;8372000;19690000;945000;33748000;6272000;;10464000;16736000;50484000;14236000;;15723000;;420000;16143000;139008000;-1472000;-102503000;34341000;50484000
FTEK;144208;USD;2018;Q4;2018-12-31;2019-03-14;24169000;23752000;12039000;18399000;957000;40717000;5976000;;5026000;11002000;51719000;15598000;;17161000;;506000;17667000;139240000;-1484000;-102495000;34052000;51719000
CALL;144735;USD;2016;Q4;2016-12-31;2017-03-16;-31662387;-31688393;52841000;3171000;4441000;67269000;3805000;;103443000;107248000;174517000;12743000;;61250000;;55067000;116317000;125350000;-120300000;53785000;58200000;174517000
CALL;144735;USD;2015;Q4;2015-12-31;2016-03-15;-34294968;-34328697;78956000;2925000;5723000;95103000;3302000;;70431000;73733000;168836000;7370000;;59924000;;61244000;121168000;126346000;-126772000;48094000;47668000;168836000
CALL;144735;USD;2014;Q4;2014-12-31;2015-03-16;-53419676;-53425528;76312000;3903000;5635000;115639000;3564000;;75030000;78594000;194233000;20482000;;76927000;;68220000;145147000;122185000;-107683000;34584000;49086000;194233000
CALL;144735;USD;2013;Q4;2013-12-31;2014-03-12;-55715128;-55740096;54779000;3626000;4490000;91598000;1959000;;78337000;80296000;171894000;13473000;;68014000;;66438000;134452000;115436000;-108151000;30799000;37442000;171894000
CALL;144735;USD;2012;Q4;2012-12-31;2013-04-02;59412501;59313253;38349000;6004000;5340000;59284000;2348000;;59135000;61483000;120767000;17220000;;84258000;;61279000;145537000;109777000;-93541000;-39512000;-24770000;120767000
CALL;144735;USD;2011;Q4;2011-12-31;2012-05-04;24556000;23744000;35096000;8786000;8676000;62904000;2669000;;45057000;47726000;110630000;14954000;;86645000;;50362000;137007000;105127000;-35358000;-95363000;-26377000;110630000
CALL;144735;USD;2017;Q4;2017-12-31;2018-03-16;32143966;32143966;53007000;2428000;1880000;63141000;2772000;;75129000;77901000;141042000;9653000;;51896000;;52584000;104480000;125886000;-118146000;28822000;36562000;141042000
CNXR;145641;USD;2016;Q4;2016-12-31;2017-03-31;22427913;22427913;6208000;8390000;;15751000;1957000;;64780000;66737000;82488000;12332000;578000;46466000;31944000;41512000;87978000;102008000;-287000;-159105000;-5490000;82488000
CNXR;145641;USD;2015;Q4;2015-12-31;2016-03-15;21967331;21967331;5424000;10792000;;16868000;2109000;;63712000;65821000;82689000;10413000;1441000;48091000;46964000;65778000;113869000;101568000;-177000;-132571000;-31180000;82689000
CNXR;145641;USD;2014;Q4;2014-12-31;2015-06-12;4896283;4896283;28252000;12128000;;41937000;1892000;;67561000;69453000;111390000;9617000;4479000;61047000;47627000;79184000;140231000;96387000;;-125228000;-28841000;111390000
CNXR;145641;USD;2017;Q4;2017-12-31;2018-04-02;23055920;23055920;7743000;11094000;;19870000;1079000;;62129000;63208000;83078000;10187000;32616000;74552000;;10611000;85163000;97746000;-322000;-174649000;-2085000;83078000
EVH;146041;USD;2016;Q4;2016-12-31;2017-03-03;52235000;52235000;178904000;40635000;;264966000;31179000;;903694000;934873000;1199839000;111460000;;131941000;120283000;155784000;287725000;555909000;;146617000;912114000;1199839000
EVH;146041;USD;2015;Q4;2015-12-31;2016-02-29;42084000;103445000;155171000;20381000;;184463000;12796000;44618000;773637000;831051000;1015514000;44671000;;59506000;0;21429000;80935000;342653000;;306688000;934579000;1015514000
EVH;146041;USD;2014;Q4;2014-12-31;2015-08-07;2704000;2704000;0;0;;0;0;0;37203000;37203000;37203000;0;;0;;0;0;23734000;;-25806000;37201000;37201000
EVH;146041;USD;2017;Q4;2017-12-31;2018-03-01;74999000;74999000;238433000;48947000;;378182000;50922000;;883593000;934515000;1312697000;107892000;;132699000;121394000;133692000;266391000;924927000;;85952000;1046306000;1312697000
EVH;146041;USD;2018;Q4;2018-12-31;2019-02-28;78769000;78769000;228320000;80208000;;485864000;73628000;16286000;1146503000;1236417000;1722281000;221177000;;269356000;221041000;263569000;532925000;1093997000;;50009000;1189356000;1722281000
GIDYL;146177;USD;2016;Q4;2016-12-31;2017-03-30;9693835;9693835;8293000;30000;213000;9049000;149000;;;149000;9198000;2166000;;2391000;;17000;2408000;254993000;;-248203000;6790000;9198000
GIDYL;146177;USD;2015;Q4;2015-12-31;2016-03-30;9505323;9505323;19590000;40000;1025000;21381000;401000;;;401000;21782000;3503000;;3521000;;3000;3524000;253345000;;-235087000;18258000;21782000
GIDYL;146177;USD;2014;Q4;2014-12-31;2015-03-30;9496599;9496599;51191000;470000;5488000;58314000;1089000;;97000;1186000;59500000;8556000;;9143000;;179000;9322000;250104000;;-199926000;50178000;59500000
GIDYL;146177;USD;2013;Q4;2013-12-31;2014-08-14;-163420957;-163420957;58616000;660000;7271000;67835000;1490000;;;1490000;69325000;5667000;58000;6447000;;493000;6940000;214106000;;-151721000;62385000;69325000
GIDYL;146177;USD;2017;Q4;2017-12-31;2018-03-28;11199103;11199103;3034000;40000;;3369000;97000;;;97000;3466000;2212000;4929000;7152000;;29000;7181000;255406000;;-259121000;-3715000;3466000
GIDYL;146177;USD;2018;Q4;2018-12-31;2019-03-13;17970221;17970221;3806000;;;4366000;63000;;;63000;4429000;2695000;4960000;7706000;168000;168000;7874000;263714000;;-267159000;-3445000;4429000
COTV;146741;USD;2017;Q4;2017-12-31;2018-02-22;92284333;94958474;165518000;83756000;;275971000;77340000;;1745918000;1823258000;2099229000;68631000;18000000;159621000;749618000;838140000;997761000;933802000;;172120000;1101468000;2099229000
COTV;146741;USD;2016;Q4;2016-12-31;2017-02-23;90465713;99488472;110635000;67735000;;202430000;67640000;;1732193000;1799833000;2002263000;81751000;18000000;171393000;762202000;891534000;1062927000;911673000;-98000;33917000;939336000;2002263000
COTV;146741;USD;2015;Q4;2015-12-31;2016-08-10;77230470;77420717;149365000;78856000;;263006000;57452000;;1793630000;1851082000;2114088000;72423000;21099000;172038000;1012971000;1154454000;1326492000;807496000;-98000;-14935000;787596000;2114088000
MXPT;146869;USD;2015;Q4;2015-12-31;2016-03-10;6588058;6588058;41143000;43336000;;87586000;19385000;;315000;19700000;107286000;23373000;31225000;54598000;;955000;55553000;103115000;;-51300000;51733000;107286000
MXPT;146869;USD;2014;Q4;2014-12-31;2015-05-14;1020996;1020996;12949000;41303000;;55131000;10653000;;7913000;18566000;73697000;25937000;0;25937000;44127000;46443000;72380000;4732000;;-28847000;1317000;73697000
MXPT;146869;USD;2016;Q4;2016-12-31;2017-03-08;6623529;6623529;24221000;43432000;;69130000;20125000;;60000;20185000;89315000;22060000;27489000;49549000;;1218000;50767000;107899000;;-69151000;38548000;89315000
LOV;147014;USD;2015;Q4;2015-12-31;2016-03-11;25738000;;6565000;790000;;9443000;5584000;;18049000;23633000;33076000;5603000;;11437000;;2673000;14110000;77215000;;-58988000;18966000;33076000
LOV;147014;USD;2014;Q4;2014-12-31;2015-03-16;24448000;;11696000;1308000;;15587000;4072000;;11346000;15418000;31005000;5248000;;12836000;;2414000;15250000;72547000;;-57551000;15755000;31005000
LOV;147014;USD;2013;Q4;2013-12-31;2014-03-14;91112802;;14723000;1569000;;19385000;3901000;;11968000;15869000;35254000;7277000;;16633000;;3498000;20131000;70771000;;-56424000;15123000;35254000
LOV;147014;USD;2012;Q4;2012-12-31;2013-03-08;21204000;;10458000;1510000;;14069000;3133000;;11162000;14295000;28364000;6432000;;14817000;;2001000;16818000;54878000;;-44044000;11546000;28364000
LOV;147014;USD;2011;Q4;2011-12-31;2012-03-27;20593000;;15106000;1146000;;18418000;2839000;;16679000;19518000;37936000;4998000;;10924000;;2381000;13305000;53014000;;-29055000;24631000;37936000
LOV;147014;USD;2010;Q4;2010-12-31;2011-08-11;20589000;20596000;13901000;847000;;16698000;2520000;;17350000;19870000;36568000;5006000;;9337000;;1882000;11219000;52020000;;-27444000;25349000;36568000
LOV;147014;USD;2016;Q4;2016-12-31;2017-03-22;31962000;;11360000;525000;;13747000;4494000;;13576000;18070000;31817000;3409000;;7414000;;2338000;9752000;87230000;;-65878000;22065000;31817000
FCS;147401;USD;2015;Q4;2015-12-31;2016-02-25;113600000;110900000;279600000;132600000;304200000;766900000;550400000;2000000;266600000;819000000;1585900000;226200000;;226200000;198400000;257200000;483400000;1562000000;-387600000;-62700000;1102500000;1585900000
FCS;147401;USD;2014;Q4;2014-12-31;2015-02-26;118000000;116800000;353000000;124000000;264900000;785300000;627700000;2200000;273900000;903800000;1689100000;235800000;;235800000;197100000;255200000;491000000;1543900000;-291900000;-47600000;1198100000;1689100000
FCS;147401;USD;2013;Q4;2013-12-31;2014-02-27;126700000;131600000;417900000;127400000;228100000;824600000;707900000;2200000;261300000;971400000;1796000000;183800000;;183800000;200100000;248100000;431900000;1519200000;-149400000;-12400000;1364100000;1796000000
FCS;147401;USD;2012;Q4;2012-12-31;2013-02-28;126800000;129300000;406000000;136700000;236700000;832000000;764900000;2600000;284400000;1051900000;1883900000;204900000;0;204900000;250100000;309000000;513900000;1499900000;-120500000;-17400000;1370000000;1883900000
FCS;147401;USD;2011;Q4;2011-12-31;2012-02-23;125900000;128700000;423500000;142900000;234200000;853000000;765400000;32300000;286200000;1083900000;1936900000;258200000;0;258200000;300100000;354200000;612400000;1483200000;-106600000;-42000000;1324500000;1936900000
FCS;147401;USD;2010;Q4;2010-12-31;2011-02-24;124000000;128200000;404700000;156400000;232700000;843100000;689300000;30300000;286400000;1006000000;1849100000;278200000;3800000;282000000;316900000;388400000;670400000;1433700000;-64300000;-187500000;1178700000;1849100000
FCS;147401;USD;2009;Q4;2009-12-31;2010-08-04;123800000;123800000;415900000;134000000;189500000;781200000;653200000;35800000;292200000;981200000;1762400000;190200000;5300000;195500000;466900000;538000000;733500000;1407900000;-38700000;-340700000;1028900000;1762400000
SPNE;147451;USD;2015;Q4;2015-12-31;2016-03-16;11337000;11337000;33429000;25326000;51271000;113722000;21958000;;40709000;62667000;176389000;26035000;;26035000;328000;3015000;29050000;173897000;;-27949000;147339000;176389000
SPNE;147451;USD;2014;Q4;2014-12-31;2015-08-13;11048000;11048000;652000;22538000;49862000;74616000;16360000;;48666000;65026000;139642000;45952000;;45952000;0;92797000;138749000;0;;0;893000;139642000
SPNE;147451;USD;2016;Q4;2016-12-31;2017-03-03;11271000;11271000;14566000;20982000;45299000;82660000;21863000;;42642000;64505000;147165000;21118000;445000;24418000;3835000;11770000;36188000;180866000;;-71161000;110977000;147165000
SPNE;147451;USD;2017;Q4;2017-12-31;2018-03-02;13415000;13415000;10788000;21872000;41721000;76418000;22063000;;35993000;58056000;134474000;22950000;;23157000;0;5664000;28821000;206979000;;-103276000;105653000;134474000
SPNE;147451;USD;2018;Q4;2018-12-31;2019-03-01;18007000;18007000;54033000;20335000;42742000;120058000;22623000;;29661000;52284000;172342000;26417000;;26546000;;3711000;30257000;277283000;;-136800000;142085000;172342000
EBIX;147655;USD;2015;Q4;2015-12-31;2016-02-29;170934000;172136000;58717000;47171000;;116830000;34088000;;525071000;559159000;675989000;27975000;606000;51266000;206500000;215752000;267018000;60462000;0;378787000;408971000;675989000
EBIX;147655;USD;2014;Q4;2014-12-31;2015-03-16;109323000;109980000;52581000;41100000;;101748000;24661000;;507902000;532563000;634311000;45401000;936000;69786000;121058000;132304000;202090000;140720000;-76000;309726000;432221000;634311000
EBIX;147655;USD;2013;Q4;2013-12-31;2014-03-17;114165000;115647000;57475000;39070000;;102349000;8528000;;434565000;443093000;545442000;24300000;13889000;66675000;42964000;60542000;127217000;168021000;-76000;257574000;418225000;545442000
EBIX;147655;USD;2012;Q4;2012-12-31;2013-03-18;111660000;116790000;37420000;37298000;;81669000;10082000;;425195000;435277000;516946000;20928000;12259000;53425000;69432000;96366000;149791000;168055000;-76000;201094000;367155000;516946000
EBIX;147655;USD;2011;Q4;2011-12-31;2012-03-15;108939000;127827000;25201000;31133000;;63817000;8834000;;338531000;347365000;411182000;16163000;6832000;49779000;40218000;45288000;95067000;183156000;-76000;137559000;316115000;411182000
EBIX;147655;USD;2010;Q4;2010-12-31;2011-08-26;417827115;467863038;29697000;26028000;;60782000;7806000;;234712000;242518000;303300000;19880000;10370000;42619000;25205000;29413000;72032000;156823000;-76000;67642000;231268000;303300000
EBIX;147655;USD;2016;Q4;2016-12-31;2017-03-01;-33826000;-34152000;117223000;62713000;;207046000;37061000;;559648000;596709000;803755000;37935000;12373000;89712000;259853000;275407000;365119000;3209000;;457364000;438636000;803755000
EBIX;147655;USD;2017;Q4;2017-12-31;2018-03-01;31458000;31644000;89487000;117838000;;252932000;41704000;;818377000;860081000;1113013000;92517000;14381000;146932000;385507000;432322000;579254000;4558000;;510975000;533759000;1113013000
EBIX;147655;USD;2018;Q4;2018-12-31;2019-03-01;31133000;31223000;178958000;174340000;;427380000;50294000;;1133273000;1183567000;1610947000;157289000;18593000;317428000;699253000;749082000;1066510000;6454000;;535118000;544437000;1610947000
VDSI;147770;USD;2017;Q4;2017-12-31;2018-03-08;39840000;39775000;158394000;48126000;12040000;227937000;4776000;;104909000;109685000;337622000;31206000;;66153000;;33539000;99692000;90347000;;156151000;237930000;337622000
VDSI;147770;USD;2016;Q4;2016-12-31;2017-03-10;39749000;39770000;144201000;36693000;17420000;207159000;3281000;;116830000;120111000;327270000;29867000;;67960000;;6148000;74108000;87521000;;178551000;253162000;327270000
VDSI;147770;USD;2015;Q4;2015-12-31;2016-02-29;39585000;39813000;123483000;29426000;20618000;183365000;3099000;;125358000;128457000;311822000;31737000;;55690000;;8084000;63774000;85806000;;168036000;248048000;311822000
VDSI;147770;USD;2014;Q4;2014-12-31;2015-03-13;39360000;39595000;137381000;29994000;33875000;206226000;2825000;;42287000;45112000;251338000;26450000;;45197000;;268000;45465000;82490000;;125885000;205873000;251338000
VDSI;147770;USD;2013;Q4;2013-12-31;2014-03-12;38987000;39116000;98607000;28528000;25653000;161645000;3145000;;47087000;50232000;211877000;21373000;;37106000;;493000;37599000;79911000;;92401000;174278000;211877000
VDSI;147770;USD;2012;Q4;2012-12-31;2013-03-08;38381000;38781000;106469000;27574000;18675000;159435000;4052000;;23019000;27071000;186506000;18043000;;29948000;;238000;30186000;75004000;;81256000;156320000;186506000
VDSI;147770;USD;2011;Q4;2011-12-31;2012-03-09;37631000;38446000;84497000;31618000;16033000;139758000;4405000;;24760000;29165000;168923000;19019000;;31168000;;1956000;33124000;71758000;;65658000;135799000;168923000
VDSI;147770;USD;2010;Q4;2010-12-31;2011-08-25;37419000;38316000;85533000;21702000;10710000;122654000;4771000;;15516000;20287000;142941000;19301000;;25765000;;683000;26448000;68466000;;47524000;116493000;142941000
VDSI;147770;USD;2018;Q4;2018-12-31;2019-03-15;39988000;40295000;99497000;59631000;14428000;191956000;6250000;;154620000;160870000;352826000;37362000;;72357000;;28028000;100385000;93350000;;172378000;252441000;352826000
RLOC;148191;USD;2014;Q4;2014-12-31;2015-03-13;28772000;28772000;44624000;7844000;;60323000;19639000;9000000;82426000;111065000;171388000;64042000;624000;106848000;1103000;11616000;118464000;132015000;;-74569000;52924000;171388000
RLOC;148191;USD;2013;Q4;2013-12-31;2014-03-05;27527000;28362000;77774000;9699000;;100884000;12903000;2500000;69722000;85125000;186009000;54250000;;103676000;;3965000;107641000;111861000;;-29559000;78368000;186009000
RLOC;148191;USD;2012;Q4;2012-12-31;2013-03-11;28255000;28226000;95469000;5689000;;111303000;11040000;;63353000;74393000;185696000;49729000;;99790000;;4020000;103810000;110484000;;-27076000;81886000;185696000
RLOC;148191;USD;2011;Q4;2011-12-31;2012-03-15;29088000;29090000;85169000;4240000;;98635000;9885000;;57917000;67802000;166437000;49368000;;81111000;;3039000;84150000;109406000;;-26844000;82287000;166437000
RLOC;148191;USD;2010;Q4;2010-12-31;2011-08-04;;27997000;88114000;3295000;;96818000;6531000;;48050000;54581000;151399000;42524000;;67710000;;1673000;69383000;98053000;;-16044000;82016000;151399000
BSTG;148380;USD;2017;Q4;2017-12-31;2018-04-03;2028500;2028500;4038000;;;4413000;632000;;;632000;5045000;1306000;;1622000;;0;1622000;50182000;;-48234000;3423000;5045000
BSTG;148380;USD;2016;Q4;2016-12-31;2017-03-17;856700;856700;2941000;42000;;3486000;1065000;;;1065000;4551000;2172000;;2777000;;0;2777000;38092000;;-36318000;1774000;4551000
BSTG;148380;USD;2015;Q4;2015-12-31;2016-03-30;673300;673300;7456000;21000;75000;7882000;1074000;;;1074000;8956000;654000;;654000;;0;654000;33049000;;-24739000;8302000;8956000
BSTG;148380;USD;2014;Q4;2014-12-31;2015-03-27;392850;392850;5272000;5000;207000;5828000;1376000;;;1376000;7204000;694000;;710000;;0;710000;19528000;;-13035000;6494000;7204000
BSTG;148380;USD;2013;Q4;2013-12-31;2014-03-31;387000;387000;14008000;;38000;14489000;575000;;;575000;15064000;405000;;495000;;0;495000;16543000;;-1974000;14569000;15064000
BSTG;148380;USD;2012;Q4;2012-12-31;2013-11-27;;;0;;0;0;438000;;;438000;438000;411000;;411000;;27000;438000;0;;0;0;438000
BSTG;148380;USD;2018;Q4;2018-12-31;2019-03-29;5715000;5715000;1305000;;;2104000;479000;;50000;529000;2633000;564000;;662000;;0;662000;57734000;;-55763000;1971000;2633000
BLFS;148798;USD;2017;Q4;2017-12-31;2018-03-09;13751817;13751817;6663318;1021315;1846746;9930881;1106036;1070120;36166;2212322;12143203;1382682;;1512898;;537719;2050617;84050465;;-73957883;10092586;12143203
BLFS;148798;USD;2016;Q4;2016-12-31;2016-11-10;12846666;12846666;1405826;1193646;1757784;4628070;1187378;2075000;36166;3298544;7926614;1002947;;1133163;685450;3627311;4760474;74368509;;-71202369;3166140;7926614
BLFS;148798;USD;2015;Q4;2015-12-31;2016-02-25;12306645;12306645;3824599;929289;1834635;6972937;1446399;0;3950286;5396685;12369622;1595577;;1725793;784458;784458;2510251;72835845;;-64326923;9859371;12369622
BLFS;148798;USD;2014;Q4;2014-12-31;2015-03-12;12166218;12166218;9938394;901623;965224;12165762;1655605;;2251551;3907156;16072918;1131560;;1261776;874825;874825;2136601;71923412;;-60112987;13936317;16072918
BLFS;148798;USD;2013;Q4;2013-12-31;2014-02-12;5027498;5027498;156273;1009316;420924;1878258;1324044;;151040;1475084;3353342;1516890;;1628140;891986;14996723;16624863;43623716;;-56895237;-13271521;3353342
BLFS;148798;USD;2012;Q4;2012-12-31;2013-03-29;;4983107;196478;600153;656397;1627759;1334446;;207624;1542070;3169829;1234088;;1365338;838829;14290514;15655852;43325054;;-55811077;-12486023;3169829
BLFS;148798;USD;2011;Q4;2011-12-31;2012-03-29;;4975142;16864;547143;505956;1160407;353402;;148208;501610;1662017;559248;;579248;;12263255;12842503;42971005;;-54151491;-11180486;1662017
BLFS;148798;USD;2010;Q4;2010-12-31;2011-08-12;;;3211;338899;410486;814973;360700;;133386;494086;1309059;320702;;340702;;10517269;10857971;42645940;;-52194852;-9548912;1309059
BLFS;148798;USD;2018;Q4;2018-12-31;2019-03-15;18473669;28379511;30657000;3045000;3509000;37564000;1319000;6548000;36000;7903000;45467000;1809000;;1939000;;380000;2319000;114179000;;-71031000;43148000;45467000
SHAK;148890;USD;2016;Q4;2016-12-31;2017-03-13;24895000;25380000;73647000;6006000;806000;83944000;136264000;;317986000;454250000;538194000;21543000;;31716000;;305125000;336841000;135484000;;16719000;201353000;538194000
SHAK;148890;USD;2015;Q4;2015-12-31;2016-03-30;16584000;14275000;71124000;4217000;543000;78934000;93041000;;207572000;300613000;379547000;19391000;;24005000;313000;198523000;222528000;96347000;;4273000;157019000;379547000
SHAK;148890;USD;2014;Q4;2014-12-31;2015-05-15;30004000;30132000;2677000;3278000;529000;7925000;70124000;;4913000;75037000;82962000;14428000;32000000;48177000;313000;22185000;70362000;12600000;;;12600000;82962000
SHAK;148890;USD;2017;Q4;2017-12-31;2018-02-26;26306000;24760000;84543000;5641000;1258000;93199000;187095000;;190312000;377407000;470606000;26087000;;34024000;;212103000;246127000;153142000;;16399000;224479000;470606000
SHAK;148890;USD;2018;Q4;2018-12-31;2019-02-25;29406000;30256000;86863000;10523000;1749000;101119000;261854000;;247559000;509413000;610532000;45918000;;59948000;;277129000;337077000;195671000;;30404000;273455000;610532000
RUN;148978;USD;2016;Q4;2016-12-31;2017-03-08;103519000;105777000;206364000;60258000;67326000;369345000;48471000;;3155002000;3203473000;3572818000;125279000;32179000;244784000;896835000;2265941000;2510725000;668086000;;4438000;1062093000;3572818000
RUN;148978;USD;2015;Q4;2015-12-31;2016-03-11;101990000;101990000;203864000;60275000;71258000;359715000;44866000;;2330011000;2374877000;2734592000;153279000;27622000;252481000;545084000;1675412000;1927893000;642239000;;-87249000;806699000;2734592000
RUN;148978;USD;2014;Q4;2014-12-31;2015-09-15;24334000;24334000;152154000;43189000;23914000;236534000;22195000;;1673855000;1696050000;1932584000;76611000;17949000;150883000;242410000;1229134000;1380017000;383862000;;-59003000;552567000;1932584000
RUN;148978;USD;2017;Q4;2017-12-31;2018-03-06;106814000;109410000;202525000;112069000;94427000;468573000;36402000;;3458161000;3494563000;3963136000;212423000;37143000;311145000;1279227000;2287674000;2598819000;682961000;;202734000;1364317000;3963136000
RUN;148978;USD;2018;Q4;2018-12-31;2019-02-28;112214000;120204000;226625000;66435000;79467000;461413000;34893000;;4253481000;4288374000;4749787000;229914000;52562000;372191000;2060712000;2968512000;3340703000;722440000;;229391000;1409084000;4749787000
NTRA;149288;USD;2017;Q4;2017-12-31;2018-03-15;53955000;54838000;118867000;44089000;8998000;180625000;29667000;;4321000;33988000;214613000;51385000;50112000;105561000;73065000;83635000;189196000;472558000;;-446375000;25417000;214613000
NTRA;149288;USD;2016;Q4;2016-12-31;2017-03-16;52408000;52408000;146116000;13396000;6414000;174115000;32289000;;4276000;36565000;210680000;42425000;49624000;96415000;;7789000;104204000;453049000;;-345848000;106476000;210680000
NTRA;149288;USD;2015;Q4;2015-12-31;2016-03-24;49089000;49089000;230533000;5862000;8093000;250726000;12710000;;1804000;14514000;265240000;34592000;42090000;80475000;;0;80475000;436264000;;-250083000;184765000;265240000
NTRA;149288;USD;2014;Q4;2014-12-31;2015-08-13;5016000;5016000;87176000;5942000;11542000;106477000;14574000;;2572000;17146000;123623000;25188000;2340000;29872000;3510000;24282000;54154000;8665000;;-179808000;69469000;123623000
NTRA;149288;USD;2018;Q4;2018-12-31;2019-03-15;62139000;62139000;153868000;62223000;13633000;240518000;24336000;;3317000;27653000;268171000;59697000;50153000;113981000;81970000;122028000;236009000;607243000;;-574529000;32162000;268171000
IAIC;149465;USD;2018;Q4;2018-12-31;2019-04-01;11201760;10810337;1963956;652839;;3010328;7147;;6281;13428;3023756;832613;;1151165;;0;1151165;14804449;-930211;-12001647;1872591;3023756
IAIC;149465;USD;2017;Q4;2017-12-31;2019-09-07;11201760;12077085;2731510;610182;;3717569;11133;;6281;17414;3734983;1453956;;1840958;;;1840958;14774849;-930211;-11950613;1894025;3734983
IAIC;149465;USD;2016;Q4;2016-12-31;2019-09-07;11201760;11201760;1895372;1157387;;3718945;27198;;6281;33479;3752424;1504870;;2119905;;;2119905;14759805;-930211;-12197075;1632519;3752424
IAIC;149465;USD;2015;Q4;2015-12-31;2019-09-07;11201760;11636268;2167928;1298029;;4069297;42039;;6281;48320;4117617;1359325;;1940427;;;1940427;14750795;-930211;-11643394;2177190;4117617
IAIC;149465;USD;2014;Q4;2014-12-31;2019-09-07;11201760;11056413;2450006;970621;;4184505;53675;5102;6281;65058;4249563;1421174;;2159168;;;2159168;14742330;-930211;-11721724;2090395;4249563
IAIC;149465;USD;2013;Q4;2013-12-31;2019-09-07;11201760;11192019;2359527;1437754;;4338567;52887;8665;6281;67833;4406400;1796927;;2300409;;;2300409;14728139;-930211;-11691937;2105991;4406400
IAIC;149465;USD;2012;Q4;2012-12-31;2019-09-07;11201798;11220493;2623016;738044;;3554876;39226;3885;6281;49392;3604268;1235835;;1456259;;;1456259;14709918;-930211;-11631698;2148009;3604268
IAIC;149465;USD;2011;Q4;2011-12-31;2019-09-07;11196760;11254101;1280926;2889658;;4964542;40440;4287;6281;51008;5015550;2035578;;2975361;;;2975361;14702521;-930211;-11732121;2040189;5015550
IAIC;149465;USD;2010;Q4;2010-12-31;2019-09-07;11196760;11193597;1968077;771814;;3317277;35705;10955;6281;52941;3370218;837545;;1490136;;;1490136;14695815;-930211;-11885522;1880082;3370218
CVSI;150939;USD;2017;Q4;2017-12-31;2018-03-30;130977910;130977910;2012965;1507824;2822585;8335171;2083433;;12291601;14375034;22710205;2610191;726296;3336487;850000;2992259;6328746;51409387;;-35027928;16381459;22710205
CVSI;150939;USD;2016;Q4;2016-12-31;2017-03-31;56582452;56582452;781857;360475;2851772;4821110;242702;389723;13138627;13771052;18592162;901799;2023940;3148539;679174;2235474;5384013;43338938;;-30130789;13208149;18592162
CVSI;150939;USD;2015;Q4;2015-12-31;2016-04-14;36522618;36522618;518462;1488233;14133920;16591742;439615;0;10263812;10703427;27295169;1182127;1020778;2452905;0;1556300;4009205;39275455;;-15989491;23285964;27295169
CVSI;150939;USD;2014;Q4;2014-12-31;2015-03-31;33513815;;2302418;1790875;11666251;16286648;516423;;4936837;5453260;21739908;664593;0;664593;;0;664593;24831678;;-3756363;21075315;21739908
CVSI;150939;USD;2013;Q4;2013-12-31;2014-03-28;13022720;13022720;2243670;1430202;2473322;6321511;214128;749546;6946843;7910517;14232028;247325;175000;422625;;5502595;5925220;10751220;;-2444412;8306808;14232028
CVSI;150939;USD;2012;Q4;2012-12-31;2013-04-16;7000000;7000000;431;0;0;431;0;0;0;0;431;0;0;500;;0;500;144147;;-144216;-69;431
CVSI;150939;USD;2011;Q4;2011-12-31;2012-04-10;7001613;;1168;;;2918;;;;;2918;20223;;41023;;;41023;60500;;-98605;-38105;2918
CVSI;150939;USD;2018;Q4;2018-12-31;2019-03-12;94799020;133888879;12684000;3340000;8550000;27469000;2844000;;6589000;9433000;36902000;3918000;474000;4392000;;2394000;6786000;55143000;;-25027000;30116000;36902000
ISSC;153113;USD;2017;Q4;2017-09-30;2017-12-15;16763245;16989099;24680301;2748597;4179654;34181438;6669011;;187315;6856326;41037764;3081288;;3361642;;67742;3429384;51602721;-21368537;7374196;37608380;41037764
ISSC;153113;USD;2016;Q4;2016-09-30;2016-12-16;16931156;17169839;18767661;4511091;3645828;29369459;6962562;;156948;7119510;36488969;3393679;;3573264;;67701;3640965;51410972;-21368537;2805569;32848004;36488969
ISSC;153113;USD;2015;Q4;2015-09-30;2016-01-14;16905527;16820572;16282039;2394695;4597316;28415976;7095330;;595263;7690593;36106569;4004512;;4761257;;2826;4764083;51167478;-20643760;818768;31342486;36106569
ISSC;153113;USD;2014;Q4;2014-09-30;2014-12-15;16956247;17171828;15214584;4419863;5470786;36526292;7467663;;168555;7636218;44162510;6479942;;7006262;;144724;7150986;50716212;-20389590;6684902;37011524;44162510
ISSC;153113;USD;2013;Q4;2013-09-30;2013-12-20;16836357;17051862;16386207;4489434;4377513;34437485;7320495;;872531;8193026;42630511;6045046;;6492571;;143693;6636264;49899203;-20389590;6484634;35994247;42630511
ISSC;153113;USD;2012;Q4;2012-09-30;2012-12-14;16581820;16581833;42977501;3978512;3801547;54377366;7214378;;1005487;8219865;62597231;3863276;;5289828;;227000;5516828;47864061;-20388894;29605236;57080403;62597231
ISSC;153113;USD;2011;Q4;2011-09-30;2011-12-14;16782264;16856015;42625854;3124114;3508595;50572834;7476362;;208408;7684770;58257604;2994905;13189;3240724;;756093;3996817;47224977;-19590432;26626242;54260787;58257604
ISSC;153113;USD;2010;Q4;2010-09-30;2011-08-09;16747193;16852625;40916346;2529976;4656392;49607834;7761538;;221150;7982688;57590522;3128937;9908;3296778;15560;825707;4122485;46849891;-19291506;25909652;53468037;57590522
ISSC;153113;USD;2018;Q4;2018-09-30;2018-12-21;16823753;16823753;20390713;3449893;4280108;28664948;8786737;;181993;8968730;37633678;2992813;;3349614;;129594;3479208;51802716;-21368537;3720291;34154470;37633678
MXIM;153611;USD;2017;Q4;2017-06-30;2017-08-11;282758000;287334000;2744839000;256454000;247242000;3305594000;606581000;;658058000;1264639000;4570233000;264023000;0;278997000;1487678000;2088542000;2367539000;283000;;2212301000;2202694000;4570233000
MXIM;153611;USD;2016;Q4;2016-06-30;2016-08-12;284356000;293024000;2230668000;256531000;227929000;2807048000;692551000;;735017000;1427568000;4234616000;320907000;249717000;609403000;990090000;1517399000;2126802000;284000;;2121749000;2107814000;4234616000
MXIM;153611;USD;2015;Q4;2015-06-30;2015-08-18;284204000;294534000;1626119000;278844000;288474000;2319403000;1090739000;;805929000;1896668000;4216071000;351826000;1024000;383177000;987687000;1542874000;1926051000;28142000;;2279112000;2290020000;4216071000
MXIM;153611;USD;2014;Q4;2014-06-30;2014-08-18;283431000;289032000;1372425000;295828000;289292000;2086702000;1331519000;;987397000;2318916000;4405618000;372901000;;398635000;1001026000;1577072000;1975707000;23290000;;2423794000;2429911000;4405618000
MXIM;153611;USD;2013;Q4;2013-06-30;2013-08-13;290164000;296761000;1200046000;285438000;275640000;1939906000;1373124000;;622880000;1996004000;3935910000;378336000;;404893000;503573000;1023019000;1427912000;288000;;2523457000;2507998000;3935910000
MXIM;153611;USD;2012;Q4;2012-06-30;2012-08-17;292665000;299421000;956386000;317461000;242162000;1699366000;1353606000;;684974000;2038580000;3737946000;425613000;303496000;755389000;5592000;444280000;1199669000;293000;;2553418000;2538277000;3737946000
MXIM;153611;USD;2011;Q4;2011-06-30;2011-08-08;295743000;304045000;1012887000;297632000;237928000;1727852000;1308850000;;491041000;1799891000;3527743000;377459000;0;414340000;300000000;602585000;1016925000;296000;;2524790000;2510818000;3527743000
MXIM;153611;USD;2010;Q4;2010-06-30;2010-11-02;302198000;313294000;826512000;339322000;206040000;1706613000;1324436000;;451276000;1775712000;3482325000;333738000;;532517000;300000000;596850000;1129367000;301000;;2364598000;2352958000;3482325000
MXIM;153611;USD;2018;Q4;2018-06-30;2018-08-17;279336000;288818000;2626399000;280072000;282390000;3210409000;579364000;;661788000;1241152000;4451561000;297989000;499406000;797395000;991147000;1723226000;2520621000;279000;;1945646000;1930940000;4451561000
MXIM;153611;USD;2019;Q4;2019-06-30;2019-08-21;272346000;276036000;1898332000;360016000;246512000;2539500000;577722000;;626760000;1204482000;3743982000;587626000;;688116000;992584000;1210590000;1898706000;272000;;1856358000;1845276000;3743982000
CAGU;154936;USD;2017;Q4;2017-12-31;2018-04-02;10056392;10056392;4324791;2469922;;7182468;6030724;;2344582;8375306;15557774;4936922;340896;8489795;4586604;4586604;13076399;5757137;;-4409227;2481375;15557774
CAGU;154936;USD;2016;Q4;2016-12-31;2017-04-07;10056392;9319726;2775956;2405473;;5543478;6100677;;1509176;7609853;13153331;4846946;416613;6146200;4847168;4847168;10993368;5523837;;-4515200;2159963;13153331
CAGU;154936;USD;2015;Q4;2015-12-31;2016-03-30;10056535;10793201;2370557;2037058;;4806785;6032375;;1841348;7873723;12680508;4268684;399195;5487375;5509766;5547685;11035060;5294743;;-4803759;1645448;12680508
CAGU;154936;USD;2014;Q4;2014-12-31;2015-03-31;10038448;10775114;1753780;2365071;;5050954;6701806;;1641798;8343604;13394558;4183226;419808;5468275;6621571;6693815;12162090;5078703;;-4978419;1232468;13394558
CAGU;154936;USD;2013;Q4;2013-12-31;2014-03-31;10026392;11499724;1137215;2453363;;4368864;7160790;;1869694;9030484;13399348;4454937;541776;5630576;7319340;7436656;13067232;4824543;;-5628512;332116;13399348
CAGU;154936;USD;2012;Q4;2012-12-31;2013-04-01;10026392;11499724;781662;2047772;;3598863;7380379;;2011385;9391764;12990627;4059721;286304;5002695;7939941;8072362;13075057;4624513;;-5830379;-84430;12990627
CAGU;154936;USD;2011;Q4;2011-12-31;2012-03-30;10026392;12819724;710487;2580371;;3839302;7171329;;2184682;9356011;13195313;4831901;597078;6017388;7724265;7862936;13880324;4624513;;-6327415;-685011;13195313
CAGU;154936;USD;2010;Q4;2010-12-31;2011-08-15;10025151;10025151;539701;2607109;;3796175;7349343;;2369080;9718423;13514598;4776865;415448;5882055;8145021;8644279;14526334;4624513;;-6587930;-1011736;13514598
AFI;155205;USD;2015;Q4;2015-12-31;2016-05-09;27738779;27738779;0;72200000;242800000;349700000;434500000;;79200000;513700000;863400000;161000000;;161300000;10000000;700100000;861400000;0;;0;2000000;863400000
AFI;155205;USD;2016;Q4;2016-12-31;2017-03-06;27915927;27915929;30600000;76000000;272100000;404900000;445200000;;54300000;499500000;904400000;163400000;;163400000;21200000;117500000;280900000;673300000;0;10000000;623500000;904400000
AFI;155205;USD;2017;Q4;2017-12-31;2018-03-06;25881777;25648136;39000000;79700000;236000000;390300000;418100000;;71100000;489200000;879500000;151000000;0;151000000;86000000;178500000;329500000;674200000;-39900000;-31800000;550000000;879500000
AFI;155205;USD;2018;Q4;2018-12-31;2019-03-05;26037945;25794950;173800000;39000000;139500000;370900000;296100000;;41200000;337300000;708200000;141900000;28700000;170600000;70600000;146600000;317200000;678600000;-39700000;-186300000;391000000;708200000
COKE;156024;USD;2016;Q4;2017-01-31;2017-03-14;7141000;9392000;21850000;369022000;143553000;593811000;812989000;;1042684000;1855673000;2449484000;450380000;7527000;457907000;948448000;1628553000;2086460000;129771000;-61254000;301511000;363024000;2449484000
COKE;156024;USD;2015;Q4;2016-01-31;2016-03-18;7141000;9331000;55498000;238737000;89464000;434919000;525820000;;885826000;1411646000;1846565000;319490000;7063000;326553000;668349000;1197580000;1524133000;126045000;-61254000;260672000;322432000;1846565000
COKE;156024;USD;2014;Q4;2015-01-31;2015-03-13;7141000;9310000;9095000;162998000;70740000;287001000;358232000;;787843000;1146075000;1433076000;220974000;6446000;227420000;497363000;948713000;1176133000;123820000;-61254000;210957000;256943000;1433076000
COKE;156024;USD;2013;Q4;2014-01-31;2014-03-14;7141000;9288000;11761000;138595000;61987000;239215000;302998000;;733943000;1036941000;1276156000;182877000;25939000;208816000;437616000;807414000;1016230000;121881000;-61254000;188869000;259926000;1276156000
COKE;156024;USD;2012;Q4;2013-01-31;2013-03-14;7141000;9270000;10399000;131921000;65924000;241312000;307467000;;734695000;1042162000;1283474000;191082000;25230000;216312000;467737000;867724000;1084036000;120600000;-61254000;170439000;199438000;1283474000
COKE;156024;USD;2011;Q4;2012-01-31;2012-03-16;7141000;9248000;90758000;130689000;66158000;322212000;302920000;;737293000;1040213000;1362425000;179196000;124574000;303770000;472699000;869248000;1173018000;119098000;-61254000;152446000;189407000;1362425000
COKE;156024;USD;2010;Q4;2011-01-31;2011-08-12;7141000;9224000;45872000;124697000;64870000;264699000;322143000;;720780000;1042923000;1307622000;172874000;3866000;176740000;578458000;946465000;1123205000;117710000;-61254000;134872000;184417000;1307622000
COKE;156024;USD;2017;Q4;2018-01-31;2018-02-28;7141000;9409000;16902000;500978000;183618000;794538000;1031388000;;1247034000;2278422000;3072960000;631231000;8221000;639452000;1123266000;1974601000;2614053000;133440000;-61254000;388718000;458907000;3072960000
COKE;156024;USD;2018;Q4;2019-01-31;2019-02-27;7141000;9301000;13548000;512298000;210033000;797418000;1014252000;;1198258000;2212510000;3009928000;593120000;8617000;601737000;1131034000;1953025000;2554762000;137271000;-61254000;359435000;455166000;3009928000
XBIT;156298;USD;2015;Q4;2015-12-31;2016-03-30;32227991;32227991;91051000;;;93041000;16317000;;;16317000;109358000;6291000;;6291000;;17000;6308000;233902000;;-130651000;103050000;109358000
XBIT;156298;USD;2014;Q4;2014-12-31;2015-06-18;25233918;25233918;57329000;;;58064000;4113000;;;4113000;62177000;3147000;;3147000;;0;3147000;152351000;;-93168000;59030000;62177000
XBIT;156298;USD;2016;Q4;2016-12-31;2017-03-16;32506839;32506839;34324000;;;36930000;30120000;;;30120000;67050000;7963000;;7963000;;23000;7986000;242419000;;-183412000;59064000;67050000
XBIT;156298;USD;2017;Q4;2017-12-31;2018-03-16;35467980;35467980;31768000;;;33332000;29640000;;;29640000;62972000;2792000;;2792000;;18000;2810000;277492000;;-216562000;60162000;62972000
XBIT;156298;USD;2018;Q4;2018-12-31;2019-03-14;36130368;36130368;15823000;;;17016000;27329000;;;27329000;44345000;2944000;;2944000;;3000;2947000;279353000;;-237700000;41398000;44345000
BVSN;156413;USD;2015;Q4;2015-12-31;2016-04-14;4881000;4881000;29131000;1751000;;31980000;87000;;143000;230000;32210000;4230000;;5783000;;918000;6701000;1269582000;;-1243334000;25509000;32210000
BVSN;156413;USD;2014;Q4;2014-12-31;2015-03-13;4822000;4822000;37079000;3286000;;41484000;148000;;194000;342000;41826000;4412000;;5439000;;774000;6213000;1268243000;;-1231897000;35613000;41826000
BVSN;156413;USD;2013;Q4;2013-12-31;2014-03-14;4744000;4744000;46400000;3533000;;51171000;242000;;196000;438000;51609000;5435000;;7417000;;778000;8195000;1266686000;;-1222416000;43414000;51609000
BVSN;156413;USD;2012;Q4;2012-12-31;2013-03-15;4672000;4672000;52281000;4018000;;57374000;306000;;206000;512000;57886000;5263000;;9042000;;1187000;10229000;1265505000;;-1216994000;47657000;57886000
BVSN;156413;USD;2011;Q4;2011-12-31;2012-03-08;4514000;4514000;54414000;4100000;;60715000;143000;;144000;287000;61002000;6043000;;10296000;;936000;11232000;1262726000;;-1211942000;49770000;61002000
BVSN;156413;USD;2010;Q4;2010-12-31;2011-08-11;4470000;4470000;60823000;4277000;;66569000;264000;;1319000;1583000;68152000;6181000;;11669000;;2126000;13795000;1261800000;;-1206553000;54357000;68152000
BVSN;156413;USD;2016;Q4;2016-12-31;2017-03-30;4958000;4958000;19704000;896000;;21786000;60000;;147000;207000;21993000;3503000;;4396000;;734000;5130000;1270649000;;-1252819000;16863000;21993000
BVSN;156413;USD;2017;Q4;2017-12-31;2018-04-02;4990000;4990000;9560000;1193000;;11736000;35000;;208000;243000;11979000;3279000;;4087000;;583000;4670000;1271585000;;-1262718000;7309000;11979000
BVSN;156413;USD;2018;Q4;2018-12-31;2019-04-01;4998000;4998000;2574000;476000;;3742000;15000;;96000;111000;3853000;1552000;;1889000;;563000;2452000;1271949000;;-1269113000;1401000;3853000
TLCC;156530;USD;2016;Q4;2016-12-31;2017-03-31;252533038;275192007;5097000;7768000;17601000;33336000;3528000;;55962000;59490000;92826000;19300000;11631000;37386000;50988000;53674000;91060000;226738000;-500000;-224472000;1766000;92826000
TLCC;156530;USD;2015;Q4;2015-12-31;2016-04-14;297663679;297663679;1240000;7880000;13727000;24504000;3712000;;57984000;61696000;86200000;22065000;16564000;71720000;12861000;14751000;86471000;223517000;0;-223788000;-271000;86200000
TLCC;156530;USD;2014;Q4;2014-12-31;2015-03-31;103982745;103982745;466000;4604000;18418000;28279000;2680000;;8550000;11230000;39509000;14961000;14361000;29322000;12772000;14824000;44146000;182824000;0;-187378000;-4637000;39509000
TLCC;156530;USD;2013;Q4;2013-12-31;2014-10-15;669351132;669351132;360000;6282000;14844000;23228000;5040000;;8909000;13949000;37177000;12459000;75833000;88292000;22651000;24820000;113112000;90365000;;-166248000;-75935000;37177000
TLCC;156530;USD;2017;Q4;2017-12-31;2018-04-03;252930169;252930169;1350000;6528000;17168000;27302000;3169000;;42622000;45791000;73093000;20482000;68093000;95366000;3383000;4948000;100314000;227242000;-500000;-253963000;-27221000;73093000
TLCC;156530;USD;2018;Q4;2018-12-31;2019-04-16;254435237;291414249;6227000;8566000;7945000;29298000;1117000;;40825000;41942000;71240000;23905000;70539000;98803000;15000000;16324000;115127000;230985000;-500000;-274372000;-43887000;71240000
PROM;156801;USD;2017;Q4;2017-12-31;2018-03-30;250010162;250010162;5081000;9502000;;15740000;3315000;;26298000;29613000;45353000;10808000;6181000;16989000;60725000;75928000;92917000;3742000;;-51306000;-47564000;45353000
PROM;156801;USD;2016;Q4;2016-12-31;2017-03-30;250010162;250010162;2823000;6595000;;9982000;1594000;;34669000;36263000;46245000;7607000;6089000;13696000;65999000;80710000;94406000;2782000;;-50943000;-48161000;46245000
PROM;156801;USD;2015;Q4;2015-12-31;2016-03-30;250404206;250404206;1629000;7559000;;9802000;2525000;;37281000;39806000;49608000;8919000;5997000;16678000;68964000;83312000;99990000;1142000;;-51524000;-50382000;49608000
PROM;156801;USD;2014;Q4;2014-12-31;2015-06-12;154125921;154125921;3675000;8054000;;12072000;2034000;;56000;2090000;14162000;10334000;0;10984000;0;464000;11448000;15000;;2699000;2714000;14162000
DDE;157094;USD;2016;Q4;2016-12-31;2017-03-01;32201000;32201000;11677000;3507000;1910000;26972000;140714000;;2614000;143328000;170300000;13481000;;46741000;;7897000;54638000;8970000;;111288000;115662000;170300000
DDE;157094;USD;2015;Q4;2015-12-31;2016-03-04;32085000;32085000;10496000;2926000;1912000;27378000;145425000;;1154000;146579000;173957000;11918000;;51343000;;7606000;58949000;8710000;;110502000;115008000;173957000
DDE;157094;USD;2014;Q4;2014-12-31;2015-03-06;31961000;31961000;10079000;3838000;1783000;26553000;152107000;;1156000;153263000;179816000;12171000;;58487000;;8980000;67467000;8400000;;108629000;112349000;179816000
DDE;157094;USD;2013;Q4;2013-12-31;2014-03-07;31852000;31852000;12950000;4248000;1957000;31218000;160570000;;932000;161502000;192720000;14993000;;70478000;;6078000;76556000;7924000;;109335000;116164000;192720000
DDE;157094;USD;2012;Q4;2012-12-31;2013-03-15;31747000;31747000;14993000;4093000;1921000;35361000;168963000;;938000;169901000;205262000;14146000;;82825000;;8977000;91802000;7386000;;109322000;113460000;205262000
DDE;157094;USD;2011;Q4;2011-12-31;2012-03-09;31645000;31645000;18634000;3982000;1860000;38892000;176415000;;877000;177292000;216184000;16391000;;94660000;;9018000;103678000;6700000;;108090000;112506000;216184000
DDE;157094;USD;2010;Q4;2010-12-31;2011-08-05;;;18819000;3098000;1989000;38270000;186227000;;789000;187016000;225286000;16028000;;104764000;;9771000;114535000;5945000;;106432000;110751000;225286000
DDE;157094;USD;2017;Q4;2017-12-31;2018-03-01;32321000;32321000;10714000;3557000;1928000;25084000;134527000;;2350000;136877000;161961000;10682000;;40169000;;7483000;47652000;9191000;;109817000;114309000;161961000
DDE;157094;USD;2018;Q4;2018-12-31;2019-03-21;32446000;32446000;10864000;4297000;1975000;27569000;131322000;;1824000;133146000;160715000;12753000;;39488000;;6883000;46371000;9356000;;109881000;114344000;160715000
SOHO;158088;USD;2017;Q4;2017-12-31;2018-03-16;13655200;13653333;29777845;5981103;;46702710;357799512;;5451118;363250630;409953340;16887106;;18459494;297318816;297318816;315778310;146390127;;-48765860;94175030;409953340
SOHO;158088;USD;2016;Q4;2016-12-31;2017-03-23;14895763;14895763;31766775;4131923;;45143312;353926912;;6949340;360876252;406019564;15347487;;17663274;307017002;307017002;324680276;118539767;;-39545754;81339288;406019564
SOHO;158088;USD;2015;Q4;2015-12-31;2016-03-25;14552266;14552266;11493914;4297727;;28618623;354963242;;5390374;360353616;388972239;13670201;;15322041;320791830;320791830;336113871;82893965;;-33890834;52858368;388972239
SOHO;158088;USD;2014;Q4;2014-12-31;2015-04-14;10575125;10575125;16634499;2106436;;28697200;260192153;;10930690;271122843;299820043;12897800;;14118529;258191657;258191657;272310186;58765508;;-35388313;27509857;299820043
SOHO;158088;USD;2013;Q4;2013-12-31;2014-03-25;10208591;9232976;9376628;2021973;;17456045;202645633;;8067403;210713036;228169081;8683979;;9350737;187963549;187963549;197314286;57636182;;-32450773;30854795;228169081
SOHO;158088;USD;2012;Q4;2012-12-31;2013-03-20;9999875;8368783;7175716;1487580;;13428141;176427904;;14174824;190602728;204030869;7175863;4025220;16796657;135674432;149902082;166698739;57120977;;-27179392;37332130;204030869
SOHO;158088;USD;2011;Q4;2011-12-31;2012-03-20;9827918;9367114;4409959;1827496;;10805302;181469432;;17024712;198494144;209299446;7696018;34812510;45904680;94157825;119511523;165416203;57010577;;-22074739;43883243;209299446
SOHO;158088;USD;2010;Q4;2010-12-31;2011-08-10;9542321;9558321;2992888;1985755;;9520147;183898660;;16164624;200063284;209583431;6335145;79691828;86582875;72192253;72192253;158775128;55778389;;-16837182;50808303;209583431
SOHO;158088;USD;2018;Q4;2018-12-31;2019-03-15;13594986;;33792773;7029268;;50160433;435725814;;7596600;443322414;493482847;19677689;;22492972;388723503;388723503;411216475;147227205;;-61052418;82266372;493482847
PJT;158528;USD;2016;Q4;2016-12-31;2017-02-28;18324357;18324357;152431000;227560000;;379991000;38155000;;172330000;210485000;590476000;158957000;;160707000;;16353000;177060000;9325000;;-17946000;413416000;590476000
PJT;158528;USD;2015;Q4;2015-12-31;2016-02-29;;;82322000;169590000;;252739000;31490000;;183023000;214513000;467252000;112426000;;112903000;;12414000;125317000;43312000;;-11184000;341935000;467252000
PJT;158528;USD;2014;Q4;2014-12-31;2015-11-12;;;38533000;162924000;;250136000;5111000;;92704000;97815000;347951000;14057000;;15631000;;331310000;346941000;;;;1010000;347951000
PJT;158528;USD;2017;Q4;2017-12-31;2018-02-27;19209138;15208664;145619000;190389000;;344674000;33789000;37121000;143381000;214291000;558965000;116230000;;119469000;;17042000;136511000;30860000;-2302000;-185991000;422454000;558965000
PJT;158528;USD;2018;Q4;2018-12-31;2019-02-28;23244011;24831553;106110000;217768000;;323878000;34805000;2157000;310977000;347939000;671817000;151339000;;167651000;;16417000;184068000;151148000;-67172000;-169836000;487749000;671817000
VSTO;158610;USD;2016;Q4;2017-03-31;2016-05-27;61025000;61414000;45075000;450715000;562795000;1109847000;272346000;;1594554000;1866900000;2976747000;161381000;32000000;346389000;1089252000;1385293000;1731682000;1753474000;-287384000;-108033000;1245065000;2976747000
VSTO;158610;USD;2015;Q4;2016-03-31;2015-06-01;62759000;63803000;151692000;428398000;440240000;1049664000;203485000;;1689485000;1892970000;2942634000;207303000;17500000;368901000;652787000;913566000;1282467000;1743979000;-140019000;166421000;1660167000;2942634000
VSTO;158610;USD;2014;Q4;2015-03-31;2015-03-04;;;40004000;301729000;421949000;831030000;189071000;;1437520000;1626591000;2457621000;215640000;0;332960000;1014911000;2126166000;2459126000;0;0;0;-1505000;2457621000
VSTO;158610;USD;2017;Q4;2018-03-31;2018-05-18;53932000;53560000;22870000;421763000;382278000;1058692000;277207000;;1278937000;1556144000;2614836000;150895000;32000000;345220000;883399000;1052126000;1397346000;1746756000;-268444000;-156526000;1217490000;2614836000
VSTO;158610;USD;2018;Q4;2019-03-31;2019-05-23;57622000;57622000;21935000;344249000;344491000;939462000;215592000;;582969000;798561000;1738023000;136175000;19335000;317197000;684670000;811786000;1128983000;1752996000;-256020000;-804969000;609040000;1738023000
CAH;159950;USD;2017;Q4;2017-06-30;2017-08-10;314000000;321000000;6879000000;8048000000;11301000000;28345000000;1879000000;;9888000000;11767000000;40112000000;19894000000;1327000000;21221000000;9068000000;11945000000;33166000000;2697000000;-731000000;4967000000;6946000000;40112000000
CAH;159950;USD;2016;Q4;2016-06-30;2016-08-12;323000000;326000000;2356000000;7405000000;10615000000;21956000000;1796000000;;10370000000;12166000000;34122000000;19114000000;587000000;19701000000;4952000000;7733000000;27434000000;3010000000;-2759000000;6419000000;6688000000;34122000000
CAH;159950;USD;2015;Q4;2015-06-30;2015-08-13;331000000;332000000;4616000000;6523000000;9211000000;21752000000;1506000000;;6884000000;8390000000;30142000000;16962000000;281000000;17243000000;5211000000;6643000000;23886000000;3003000000;-2245000000;5521000000;6256000000;30142000000
CAH;159950;USD;2014;Q4;2014-06-30;2014-08-13;340000000;343000000;2865000000;5380000000;8266000000;17939000000;1459000000;;6635000000;8094000000;26033000000;14314000000;801000000;15115000000;3171000000;4517000000;19632000000;2980000000;-1423000000;4774000000;6401000000;26033000000
CAH;159950;USD;2013;Q4;2013-06-30;2013-08-20;342000000;344000000;1901000000;6304000000;8373000000;17770000000;1489000000;;6560000000;8049000000;25819000000;14422000000;168000000;14590000000;3686000000;5254000000;19844000000;2953000000;-1084000000;4038000000;5975000000;25819000000
CAH;159950;USD;2012;Q4;2012-06-30;2012-08-22;345000000;349000000;2274000000;6355000000;7864000000;17510000000;1551000000;;5199000000;6750000000;24260000000;13698000000;476000000;14174000000;2418000000;3842000000;18016000000;2930000000;-816000000;4093000000;6244000000;24260000000
CAH;159950;USD;2011;Q4;2011-06-30;2011-08-26;351000000;356500000;1929000000;6156000000;7334000000;16316000000;1512000000;;5018000000;6530000000;22846000000;13043000000;327000000;13370000000;2175000000;3627000000;16997000000;2898000000;-457000000;3331000000;5849000000;22846000000
CAH;159950;USD;2010;Q4;2010-06-30;2010-09-02;359200000;362100000;2755300000;5170600000;6355900000;14918900000;1468800000;691500000;2911000000;5071300000;19990200000;11304400000;233200000;11537600000;1896100000;3176500000;14714100000;2889900000;-331000000;2647200000;5276100000;19990200000
CAH;159950;USD;2009;Q4;2009-06-30;2009-11-09;358300000;363700000;1221600000;5214900000;6832800000;20981700000;1464500000;0;2672600000;4137100000;25118800000;10538100000;366200000;12275200000;3271600000;4118900000;16394100000;3031600000;-343000000;5953900000;8724700000;25118800000
CAH;159950;USD;2018;Q4;2018-06-30;2018-08-22;308000000;311000000;1763000000;7800000000;12308000000;24553000000;2487000000;;12911000000;15398000000;39951000000;21679000000;1001000000;22893000000;8012000000;10987000000;33880000000;2730000000;-1224000000;4645000000;6071000000;39951000000
MHH;160053;USD;2017;Q4;2017-12-31;2018-03-23;10942000;10988000;2478000;22876000;;34673000;1899000;;62032000;63931000;98604000;15676000;4003000;20109000;34149000;51342000;71451000;20367000;-4154000;10923000;27153000;98604000
MHH;160053;USD;2016;Q4;2016-12-31;2017-03-24;8920000;9068000;829000;17916000;;22684000;558000;;16164000;16722000;39406000;10261000;1800000;12257000;8077000;8077000;20334000;13916000;-4134000;9297000;19072000;39406000
MHH;160053;USD;2015;Q4;2015-12-31;2016-03-25;8702000;8898000;848000;16394000;;20842000;656000;;16979000;17635000;38477000;9795000;1800000;11936000;10738000;10738000;22674000;13166000;-4121000;6777000;15803000;38477000
MHH;160053;USD;2014;Q4;2014-12-31;2015-03-20;8646000;8948000;2568000;10677000;;18840000;701000;;503000;1204000;20044000;7057000;;7176000;;0;7176000;12784000;-3915000;4024000;12868000;20044000
MHH;160053;USD;2013;Q4;2013-12-31;2014-03-21;8450000;8954000;424000;10707000;;16400000;174000;;477000;651000;17051000;7532000;12000;7591000;;0;7591000;11974000;-3131000;601000;9460000;17051000
MHH;160053;USD;2012;Q4;2012-12-31;2013-03-22;8062500;8288000;659000;10864000;;15391000;249000;;780000;1029000;16420000;6750000;2610000;9533000;;0;9533000;11075000;-3115000;-1081000;6887000;16420000
MHH;160053;USD;2011;Q4;2011-12-31;2012-03-23;8978000;9287500;5755000;10430000;;18604000;273000;;911000;1184000;19788000;6635000;;6741000;;0;6741000;10151000;-566000;3462000;13047000;19788000
MHH;160053;USD;2010;Q4;2010-12-31;2011-08-02;9227500;9395000;6334000;8057000;;17627000;185000;;585000;770000;18397000;5908000;;6049000;;0;6049000;9999000;;2349000;12348000;18397000
MHH;160053;USD;2018;Q4;2018-12-31;2019-03-29;10986000;11227000;1294000;28913000;;40695000;2208000;;49681000;51889000;92584000;13073000;4575000;17906000;34129000;40402000;58308000;20955000;-4174000;17614000;34276000;92584000
NEOS;160118;USD;2015;Q4;2015-12-31;2016-03-18;16151708;16151708;90763000;3903000;2520000;98244000;5124000;;19142000;24266000;122510000;7965000;7973000;15938000;26271000;28198000;44136000;195330000;-171000;-116785000;78374000;122510000
NEOS;160118;USD;2014;Q4;2014-12-31;2015-09-04;882001;882001;16343000;367000;2031000;19005000;5831000;;20394000;26225000;45230000;3972000;1653000;5625000;23121000;28238000;33863000;4832000;;-83614000;11367000;45230000
NEOS;160118;USD;2016;Q4;2016-12-31;2017-03-15;16063399;16063399;39782000;6135000;5767000;55269000;7076000;;17797000;24873000;80142000;13062000;4921000;21645000;58599000;60045000;81690000;198803000;-232000;-200118000;-1548000;80142000
NEOS;160118;USD;2017;Q4;2017-12-31;2018-03-16;28881287;28881287;50417000;13671000;11732000;79395000;8203000;;16510000;24713000;104108000;32404000;896000;33300000;58938000;61861000;95161000;274613000;-352000;-265308000;8947000;104108000
NEOS;160118;USD;2018;Q4;2018-12-31;2019-03-18;41522563;41522563;46478000;27801000;10367000;88678000;7914000;;14765000;22679000;111357000;48548000;8557000;57105000;43217000;46407000;103512000;325180000;-352000;-316983000;7845000;111357000
NWS;160346;USD;2017;Q4;2017-06-30;2017-08-14;581800000;581800000;2016000000;1276000000;;3815000000;1624000000;2027000000;7086000000;10737000000;14552000000;1426000000;;2452000000;276000000;1007000000;3459000000;12401000000;;-648000000;11093000000;14552000000
NWS;160346;USD;2016;Q4;2016-06-30;2016-08-12;580000000;584400000;1832000000;1229000000;;3889000000;2405000000;2270000000;6919000000;11594000000;15483000000;1588000000;;2442000000;369000000;1239000000;3681000000;12440000000;;150000000;11802000000;15483000000
NWS;160346;USD;2015;Q4;2015-06-30;2015-08-13;582500000;584800000;1951000000;1283000000;;4014000000;2690000000;2379000000;5952000000;11021000000;15035000000;1363000000;;2110000000;0;789000000;2899000000;12439000000;;88000000;12136000000;15035000000
NWS;160346;USD;2014;Q4;2014-06-30;2014-08-14;579300000;579900000;3145000000;1388000000;;5270000000;3009000000;2609000000;5601000000;11219000000;16489000000;1464000000;;2264000000;;806000000;3070000000;12396000000;;237000000;13419000000;16489000000
NWS;160346;USD;2013;Q4;2013-06-30;2013-11-12;578800000;581200000;2381000000;1335000000;;4643000000;2992000000;2499000000;5509000000;11000000000;15643000000;1350000000;;2171000000;;776000000;2947000000;12287000000;;;12696000000;15643000000
NWS;160346;USD;2018;Q4;2018-06-30;2018-08-15;583000000;581900000;2034000000;1612000000;376000000;4394000000;2560000000;393000000;8999000000;11952000000;16346000000;1945000000;462000000;3295000000;1490000000;2554000000;5849000000;12328000000;;-2163000000;10497000000;16346000000
NWS;160346;USD;2019;Q4;2019-06-30;2019-08-13;585000000;590100000;1643000000;1544000000;348000000;4050000000;2554000000;335000000;8772000000;11661000000;15711000000;1739000000;449000000;3340000000;1004000000;2060000000;5400000000;12249000000;;-1979000000;10311000000;15711000000
ABMC;160965;USD;2017;Q4;2017-12-31;2018-04-12;29463307;29463307;36000;348000;1473000;1954000;792000;;145000;937000;2891000;944000;87000;1477000;772000;791000;2268000;21468000;;-20845000;623000;2891000
ABMC;160965;USD;2016;Q4;2016-12-31;2017-03-31;28686918;28546085;156000;556000;1582000;2386000;824000;;161000;985000;3371000;879000;75000;1593000;753000;753000;2346000;21325000;;-20300000;1025000;3371000
ABMC;160965;USD;2015;Q4;2015-12-31;2016-03-30;26052704;26052704;158000;672000;1746000;2616000;910000;;160000;1070000;3686000;877000;75000;1729000;834000;996000;2725000;20916000;;-19955000;961000;3686000
ABMC;160965;USD;2014;Q4;2014-12-31;2015-03-31;23544129;23451702;352000;814000;1722000;3016000;983000;;79000;1062000;4078000;866000;858000;2703000;213000;405000;3108000;20592000;;-19622000;970000;4078000
ABMC;160965;USD;2013;Q4;2013-12-31;2014-03-31;22583536;22583536;646000;875000;2071000;3739000;1090000;;137000;1227000;4966000;1144000;1226000;3357000;0;271000;3628000;20470000;;-19132000;1338000;4966000
ABMC;160965;USD;2012;Q4;2012-12-31;2013-03-28;22009473;22009473;89000;810000;2571000;3520000;1192000;;67000;1259000;4779000;1421000;1404000;3146000;;269000;3415000;19708000;;-18344000;1364000;4779000
ABMC;160965;USD;2011;Q4;2011-12-31;2012-04-16;21744768;21744768;93000;883000;3239000;4276000;1304000;;56000;1360000;5636000;1112000;872000;2391000;608000;875000;3266000;19603000;;-17233000;2370000;5636000
ABMC;160965;USD;2010;Q4;2010-12-31;2011-08-15;;;37000;743000;3604000;4505000;1409000;;101000;1510000;6015000;971000;130000;1604000;1480000;1754000;3358000;19545000;;-16888000;2657000;6015000
ABMC;160965;USD;2018;Q4;2018-12-31;2019-04-16;30460058;30460058;113000;452000;1019000;1613000;718000;;144000;862000;2475000;1086000;237000;1825000;;796000;2621000;21727000;;-21873000;-146000;2475000
ICPW;161289;USD;2015;Q4;2015-12-31;2016-03-23;82965007;82965007;276981;8857768;6853308;16598474;337913;;1979201;2317114;18915588;3358724;3224780;6583504;;;6583504;20858949;;-8526865;12332084;18915588
ICPW;161289;USD;2014;Q4;2014-12-31;2015-08-12;80860693;124256073;340903;6283032;7785398;15158355;290676;;1805370;2096046;17254401;2589623;2586034;5175657;;;5175657;20374294;;-8295550;12078744;17254401
ICPW;161289;USD;2013;Q4;2013-12-31;2014-03-18;76705545;95939194;313750;6782191;5439064;13216624;191318;;946464;1137782;14354406;2129905;2169411;4299316;;;4299316;19284959;;-9229869;10055090;14354406
ICPW;161289;USD;2012;Q4;2012-12-31;2013-03-14;76410964;87947523;721589;6423670;5997718;15224783;256037;;142372;398409;15623192;4932648;1483883;6416531;;;6416531;18997259;;-9790598;9206661;15623192
ICPW;161289;USD;2011;Q4;2011-12-31;2012-03-08;73827123;96739691;1060125;798004;4916378;9503132;319534;;142766;462300;9965432;2560504;1661220;4221724;;;4221724;18613114;;-12869406;5743708;9965432
ICPW;161289;USD;2010;Q4;2010-12-31;2011-08-10;72951185;106521137;1067437;776943;4302171;8235246;260024;;121312;381336;8616582;2526103;1776388;4302491;;;4302491;18305664;;-13991573;4314091;8616582
ICPW;161289;USD;2016;Q4;2016-12-31;2017-04-17;84512936;84512936;299904;7968513;8841912;17685732;421130;;687320;1108450;18794182;4674106;4248070;8922176;;0;8922176;21367088;;-11495082;9872006;18794182
HPJ;163221;USD;2015;Q4;2015-12-31;2016-03-29;15101837;15468152;5849967;36139866;19218331;80682981;47464186;0;6057317;53521503;134204484;44152901;46174752;91207597;;140549;91348146;11229489;;28140604;42856338;134204484
HPJ;163221;USD;2014;Q4;2014-12-31;2015-03-30;15072809;15770965;14611892;32316607;22268069;89163853;50437718;;6552501;56990219;146154072;52427850;47057536;101372795;1959247;3026921;104399716;10531938;;24286522;41754356;146154072
HPJ;163221;USD;2013;Q4;2013-12-31;2014-03-31;13862534;13928650;7973459;33961014;19739360;97308244;48548203;;5936929;54485132;151793376;49107787;63380897;113164205;3935071;3935071;117099276;6012703;;21533286;34694100;151793376
HPJ;163221;USD;2012;Q4;2012-12-31;2013-04-02;13582106;13582106;6627334;25323899;16719807;80785553;33462369;;6141810;39604179;120389732;33175582;48801566;82638326;5777286;5777286;88415612;6036588;;20082068;31974120;120389732
HPJ;163221;USD;2011;Q4;2011-12-31;2012-03-30;13582106;13582106;5175623;21129418;13512942;58335426;25462656;;4755827;30218483;88553909;29506421;27455226;59841647;0;0;59841647;5832595;;18365046;28712262;88553909
HPJ;163221;USD;2010;Q4;2010-12-31;2011-08-15;13582106;13322136;8490629;19949243;13944352;51594305;13837581;157027;4607519;18602127;70196432;19036573;21197108;41653304;;0;41653304;5181676;;20819045;28543128;70196432
HPJ;163221;USD;2016;Q4;2016-12-31;2017-03-28;15114575;15135691;9324393;46280769;22207333;104536987;43504991;9689576;5600196;58794763;163331750;62575755;53175195;118034754;;259;118035013;11582445;;34258531;45296737;163331750
HPJ;163221;USD;2017;Q4;2017-12-31;2018-04-04;15500720;15444334;14502171;58252999;42946644;155983609;46520776;9906379;7853774;64280929;220264538;76220748;75744282;152274668;;777685;153052353;12711307;;51031383;67212185;220264538
HPJ;163221;USD;2018;Q4;2018-12-31;2019-03-28;15560899;15688380;24916484;77279817;54790461;214967402;56523177;9993852;6571668;73088697;288056099;96472112;107225454;210800132;;0;210800132;13864838;;64185964;77255967;288056099
SPAN;164268;USD;2016;Q4;2016-09-30;2016-12-23;2750220;2766994;3752945;8079500;7437442;20608154;4116070;;8837315;12953385;33561539;5993833;;5993833;;556109;6549942;379828;;29133746;27011597;33561539
SPAN;164268;USD;2015;Q4;2015-09-30;2016-01-04;2980132;3003725;1224026;7813773;8746039;18546818;4536104;;9098700;13634804;32181622;7155444;;7155444;;724418;7879862;0;;26848299;24301760;32181622
SPAN;164268;USD;2014;Q4;2014-09-30;2014-12-23;2962008;2999959;6865931;5851822;7395955;21146503;4888096;;9812235;14700331;35846834;4528860;;4528860;;618142;5147002;3971492;;27735768;30699832;35846834
SPAN;164268;USD;2013;Q4;2013-09-30;2013-12-27;2941564;2997005;5424521;7787837;6445950;20705261;5136535;;10534832;15671367;36376628;5533725;;5533725;;729122;6262847;3499020;;26828012;30113781;36376628
SPAN;164268;USD;2012;Q4;2012-09-30;2012-12-28;2919251;2974382;2665302;8238266;9418842;21250742;5390675;;11006349;16397024;37647766;6720346;;6720346;;847436;7567782;3595611;;26199977;30079984;37647766
SPAN;164268;USD;2011;Q4;2011-09-30;2011-12-30;2793525;2846058;6126237;6350360;7669741;20916648;5155528;;4523824;9679352;30596000;5604885;;5604885;;769992;6374877;1877694;;22343429;24221123;30596000
SPAN;164268;USD;2010;Q4;2010-09-30;2011-08-16;2757899;2837461;4482706;7129352;4135379;16845372;5684797;;4682019;10366816;27212188;4976981;;4976981;;856618;5833599;1567437;;19811152;21378589;27212188
NLST;164920;USD;2017;Q4;2017-12-31;2018-03-30;72883000;72883000;6720000;2997000;4105000;16925000;459000;;1406000;1865000;18790000;7265000;;9289000;14766000;14827000;24116000;152720000;;-158046000;-5326000;18790000
NLST;164920;USD;2016;Q4;2016-12-31;2016-03-04;61237000;61237000;9476000;1751000;3160000;19253000;645000;;70000;715000;19968000;5383000;151000;6210000;14251000;14287000;20497000;144097000;;-144626000;-529000;19968000
NLST;164920;USD;2015;Q4;2015-12-31;2015-05-12;50452000;50452000;19684000;716000;1658000;24197000;408000;;61000;469000;24666000;5346000;13000;12216000;13735000;13784000;26000000;132061000;;-133395000;-1334000;24666000
NLST;164920;USD;2014;Q4;2014-12-31;2015-03-27;41391000;41391000;11040000;1091000;1880000;15699000;393000;;150000;543000;16242000;5587000;2205000;7792000;3632000;3731000;11523000;117587000;;-112868000;4719000;16242000
NLST;164920;USD;2013;Q4;2013-12-31;2014-03-18;31731000;31731000;6701000;4866000;2620000;16110000;1143000;;422000;1565000;17675000;5463000;;5463000;5099000;5199000;10662000;104500000;;-97487000;7013000;17675000
NLST;164920;USD;2012;Q4;2012-12-31;2013-03-29;28373000;28373000;8170000;3434000;7380000;19707000;2560000;;130000;2690000;22397000;5098000;3493000;8591000;;94000;8685000;100433000;;-86721000;13712000;22397000
NLST;164920;USD;2011;Q4;2011-12-31;2012-02-28;25446000;25446000;10535000;11399000;6057000;28797000;2771000;444000;161000;3376000;32173000;8878000;2144000;11022000;1118000;1212000;12234000;92735000;;-72740000;19939000;32173000
NLST;164920;USD;2018;Q4;2018-12-31;2019-03-22;138736000;138736000;14802000;2917000;2946000;23192000;279000;;1394000;1673000;24865000;10444000;376000;13113000;17346000;17424000;30537000;169494000;;-175166000;-5672000;24865000
ARCI;165913;USD;2017;Q4;2018-01-31;2018-06-12;20163690;20113690;3313000;10036000;762000;21117000;538000;;25236000;25774000;46891000;9885000;5877000;15762000;;4891000;20653000;37641000;;-10910000;26238000;46891000
ARCI;165913;USD;2016;Q4;2017-01-31;2017-03-31;6395000;6395000;968000;8971000;1119000;28545000;9563000;;3748000;13311000;41856000;15031000;2093000;27457000;2826000;3190000;30647000;22405000;;-11028000;11209000;41856000
ARCI;165913;USD;2015;Q4;2016-01-31;2016-04-04;11695199;11695198;1969000;11536000;16733000;32714000;10985000;;3147000;14132000;46846000;15953000;1251000;29872000;4573000;4930000;34802000;21466000;;-9577000;12044000;46846000
ARCI;165913;USD;2014;Q4;2015-01-31;2015-03-30;5797000;5507000;3523000;10954000;16113000;34477000;11761000;;722000;12483000;46960000;14513000;1138000;24888000;5118000;6535000;31423000;21137000;;-6860000;15537000;46960000
ARCI;165913;USD;2013;Q4;2014-01-31;2014-03-14;5572000;5926000;1948000;12278000;16654000;33391000;11424000;;1448000;12872000;46263000;13766000;1131000;24558000;5447000;7057000;31615000;20846000;;-7631000;14648000;46263000
ARCI;165913;USD;2012;Q4;2013-01-31;2013-03-22;5556000;5556000;3174000;6256000;17274000;28558000;12248000;;998000;13246000;41804000;9267000;955000;20781000;6357000;7789000;28570000;20577000;;-8649000;13234000;41804000
ARCI;165913;USD;2011;Q4;2012-01-31;2012-03-15;5509000;5874000;4401000;7445000;18456000;31895000;12535000;;2379000;14914000;46809000;8776000;989000;20450000;7251000;8979000;29429000;20338000;;-4797000;17380000;46809000
ARCI;165913;USD;2010;Q4;2011-01-31;2011-08-15;5495000;5764000;3065000;5030000;16593000;25207000;11747000;;2910000;14657000;39864000;9299000;4396000;23876000;2501000;3841000;27717000;19740000;;-9258000;12147000;39864000
ARCI;165913;USD;2018;Q4;2019-01-31;2019-04-02;22211250;29878575;1195000;5804000;801000;8518000;617000;;25486000;26103000;34621000;9009000;256000;9265000;0;3745000;13010000;38662000;;-16518000;21611000;34621000
MRCY;166196;USD;2017;Q4;2017-06-30;2017-08-18;46155000;47408000;41637000;76341000;81071000;246196000;51643000;;517906000;569549000;815745000;66485000;;72845000;;17483000;90328000;585258000;;139085000;725417000;815745000
MRCY;166196;USD;2016;Q4;2016-06-30;2016-08-16;37815000;38950000;81691000;73427000;58284000;245392000;28337000;;462767000;491104000;736496000;50279000;10000000;67644000;182275000;195808000;263452000;357887000;;114210000;473044000;736496000
MRCY;166196;USD;2015;Q4;2015-06-30;2015-08-13;32471000;33356000;77586000;31765000;31960000;175757000;13226000;;197897000;211123000;386880000;25808000;0;33285000;0;3457000;36742000;254894000;;94468000;350138000;386880000
MRCY;166196;USD;2014;Q4;2014-06-30;2014-08-14;31203000;31203000;47287000;37625000;31655000;160305000;14144000;;199263000;213407000;373712000;25414000;;32930000;;13635000;46565000;242037000;;84099000;327147000;373712000
MRCY;166196;USD;2013;Q4;2013-06-30;2013-08-16;30287000;30112000;39126000;29229000;37432000;146301000;14462000;;213668000;228130000;374431000;23376000;;30818000;;15112000;45930000;232015000;;95524000;328501000;374431000
MRCY;166196;USD;2012;Q4;2012-06-30;2012-08-22;29612000;30170000;115964000;38532000;25845000;207703000;15929000;;161974000;177903000;385606000;32087000;;36942000;;15560000;52502000;223066000;;108732000;333104000;385606000
MRCY;166196;USD;2011;Q4;2011-06-30;2011-11-04;-63799000;30103000;162875000;44786000;18540000;240184000;14520000;;100858000;115378000;355562000;30068000;;36206000;;17920000;54126000;214068000;;86113000;301436000;355562000
MRCY;166196;USD;2018;Q4;2018-06-30;2018-08-16;46776000;47416000;66521000;104040000;108585000;331743000;50980000;;681757000;732737000;1064480000;59084000;;71680000;195000000;220909000;292589000;590632000;;179968000;771891000;1064480000
MRCY;166196;USD;2019;Q4;2019-06-30;2019-08-15;49829000;50640000;257932000;118832000;137112000;582172000;60001000;;774804000;834805000;1416977000;86741000;;98032000;0;34206000;132238000;1059287000;;226743000;1284739000;1416977000
SPLS;166539;USD;2016;Q4;2016-12-31;2017-03-09;645000000;650000000;825000000;1899000000;2078000000;5112000000;1586000000;;3474000000;5060000000;10172000000;3247000000;17000000;3264000000;1018000000;1524000000;4788000000;5011000000;-5419000000;6900000000;5384000000;10172000000
SPLS;166539;USD;2015;Q4;2015-12-31;2016-03-04;640000000;644000000;627000000;1928000000;2144000000;4951000000;1706000000;;3651000000;5357000000;10308000000;3197000000;92000000;3289000000;1018000000;1706000000;4995000000;4936000000;-5419000000;6829000000;5313000000;10308000000
SPLS;166539;USD;2014;Q4;2014-12-31;2015-03-06;647393000;650458000;492532000;1838714000;2328299000;5239558000;1870719000;;4064599000;5935318000;11174876000;3264468000;103982000;3368450000;1000205000;1665591000;5034041000;4867030000;-5229368000;7001755000;6140835000;11174876000
SPLS;166539;USD;2013;Q4;2013-12-31;2014-03-06;657819000;642366000;1334302000;1815586000;2314058000;6200437000;1963175000;;4116393000;6079568000;12280005000;3301792000;987161000;4418625000;1001943000;1725286000;6143911000;4711672000;-4888953000;6694207000;6136094000;12280005000
SPLS;166539;USD;2012;Q4;2012-12-31;2013-03-06;683504000;691993000;1264149000;2033680000;2431845000;6290820000;2080361000;;5059441000;7139802000;13430622000;3635135000;439143000;4074278000;1599037000;2334131000;6408409000;4551852000;-4416018000;7199060000;7022213000;13430622000
SPLS;166539;USD;2011;Q4;2011-12-31;2012-02-29;709923000;721163000;1461257000;1970483000;2359173000;6468167000;2147771000;;5295729000;7443500000;13911667000;3706237000;587356000;4293593000;2014407000;2666893000;6960486000;4335280000;-3786977000;6492340000;6951181000;13911667000
SPLS;166539;USD;2010;Q4;2010-12-31;2010-03-02;714919000;727319000;1415819000;1811365000;2261149000;6174767000;2164533000;;5378034000;7542567000;13717334000;3715050000;67269000;3782319000;2500329000;3080075000;6862394000;4380480000;-3388395000;5869138000;6854940000;13717334000
SPLS;166539;USD;2009;Q4;2009-12-31;2009-08-25;;;633774000;1841231000;2404174000;5797258000;2290626000;;4985171000;7275797000;13073055000;3372306000;1473248000;4845554000;1968928000;2605070000;7450624000;4048927000;-3357734000;5367341000;5622431000;13073055000
SPLS;166539;USD;2017;Q4;2017-12-31;2016-11-17;652000000;646000000;1137000000;1538000000;1737000000;5231000000;1147000000;;1893000000;3040000000;8271000000;2729000000;519000000;3650000000;529000000;925000000;4575000000;5068000000;-5419000000;5092000000;3696000000;8271000000
HURN;166848;USD;2016;Q4;2016-12-31;2017-02-23;21085000;21415000;17027000;94246000;;180082000;32434000;34675000;906024000;973133000;1153215000;109730000;;135768000;292065000;369414000;505182000;406130000;-113195000;351483000;648033000;1153215000
HURN;166848;USD;2015;Q4;2015-12-31;2016-02-23;22091000;22552000;58437000;85297000;;228387000;28888000;34831000;867437000;931156000;1159543000;112335000;;131421000;307376000;375797000;507218000;438608000;-103734000;313866000;652325000;1159543000
HURN;166848;USD;2014;Q4;2014-12-31;2015-02-24;22003000;22541000;256872000;76490000;;486159000;30691000;12250000;626814000;669755000;1155914000;133377000;28750000;176376000;327852000;378904000;555280000;442549000;-94074000;254814000;600634000;1155914000
HURN;166848;USD;2013;Q4;2013-12-31;2014-02-26;22412000;22988000;58131000;123750000;;272514000;38742000;;574344000;613086000;885600000;133136000;25000000;173384000;143750000;181952000;355336000;443389000;-88091000;175763000;530264000;885600000
HURN;166848;USD;2012;Q4;2012-12-31;2013-02-21;21977000;22402000;25162000;97510000;;200372000;33805000;;553723000;587528000;787900000;101337000;;116725000;192500000;225854000;342579000;421065000;-83715000;109330000;445321000;787900000
HURN;166848;USD;2011;Q4;2011-12-31;2012-02-23;21630000;22103000;5080000;107820000;;211524000;31176000;;543944000;575120000;786644000;132216000;;169702000;193500000;220153000;389855000;400831000;-75735000;72902000;396789000;786644000
HURN;166848;USD;2010;Q4;2010-12-31;2011-02-22;20735000;20995000;6271000;88860000;;200614000;32935000;0;555434000;588369000;788983000;145814000;;166159000;257000000;274452000;440611000;363624000;-65675000;52383000;348372000;788983000
HURN;166848;USD;2009;Q4;2009-12-31;2010-07-29;20273000;21921000;5715000;75845000;;192783000;39133000;;522299000;561432000;754215000;170155000;278000;192993000;219005000;234233000;427226000;335485000;-51561000;43858000;326989000;754215000
HURN;166848;USD;2017;Q4;2017-12-31;2018-02-28;21520000;21168000;16909000;101778000;;208047000;45541000;39904000;743436000;828881000;1036928000;103036000;;139467000;342507000;394145000;533612000;434497000;-121994000;180443000;503316000;1036928000
HURN;166848;USD;2018;Q4;2018-12-31;2019-02-27;21778000;22612000;33107000;109677000;;235084000;40374000;50429000;723645000;814448000;1049532000;137052000;243132000;418305000;53853000;90603000;508908000;452817000;-124794000;196106000;540624000;1049532000
AIRI;166965;USD;2017;Q4;2017-12-31;2018-04-19;24159398;24159398;630000;5464000;31141000;47580000;10050000;;3125000;13175000;60755000;10892000;23393000;38049000;3448000;4940000;42989000;71297000;;-53531000;17766000;60755000
AIRI;166965;USD;2016;Q4;2016-12-31;2017-04-21;7534928;7534928;1304000;6073000;32568000;61950000;11197000;;9653000;20850000;82800000;14170000;33999000;53388000;2971000;4522000;57910000;55869000;;-30980000;24890000;82800000
AIRI;166965;USD;2015;Q4;2015-12-31;2016-04-04;7559522;7147658;529000;13662000;36923000;56122000;15299000;;16829000;32128000;88250000;12060000;40895000;53951000;3917000;5494000;59445000;44162000;;-15357000;28805000;88250000
AIRI;166965;USD;2014;Q4;2014-12-31;2015-03-31;7134320;7550353;1418000;11916000;28651000;44237000;9557000;;12386000;21943000;66180000;8085000;19564000;28105000;8217000;9803000;37908000;42797000;;-14525000;28272000;66180000
AIRI;166965;USD;2013;Q4;2013-12-31;2014-03-25;5822777;6278160;561000;8584000;26222000;36928000;6523000;;6721000;13244000;50172000;9068000;15040000;24397000;2583000;4162000;28559000;36805000;;-15192000;21613000;50172000
AIRI;166965;USD;2012;Q4;2012-12-31;2013-03-29;5733689;5883991;490000;11631000;26739000;39539000;5883000;;7734000;13617000;53156000;8525000;19296000;27859000;4767000;6309000;34168000;37919000;;-18931000;18988000;53156000
AIRI;166965;USD;2011;Q4;2011-12-31;2012-10-02;3579114;3579242;577000;6042000;22521000;29472000;3971000;;3538000;7509000;36981000;7473000;14140000;21651000;9167000;10664000;32315000;26145000;;-21479000;4666000;36981000
AIRI;166965;USD;2010;Q4;2010-12-31;2012-10-02;;;537000;4381000;21443000;26643000;3935000;;3806000;7741000;34384000;5866000;13036000;18940000;11796000;13157000;32097000;26013000;;-23726000;2287000;34384000
AIRI;166965;USD;2018;Q4;2018-12-31;2019-04-01;28691954;28602497;2012000;6522000;29051000;38048000;8777000;;931000;9708000;47756000;8743000;19345000;29007000;5721000;7143000;36150000;76129000;;-64523000;11606000;47756000
PRGB;167827;USD;2016;Q4;2016-12-31;2017-04-14;143422490;;78720;436933;92244;728924;2466125;;19041;2485166;3214090;4884372;4012149;15550489;1769355;1769355;17319844;81139730;;-95245530;-14105754;3214090
PRGB;167827;USD;2015;Q4;2015-12-31;2016-03-16;122534445;;6450;195823;111087;411591;2626907;;5248;2632155;3043746;3912867;1323594;9590170;1726158;1726158;11316328;71324887;;-79597608;-8272582;3043746
PRGB;167827;USD;2014;Q4;2014-12-31;2015-02-13;73710797;;322877;273914;161301;931344;2960090;;136693;3096783;4028127;2634883;1457800;7765562;1817237;1817237;9582799;64312402;;-69867118;-5554672;4028127
PRGB;167827;USD;2013;Q4;2013-12-31;2014-03-31;56811280;;1086330;216864;465334;2508502;2886176;;23249;2909425;5417927;1224904;1054053;6848692;1580260;1580260;8428952;55358158;;-58392348;-3011025;5417927
PRGB;167827;USD;2012;Q4;2012-12-31;2013-03-27;;31126510;27604;127721;905186;1399012;2790464;;22555;2813019;4212031;5168887;1374489;10032836;2083026;2083026;12115862;39077250;;-46974678;-7903831;4212031
PRGB;167827;USD;2011;Q4;2011-12-31;2012-03-29;;15701018;505277;76650;223336;1312222;3319219;;17632;3336851;4649073;3254094;398383;6963401;2189454;2189454;9152855;32924818;;-37443419;-4503782;4649073
PRGB;167827;USD;2010;Q4;2010-12-31;2011-08-15;;;410696;50651;267065;1502174;3073804;;22122;3095926;4598100;2342767;369548;5965979;5070064;5070064;11036043;19511942;;-25946087;-6437943;4598100
CRIS;168118;USD;2016;Q4;2016-12-31;2017-03-09;28157236;28157236;44485000;2459000;;48201000;413000;153000;8985000;9551000;57752000;8608000;4939000;13547000;14921000;14939000;28486000;929742000;-1524000;-898948000;29266000;57752000
CRIS;168118;USD;2015;Q4;2015-12-31;2016-02-29;25756478;25756478;82191000;2106000;;85501000;278000;153000;9033000;9464000;94965000;6151000;4607000;10758000;19558000;19697000;30455000;904543000;-1524000;-838537000;64510000;94965000
CRIS;168118;USD;2014;Q4;2014-12-31;2015-02-24;17202371;17202371;49750193;1960995;;52214909;407738;941378;9049544;10398660;62613569;4356882;5709985;10066867;22589058;22763076;32829943;810873947;-1524029;-779555295;29783626;62613569
CRIS;168118;USD;2013;Q4;2013-12-31;2014-03-13;17135228;17135228;58179622;1477188;;60165947;445655;10893172;9086034;20424861;80590808;3948343;2610174;6558517;27945186;28858706;35417223;807531159;-1524029;-760826561;45173585;80590808
CRIS;168118;USD;2012;Q4;2012-12-31;2013-03-13;15997659;14841593;55539398;908064;;56851903;434168;3342430;9139848;12916446;69768349;3978826;;3978826;29838925;31522025;35500851;783648162;-891274;-748504549;34267498;69768349
CRIS;168118;USD;2011;Q4;2011-12-31;2012-02-29;15332036;15332036;37717575;42067;;38503441;455730;235914;8984980;9676624;48180065;3786544;;3786544;;4517564;8304108;772820908;-891274;-732087642;39875957;48180065
CRIS;168118;USD;2010;Q4;2010-12-31;2011-08-04;15135226;13526962;40379818;92371;;41083896;302721;277546;8984980;9565247;50649143;3475573;;5080315;;50216;5130531;768593271;-891274;-722228747;45518612;50649143
CRIS;168118;USD;2017;Q4;2017-12-31;2018-03-08;32844237;32844237;60232000;3073000;;64294000;366000;153000;8985000;9504000;73798000;8216000;5886000;14102000;35669000;35703000;49805000;977784000;-1524000;-952265000;23993000;73798000
CRIS;168118;USD;2018;Q4;2018-12-31;2019-03-26;33122843;33122843;24270000;2864000;;27961000;267000;153000;8984000;9404000;37365000;6366000;6884000;13250000;28600000;28611000;41861000;980344000;0;-984840000;-4496000;37365000
AWK;168302;USD;2017;Q4;2017-12-31;2018-02-20;178000000;179000000;55000000;272000000;41000000;720000000;16246000000;;2516000000;18762000000;19482000000;931000000;1227000000;2325000000;6490000000;11764000000;14089000000;6434000000;-247000000;-723000000;5393000000;19482000000
AWK;168302;USD;2016;Q4;2016-12-31;2016-11-02;178000000;181000000;75000000;269000000;39000000;784000000;14992000000;;2706000000;17698000000;18482000000;857000000;1423000000;2392000000;5749000000;10862000000;13254000000;6390000000;-213000000;-873000000;5228000000;18482000000
AWK;168302;USD;2015;Q4;2015-12-31;2016-02-25;177422000;179647000;45000000;255000000;38000000;657000000;13933000000;;2651000000;16584000000;17241000000;707000000;682000000;1533000000;5862000000;10647000000;12180000000;6353000000;-143000000;-1073000000;5061000000;17241000000
AWK;168302;USD;2014;Q4;2014-12-31;2015-02-25;179606000;180902000;23000000;232000000;37000000;575000000;13029000000;;2434000000;15463000000;16038000000;577000000;511000000;1241000000;5427000000;9867000000;11108000000;6304000000;-11000000;-1296000000;4930000000;16038000000
AWK;168302;USD;2013;Q4;2013-12-31;2014-02-27;178992000;179471000;26964000;241926000;32973000;571807000;12388354000;;2127981000;14516335000;15088142000;348368000;644481000;1235533000;5212881000;9107628000;10343161000;6263180000;-5043000;-1495698000;4744981000;15088142000
AWK;168302;USD;2012;Q4;2012-12-31;2013-03-01;176914000;178324000;24433000;221655000;29772000;499447000;11739364000;;2480165000;14219529000;14718976000;368978000;385904000;994832000;5190509000;9260295000;10255127000;6224414000;0;-1664955000;4463849000;14718976000
AWK;168302;USD;2011;Q4;2011-12-31;2012-02-28;175661000;177064000;14207000;200352000;28598000;1397659000;11021098000;;2357634000;13378732000;14776391000;339382000;543908000;1489105000;5339947000;9025765000;10514870000;6182315000;;-1848801000;4261521000;14776391000
AWK;168302;USD;2010;Q4;2010-12-31;2011-02-28;174979000;175788000;13112000;145747000;27743000;1457775000;10381640000;;2246831000;12628471000;14086246000;285747000;264997000;1106764000;5394135000;8825075000;9931839000;6158425000;-19000;-1959235000;4154407000;14086246000
AWK;168302;USD;2009;Q4;2009-12-31;2010-08-04;174680000;174680000;22256000;149417000;29521000;499127000;10677393000;;2276131000;12953524000;13452651000;244289000;173565000;607392000;5288180000;8815897000;9423289000;6141823000;0;-2076287000;4029362000;13452651000
AWK;168302;USD;2018;Q4;2018-12-31;2019-02-19;182000000;181000000;130000000;301000000;41000000;781000000;17409000000;;3033000000;20442000000;21223000000;863000000;1035000000;2094000000;7569000000;13258000000;15352000000;6659000000;-297000000;-464000000;5871000000;21223000000
QNST;168827;USD;2017;Q4;2017-06-30;2017-09-08;45470000;45255000;49571000;44059000;;99855000;5613000;;68840000;74453000;174308000;51428000;;52554000;;3672000;56226000;263578000;;-145033000;118082000;174308000
QNST;168827;USD;2016;Q4;2016-06-30;2016-08-19;45492000;45492000;53710000;47218000;;107983000;7678000;;77441000;85119000;193102000;47519000;15000000;63719000;;4631000;68350000;257995000;;-132825000;124752000;193102000
QNST;168827;USD;2015;Q4;2015-06-30;2015-08-19;44588000;44588000;60468000;46240000;;118377000;8565000;;78211000;86776000;205153000;47571000;49000;48828000;15000000;20740000;69568000;249403000;;-113405000;135585000;205153000
QNST;168827;USD;2014;Q4;2014-06-30;2014-09-12;44008000;44008000;122807000;41979000;;176656000;11126000;;89061000;100187000;276843000;47371000;17698000;66244000;59565000;65448000;131692000;239602000;;-93397000;145151000;276843000
QNST;168827;USD;2013;Q4;2013-06-30;2013-08-20;42871000;42871000;127964000;38391000;;177731000;9707000;;242109000;251816000;429547000;49625000;15428000;66691000;77249000;83961000;150652000;226900000;;53007000;278895000;429547000
QNST;168827;USD;2012;Q4;2012-06-30;2012-08-23;43955000;44730000;105267000;52830000;;173536000;8755000;;324869000;333624000;507160000;52332000;15429000;70314000;92167000;98489000;168803000;220595000;-1178000;120379000;338357000;507160000
QNST;168827;USD;2011;Q4;2011-06-30;2011-11-08;47140000;49621000;167217000;48225000;;231468000;8875000;;284581000;293456000;524924000;56538000;10038000;69107000;96010000;100428000;169535000;255739000;-7779000;107378000;355389000;524924000
QNST;168827;USD;2018;Q4;2018-06-30;2018-09-12;47514000;51871000;64700000;68492000;;137624000;4211000;;78461000;82672000;220296000;67317000;;68032000;;3938000;71970000;277809000;;-129103000;148326000;220296000
TMED;169714;USD;2015;Q4;2015-09-30;2016-01-13;183960;183960;365000;416000;1808000;2685000;480000;;619000;1099000;3784000;622000;68000;716000;4000;9000;725000;51542000;-713000;-47770000;3059000;3784000
TMED;169714;USD;2014;Q4;2014-09-30;2015-01-13;183960;183960;1292000;463000;1581000;3459000;635000;;617000;1252000;4711000;933000;70000;1053000;43000;49000;1102000;51497000;-713000;-47175000;3609000;4711000
TMED;169714;USD;2013;Q4;2013-09-30;2014-01-14;183960;183960;1572000;475000;1201000;3414000;706000;;581000;1287000;4701000;617000;49000;703000;0;11000;714000;51494000;-713000;-46794000;3987000;4701000
TMED;169714;USD;2012;Q4;2012-09-30;2013-01-29;183960;183960;472000;493000;1847000;2970000;751000;;612000;1363000;4333000;524000;68000;645000;;43000;688000;51481000;-713000;-47123000;3645000;4333000
TMED;169714;USD;2011;Q4;2011-09-30;2012-02-07;184089;184089;1151000;598000;2162000;4054000;1027000;;636000;1663000;5717000;924000;133000;1150000;13000;113000;1263000;51454000;-713000;-46287000;4454000;5717000
TMED;169714;USD;2010;Q4;2010-09-30;2011-08-22;183660;280458;2528000;691000;2613000;6009000;908000;;646000;1554000;7563000;748000;161000;984000;493000;669000;1653000;51424000;-713000;-44801000;5910000;7563000
CDNA;171003;USD;2014;Q4;2014-12-31;2015-03-31;11958955;17961079;36431000;2687000;686000;40346000;1968000;;18827000;20795000;61141000;4669000;5961000;11135000;5451000;8708000;19843000;200673000;;-159375000;41298000;61141000
CDNA;171003;USD;2013;Q4;2013-12-31;2014-08-28;1010237;1010237;5128000;2270000;518000;8171000;1553000;;149000;1702000;9873000;3052000;4461000;7593000;10914000;17751000;25344000;9483000;;-160156000;-15471000;9873000
ZYXI;171401;USD;2017;Q4;2017-12-31;2018-02-28;32831141;34412516;5565000;2185000;423000;8371000;188000;;370000;558000;8929000;2781000;354000;4015000;;12000;4027000;7645000;-243000;-2411000;4902000;8929000
ZYXI;171401;USD;2016;Q4;2016-12-31;2017-04-17;31271468;31101468;247000;3028000;107000;3422000;580000;;89000;669000;4091000;3976000;118000;7745000;136000;148000;7893000;6063000;0;-9776000;-3802000;4091000
ZYXI;171401;USD;2015;Q4;2015-12-31;2016-03-31;31271234;31271234;8000;2426000;305000;2766000;801000;;129000;930000;3696000;3339000;109000;7539000;216000;228000;7767000;5863000;;-9845000;-4071000;3696000
ZYXI;171401;USD;2014;Q4;2014-12-31;2015-03-31;31272421;31272421;63000;3189000;1935000;5705000;1276000;;133000;1409000;7114000;3425000;78000;8057000;311000;324000;8381000;5733000;;-6934000;-1267000;7114000
ZYXI;171401;USD;2013;Q4;2013-12-31;2014-03-28;31163358;31163358;323000;7033000;5002000;13704000;2891000;;626000;3517000;17221000;3765000;92000;9684000;150000;2689000;12373000;5617000;;-735000;4848000;17221000
ZYXI;171401;USD;2012;Q4;2012-12-31;2013-03-28;31145134;31285144;823000;12224000;6160000;21362000;3705000;;869000;4574000;25936000;5651000;144000;12093000;114000;1788000;13881000;5484000;;6566000;12055000;25936000
ZYXI;171401;USD;2011;Q4;2011-12-31;2012-03-28;30818427;31243642;789000;10984000;4556000;18048000;3422000;;315000;3737000;21785000;6032000;131000;9748000;258000;1897000;11645000;5127000;;5013000;10140000;21785000
ZYXI;171401;USD;2010;Q4;2010-12-31;2011-08-12;30516946;30584656;602000;7309000;3641000;12532000;2906000;;263000;3169000;15701000;3968000;93000;5552000;327000;1967000;7519000;4733000;;3449000;8182000;15701000
RGS;171506;USD;2018;Q4;2018-06-30;2018-08-23;45958000;46773000;110399000;52430000;79363000;290059000;105860000;;460816000;566676000;856735000;155368000;;155368000;90000000;197875000;353243000;196699000;;297225000;503492000;856735000
RGS;171506;USD;2017;Q4;2017-06-30;2017-08-23;46522000;46127000;171044000;19683000;98392000;370147000;123281000;;518060000;641341000;1011488000;164936000;;178062000;120599000;325205000;503267000;216429000;;288456000;508221000;1011488000
RGS;171506;USD;2016;Q4;2016-06-30;2016-08-23;46334000;46334000;147346000;24691000;134212000;358014000;183321000;;494597000;677918000;1035932000;195315000;;195315000;119606000;321216000;516531000;209783000;;304550000;519401000;1035932000
RGS;171506;USD;2015;Q4;2015-06-30;2015-08-28;54253000;54253000;212279000;24631000;128610000;428282000;218157000;;515576000;733733000;1162015000;216666000;;216666000;120000000;317905000;534571000;301079000;;316859000;627444000;1162015000
RGS;171506;USD;2014;Q4;2014-06-30;2014-08-26;56625000;56625000;378627000;25808000;137151000;613266000;266538000;;536145000;802683000;1415949000;213035000;173501000;386536000;120002000;315421000;701957000;340670000;;350671000;713992000;1415949000
RGS;171506;USD;2013;Q4;2013-06-30;2013-08-27;56394000;45501000;200488000;33062000;139607000;488546000;313460000;;588486000;901946000;1390492000;203297000;173515000;376812000;1255000;156266000;533078000;337098000;;499760000;857414000;1390492000
RGS;171506;USD;2012;Q4;2012-06-30;2012-08-29;57789000;45980000;111943000;28954000;142276000;384677000;305799000;;881370000;1187169000;1571846000;204916000;28937000;251973000;258737000;430716000;682689000;349814000;;484229000;889157000;1571846000
RGS;171506;USD;2011;Q4;2011-06-30;2011-08-26;56799000;34015000;96263000;27149000;150804000;346562000;347811000;;1111380000;1459191000;1805753000;222428000;32252000;254680000;281159000;518454000;773134000;344076000;;610597000;1032619000;1805753000
RGS;171506;USD;2010;Q4;2010-06-30;2010-11-09;56493000;88957000;151871000;24312000;153380000;428865000;359250000;;1131457000;1490707000;1919572000;218480000;51629000;270109000;388400000;636170000;906279000;335250000;;631011000;1013293000;1919572000
RGS;171506;USD;2019;Q4;2019-06-30;2019-08-27;38653000;37793000;70141000;30143000;77322000;210822000;78090000;;393925000;472015000;682837000;128283000;;128283000;90000000;230309000;358592000;48995000;;265908000;324245000;682837000
NVDA;172199;USD;2016;Q4;2017-01-31;2017-03-01;555000000;710000000;6798000000;826000000;794000000;8536000000;521000000;;784000000;1305000000;9841000000;485000000;796000000;1788000000;1989000000;2291000000;4079000000;4709000000;-5039000000;6108000000;5762000000;9841000000
NVDA;172199;USD;2015;Q4;2016-01-31;2016-03-17;540000000;587000000;5037000000;505000000;418000000;6053000000;466000000;;851000000;1317000000;7370000000;296000000;1413000000;2351000000;10000000;550000000;2901000000;4171000000;-4048000000;4350000000;4469000000;7370000000
NVDA;172199;USD;2014;Q4;2015-01-31;2015-03-12;543000000;553000000;4623000000;474000000;483000000;5713000000;557000000;;931000000;1488000000;7201000000;293000000;0;896000000;1398000000;1887000000;2783000000;3856000000;-3395000000;3949000000;4418000000;7201000000
NVDA;172199;USD;2013;Q4;2014-01-31;2014-03-13;568913000;579940000;4671810000;426357000;387765000;5624711000;582740000;;1043443000;1626183000;7250894000;324391000;;945496000;1373875000;1849000000;2794496000;3484074000;-2537295000;3504742000;4456398000;7250894000
NVDA;172199;USD;2012;Q4;2013-01-31;2013-03-12;620168000;624054000;3727883000;454252000;412467000;4775258000;576144000;;1060843000;1636987000;6412245000;356428000;;976223000;18998000;608319000;1584542000;3194343000;-1622709000;3246088000;4827703000;6412245000
NVDA;172199;USD;2011;Q4;2012-01-31;2012-03-13;611379000;624516000;3129576000;336143000;340297000;3905358000;560072000;;1087498000;1647570000;5552928000;335072000;;929958000;21439000;477246000;1407204000;2901596000;-1496904000;2730418000;4145724000;5552928000
NVDA;172199;USD;2010;Q4;2011-01-31;2011-03-16;1722245053;1770924239;2490563000;348770000;345525000;3226950000;568857000;;699439000;1268296000;4495246000;286138000;;942682000;23389000;371102000;1313784000;2501254000;-1479392000;2149328000;3181462000;4495246000
NVDA;172199;USD;2009;Q4;2010-01-31;2010-12-07;1099831693;1076733693;1728227000;374963000;330674000;2480830000;571858000;;533230000;1105088000;3585918000;344527000;;784378000;24450000;136400000;920778000;2220054000;-1463268000;1896182000;2665140000;3585918000
NVDA;172199;USD;2008;Q4;2009-01-31;2009-08-20;-1652676496;-1769277496;1255390000;318435000;537834000;2167958000;625798000;;556971000;1182769000;3350727000;218864000;;778591000;25634000;177484000;956075000;1889886000;-1463268000;1964169000;2394652000;3350727000
NVDA;172199;USD;2017;Q4;2018-01-31;2018-02-28;604000000;626000000;7108000000;1265000000;796000000;9255000000;997000000;;989000000;1986000000;11241000000;596000000;15000000;1153000000;1985000000;2617000000;3770000000;5352000000;-6650000000;8787000000;7471000000;11241000000
NVDA;172199;USD;2018;Q4;2019-01-31;2019-02-21;610000000;622000000;7422000000;1424000000;1575000000;10557000000;1404000000;;1331000000;2735000000;13292000000;511000000;0;1329000000;1988000000;2621000000;3950000000;6052000000;-9263000000;12565000000;9342000000;13292000000
LTRX;172507;USD;2016;Q4;2016-06-30;2016-08-24;15552000;15552000;5962000;3164000;6584000;16659000;1569000;;9551000;11120000;27779000;4538000;;7598000;116000;463000;8061000;209299000;;-189952000;19718000;27779000
LTRX;172507;USD;2015;Q4;2015-06-30;2015-08-21;15013000;15013000;4989000;2658000;9503000;17919000;1471000;;9581000;11052000;28971000;5318000;;10030000;152000;232000;10262000;206328000;;-187990000;18709000;28971000
LTRX;172507;USD;2014;Q4;2014-06-30;2014-08-22;14741000;14741000;6264000;3631000;8404000;19182000;1487000;;10013000;11500000;30682000;6410000;;10378000;7000;138000;10516000;205014000;;-185219000;20166000;30682000
LTRX;172507;USD;2013;Q4;2013-06-30;2013-08-29;58252284;58252284;5243000;2599000;8741000;17621000;1687000;;10051000;11738000;29359000;4386000;167000;9099000;54000;303000;9402000;203872000;;-184286000;19957000;29359000
LTRX;172507;USD;2012;Q4;2012-06-30;2012-08-30;13236;13286;11374000;2674000;5955000;21174000;1605000;;9866000;11471000;32645000;5663000;667000;10195000;215000;518000;10713000;203050000;;-181517000;21932000;32645000
LTRX;172507;USD;2011;Q4;2011-06-30;2011-11-14;-31200264;-31200264;5836000;2908000;9160000;19145000;1761000;;10286000;12047000;31192000;10358000;667000;15061000;878000;1428000;16489000;192781000;;-178477000;14703000;31192000
LTRX;172507;USD;2017;Q4;2017-06-30;2017-08-24;17681000;17325000;8073000;3432000;6959000;19380000;1218000;;9534000;10752000;30132000;5801000;;8989000;59000;455000;9444000;210552000;;-190235000;20688000;30132000
LTRX;172507;USD;2018;Q4;2018-06-30;2018-08-23;18534000;20908000;9568000;4244000;8439000;23270000;1036000;;9549000;10585000;33855000;6750000;;9726000;4000;316000;10042000;212997000;;-189555000;23813000;33855000
LTRX;172507;USD;2019;Q4;2019-06-30;2019-09-11;22636000;21251000;18282000;7388000;10509000;38190000;1199000;;9555000;10754000;48944000;6776000;;11472000;0;206000;11678000;226276000;;-189381000;37266000;48944000
EL;172930;USD;2016;Q4;2016-06-30;2016-08-24;368800000;375800000;1383400000;1258300000;1263400000;4225100000;1583300000;1107700000;2307200000;4998200000;9223300000;2349000000;331500000;2680500000;1910000000;2955500000;5636000000;3166400000;-6743000000;7693300000;3587300000;9223300000
EL;172930;USD;2015;Q4;2015-06-30;2015-08-20;376900000;383800000;1525100000;1174500000;1215800000;4183600000;1490200000;420300000;2132800000;4043300000;8226900000;2100000000;29800000;2129800000;1595100000;2442800000;4572600000;2877300000;-5856700000;7004100000;3654300000;8226900000
EL;172930;USD;2014;Q4;2014-06-30;2014-08-20;382900000;390000000;1629100000;1379300000;1294000000;4825200000;1502600000;13600000;1527400000;3043600000;7868800000;2038300000;18400000;2056700000;1324700000;1942700000;3999400000;2568300000;-4878900000;6265800000;3869400000;7868800000
EL;172930;USD;2013;Q4;2013-06-30;2013-08-23;388000000;395400000;1495700000;1171700000;1113900000;4297200000;1350700000;;1497300000;2848000000;7145200000;1916300000;18300000;1934600000;1326000000;1908700000;3843300000;2295500000;-4215200000;5364100000;3301900000;7145200000
EL;172930;USD;2012;Q4;2012-06-30;2012-08-17;389300000;397200000;1347700000;1060300000;983600000;3855100000;1231800000;;1506100000;2737900000;6593000000;1906800000;219000000;2125800000;1069100000;1719700000;3845500000;2011600000;-3830400000;4764900000;2747500000;6593000000
EL;172930;USD;2011;Q4;2011-06-30;2011-08-22;393900000;402900000;1253000000;945600000;995600000;3686500000;1143100000;;1444300000;2587400000;6273900000;1805300000;138000000;1943300000;1080100000;1683600000;3626900000;1741100000;-3243100000;4113700000;2647000000;6273900000
EL;172930;USD;2010;Q4;2010-06-30;2010-11-01;397600000;405200000;1120700000;746200000;826600000;3121000000;1023600000;;1191000000;2214600000;5335600000;1548800000;23400000;1572200000;1205000000;1798000000;3370200000;1431400000;-2850300000;3564000000;1965400000;5335600000
EL;172930;USD;2017;Q4;2017-06-30;2017-08-25;368100000;373800000;1741000000;1395000000;1479000000;4964000000;1671000000;1026000000;3907000000;6604000000;11568000000;2634000000;189000000;2823000000;3383000000;4343000000;7166000000;3565000000;-7149000000;8452000000;4402000000;11568000000
EL;172930;USD;2018;Q4;2018-06-30;2018-08-24;367000000;375600000;2715000000;1487000000;1618000000;6168000000;1823000000;843000000;3733000000;6399000000;12567000000;3127000000;183000000;3310000000;3361000000;4547000000;7857000000;3978000000;-7896000000;9040000000;4710000000;12567000000
EL;172930;USD;2019;Q4;2019-06-30;2019-08-23;362000000;369000000;2987000000;1831000000;2006000000;7212000000;2068000000;;3876000000;5944000000;13156000000;4089000000;516000000;4605000000;2896000000;4140000000;8745000000;4409000000;-9444000000;9984000000;4411000000;13156000000
ARAY;173115;USD;2018;Q4;2018-06-30;2018-08-24;85780000;85780000;83083000;65994000;108540000;284157000;23698000;;70872000;94570000;378727000;71134000;;169434000;131077000;160661000;330095000;521824000;;-474285000;48632000;378727000
ARAY;173115;USD;2017;Q4;2017-06-30;2017-08-25;83163000;83163000;95993000;72789000;105054000;309003000;23062000;;74399000;97461000;406464000;66758000;113023000;284492000;51548000;75439000;359931000;496971000;;-450386000;46533000;406464000
ARAY;173115;USD;2016;Q4;2016-06-30;2016-08-24;81070000;79859000;167010000;56810000;115987000;361680000;27878000;;79475000;107353000;469033000;56138000;39900000;210212000;170512000;199161000;409373000;481427000;;-420807000;59660000;469033000
ARAY;173115;USD;2015;Q4;2015-06-30;2015-08-28;79148000;79148000;143857000;77727000;106151000;354329000;31829000;;80615000;112444000;466773000;53750000;;169915000;199655000;221078000;390993000;471509000;;-395303000;75780000;466773000
ARAY;173115;USD;2014;Q4;2014-06-30;2014-08-29;76854000;76854000;171899000;72152000;87752000;364470000;34391000;;96327000;130718000;495188000;72672000;;184569000;195612000;212071000;396640000;451827000;;-355094000;98548000;495188000
ARAY;173115;USD;2013;Q4;2013-06-30;2013-08-29;74243000;74243000;174397000;55458000;81592000;335935000;34733000;;105261000;139994000;475929000;51274000;;155859000;198768000;213235000;369094000;424599000;;-319646000;106835000;475929000
ARAY;173115;USD;2012;Q4;2012-06-30;2012-09-10;71467000;71467000;143504000;67890000;81693000;316258000;37458000;;119454000;156912000;473170000;72926000;;174174000;79466000;95129000;269303000;409215000;;-216427000;203867000;473170000
ARAY;173115;USD;2011;Q4;2011-06-30;2011-11-08;62431000;60337000;95906000;61853000;97836000;285722000;44823000;;125239000;170062000;455784000;109063000;;203044000;;12413000;215457000;374033000;;-144385000;240327000;455784000
AEO;173396;USD;2017;Q4;2018-01-31;2018-03-16;177924000;181026000;413613000;78304000;398213000;968530000;724239000;;123544000;847783000;1816313000;387120000;11203000;485221000;;84301000;569522000;596266000;-1202272000;1883592000;1246791000;1816313000
AEO;173396;USD;2016;Q4;2017-01-31;2017-03-10;182152000;184385000;378613000;86634000;358446000;901229000;707797000;;173634000;881431000;1782660000;391227000;12780000;493783000;;84308000;578091000;606386000;-1141130000;1775775000;1204569000;1782660000
AEO;173396;USD;2015;Q4;2016-01-31;2016-03-10;191706000;194705000;260067000;80912000;305178000;723375000;703586000;;185285000;888871000;1612246000;361796000;12711000;463682000;;97188000;560870000;593316000;-1171339000;1659267000;1051376000;1612246000
AEO;173396;USD;2014;Q4;2015-01-31;2015-03-11;194604000;195870000;410697000;67894000;278972000;828040000;698227000;;170641000;868868000;1696908000;347707000;12969000;459093000;;98069000;557162000;572171000;-965566000;1543085000;1139746000;1696908000
AEO;173396;USD;2013;Q4;2014-01-31;2014-03-13;192949000;190619000;428935000;73882000;291541000;927991000;632986000;;133187000;766173000;1694164000;309607000;13293000;415478000;;112508000;527986000;575504000;-991334000;1569851000;1166178000;1694164000
AEO;173396;USD;2012;Q4;2013-01-31;2013-03-12;196621000;203634000;630992000;46321000;332452000;1141800000;509633000;;104620000;614253000;1756053000;349435000;13381000;435902000;;98964000;534866000;629561000;-990729000;1553058000;1221187000;1756053000
AEO;173396;USD;2011;Q4;2012-01-31;2012-03-15;193810000;196060000;745044000;40310000;367514000;1287488000;582162000;;81152000;663314000;1950802000;323464000;15066000;405401000;;128550000;533951000;555293000;-938565000;1771464000;1416851000;1950802000
AEO;173396;USD;2010;Q4;2011-01-31;2011-03-11;194844000;196511000;734695000;36721000;301208000;1174410000;643120000;;62468000;705588000;1879998000;305535000;16203000;387837000;;141090000;528927000;549093000;-938023000;1711929000;1351071000;1879998000
AEO;173396;USD;2009;Q4;2010-01-31;2010-08-25;206177000;212059000;698635000;34746000;326454000;1167030000;713142000;197773000;60203000;971118000;2138148000;303121000;47388000;408955000;;150676000;559631000;556885000;-759255000;1764049000;1578517000;2138148000
AEO;173396;USD;2018;Q4;2019-01-31;2019-03-14;174864000;177240000;425465000;93477000;424404000;1046253000;742149000;;114976000;857125000;1903378000;431984000;9974000;542645000;;73178000;615823000;577425000;-1309692000;2054654000;1287555000;1903378000
SMCI;175410;USD;2016;Q4;2016-06-30;2016-08-26;48453000;52265000;180964000;288941000;448980000;938002000;187949000;2643000;37006000;227598000;1165600000;310029000;53589000;363618000;40000000;80603000;444221000;277339000;-2030000;445971000;721379000;1165600000
SMCI;175410;USD;2015;Q4;2015-06-30;2015-09-10;47308000;47590000;95442000;322594000;463493000;914415000;163038000;2633000;9723000;175394000;1089809000;360628000;93479000;454107000;933000;16617000;470724000;247081000;-2030000;373950000;619085000;1089809000
SMCI;175410;USD;2014;Q4;2014-06-30;2014-09-15;44993000;48983000;96872000;212738000;315837000;654081000;130589000;2647000;9008000;142244000;796325000;268332000;42554000;310886000;3733000;16208000;327094000;199062000;-2030000;272087000;469231000;796325000
SMCI;175410;USD;2013;Q4;2013-06-30;2013-09-11;42261000;43875000;93038000;149340000;254170000;523192000;95912000;2637000;10516000;109065000;632257000;213026000;28638000;241664000;6533000;16869000;258533000;157712000;-2030000;217930000;373724000;632257000
SMCI;175410;USD;2012;Q4;2012-06-30;2012-09-13;41523000;44787000;80826000;102014000;276599000;481912000;97419000;2923000;6849000;107191000;589103000;207146000;13362000;220508000;19395000;30244000;250752000;143806000;-2030000;196651000;338351000;589103000
SMCI;175410;USD;2011;Q4;2011-06-30;2011-11-07;39492000;43680000;69943000;85005000;192711000;369622000;74438000;5188000;15372000;94998000;464620000;140092000;555000;140647000;27596000;36716000;177363000;122693000;-2030000;166798000;287257000;464620000
SMCI;175410;USD;2017;Q4;2017-06-30;2019-05-17;48798000;52157000;110606000;324004000;736668000;1261166000;195576000;8692000;49696000;253964000;1515130000;511083000;161447000;672530000;0;68754000;741284000;308271000;-20491000;485973000;773846000;1515130000
KE;175788;USD;2016;Q4;2016-06-30;2016-08-25;28373000;29217000;54738000;149652000;132877000;362211000;120701000;;27653000;148354000;510565000;165803000;;174803000;;11393000;186196000;301581000;-13514000;48492000;324369000;510565000
KE;175788;USD;2015;Q4;2015-06-30;2015-08-28;29171000;29797000;65180000;139892000;125198000;354192000;106779000;;22286000;129065000;483257000;159954000;;159954000;;10854000;170808000;298491000;0;26205000;312449000;483257000
KE;175788;USD;2014;Q4;2014-06-30;2014-11-19;29143000;29143000;26260000;128425000;116159000;291334000;97934000;;19462000;117396000;408730000;146455000;;146455000;;260656000;407111000;0;;0;1619000;408730000
KE;175788;USD;2017;Q4;2017-06-30;2017-08-29;26958000;27154000;44555000;169785000;144606000;388165000;137549000;;29230000;166779000;554944000;189249000;;199249000;;13423000;212672000;302483000;-33798000;82671000;342272000;554944000
KE;175788;USD;2018;Q4;2018-06-30;2018-08-28;26642000;27389000;46428000;173559000;201596000;436988000;137210000;;34560000;171770000;608758000;220234000;;228571000;;24660000;253231000;304215000;-41163000;99374000;355527000;608758000
DEST;175862;USD;2016;Q4;2017-02-28;2017-04-13;13722000;13720000;2859000;5683000;69040000;87046000;83029000;;5912000;88941000;175987000;49015000;6948000;60563000;31485000;54274000;114837000;105915000;;-44693000;61150000;175987000
DEST;175862;USD;2015;Q4;2016-02-29;2016-04-14;13627000;13584000;2116000;10154000;72509000;108374000;92673000;;18027000;110700000;219074000;61226000;2897000;92523000;9302000;33653000;126176000;104922000;;-11951000;92898000;219074000
DEST;175862;USD;2014;Q4;2015-02-28;2014-12-12;13347000;13631000;1349000;9203000;75759000;113578000;90135000;;16347000;106482000;220060000;73344000;2801000;76145000;12199000;37913000;114058000;102508000;;3558000;106002000;220060000
DEST;175862;USD;2013;Q4;2014-02-28;2013-12-13;13324000;13544000;24555000;12463000;86546000;138503000;53447000;;16031000;69478000;207981000;63227000;;63227000;;22121000;85348000;98770000;;23930000;122633000;207981000
DEST;175862;USD;2012;Q4;2013-02-28;2012-12-14;13154000;13293000;22376000;13197000;88754000;136104000;51078000;;12462000;63540000;199644000;57531000;15257000;72788000;;21884000;94672000;95220000;;9786000;104972000;199644000
DEST;175862;USD;2011;Q4;2012-02-29;2011-12-14;13019000;13184000;15285000;11015000;90366000;131035000;55854000;;11883000;67737000;198772000;52136000;2915000;55051000;28427000;51026000;106077000;93064000;;-261000;92695000;198772000
DEST;175862;USD;2010;Q4;2011-02-28;2011-08-09;12472000;12877000;24633000;10343000;80735000;131047000;58702000;;15405000;74107000;205154000;61563000;5834000;67397000;39327000;66159000;133556000;88526000;;-16348000;71598000;205154000
DEST;175862;USD;2017;Q4;2018-02-28;2018-04-19;13811000;13811000;1635000;6692000;71256000;91105000;66146000;;5331000;71477000;162582000;62610000;4780000;75390000;23809000;46524000;121914000;107012000;;-66274000;40668000;162582000
DEST;175862;USD;2018;Q4;2019-02-28;2019-04-16;13999000;13875000;1154000;7945000;70872000;89378000;51483000;;5313000;56796000;146174000;52910000;4372000;77682000;21784000;41341000;119023000;107819000;;-80594000;27151000;146174000
OSTK;176064;USD;2017;Q4;2017-12-31;2018-03-15;24887000;24887000;203215000;30080000;13703000;265197000;129343000;13024000;26251000;168618000;433815000;168017000;178000;214663000;0;47029000;261692000;494735000;-63816000;-254692000;172123000;433815000
OSTK;176064;USD;2016;Q4;2016-12-31;2016-05-05;25391000;25717000;183098000;28142000;21049000;244373000;134552000;9946000;96205000;240703000;485076000;202553000;4883000;249216000;56010000;62900000;312116000;383351000;-52587000;-153898000;172960000;485076000
OSTK;176064;USD;2015;Q4;2015-12-31;2015-04-29;25248000;25343000;170262000;16128000;21353000;248368000;93696000;9722000;76603000;180021000;428389000;206092000;1640000;258676000;13378000;20352000;279028000;370050000;-51747000;-166420000;149361000;428389000
OSTK;176064;USD;2014;Q4;2014-12-31;2014-04-29;24034000;24399000;181641000;18963000;29422000;258062000;52071000;10905000;55827000;118803000;376865000;194351000;0;242802000;0;4843000;247645000;366254000;-82531000;-153864000;129220000;376865000
OSTK;176064;USD;2013;Q4;2013-12-31;2013-04-25;23782000;24431000;148665000;16047000;28847000;219007000;27194000;9678000;59757000;96629000;315636000;156261000;;193582000;;3294000;196876000;361708000;-80230000;-162718000;118760000;315636000
OSTK;176064;USD;2012;Q4;2012-12-31;2012-04-26;23272000;24056000;93547000;19273000;28376000;155998000;21037000;0;4950000;25987000;181985000;110090000;;148501000;;2522000;151023000;356897000;-78839000;-247096000;30962000;181985000
OSTK;176064;USD;2011;Q4;2011-12-31;2011-07-28;23280000;23280000;96985000;13501000;24020000;149193000;25322000;;5044000;30366000;179559000;118234000;110000;163322000;2000;3000000;166322000;353370000;-78368000;-261765000;13237000;179559000
OSTK;176064;USD;2010;Q4;2010-12-31;2011-07-28;23058000;24446000;124021000;13560000;34196000;185970000;27800000;;4189000;31989000;217959000;108062000;39135000;171224000;12332000;16077000;187301000;349749000;-76764000;-242327000;30658000;217959000
OSTK;176064;USD;2018;Q4;2018-12-31;2019-03-18;32156000;32156000;141512000;35930000;14108000;215267000;134687000;60427000;50838000;245952000;461219000;190432000;476000;241486000;3069000;9027000;250513000;657984000;-66757000;-458897000;210706000;461219000
SKX;176359;USD;2016;Q4;2016-12-31;2017-03-01;154671000;155292000;718536000;326844000;700515000;1827766000;494473000;;71431000;565904000;2393670000;613861000;7869000;621730000;67159000;86426000;708156000;419192000;;1211045000;1685514000;2393670000
SKX;176359;USD;2015;Q4;2015-12-31;2016-02-26;153368000;154866000;507991000;343930000;620247000;1548192000;435907000;;55779000;491686000;2039878000;561301000;15712000;577013000;68942000;87131000;664144000;386309000;;967552000;1375734000;2039878000
SKX;176359;USD;2014;Q4;2014-12-31;2015-02-27;152105000;154088000;466685000;272103000;453837000;1285014000;373183000;;16721000;389904000;1674918000;402520000;103217000;505737000;15081000;35074000;540811000;355686000;;735640000;1134107000;1674918000
SKX;176359;USD;2013;Q4;2013-12-31;2014-02-28;151402000;151981000;372011000;225941000;358168000;1014928000;361755000;;31887000;393642000;1408570000;298307000;12115000;310422000;116488000;118228000;428650000;342194000;;596829000;979920000;1408570000
SKX;176359;USD;2012;Q4;2012-12-31;2013-03-01;149928000;153852000;325826000;213697000;339012000;940312000;362446000;;37462000;399908000;1340220000;278448000;14093000;292541000;128517000;128590000;421131000;336328000;;542041000;919089000;1340220000
SKX;176359;USD;2011;Q4;2011-12-31;2012-02-29;146805000;140832000;351144000;176018000;226407000;887351000;376446000;;18091000;394537000;1281888000;247994000;60472000;308466000;76531000;80895000;389361000;320926000;;532529000;892527000;1281888000
SKX;176359;USD;2010;Q4;2010-12-31;2011-05-09;143829000;147456000;233558000;266057000;398588000;973364000;293802000;;37628000;331430000;1304794000;276980000;30330000;307310000;51650000;51650000;358960000;303925000;;600013000;945834000;1304794000
SKX;176359;USD;2017;Q4;2017-12-31;2018-03-01;156104000;157250000;736431000;405921000;873016000;2105024000;541601000;;88457000;630058000;2735082000;587536000;9812000;597348000;71103000;189523000;786871000;453573000;;1390235000;1948211000;2735082000
SKX;176359;USD;2018;Q4;2018-12-31;2019-03-01;154543000;154781000;972266000;501913000;863260000;2472140000;585457000;93745000;76913000;756115000;3228255000;841334000;8888000;850222000;88119000;188758000;1038980000;375170000;;1691276000;2189275000;3228255000
TIVO;176762;USD;2016;Q4;2017-01-31;2016-03-23;94458364;67381277;646069000;55654000;17535000;735885000;12629000;;341292000;353921000;1089806000;74548000;132409000;373318000;182382000;371569000;744887000;1252007000;-545744000;-357983000;344919000;1089806000
TIVO;176762;USD;2015;Q4;2016-01-31;2015-03-19;96283622;132794158;742961000;40184000;20341000;878200000;11854000;;287467000;299321000;1177521000;83790000;0;259293000;352562000;608915000;868208000;1203860000;-514853000;-379680000;309313000;1177521000
TIVO;176762;USD;2014;Q4;2015-01-31;2014-03-14;117039904;159096599;1002472000;35151000;22316000;1193585000;10687000;;97519000;108206000;1301791000;73122000;;247861000;172500000;504845000;752706000;1113091000;-154071000;-410512000;549085000;1301791000
TIVO;176762;USD;2013;Q4;2014-01-31;2013-03-15;120199880;100975562;627240000;40102000;14500000;705723000;10300000;;47630000;57930000;763653000;74535000;;178040000;172500000;244849000;422889000;1060661000;-37791000;-682328000;340764000;763653000
TIVO;176762;USD;2012;Q4;2013-01-31;2012-03-23;117747440;177033299;618799000;24665000;18925000;678895000;9191000;;31724000;40915000;719810000;77443000;;152429000;172500000;254354000;406783000;1003819000;-13788000;-677064000;313027000;719810000
TIVO;176762;USD;2011;Q4;2012-01-31;2011-03-14;114476120;114476120;209437000;16011000;13228000;259419000;10229000;5890000;10280000;26399000;285818000;48167000;;81959000;0;35103000;117062000;957064000;-8660000;-779225000;168756000;285818000
TIVO;176762;USD;2010;Q4;2011-01-31;2010-06-09;;;244582000;16996000;12110000;282374000;10098000;7512000;10828000;28438000;310812000;45498000;;84450000;;29221000;113671000;896805000;-4325000;-694713000;197141000;310812000
LRDC;176863;USD;2018;Q4;2018-05-31;2018-08-29;54514765;54514765;106311;;;266416;;;;;266416;1439963;350000;1835796;0;0;1835796;8835982;;-10405362;-1569380;266416
LRDC;176863;USD;2017;Q4;2017-05-31;2017-08-29;54514765;54514765;330684;;;377879;;;;;377879;1889337;350000;2285170;;0;2285170;8596778;;-10504069;-1907291;377879
LRDC;176863;USD;2016;Q4;2016-05-31;2016-08-29;54511376;54511376;393937;;;440230;;;;;440230;1390354;350000;1786187;;0;1786187;8193650;;-9539607;-1345957;440230
LRDC;176863;USD;2015;Q4;2015-05-31;2015-08-31;54088069;54555459;85835;;;241757;;;;;241757;1147614;350000;1795438;;0;1795438;7325778;;-8879459;-1553681;241757
LRDC;176863;USD;2014;Q4;2014-05-31;2014-08-29;53599910;;88271;;;136494;;;;;136494;587606;350000;1619867;;0;1619867;6689763;;-8173136;-1483373;136494
LRDC;176863;USD;2013;Q4;2013-05-31;2013-08-29;;;107674;;;143364;;;;;143364;300887;0;482085;350000;350000;832085;6168436;;-6857157;-688721;143364
LRDC;176863;USD;2012;Q4;2012-05-31;2012-08-29;;;114563;;;145325;;;;;145325;110125;;224314;350000;350000;574314;5740421;;-6169410;-428989;145325
LRDC;176863;USD;2011;Q4;2011-05-31;2011-10-28;;;428;;;24479;;;;;24479;285150;725000;2275745;0;0;2275745;-395784;;-1855482;-2251266;24479
LRDC;176863;USD;2019;Q4;2019-05-31;2019-08-29;54514765;54514765;289559;;;357100;;;;;357100;1662713;350000;2058546;;0;2058546;8850043;;-10551489;-1701446;357100
TECH;176917;USD;2016;Q4;2016-06-30;2016-08-29;37222000;37389000;95835000;93393000;57102000;253891000;132362000;;743328000;875690000;1129581000;30803000;;54147000;91500000;196154000;250301000;179132000;;770553000;879280000;1129581000
TECH;176917;USD;2015;Q4;2015-06-30;2015-08-31;37154000;37296000;110921000;70034000;49577000;248283000;129749000;;685328000;815077000;1063360000;22019000;;39767000;73000000;176657000;216424000;163677000;;713851000;846935000;1063359000
TECH;176917;USD;2014;Q4;2014-06-30;2014-08-29;36925000;37024000;363354000;55001000;38847000;469413000;117120000;3575000;272383000;393078000;862491000;14284000;;26391000;0;40835000;67226000;147374000;;653279000;795265000;862491000
TECH;176917;USD;2013;Q4;2013-06-30;2013-08-29;36840000;36897000;332937000;38183000;34877000;409516000;108756000;132376000;127450000;368582000;778098000;18115000;;32084000;;8473000;40557000;135263000;;587725000;737541000;778098000
TECH;176917;USD;2012;Q4;2012-06-30;2012-08-29;36831000;36896000;268986000;35668000;38277000;346507000;93788000;143966000;135063000;372817000;719324000;16817000;;35750000;;9132000;44882000;132219000;;520448000;674442000;719324000
TECH;176917;USD;2011;Q4;2011-06-30;2011-08-29;37140000;37231000;140813000;35914000;44906000;230417000;95398000;131988000;159867000;387253000;617670000;13404000;;18188000;;13360000;31548000;129683000;;472730000;586122000;617670000
TECH;176917;USD;2010;Q4;2010-06-30;2010-11-09;37231000;37316000;138811000;30850000;13737000;201040000;97400000;171171000;49205000;317776000;518816000;13243000;;17024000;;0;17024000;122907000;;400119000;501792000;518816000
TECH;176917;USD;2017;Q4;2017-06-30;2017-09-07;37343000;37555000;157714000;116830000;60151000;348025000;135124000;;1075070000;1210194000;1558219000;37852000;;135522000;343771000;473070000;608592000;199535000;;799027000;949627000;1558219000
TECH;176917;USD;2018;Q4;2018-06-30;2018-08-27;37576000;38447000;181754000;120296000;85648000;398366000;145348000;;1049488000;1194836000;1593202000;48733000;;79510000;339000000;434631000;514141000;246944000;;876931000;1079061000;1593202000
PAHC;177507;USD;2016;Q4;2016-06-30;2016-08-29;39405000;39858000;33605000;123790000;167691000;342831000;127323000;;140219000;267542000;610373000;105870000;2803000;108673000;349907000;411220000;519893000;118303000;;33962000;90480000;610373000
PAHC;177507;USD;2015;Q4;2015-06-30;2015-09-10;39021000;39944000;29216000;111099000;149786000;313728000;104414000;;75176000;179590000;493318000;108524000;2809000;111333000;286709000;352357000;463690000;118196000;;-36968000;29628000;493318000
PAHC;177507;USD;2014;Q4;2014-06-30;2014-09-18;37398000;37199000;11821000;113858000;143184000;299289000;109159000;;63875000;173034000;472323000;109469000;2969000;112438000;286422000;344736000;457174000;132457000;;-97248000;15149000;472323000
PAHC;177507;USD;2013;Q4;2013-06-30;2014-05-13;30458000;30458000;27369000;99137000;140032000;296386000;104422000;;73334000;177756000;474142000;115340000;64000;115404000;331666000;427676000;543080000;42955000;;-94121000;-68938000;474142000
PAHC;177507;USD;2017;Q4;2017-06-30;2017-08-30;39765000;40201000;56083000;125847000;161233000;363665000;127351000;;132381000;259732000;623397000;109546000;6250000;115796000;306891000;356444000;472240000;123844000;;82750000;151157000;623397000
PAHC;177507;USD;2018;Q4;2018-06-30;2018-08-27;40340000;40493000;79168000;135742000;178170000;415461000;130108000;;126110000;256218000;671679000;130642000;12579000;143221000;299802000;343504000;486725000;129877000;;131560000;184954000;671679000
PAHC;177507;USD;2019;Q4;2019-06-30;2019-08-27;40454;40478;81573000;159022000;198322000;466162000;140235000;;120274000;260509000;726671000;141687000;12540000;154227000;313635000;356429000;510656000;133270000;;168926000;216015000;726671000
SCSC;177685;USD;2016;Q4;2016-06-30;2016-08-29;25675000;25950000;61400000;559557000;558581000;1228905000;52388000;;209892000;262280000;1491185000;474543000;0;585112000;76856000;131577000;716689000;67249000;;779934000;774496000;1491185000
SCSC;177685;USD;2015;Q4;2015-06-30;2015-08-27;28463000;28716000;121646000;522532000;553063000;1244158000;46574000;;186209000;232783000;1476941000;505509000;2860000;598760000;5966000;69196000;667956000;157172000;;716315000;808985000;1476941000
SCSC;177685;USD;2014;Q4;2014-06-30;2014-08-28;28519000;28824000;194851000;464405000;504758000;1215681000;31823000;;87620000;119443000;1335124000;430406000;0;499831000;5429000;32650000;532481000;168447000;;650896000;802643000;1335124000
SCSC;177685;USD;2013;Q4;2013-06-30;2013-08-26;27918000;28093000;148164000;435028000;402307000;1042060000;20203000;;101920000;122123000;1164183000;363967000;0;427682000;5429000;40545000;468227000;149821000;;569107000;695956000;1164183000
SCSC;177685;USD;2012;Q4;2012-06-30;2012-08-24;27577000;27853000;29173000;458341000;487946000;1031930000;48785000;;121091000;169876000;1201806000;421381000;4268000;498401000;5429000;51094000;549495000;139557000;;534445000;652311000;1201806000
SCSC;177685;USD;2011;Q4;2011-06-30;2011-08-29;27051000;27419000;28747000;462102000;467350000;1009514000;36819000;;135855000;172674000;1182188000;411628000;3164000;477347000;56942000;117447000;594794000;123608000;;460157000;587394000;1182188000
SCSC;177685;USD;2010;Q4;2010-06-30;2010-11-03;53251392;53830116;34605000;357749000;346610000;767792000;23528000;;68430000;91958000;859750000;295812000;0;330839000;30429000;42060000;372899000;111951000;;386634000;486851000;859750000
SCSC;177685;USD;2017;Q4;2017-06-30;2017-08-29;25341000;25613000;56094000;637293000;531314000;1281023000;56566000;;380714000;437280000;1718303000;520885000;0;656275000;97300000;224883000;881158000;61169000;;849180000;837145000;1718303000
SCSC;177685;USD;2018;Q4;2018-06-30;2018-08-28;25576000;25663000;25530000;678940000;595948000;1362162000;73042000;;510091000;583133000;1945295000;575912000;551000;710311000;248878000;368608000;1078919000;68220000;;882333000;866376000;1945295000
SCSC;177685;USD;2019;Q4;2019-06-30;2019-08-22;25625000;25669000;23818000;654983000;697343000;1477315000;63363000;;526583000;589946000;2067261000;562411000;8675000;700886000;351831000;452246000;1153132000;64287000;;939930000;914129000;2067261000
EXA;177765;USD;2016;Q4;2017-01-31;2017-03-22;14868482;14433244;24552000;24259000;;51709000;14028000;;3337000;17365000;69074000;15185000;1737000;45928000;914000;3972000;49900000;94531000;0;-74817000;19174000;69074000
EXA;177765;USD;2015;Q4;2016-01-31;2016-03-21;14635609;14635609;27649000;32072000;;63428000;12032000;;3561000;15593000;79021000;15661000;2823000;51333000;2549000;10201000;61534000;91641000;0;-73685000;17487000;79021000
EXA;177765;USD;2014;Q4;2015-01-31;2015-03-24;13839448;12918594;21785000;27462000;;52345000;6961000;;3747000;10708000;63053000;12205000;2390000;41458000;1602000;2704000;44162000;88195000;0;-68878000;18891000;63053000
EXA;177765;USD;2013;Q4;2014-01-31;2014-03-26;-13291772801;11986728;28753000;27245000;;60319000;7356000;;17174000;24530000;84849000;11969000;2426000;44989000;2695000;4327000;49316000;85214000;0;-49721000;35533000;84849000
EXA;177765;USD;2012;Q4;2013-01-31;2013-04-09;13438035;14714958;30716000;27840000;;61464000;6176000;;16430000;22606000;84070000;9027000;3798000;38838000;7842000;10461000;49299000;83799000;0;-49012000;34771000;84070000
EXA;177765;USD;2011;Q4;2012-01-31;2012-09-13;496124;10417337;11468000;19205000;;32212000;3364000;;18990000;22354000;54566000;11219000;1618000;48231000;4506000;9280000;57511000;14205000;0;-49775000;-2945000;54566000
AEHR;178053;USD;2016;Q4;2016-05-31;2016-08-29;13189;12338;939000;522000;7033000;8748000;1204000;;94000;1298000;10046000;2966000;;4680000;5962000;6089000;10769000;58184000;;-61124000;-723000;10046000
AEHR;178053;USD;2015;Q4;2015-05-31;2015-08-31;12396;12396;5527000;1383000;7123000;14295000;478000;;95000;573000;14868000;1769000;;6519000;3791000;3799000;10318000;56676000;;-54339000;4550000;14868000
AEHR;178053;USD;2014;Q4;2014-05-31;2014-08-28;11085;12805;1809000;3390000;6148000;11673000;474000;;78000;552000;12225000;3282000;;5117000;0;79000;5196000;52254000;;-47692000;7029000;12225000
AEHR;178053;USD;2013;Q4;2013-05-31;2013-08-28;38168171;38168171;2324000;2632000;5369000;10601000;301000;;73000;374000;10975000;2628000;;5701000;;280000;5981000;50686000;;-48114000;4994000;10975000
AEHR;178053;USD;2012;Q4;2012-05-31;2012-08-28;-26930936;-27098936;2073000;2588000;6070000;10928000;510000;;175000;685000;11613000;2892000;;4808000;;351000;5159000;48713000;;-44695000;6454000;11613000
AEHR;178053;USD;2011;Q4;2011-05-31;2011-10-14;8878;8878;4020000;1432000;4958000;10571000;954000;;558000;1512000;12083000;2319000;;2540000;;442000;2982000;47836000;;-41328000;9101000;12083000
AEHR;178053;USD;2017;Q4;2017-05-31;2017-08-29;65021982;65021982;17803000;4010000;6604000;29378000;1419000;;95000;1514000;30892000;4417000;;7884000;6110000;6214000;14098000;81341000;;-66777000;16794000;30892000
AEHR;178053;USD;2018;Q4;2018-05-31;2018-08-28;86863106;91059485;16848000;2856000;9049000;29456000;1203000;;296000;1499000;30955000;3408000;6110000;11148000;;522000;11670000;83262000;;-66249000;19285000;30955000
AEHR;178053;USD;2019;Q4;2019-05-31;2019-08-28;22605;22605;5428000;4859000;9061000;20034000;1045000;;228000;1273000;21307000;3967000;;5512000;;342000;5854000;84726000;;-71484000;15453000;21307000
GLGI;178127;USD;2018;Q4;2018-05-31;2018-08-29;28361201;30270298;379632;5011193;3089267;8695709;25353876;;0;25353876;34049585;4706799;4484853;12595986;18569187;19060152;31656138;53793600;;-52485313;2393447;34049585
GLGI;178127;USD;2017;Q4;2017-05-31;2017-08-25;28363354;29545978;579021;6233723;1587552;8536691;19706782;;281415;19988197;28524888;5786705;4754796;10541501;16843257;16843257;27384758;53793600;;-53724991;1140130;28524888
GLGI;178127;USD;2016;Q4;2016-05-31;2016-08-29;27879810;29240966;897377;5086140;1304495;7358070;12565319;;1307087;13872406;21230476;6577260;2088327;8665587;13289236;13289236;21954823;53616600;;-55385912;-724347;21230476
GLGI;178127;USD;2015;Q4;2015-05-31;2015-08-31;27406671;28261920;598887;1973075;1429344;4021555;8509315;;1908871;10418186;14439741;2996060;2278164;5274224;10300847;10300847;15575071;53506176;;-55657638;-1135330;14439741
GLGI;178127;USD;2014;Q4;2014-05-31;2014-08-29;26461201;30912307;661263;2243068;1616165;5694666;8776137;;1296188;10072325;15766991;2646193;3979376;6625569;10524745;10524745;17150314;53338752;;-55715203;-1383323;15766991
GLGI;178127;USD;2013;Q4;2013-05-31;2013-09-13;26111201;27962302;366896;2239594;1044379;3770067;7044139;;1230371;8274510;12044577;5078452;1344160;6422612;9658020;9658020;16080632;53145328;;-58321266;-4036055;12044577
GLGI;178127;USD;2012;Q4;2012-05-31;2012-09-14;26111201;26111201;194400;2715893;956638;3912021;7798178;;671454;8469632;12381653;6791609;1286312;8077921;10757561;10757561;18835482;53091904;;-60586143;-6453829;12381653
GLGI;178127;USD;2011;Q4;2011-05-31;2011-11-16;;;169420;2421789;543557;3205756;7713608;;100693;7814301;11020057;4274080;4072754;8346834;12378214;12378214;20725048;48091909;;-62297986;-9704991;11020057
GLGI;178127;USD;2019;Q4;2019-05-31;2019-08-29;28361201;29003654;1255408;6371195;2620991;10486740;32680472;;;32680472;43167212;6632913;4605495;13439475;24989896;25916538;39356013;53793600;;-51108677;3811199;43167212
LLTC;178219;USD;2016;Q4;2016-07-31;2016-08-25;244670000;245314000;1448275000;157460000;97251000;1754730000;285866000;;9385000;295251000;2049981000;131265000;;179966000;;110840000;290806000;2137150000;;-379210000;1759175000;2049981000
LLTC;178219;USD;2015;Q4;2015-07-31;2015-08-19;245168000;246396000;1202722000;179264000;99861000;1584752000;287742000;;11585000;299327000;1884079000;136058000;;182918000;;123234000;306152000;2052490000;;-475124000;1577927000;1884079000
LLTC;178219;USD;2014;Q4;2014-07-31;2014-08-20;243971000;246214000;1012787000;173340000;91310000;1364713000;277080000;;13785000;290865000;1655578000;169496000;;215115000;;109094000;324209000;1948006000;;-616992000;1331369000;1655578000
LLTC;178219;USD;2013;Q4;2013-07-31;2013-08-19;238674000;239511000;1524741000;145274000;87229000;1793890000;288466000;;15985000;304451000;2098341000;119684000;826629000;1025880000;;90553000;1116433000;1736729000;;-754555000;981908000;2098341000
LLTC;178219;USD;2012;Q4;2012-07-31;2012-08-29;234634000;235820000;1203059000;153090000;79664000;1505410000;320222000;;25436000;345658000;1851068000;129248000;0;170581000;805599000;943979000;1114560000;1588045000;;-851702000;736508000;1851068000
LLTC;178219;USD;2011;Q4;2011-07-31;2011-08-24;232348000;234536000;922537000;169637000;72195000;1246290000;332969000;;14807000;347776000;1594066000;135219000;;182806000;785732000;905649000;1088455000;1466098000;;-961617000;505611000;1594066000
LLTC;178219;USD;2010;Q4;2010-07-31;2010-11-05;683527971;687130610;958069000;176874000;54044000;1264301000;257035000;;69382000;326417000;1590718000;155884000;392926000;582510000;766960000;968423000;1550933000;1331888000;;-1294077000;39785000;1590718000
DXLG;178401;USD;2016;Q4;2017-01-31;2016-03-18;49140000;49140000;5170000;4721000;125014000;143159000;124962000;;6226000;131188000;274347000;30684000;8620000;115066000;19003000;70877000;185943000;303344000;-87977000;-120311000;88404000;274347000
DXLG;178401;USD;2015;Q4;2016-01-31;2016-03-18;48788000;48788000;4586000;3619000;115220000;132338000;120328000;;7215000;127543000;259881000;29979000;8800000;89568000;26171000;77923000;167491000;300508000;-87977000;-111903000;92390000;259881000
DXLG;178401;USD;2014;Q4;2015-01-31;2014-03-17;48569000;48273000;4544000;8347000;105556000;126441000;102939000;;8001000;110940000;237381000;32945000;6026000;76227000;12145000;56183000;132410000;297116000;-87977000;-99608000;104971000;237381000
DXLG;178401;USD;2013;Q4;2014-01-31;2013-03-15;48127000;49029000;8162000;5007000;104211000;133086000;65942000;;46917000;112859000;245945000;25464000;1465000;50584000;;34149000;84733000;294572000;-87977000;-39822000;161212000;245945000
DXLG;178401;USD;2012;Q4;2013-01-31;2012-03-16;47541000;48464000;10353000;3627000;104167000;133407000;45933000;;54381000;100314000;233721000;24657000;1465000;54906000;;24457000;79363000;293999000;-87977000;-45948000;154358000;233721000
DXLG;178401;USD;2011;Q4;2012-01-31;2011-08-19;47099000;47955000;4114000;3618000;92889000;109506000;39051000;;34056000;73107000;182613000;17794000;1465000;46195000;;25086000;71281000;291956000;-87977000;-88611000;111332000;182613000
DXLG;178401;USD;2017;Q4;2018-01-31;2018-03-23;47901000;47112000;5362000;3046000;103332000;121667000;111032000;;7706000;118738000;240405000;33987000;2857000;109814000;10669000;60605000;170419000;308172000;-92658000;-139285000;69986000;240405000
DXLG;178401;USD;2018;Q4;2019-01-31;2019-03-22;49449000;49449000;4868000;4420000;106837000;127660000;92525000;;5891000;98416000;226076000;34418000;1465000;107931000;14757000;59505000;167436000;311015000;-92658000;-153534000;58640000;226076000
CETX;178699;USD;2017;Q4;2017-09-30;2017-12-13;1286377;1278652;10442857;15461139;17271882;46428637;20118311;;3634425;23752736;70181373;12828876;2304084;20062200;9235868;11126868;31189068;24704728;;14418245;38992305;70181373
CETX;178699;USD;2016;Q4;2016-09-30;2016-12-28;1176732;1187820;6045521;13568727;14071627;36926738;17647888;;1458883;19106771;56033509;14507853;5804887;25154792;11493452;15186759;40341551;5240205;;11424900;15691958;56033509
CETX;178699;USD;2015;Q4;2015-09-30;2015-12-21;875078;975098;1486737;4771044;6369516;13521089;8142523;;880630;9023153;22544242;4769454;1928020;8827185;6472433;6591488;15418673;1027602;;6430855;7125569;22544242
CETX;178699;USD;2014;Q4;2014-09-30;2014-12-29;-7612312;-7612312;705910;4038340;6270327;11545839;7399096;;897428;8296524;19842363;3224173;3045033;6269206;8059857;9929648;16198854;206329;;3592739;3643509;19842363
CETX;178699;USD;2013;Q4;2013-09-30;2014-01-16;5074891;5074891;66963;641264;159348;2506078;9323;;358375;367698;2873776;635110;0;635110;1107484;1107484;1742594;206329;;923853;1131182;2873776
CETX;178699;USD;2012;Q4;2012-09-30;2012-12-26;4977991;4977991;333045;293155;196844;1571638;20466;;86270;106736;1678374;359231;;359231;476458;476458;835689;206329;;635356;842685;1678374
CETX;178699;USD;2011;Q4;2011-09-30;2012-01-10;4977991;4977991;415369;261549;317896;2385563;39331;0;4225;43556;2429119;798855;;814455;1520178;1520178;2334633;106329;;-12843;94486;2429119
CETX;178699;USD;2010;Q4;2010-09-30;2011-09-13;4961633;4961633;41139;731968;387628;1164757;62273;;4225;66498;1231255;1103222;250000;1353222;55938;794429;2147651;106329;;-1023725;-916396;1231255
CETX;178699;USD;2018;Q4;2018-09-30;2019-01-11;1532889;1500583;973772;13945655;11354458;31914264;27300654;1699271;6416425;35416350;67330614;9967456;10913703;21902368;8095733;10147580;32049948;31498293;;4262756;35280666;67330614
ULTA;178804;USD;2016;Q4;2017-01-31;2017-03-28;62199000;62564000;415010000;88631000;943975000;1536237000;1004358000;;11283000;1015641000;2551878000;529343000;;529343000;;472317000;1001660000;658957000;-14524000;905785000;1550218000;2551878000
ULTA;178804;USD;2015;Q4;2016-01-31;2016-03-30;63647000;63939000;475840000;64992000;761793000;1375173000;847600000;;8145000;855745000;2230918000;396227000;;396227000;;391805000;788032000;622356000;-11685000;832215000;1442886000;2230918000
ULTA;178804;USD;2014;Q4;2015-01-31;2015-04-01;64299000;64623000;539358000;52440000;581229000;1260355000;717159000;;5656000;722815000;1983170000;359594000;;359594000;;376067000;735661000;577629000;-9713000;679593000;1247509000;1983170000
ULTA;178804;USD;2013;Q4;2014-01-31;2014-04-02;64231000;64480000;419476000;47049000;457933000;1002697000;595736000;;4294000;600030000;1602727000;266811000;;266811000;;332822000;599633000;548841000;-8125000;462378000;1003094000;1602727000
ULTA;178804;USD;2012;Q4;2013-01-31;2013-04-03;63950000;64736000;320475000;41515000;361125000;789324000;483059000;;2866000;485925000;1275249000;221067000;;221067000;;267240000;488307000;497575000;-7494000;296861000;786942000;1275249000
ULTA;178804;USD;2011;Q4;2012-01-31;2012-03-28;61905000;63918000;253738000;26153000;244647000;580232000;376985000;;;376985000;957217000;164855000;;164855000;;207658000;372513000;405325000;-7415000;186794000;584704000;957217000
ULTA;178804;USD;2010;Q4;2011-01-31;2011-06-07;59740000;63147000;111185000;22292000;218516000;404389000;326099000;;;326099000;730488000;163357000;;163357000;;164598000;327955000;340182000;-4179000;66530000;402533000;730488000
ULTA;178804;USD;2017;Q4;2018-01-31;2018-04-03;60889000;61297000;397445000;99719000;1096424000;1693743000;1189453000;;25491000;1214944000;2908687000;642166000;;642166000;;492304000;1134470000;699531000;-18767000;1093453000;1774217000;2908687000
ULTA;178804;USD;2018;Q4;2019-01-31;2019-04-02;59052000;59378000;409251000;136168000;1214329000;1914861000;1226029000;;50282000;1276311000;3191172000;624682000;;823736000;;547218000;1370954000;739263000;-24908000;1105863000;1820218000;3191172000
CREE;178872;USD;2016;Q4;2016-06-30;2016-08-25;100662000;99917000;605305000;165611000;303542000;1156707000;599723000;40179000;969451000;1609353000;2766060000;176928000;;222999000;160000000;175237000;398236000;2359709000;;-613000;2367824000;2766060000
CREE;178872;USD;2015;Q4;2015-06-30;2015-08-27;106557000;103510000;713191000;186157000;280576000;1308250000;635072000;57595000;947116000;1639783000;2948033000;210578000;;254786000;200000000;231295000;486081000;2285685000;;170469000;2461952000;2948033000
CREE;178872;USD;2014;Q4;2014-06-30;2014-08-27;120461000;122393000;1162466000;225160000;284780000;1773891000;605713000;0;964765000;1570478000;3344369000;267669000;;306655000;0;47568000;354223000;2190160000;;788581000;2990146000;3344369000
CREE;178872;USD;2013;Q4;2013-06-30;2013-08-28;118298000;120938000;1023915000;192507000;197001000;1515766000;542833000;;993811000;1536644000;3052410000;164163000;;207411000;;38347000;245758000;2025912000;;772496000;2806652000;3052410000
CREE;178872;USD;2012;Q4;2012-06-30;2012-08-21;115729000;116400000;744513000;152258000;188849000;1164281000;582461000;;1000756000;1583217000;2747498000;112544000;;149177000;;38304000;187481000;1861646000;;687238000;2560017000;2747498000
CREE;178872;USD;2011;Q4;2011-06-30;2011-08-17;109075000;110224000;1085797000;118469000;176482000;1456895000;555929000;;433898000;989827000;2446722000;110577000;;140316000;;44842000;185158000;1593666000;;654807000;2261564000;2446722000
CREE;178872;USD;2010;Q4;2010-06-30;2010-10-21;107366000;110854000;1066405000;117535000;112241000;1355163000;419726000;;424287000;844013000;2199176000;104448000;;120091000;;51037000;171128000;1507570000;;508307000;2028048000;2199176000
CREE;178872;USD;2017;Q4;2017-06-30;2017-08-23;97576000;97576000;610938000;148392000;284385000;1100630000;581263000;50366000;917608000;1549237000;2649867000;175045000;;212023000;145000000;215039000;427062000;2419638000;;-202742000;2222805000;2649867000
CREE;178872;USD;2018;Q4;2018-06-30;2018-08-20;100985000;99406000;387085000;153875000;296015000;890090000;661319000;57501000;1028635000;1747455000;2637545000;204765000;;248293000;292000000;317171000;565464000;2549250000;;-482710000;2072081000;2637545000
CREE;178872;USD;2019;Q4;2019-06-30;2019-08-21;105890000;105890000;1051400000;128900000;187400000;1412800000;625200000;39500000;739400000;1404100000;2816900000;249700000;;268200000;469100000;507500000;775700000;2874200000;;-847500000;2041200000;2816900000
CSII;178927;USD;2017;Q4;2017-06-30;2017-08-24;31668800;31054476;108616000;28472000;16897000;159059000;29696000;;5185000;34881000;193940000;40972000;;40972000;;34579000;75551000;447592000;;-329303000;118389000;193940000
CSII;178927;USD;2016;Q4;2016-06-30;2016-08-25;32674278;32674278;61322000;23128000;17440000;104882000;32471000;;5053000;37524000;142406000;35499000;;35499000;;6010000;41509000;428268000;;-327411000;100897000;142406000
CSII;178927;USD;2015;Q4;2015-06-30;2015-08-27;31747854;31747854;85718000;30830000;13966000;133894000;32883000;;4551000;37434000;171328000;29888000;;29888000;;2005000;31893000;410732000;;-271387000;139435000;171328000
CSII;178927;USD;2014;Q4;2014-06-30;2014-08-28;30885027;30885027;126592000;21383000;12890000;162711000;15297000;;3893000;19190000;181901000;27329000;2400000;29729000;;117000;29846000;390620000;;-238565000;152055000;181901000
CSII;178927;USD;2013;Q4;2013-06-30;2013-09-11;24158623;24158623;67897000;14730000;6243000;89829000;2999000;;4069000;7068000;96897000;17318000;5095000;22413000;7472000;7652000;30065000;270107000;;-203275000;66832000;96897000
CSII;178927;USD;2012;Q4;2012-06-30;2012-09-10;18896454;18896454;35529000;13644000;7061000;57770000;2163000;;3191000;5354000;63124000;12872000;4678000;17852000;12842000;13083000;30935000;211427000;;-179238000;32189000;63124000
CSII;178927;USD;2011;Q4;2011-06-30;2011-11-08;;;21159000;13254000;5818000;41028000;2383000;;3347000;5730000;46758000;10726000;3813000;15186000;8331000;9937000;25123000;184083000;;-162448000;21635000;46758000
CSII;178927;USD;2018;Q4;2018-06-30;2018-08-23;33262158;34734386;116804000;31225000;16605000;167611000;27744000;;7997000;35741000;203352000;36217000;;37460000;;31422000;68882000;461960000;;-327591000;134470000;203352000
CSII;178927;USD;2019;Q4;2019-06-30;2019-08-23;33609980;32355900;122672000;36015000;18058000;180075000;27324000;;11178000;38502000;218577000;40581000;;42345000;;28288000;70633000;477402000;;-329536000;147944000;218577000
BURL;179036;USD;2016;Q4;2017-02-28;2017-03-16;69650000;70877000;81597000;43252000;701891000;928324000;1049447000;;596712000;1646159000;2574483000;640326000;1638000;996834000;1128843000;1627461000;2624295000;1420588000;-403110000;-1060099000;-49812000;2574483000
BURL;179036;USD;2015;Q4;2016-02-29;2016-03-15;72166000;73366000;20915000;38571000;783528000;932982000;1018570000;;620261000;1638831000;2571813000;598199000;1403000;886588000;1295163000;1784247000;2670835000;1395870000;-209928000;-1275972000;-99022000;2571813000
BURL;179036;USD;2014;Q4;2015-02-28;2015-03-25;74574000;79807000;25349000;49716000;788708000;950254000;970419000;;703896000;1674315000;2624569000;621682000;1167000;933117000;1249276000;1757403000;2690520000;1370505000;-8258000;-1426454000;-65951000;2624569000
BURL;179036;USD;2013;Q4;2014-02-28;2014-03-31;-1390742000;-1390742000;132984000;35678000;720052000;1003045000;902657000;;715390000;1618047000;2621092000;542987000;59026000;903816000;1369159000;1867744000;2771560000;1346266000;-4325000;-1492409000;-150468000;2621092000
BURL;179036;USD;2012;Q4;2013-02-28;2013-12-12;507320000;507320000;43336000;41734000;680190000;873521000;878305000;;726256000;1604561000;2478082000;500406000;784000;740055000;1335532000;2847485000;3587540000;47000;-4000;-1109501000;-1109458000;2478082000
BURL;179036;USD;2017;Q4;2018-02-28;2018-03-20;67310000;69305000;133286000;71649000;752562000;1100433000;1134772000;;577624000;1712396000;2812829000;736252000;13164000;1119631000;1113808000;1606424000;2726055000;1457212000;-692887000;-675664000;86774000;2812829000
BURL;179036;USD;2018;Q4;2019-02-28;2019-03-20;66595000;68349000;112274000;58752000;954183000;1271900000;1253705000;;553567000;1807272000;3079172000;848561000;2924000;1247742000;983643000;1508720000;2756462000;1509003000;-921761000;-260919000;322710000;3079172000
LNTH;179201;USD;2016;Q4;2016-12-31;2017-02-23;36208937;37306116;51178000;36818000;17640000;110819000;94187000;;50892000;145079000;255898000;40189000;3650000;43839000;274460000;318575000;362414000;226829000;;-332398000;-106516000;255898000
LNTH;179201;USD;2015;Q4;2015-12-31;2016-03-02;97692041537;97691315833;28596000;37293000;15622000;90006000;95654000;;56719000;152373000;242379000;30159000;3650000;35524000;349858000;392144000;427668000;175856000;;-359160000;-185289000;242379000
LNTH;179201;USD;2014;Q4;2014-12-31;2015-08-05;72268218512;72268218512;19739000;41540000;15582000;81235000;96014000;;65904000;161918000;243153000;40528000;;48528000;392863000;433895000;482423000;106880000;-106000;-344414000;-239270000;243153000
LNTH;179201;USD;2017;Q4;2017-12-31;2018-02-26;37587282;38945644;76290000;40259000;26080000;147850000;92999000;;143009000;236008000;383858000;44000000;2750000;46750000;265393000;313817000;360567000;233338000;;-209013000;23291000;383858000
LNTH;179201;USD;2018;Q4;2018-12-31;2019-02-20;38471000;39711000;113401000;43753000;33019000;195415000;107888000;;136528000;244416000;439831000;50005000;2750000;52755000;263709000;316074000;368829000;240250000;;-168140000;71002000;439831000
DKS;179423;USD;2016;Q4;2017-01-31;2017-03-24;110396000;111644000;164777000;75199000;1638632000;1995678000;1522574000;;540044000;2062618000;4058296000;1192981000;646000;1397415000;4679000;731392000;2128807000;1131933000;-1158378000;1956066000;1929489000;4058296000
DKS;179423;USD;2015;Q4;2016-01-31;2016-03-25;112617000;113959000;118936000;61395000;1527187000;1812690000;1347885000;;398761000;1746646000;3559336000;1006700000;589000;1191675000;5324000;578474000;1770149000;1064823000;-1012671000;1737214000;1789187000;3559336000
DKS;179423;USD;2014;Q4;2015-01-31;2015-03-27;117746000;119750000;221679000;80292000;1390767000;1798798000;1203382000;;389524000;1592906000;3391704000;946037000;537000;1118833000;5913000;440646000;1559479000;1016585000;-655469000;1471182000;1832225000;3391704000
DKS;179423;USD;2013;Q4;2014-01-31;2014-03-28;122688000;125215000;181731000;60779000;1232065000;1620071000;1084529000;;366887000;1451416000;3071487000;847304000;899000;1002587000;6476000;376721000;1379308000;960153000;-455512000;1187514000;1692179000;3071487000
DKS;179423;USD;2012;Q4;2013-01-31;2013-03-22;122971000;126506000;345214000;34625000;1096186000;1595889000;840135000;;451783000;1291918000;2887807000;845893000;8513000;1000768000;7762000;299715000;1300483000;875466000;-199958000;911704000;1587324000;2887807000
DKS;179423;USD;2011;Q4;2012-01-31;2012-03-16;120928000;126317000;734402000;38338000;1014997000;1868393000;778034000;;350025000;1128059000;2996452000;803955000;7426000;940146000;151596000;423561000;1363707000;700980000;-1224000;932871000;1632745000;2996452000
DKS;179423;USD;2010;Q4;2011-01-31;2011-03-18;117950000;124062000;546052000;34978000;896895000;1564330000;684886000;;348320000;1033206000;2597536000;725795000;995000;848543000;139846000;385412000;1233955000;626372000;0;730468000;1363581000;2597536000
DKS;179423;USD;2009;Q4;2010-01-31;2010-08-27;114639000;119665000;225611000;35435000;895776000;1222361000;662304000;10880000;349788000;1022972000;2245333000;686467000;978000;795675000;141265000;366431000;1162106000;527863000;;548391000;1083227000;2245333000
DKS;179423;USD;2017;Q4;2018-01-31;2018-03-30;103826000;104445000;101253000;60107000;1711103000;2006085000;1677340000;;520514000;2197854000;4203939000;1207732000;5202000;1425014000;60084000;837424000;2262438000;1178808000;-1442880000;2205651000;1941501000;4203939000
DKS;179423;USD;2018;Q4;2019-01-31;2019-03-29;94195000;95490000;113653000;37970000;1824696000;2122398000;1565271000;;499480000;2064751000;4187149000;1274392000;;1504639000;0;778349000;2282988000;1215225000;-1766136000;2455192000;1904161000;4187149000
SMED;179660;USD;2018;Q4;2018-06-30;2018-08-22;16083000;15977000;5155000;6370000;3986000;16250000;6572000;;10409000;16981000;33231000;3561000;537000;5992000;1465000;2065000;8057000;28785000;-1554000;-2057000;25174000;33231000
SMED;179660;USD;2017;Q4;2017-06-30;2017-08-23;16005000;16005000;4675000;7553000;4098000;17020000;6543000;;10901000;17444000;34464000;3510000;601000;6532000;2002000;2645000;9177000;28226000;-1554000;-1385000;25287000;34464000
SMED;179660;USD;2016;Q4;2016-06-30;2016-08-25;15444000;15902000;12435000;5814000;3919000;22863000;5032000;;2252000;7284000;30147000;3154000;0;5631000;0;673000;6304000;25489000;-1554000;-92000;23843000;30147000
SMED;179660;USD;2015;Q4;2015-06-30;2015-08-26;15379000;16185000;15157000;6647000;2738000;25222000;3810000;;719000;4529000;29751000;3722000;;5599000;;566000;6165000;24500000;-809000;-105000;23586000;29751000
SMED;179660;USD;2014;Q4;2014-06-30;2014-08-27;15270000;61557948;13717000;4728000;1320000;21888000;3858000;;715000;4573000;26461000;2663000;;4000000;;557000;4557000;23850000;-681000;-1265000;21904000;26461000
SMED;179660;USD;2013;Q4;2013-06-30;2013-08-29;15333000;60974313;15503000;2595000;1632000;20424000;4440000;;668000;5108000;25532000;2430000;;3781000;;681000;4462000;23365000;-74000;-2221000;21070000;25532000
SMED;179660;USD;2012;Q4;2012-06-30;2012-08-30;15183000;14856000;17498000;2215000;2219000;22542000;4632000;;464000;5096000;27638000;2054000;;3935000;;523000;4458000;22689000;0;491000;23180000;27638000
SMED;179660;USD;2011;Q4;2011-06-30;2011-11-03;59731225;59731225;18280000;3065000;1770000;24175000;5350000;;1073000;6423000;30598000;2225000;;3949000;;784000;4733000;21753000;;4112000;25865000;30598000
SMED;179660;USD;2019;Q4;2019-06-30;2019-08-28;16144000;16159000;4512000;9289000;3770000;18753000;5867000;;11420000;17287000;36040000;5159000;517000;8178000;948000;1736000;9914000;29185000;-1554000;-1505000;26126000;36040000
TPIC;180206;USD;2016;Q4;2016-12-31;2017-03-17;34360000;34607000;119066000;67842000;105403000;325227000;91166000;;20813000;111979000;437206000;132193000;33403000;236554000;89752000;94145000;330699000;293170000;;-182801000;106507000;437206000
TPIC;180206;USD;2015;Q4;2015-12-31;2016-08-30;4238000;4238000;45917000;72913000;100435000;252362000;67732000;;9826000;77558000;329920000;114704000;52065000;241194000;77281000;279923000;521117000;;;-191172000;-191197000;329920000
TPIC;180206;USD;2017;Q4;2017-12-31;2018-03-08;34011000;36778000;148113000;121576000;4112000;410776000;123480000;;22306000;145786000;556562000;197594000;35506000;235863000;85879000;90817000;326680000;301883000;-511000;-70932000;229882000;556562000
TPIC;180206;USD;2018;Q4;2018-12-31;2019-03-05;34612000;38083000;85346000;176815000;5735000;414197000;159423000;;31235000;190658000;604855000;235843000;27058000;270044000;110565000;113854000;383898000;312118000;-1788000;-74981000;220957000;604855000
JCP;180279;USD;2016;Q4;2017-01-31;2016-03-16;306200000;306200000;900000000;;2721000000;4018000000;4816000000;;608000000;5424000000;9442000000;2285000000;127000000;2412000000;4678000000;5721000000;8133000000;4807000000;;-3007000000;1309000000;9442000000
JCP;180279;USD;2015;Q4;2016-01-31;2016-03-16;305300000;305300000;1318000000;;2652000000;4331000000;5148000000;;830000000;5978000000;10309000000;2100000000;56000000;2156000000;5265000000;6239000000;8395000000;4758000000;;-2494000000;1914000000;10309000000
JCP;180279;USD;2014;Q4;2015-01-31;2014-03-21;304900000;304900000;1515000000;;2935000000;4833000000;5619000000;;1349000000;6968000000;11801000000;2146000000;50000000;2846000000;4901000000;5868000000;8714000000;4723000000;;-1008000000;3087000000;11801000000
JCP;180279;USD;2013;Q4;2014-01-31;2013-03-20;219800000;219800000;930000000;;2341000000;3683000000;5353000000;;745000000;6098000000;9781000000;2542000000;26000000;2568000000;2956000000;4042000000;6610000000;3909000000;;380000000;3171000000;9781000000
JCP;180279;USD;2012;Q4;2013-01-31;2012-03-28;213800000;208300000;1507000000;;2916000000;5081000000;5176000000;;1167000000;6343000000;11424000000;2525000000;231000000;2756000000;2871000000;4658000000;7414000000;3807000000;;1412000000;4010000000;11424000000
JCP;180279;USD;2011;Q4;2012-01-31;2011-03-29;237600000;238000000;2622000000;;3213000000;6370000000;5231000000;;1467000000;6698000000;13068000000;2647000000;;2647000000;3099000000;4961000000;7608000000;4043000000;;2222000000;5460000000;13068000000
JCP;180279;USD;2010;Q4;2011-01-31;2010-03-30;235000000;236400000;3011000000;;3024000000;6652000000;5357000000;;572000000;5929000000;12581000000;2856000000;393000000;3249000000;2999000000;4554000000;7803000000;3985000000;;2023000000;4778000000;12581000000
JCP;180279;USD;2009;Q4;2010-01-31;2009-09-09;;;2352000000;;3259000000;6220000000;5367000000;;424000000;5791000000;12011000000;2794000000;0;2794000000;3505000000;5062000000;7856000000;3610000000;;1959000000;4155000000;12011000000
JCP;180279;USD;2017;Q4;2018-01-31;2018-03-19;320900000;320900000;458000000;;2803000000;3451000000;4281000000;;722000000;5003000000;8454000000;2129000000;240000000;2369000000;3992000000;4702000000;7071000000;4861000000;;-3118000000;1383000000;8454000000
JCP;180279;USD;2018;Q4;2019-01-31;2019-03-19;316900000;316900000;333000000;;2437000000;2959000000;3938000000;;824000000;4762000000;7721000000;1842000000;100000000;1942000000;3920000000;4609000000;6551000000;4871000000;;-3373000000;1170000000;7721000000
PFGC;180458;USD;2017;Q4;2017-06-30;2017-08-25;100668713;103841170;8100000;1028500000;1013300000;2084900000;740700000;;978500000;1719200000;3804100000;1153100000;11700000;1383300000;1285900000;1495300000;2878600000;856500000;;66600000;925500000;3804100000
PFGC;180458;USD;2016;Q4;2016-06-30;2016-08-30;100116081;103133530;10900000;968200000;919700000;1938900000;637000000;;879500000;1516500000;3455400000;1149400000;2400000;1316700000;1143100000;1335900000;2652600000;837800000;;-29200000;802800000;3455400000
PFGC;180458;USD;2015;Q4;2015-06-30;2015-11-04;86876605;87511087;9200000;964600000;882600000;1882800000;594700000;;876000000;1470700000;3353500000;1130000000;12900000;1277000000;1409700000;1583500000;2860500000;595000000;;-97500000;493000000;3353500000
PFGC;180458;USD;2018;Q4;2018-06-30;2018-08-16;103000000;105500000;7500000;1065600000;1051900000;2203500000;795500000;;1001900000;1797400000;4000900000;1200800000;8400000;1470000000;1175800000;1395600000;2865600000;862200000;;264800000;1135300000;4000900000
MENT;181078;USD;2017;Q4;2018-01-31;2017-03-17;109834000;124217000;441087000;512644000;18575000;1023851000;210680000;303686000;722968000;1237334000;2261185000;193820000;31717000;762755000;15224000;122747000;885502000;737164000;;664084000;1375683000;2261185000
MENT;181078;USD;2016;Q4;2017-01-31;2016-03-21;116458000;121540000;334826000;493209000;24762000;898467000;182092000;268657000;715148000;1165897000;2064364000;131136000;33449000;423310000;240076000;320625000;743935000;818683000;;522846000;1320429000;2064364000
MENT;181078;USD;2015;Q4;2016-01-31;2015-03-16;115332000;120111000;230281000;546622000;22512000;865294000;170737000;301862000;708115000;1180714000;2046008000;174962000;7228000;441530000;227386000;318252000;759782000;832612000;;451901000;1286226000;2046008000
MENT;181078;USD;2014;Q4;2015-01-31;2014-03-17;114999000;117684000;297312000;454483000;25121000;830109000;160165000;270365000;643470000;1074000000;1904109000;170218000;9590000;410987000;224261000;292349000;703336000;838939000;;327552000;1200773000;1904109000
MENT;181078;USD;2013;Q4;2014-01-31;2013-03-15;112635000;115058000;223783000;412245000;18036000;704952000;162402000;250497000;627433000;1040332000;1745284000;172102000;5964000;411825000;218546000;287282000;699107000;810902000;;197178000;1046177000;1745284000
MENT;181078;USD;2012;Q4;2013-01-31;2012-03-15;109255000;115484000;146499000;354924000;8136000;567435000;148019000;220355000;614866000;983240000;1550675000;166432000;14617000;373938000;213224000;301397000;675335000;775362000;;62032000;875340000;1550675000
MENT;181078;USD;2011;Q4;2012-01-31;2011-03-17;110216000;115913000;133113000;347075000;8255000;533304000;139340000;167425000;587909000;894674000;1427978000;170927000;15544000;359887000;207348000;291377000;651264000;765179000;;-20158000;776714000;1427978000
MENT;181078;USD;2010;Q4;2011-01-31;2010-09-17;98988000;98988000;99343000;289750000;3630000;430613000;121795000;164898000;505735000;792428000;1223041000;135086000;37874000;359197000;156075000;223827000;583024000;662595000;;-48742000;640017000;1223041000
GES;181484;USD;2017;Q4;2018-02-28;2016-12-06;80960000;80593000;367441000;259996000;428304000;1108705000;294254000;;252675000;546929000;1655634000;465000000;2845000;467845000;39196000;248724000;716569000;499062000;-621354000;1132173000;939065000;1655634000
GES;181484;USD;2016;Q4;2017-02-28;2016-03-25;83771000;84022000;396129000;225537000;367381000;1044012000;243005000;;247468000;490473000;1534485000;344887000;566000;345453000;23482000;203586000;549039000;481276000;-565744000;1215079000;985446000;1534485000
GES;181484;USD;2015;Q4;2016-02-29;2015-03-27;83102000;83338000;445480000;222359000;311704000;1036252000;255344000;;247152000;502496000;1538748000;323035000;4024000;327059000;2318000;175144000;502203000;469412000;-562658000;1269775000;1036545000;1538748000
GES;181484;USD;2014;Q4;2015-02-28;2014-03-28;84720000;85218000;508068000;276565000;350899000;1216086000;324606000;;223739000;548345000;1764431000;365865000;4160000;370025000;7580000;218590000;588615000;440592000;-519457000;1247180000;1175816000;1764431000
GES;181484;USD;2013;Q4;2014-02-28;2013-04-01;84273000;84546000;335927000;316863000;369712000;1107225000;355729000;;250552000;606281000;1713506000;383065000;1901000;384966000;8314000;224528000;609494000;424240000;-497769000;1162982000;1104012000;1713506000
GES;181484;USD;2012;Q4;2013-02-28;2012-03-23;84478000;84711000;495865000;340602000;328602000;1261482000;348885000;;234108000;582993000;1844475000;418006000;2030000;420036000;10206000;221881000;641917000;401074000;-357943000;1155696000;1202558000;1844475000
GES;181484;USD;2011;Q4;2012-02-29;2011-03-28;90628000;90915000;442124000;358482000;294705000;1163580000;313856000;;208368000;522224000;1685804000;428839000;2177000;431016000;12218000;173883000;604899000;369148000;-266154000;960460000;1080905000;1685804000
GES;181484;USD;2010;Q4;2011-02-28;2010-09-07;91217000;91996000;502063000;283747000;253162000;1124163000;255308000;;151778000;407086000;1531249000;340396000;2357000;342753000;14137000;148340000;491093000;320664000;-217032000;919531000;1040156000;1531249000
GES;181484;USD;2018;Q4;2019-02-28;2019-03-29;-80028427000;-80024095000;210460000;321995000;468897000;1088695000;315558000;;244952000;560510000;1649205000;539049000;4315000;543364000;35012000;247343000;790707000;524145000;-638486000;1077747000;858498000;1649205000
TTC;181580;USD;2015;Q4;2015-10-31;2015-12-23;110086000;112322000;126275000;177013000;334514000;710679000;224995000;;367984000;592979000;1303658000;420378000;23356000;443734000;354818000;397759000;841493000;54651000;;437357000;462165000;1303658000
TTC;181580;USD;2014;Q4;2014-10-31;2014-12-22;111916000;114226000;314873000;158158000;274603000;824036000;205195000;;163184000;368379000;1192415000;169029000;27458000;400420000;347316000;383268000;783688000;55678000;;368754000;408727000;1192415000
TTC;181580;USD;2013;Q4;2013-10-31;2013-12-20;114846000;117244000;182993000;157171000;240089000;653267000;185096000;;164385000;349481000;1002748000;180793000;;388845000;223544000;255165000;644010000;56789000;;314519000;358738000;1002748000
TTC;181580;USD;2012;Q4;2012-10-31;2012-12-21;117750000;120458000;125856000;147410000;251117000;612134000;180523000;;142542000;323065000;935199000;179334000;1858000;378122000;223482000;244675000;622797000;58266000;;264110000;312402000;935199000
TTC;181580;USD;2011;Q4;2011-10-31;2011-12-21;122346000;123942000;80886000;148140000;223030000;532882000;191140000;;146641000;337781000;870663000;174100000;2019000;359080000;225178000;244816000;603896000;59206000;;214387000;266767000;870663000
TTC;181580;USD;2010;Q4;2010-10-31;2010-12-22;126880000;129360000;177366000;142901000;194402000;584973000;173407000;;127242000;300649000;885622000;181685000;3004000;368283000;223578000;241529000;609812000;31395000;;253477000;275810000;885622000
TTC;181580;USD;2009;Q4;2009-10-31;2010-09-02;137632000;140328000;187773000;143709000;176275000;582138000;166716000;;123828000;290544000;872682000;142798000;8294000;316801000;225046000;240669000;557470000;33369000;;291246000;315212000;872682000
TTC;181580;USD;2016;Q4;2016-10-31;2016-12-22;109534000;111538000;273555000;163265000;307034000;779009000;222038000;;386471000;608509000;1387518000;228241000;22484000;463839000;331423000;373644000;837483000;108427000;;480044000;550035000;1387518000
TTC;181580;USD;2017;Q4;2017-10-31;2017-12-22;107962000;111639000;310256000;183073000;328992000;859886000;235230000;;398671000;633901000;1493787000;269986000;26258000;521796000;305629000;354899000;876695000;106883000;;534329000;617092000;1493787000
TTC;181580;USD;2018;Q4;2018-10-31;2018-12-21;106077000;107868000;289124000;193178000;358259000;894637000;271459000;;404888000;676347000;1570984000;308212000;0;532635000;312549000;369433000;902068000;105601000;;587252000;668916000;1570984000
TECD;181744;USD;2016;Q4;2017-01-31;2016-03-24;35050000;35340000;531169000;2995114000;2117384000;5822061000;66028000;;470199000;536227000;6358288000;3914583000;18063000;3932646000;348608000;419887000;4352533000;682316000;-1077434000;2434198000;2005755000;6358288000
TECD;181744;USD;2015;Q4;2016-01-31;2015-03-26;38054000;38294000;542995000;2811963000;1959627000;5578123000;63104000;;495498000;558602000;6136725000;3658376000;13303000;3743126000;351576000;433456000;4176582000;680062000;-939143000;2168462000;1960143000;6136725000
TECD;181744;USD;2014;Q4;2015-01-31;2014-04-09;38070000;38333000;570101000;3215729000;2450782000;6469035000;77631000;;623000000;700631000;7169666000;4574107000;43481000;4617588000;354121000;453467000;5071055000;675686000;-894936000;1993290000;2098611000;7169666000
TECD;181744;USD;2013;Q4;2014-01-31;2014-02-05;37739000;38041000;340564000;3215920000;2254510000;6145425000;84395000;;601140000;685535000;6830960000;4277418000;167522000;4444940000;354458000;467651000;4912591000;680804000;-905900000;1813358000;1918369000;6830960000
TECD;181744;USD;2012;Q4;2013-01-31;2012-03-21;41122000;41769000;486262000;2778641000;1932289000;5394500000;88881000;;312887000;401768000;5796268000;3625446000;48490000;3673936000;57253000;140203000;3814139000;773176000;-739614000;1637103000;1982129000;5796268000
TECD;181744;USD;2011;Q4;2012-01-31;2011-03-23;46572000;47216000;763725000;2896671000;2205394000;6046937000;94315000;;270831000;365146000;6412083000;3710391000;434435000;4144826000;60076000;128830000;4273656000;768846000;-466635000;1453371000;2138427000;6412083000
TECD;181744;USD;2010;Q4;2011-01-31;2010-09-01;51102000;51886000;1116579000;2593919000;1704658000;5571604000;90634000;;167881000;258515000;5830119000;3255314000;65860000;3321174000;338157000;414412000;3735586000;769384000;-279198000;1239128000;2094533000;5830119000
TECD;181744;USD;2017;Q4;2018-01-31;2018-03-22;35224000;35515000;955628000;6035716000;2965521000;10360413000;279091000;;2280855000;2559946000;12920359000;8132179000;132661000;8264840000;1505248000;1734027000;9998867000;827390000;-940124000;2745934000;2921492000;12920359000
GPN;182201;USD;2016;Q4;2016-12-31;2016-07-28;140016000;141009000;1044728000;281612000;;2851313000;493678000;;7164961000;7658639000;10509952000;696414000;135542000;2430707000;4379744000;5201841000;7632548000;1976715000;;1015811000;2877404000;10509952000
GPN;182201;USD;2015;Q4;2015-12-31;2015-07-30;131462000;132368000;650739000;202390000;;3289915000;374143000;;2115243000;2489386000;5779301000;326875000;61784000;3015188000;1678283000;1900560000;4915748000;148742000;;795226000;863553000;5779301000
GPN;182201;USD;2014;Q4;2014-12-31;2014-07-29;141404000;142646000;581872000;214574000;6636000;1643444000;369753000;;2005453000;2375206000;4018650000;302496000;17677000;1211618000;1376002000;1674233000;2885851000;183023000;;815980000;1132799000;4018650000
GPN;182201;USD;2013;Q4;2013-12-31;2013-07-25;151914000;152794000;680470000;189435000;11057000;1214492000;348064000;;1562500000;1910564000;3125056000;281760000;72335000;704114000;891134000;1134335000;1838449000;202396000;;958751000;1286607000;3125056000
GPN;182201;USD;2012;Q4;2012-12-31;2012-07-27;156942000;157904000;781275000;182962000;9864000;1248739000;305848000;;1133556000;1439404000;2688143000;328596000;76420000;837285000;236565000;405515000;1242800000;358728000;;843456000;1445343000;2688143000
GPN;182201;USD;2011;Q4;2011-12-31;2011-07-25;160306000;160992000;1354285000;166540000;7640000;1847975000;256301000;;1246255000;1502556000;3350531000;249252000;85802000;1444364000;268217000;434492000;1878856000;419591000;;685624000;1471675000;3350531000
GPN;182201;USD;2010;Q4;2010-12-31;2010-10-12;;;769946000;131817000;9740000;968264000;183938000;;887124000;1071062000;2039326000;180005000;148169000;672471000;272965000;392666000;1065137000;460747000;-100000000;544772000;974189000;2039326000
GPN;182201;USD;2017;Q4;2017-12-31;2018-02-23;157622000;158280000;1335855000;301887000;;4303579000;588348000;;8106142000;8694490000;12998069000;1039607000;100308000;3815590000;4559408000;5217248000;9032838000;2379774000;;1597897000;3965231000;12998069000
GPN;182201;USD;2018;Q4;2018-12-31;2019-02-21;158196000;158666000;1210878000;348400000;;3376208000;653542000;;9201024000;9854566000;13230774000;1176703000;115075000;3268620000;5015168000;5775811000;9044431000;2235167000;;2066415000;4186343000;13230774000
BAH;182296;USD;2018;Q4;2019-03-31;2019-05-28;140035876;568772642;283990000;1330364000;;1699340000;172453000;;1960048000;2132501000;3831841000;990501000;57924000;1179239000;1701837000;1977236000;3156475000;403195000;-711450000;994811000;675366000;3831841000
BAH;182296;USD;2017;Q4;2018-03-31;2018-05-29;144115622;585416375;286958000;1133705000;;1491972000;152364000;;1962283000;2114647000;3606619000;840309000;63100000;1028767000;1755479000;2015361000;3044128000;348538000;-461457000;690516000;562491000;3606619000
BAH;182296;USD;2016;Q4;2017-03-31;2017-05-22;148945703;594586424;217417000;991810000;;1294480000;139167000;;1939458000;2078625000;3373105000;767933000;193150000;1101401000;1470174000;1698113000;2799514000;304466000;-191900000;478102000;573591000;3373105000
BAH;182296;USD;2015;Q4;2016-03-31;2016-05-19;147120316;295567526;187529000;892289000;;1189771000;130169000;;1690231000;1820400000;3010171000;726136000;112813000;939913000;1484448000;1661770000;2601683000;245009000;-135445000;318537000;408488000;3010171000
BAH;182296;USD;2014;Q4;2015-03-31;2015-05-21;145843793;150791975;207217000;857310000;;1148669000;111367000;;1603946000;1715313000;2863982000;761054000;57063000;848994000;1555761000;1828490000;2677484000;176493000;-72293000;104457000;186498000;2863982000
BAH;182296;USD;2013;Q4;2014-03-31;2014-05-22;143244667;150145438;259994000;916737000;;1255977000;129427000;;1555414000;1684841000;2940818000;820247000;73688000;917104000;1585231000;1852078000;2769182000;145737000;-10153000;42688000;171636000;2940818000
BAH;182296;USD;2012;Q4;2013-03-31;2013-05-23;137233592;147429182;350384000;1029586000;;1424352000;166570000;;1586606000;1753176000;3177528000;836498000;55562000;964646000;1659611000;1986089000;2950735000;122249000;-6444000;124775000;226793000;3177528000
BAH;182296;USD;2011;Q4;2012-03-31;2012-05-30;130670439;140265894;484368000;1077315000;;1653657000;191079000;;1470055000;1661134000;3314791000;801823000;42500000;914446000;922925000;1215160000;2129606000;899898000;-5377000;299379000;1185185000;3314791000
BAH;182296;USD;2010;Q4;2011-03-31;2011-08-10;;;192631000;1111004000;;1360443000;173430000;;1490150000;1663580000;3024023000;803306000;30000000;866135000;964328000;1250638000;2116773000;841373000;0;71330000;907250000;3024023000
LE;182473;USD;2016;Q4;2017-01-31;2016-04-01;31990000;31750000;213108000;39284000;325314000;607400000;122836000;;384155000;506991000;1114391000;162408000;;248854000;490043000;594125000;842979000;344291000;;-60453000;271412000;1114391000
LE;182473;USD;2015;Q4;2016-01-31;2015-04-17;31957000;32174000;228368000;32061000;329203000;616550000;109831000;;555145000;664976000;1281526000;146097000;;230089000;493838000;666928000;897017000;344564000;;49329000;384509000;1281526000
LE;182473;USD;2014;Q4;2015-01-31;2014-06-12;31957000;31957000;22411000;33617000;369928000;451249000;101096000;;641930000;743026000;1194275000;115387000;;203361000;0;198600000;401961000;0;;0;792314000;1194275000
LE;182473;USD;2017;Q4;2018-01-31;2018-03-29;32183000;32297000;195581000;49860000;332297000;606753000;136501000;;380881000;517382000;1124135000;155874000;;256131000;486248000;560911000;817042000;347495000;;-29810000;307093000;1124135000
LE;182473;USD;2018;Q4;2019-01-31;2019-03-28;32212000;33453000;193405000;34549000;321905000;588381000;149894000;;372636000;522530000;1110911000;123827000;;241251000;482453000;546949000;788200000;353053000;;-17159000;322711000;1110911000
MTRX;182638;USD;2016;Q4;2016-06-30;2016-09-01;26433000;27048000;71656000;190434000;3935000;375446000;84731000;;104790000;189521000;564967000;181082000;;246030000;0;3371000;249401000;127237000;-26907000;223257000;315566000;564967000
MTRX;182638;USD;2015;Q4;2015-06-30;2015-09-11;26631000;27707000;79239000;199149000;2773000;373471000;85063000;;103155000;188218000;561689000;163885000;;267087000;8804000;10048000;277135000;123317000;-18489000;194394000;284554000;561689000
MTRX;182638;USD;2014;Q4;2014-06-30;2014-09-08;26417000;27333000;77115000;204692000;3045000;375548000;89172000;;104212000;193384000;568932000;157175000;;269861000;11621000;16788000;286649000;120056000;-16595000;177237000;282283000;568932000
MTRX;182638;USD;2013;Q4;2013-06-30;2013-09-06;26082000;26669000;63750000;140840000;2988000;296274000;71301000;;42403000;113704000;409978000;98479000;;164366000;0;7450000;171816000;118469000;-21961000;141427000;238162000;409978000
MTRX;182638;USD;2012;Q4;2012-06-30;2012-09-06;25742000;26280000;39726000;108034000;2482000;230516000;54875000;;37744000;92619000;323135000;72256000;;105963000;;6075000;112038000;116972000;-24065000;117419000;211097000;323135000
MTRX;182638;USD;2011;Q4;2011-06-30;2011-11-08;26457000;26844000;59357000;103483000;2249000;215550000;53311000;;37575000;90886000;306436000;61990000;;100176000;800000;6589000;106765000;113965000;-15961000;100231000;199671000;306436000
MTRX;182638;USD;2017;Q4;2017-06-30;2017-09-11;26598000;25910000;43805000;210953000;3737000;358630000;80274000;;147126000;227400000;586030000;136150000;;218976000;44682000;45245000;264221000;128698000;-22539000;222974000;321809000;586030000
MTRX;182638;USD;2018;Q4;2018-06-30;2018-09-12;26833000;26419000;64057000;203388000;5152000;357046000;72645000;;128342000;200987000;558033000;112901000;;238465000;0;725000;239190000;132477000;-17717000;211494000;318843000;558033000
PI;182875;USD;2016;Q4;2016-12-31;2017-03-03;19206000;17665000;100541000;17447000;27734000;148726000;14929000;;3881000;18810000;167536000;20911000;3719000;25381000;11374000;18132000;43513000;311236000;;-187203000;124023000;167536000
PI;182875;USD;2015;Q4;2015-12-31;2016-09-02;4133000;4133000;10121000;12889000;11837000;35942000;12351000;;4555000;16906000;52848000;10115000;6417000;17474000;13209000;22446000;39920000;100280000;;-185315000;12928000;52848000
PI;182875;USD;2017;Q4;2017-12-31;2018-03-15;20914000;20914000;58116000;22244000;47083000;129802000;18110000;;4122000;22232000;152034000;13557000;5024000;19923000;6245000;13169000;33092000;323503000;;-204525000;118942000;152034000
PI;182875;USD;2018;Q4;2018-12-31;2019-02-28;21475000;21475000;56073000;18462000;44725000;121214000;19778000;;4077000;23855000;145069000;14939000;6453000;23025000;17891000;24161000;47186000;337648000;;-239756000;97883000;145069000
AL;182952;USD;2016;Q4;2016-12-31;2017-02-23;102844794;111003289;274802000;;;290802000;12041925000;;1642889000;13684814000;13975616000;256775000;;356160000;8713874000;10237269000;10593429000;2238876000;;1143311000;3382187000;13975616000
AL;182952;USD;2015;Q4;2015-12-31;2016-02-25;102583501;110594947;156675000;;;173203000;10813475000;;1368420000;12181895000;12355098000;215983000;;307468000;7712421000;9027718000;9335186000;2228386000;;791526000;3019912000;12355098000
AL;182952;USD;2014;Q4;2014-12-31;2015-02-26;102396002;110219907;282819000;;;290288000;8953804000;;1447088000;10400892000;10691180000;190952000;;266829000;6630758000;7652289000;7919118000;2216489000;;555573000;2772062000;10691180000
AL;182952;USD;2013;Q4;2013-12-31;2014-02-27;101800888;109463668;270173000;;;357481000;7613135000;;1361988000;8975123000;9332604000;131223000;;192743000;5853317000;6616427000;6809170000;2210575000;;312859000;2523434000;9332604000
AL;182952;USD;2012;Q4;2012-12-31;2013-02-28;101252953;107912991;230089000;;;336396000;6251863000;;765365000;7017228000;7353624000;90169000;;131306000;4384732000;4889697000;5021003000;2199510000;;133111000;2332621000;7353624000
AL;182952;USD;2011;Q4;2011-12-31;2012-03-09;101224832;104222359;281805000;;;377962000;4237416000;;549215000;4786631000;5164593000;54648000;;80665000;2602799000;2907645000;2988310000;2175091000;;1192000;2176283000;5164593000
AL;182952;USD;2010;Q4;2010-12-31;2011-08-12;67858111;67858111;328821000;;;377497000;1629809000;;268976000;1898785000;2276282000;22054000;;30092000;911981000;1021255000;1051347000;1276975000;;-52040000;1224935000;2276282000
AL;182952;USD;2017;Q4;2017-12-31;2018-02-22;103406628;111926302;292204000;;;308282000;13280250000;;2025632000;15305882000;15614164000;309182000;;414002000;9698785000;11072720000;11486722000;2261100000;;1866342000;4127442000;15614164000
AL;182952;USD;2018;Q4;2018-12-31;2019-02-21;107046539;112288720;300127000;;;322998000;15707110000;;2451700000;18158810000;18481808000;382132000;;501658000;11538905000;13173250000;13674908000;2475348000;;2331552000;4806900000;18481808000
INTU;183557;USD;2017;Q4;2017-07-31;2017-09-01;257000000;266000000;777000000;103000000;;1415000000;1030000000;31000000;1592000000;2653000000;4068000000;457000000;50000000;1944000000;438000000;770000000;2714000000;4857000000;-10778000000;7297000000;1354000000;4068000000
INTU;183557;USD;2016;Q4;2016-07-31;2016-09-01;256000000;262000000;1080000000;108000000;;1614000000;1031000000;28000000;1577000000;2636000000;4250000000;473000000;512000000;2251000000;488000000;838000000;3089000000;4445000000;-9939000000;6687000000;1161000000;4250000000
INTU;183557;USD;2015;Q4;2015-07-31;2015-09-01;276000000;291000000;1697000000;91000000;;2560000000;682000000;27000000;1699000000;2408000000;4968000000;473000000;0;1744000000;500000000;892000000;2636000000;4010000000;-7675000000;6027000000;2332000000;4968000000
INTU;183557;USD;2014;Q4;2014-07-31;2014-09-12;284000000;302000000;1914000000;115000000;;2621000000;589000000;31000000;1960000000;2580000000;5201000000;407000000;;1421000000;499000000;702000000;2123000000;3561000000;-6430000000;5949000000;3078000000;5201000000
INTU;183557;USD;2013;Q4;2013-07-31;2013-09-13;299000000;309000000;1661000000;130000000;;2396000000;555000000;83000000;2452000000;3090000000;5486000000;355000000;;1280000000;499000000;675000000;1955000000;3201000000;-4952000000;5262000000;3531000000;5486000000
INTU;183557;USD;2012;Q4;2012-07-31;2012-09-13;292000000;311000000;744000000;142000000;;1523000000;543000000;75000000;2543000000;3161000000;4684000000;353000000;;1265000000;499000000;675000000;1940000000;3018000000;-4911000000;4612000000;2744000000;4684000000
INTU;183557;USD;2011;Q4;2011-07-31;2011-09-14;301000000;321000000;1421000000;171000000;;2254000000;561000000;63000000;2232000000;2856000000;5110000000;344000000;500000000;1805000000;499000000;689000000;2494000000;2886000000;-4316000000;4031000000;2616000000;5110000000
INTU;183557;USD;2010;Q4;2010-07-31;2010-09-16;316000000;627000000;1622000000;135000000;;2295000000;510000000;91000000;2302000000;2903000000;5198000000;363000000;0;1221000000;998000000;1156000000;2377000000;2728000000;-3315000000;3397000000;2821000000;5198000000
INTU;183557;USD;2009;Q4;2009-07-31;2009-12-04;322000000;342000000;1347000000;135000000;;1968000000;527000000;97000000;2234000000;2858000000;4826000000;274000000;;1084000000;998000000;1185000000;2269000000;2547000000;-2846000000;2849000000;2557000000;4826000000
INTU;183557;USD;2018;Q4;2018-07-31;2018-08-31;255000000;270000000;1716000000;98000000;;2404000000;812000000;13000000;1949000000;2774000000;5178000000;547000000;50000000;2116000000;388000000;708000000;2824000000;5338000000;-11050000000;8101000000;2354000000;5178000000
INTU;183557;USD;2019;Q4;2019-07-31;2019-08-30;260000000;264000000;2740000000;87000000;;3594000000;780000000;13000000;1896000000;2689000000;6283000000;659000000;50000000;1966000000;386000000;568000000;2534000000;5775000000;-11611000000;9621000000;3749000000;6283000000
GIII;183672;USD;2016;Q4;2017-01-31;2016-03-29;93601451;96960058;79957000;263881000;483269000;882938000;102571000;61171000;805264000;969006000;1851944000;315419000;;315419000;461756000;515289000;830708000;438030000;-1490000;612418000;1021236000;1851944000
GIII;183672;USD;2015;Q4;2016-01-31;2015-03-30;90883035;93113790;132587000;221500000;485311000;902440000;103579000;25662000;152389000;281630000;1184070000;244804000;;244804000;;51139000;295943000;353968000;-2643000;560491000;888127000;1184070000
GIII;183672;USD;2014;Q4;2015-01-31;2014-03-31;87351626;89884680;22091000;160010000;359639000;586190000;62832000;;181875000;244707000;830897000;187709000;48843000;241226000;20560000;67675000;308901000;185050000;-3899000;335797000;521996000;830897000
GIII;183672;USD;2013;Q4;2014-01-31;2013-04-12;40854000;42780000;27360000;178216000;280929000;516585000;40816000;;160371000;201187000;717772000;168216000;65000000;235491000;19778000;53041000;288532000;171338000;-3899000;258437000;429240000;717772000
GIII;183672;USD;2012;Q4;2013-01-31;2012-04-11;40232000;41056000;24660000;162510000;253521000;464778000;33365000;2419000;45541000;81325000;546103000;146469000;30050000;176519000;;11612000;188131000;160305000;-3899000;201562000;357972000;546103000
GIII;183672;USD;2011;Q4;2012-01-31;2011-09-08;39544000;40282000;10045000;138341000;204995000;376806000;22556000;40000;48519000;71115000;447921000;137312000;0;137312000;;7115000;144427000;152541000;-970000;151942000;303494000;447921000
GIII;183672;USD;2017;Q4;2018-01-31;2018-04-02;97696352;100734352;45776000;294430000;553323000;959601000;97857000;62422000;795297000;955576000;1915177000;347167000;;347167000;391044000;447321000;794488000;452089000;-420000;674542000;1120689000;1915177000
GIII;183672;USD;2018;Q4;2019-01-31;2019-03-28;49033000;50050000;70138000;502133000;576383000;1253895000;86407000;66587000;801169000;954163000;2208058000;337199000;;580788000;386604000;438261000;1019049000;464376000;-19054000;758881000;1189009000;2208058000
NTAP;183964;USD;2016;Q4;2016-04-30;2017-06-20;269000000;277000000;4921000000;731000000;163000000;6198000000;799000000;;2496000000;3295000000;9493000000;1129000000;1249000000;4122000000;744000000;2591000000;6713000000;2769000000;;40000000;2780000000;9493000000
NTAP;183964;USD;2015;Q4;2015-04-30;2016-06-22;285000000;292000000;5303000000;813000000;98000000;6448000000;937000000;;2652000000;3589000000;10037000000;1019000000;849000000;3662000000;1490000000;3494000000;7156000000;2912000000;;0;2881000000;10037000000
NTAP;183964;USD;2014;Q4;2014-04-30;2015-06-12;311000000;315000000;5326000000;779000000;146000000;6773000000;1030000000;;1598000000;2628000000;9401000000;985000000;0;2709000000;1487000000;3278000000;5987000000;3385000000;;53000000;3414000000;9401000000
NTAP;183964;USD;2013;Q4;2013-04-30;2014-06-17;329000000;336800000;5003300000;855900000;122400000;6471300000;1108800000;;1633700000;2742500000;9213800000;1040800000;;2694600000;990100000;2732700000;5427300000;3776300000;;1100000;3786500000;9213800000
NTAP;183964;USD;2012;Q4;2012-04-30;2013-06-17;358400000;367900000;6952600000;800900000;139500000;8418200000;1170900000;;1653300000;2824200000;11242400000;1009500000;1257800000;3830600000;994600000;2694300000;6524900000;4739400000;-2927400000;2896800000;4717500000;11242400000
NTAP;183964;USD;2011;Q4;2011-04-30;2012-06-19;363500000;382000000;5398500000;830900000;161500000;6826500000;1137200000;;1568600000;2705800000;9532300000;951000000;1202300000;3519800000;62600000;1718900000;5238700000;4410800000;-2927400000;2805300000;4293600000;9532300000
NTAP;183964;USD;2010;Q4;2010-04-30;2011-06-23;367300000;402600000;5174700000;742600000;108500000;6365200000;911600000;;1222000000;2133600000;8498800000;995800000;1150400000;3372800000;114600000;1395800000;4768600000;3970800000;-2927400000;2674000000;3730200000;8498800000
NTAP;183964;USD;2009;Q4;2009-04-30;2010-09-13;345800000;363800000;3724000000;471500000;112900000;4537100000;804400000;72800000;1080100000;1957300000;6494400000;775900000;0;1911000000;1101500000;2052900000;3963900000;3454200000;-2927400000;2000900000;2530500000;6494400000
NTAP;183964;USD;2017;Q4;2017-04-30;2018-06-19;265000000;283000000;5391000000;1009000000;126000000;6856000000;756000000;;2253000000;3009000000;9865000000;1434000000;385000000;3623000000;1541000000;4175000000;7798000000;2355000000;;-218000000;2067000000;9865000000
NTAP;183964;USD;2018;Q4;2018-04-30;2019-06-18;246000000;248000000;3899000000;1216000000;131000000;5610000000;759000000;;2372000000;3131000000;8741000000;1393000000;649000000;3867000000;1144000000;3784000000;7651000000;1133000000;;0;1090000000;8741000000
PTE;184064;USD;2014;Q4;2014-10-31;2015-01-29;1137966;1137966;7196000;1597000;1292000;11258000;198000;;;198000;11456000;4427000;;5905000;;0;5905000;125278000;;-119727000;5551000;11456000
PTE;184064;USD;2013;Q4;2013-10-31;2014-01-14;-10719635;-10719635;13385000;1169000;4859000;33263000;817000;3500000;69000;4386000;37649000;8994000;1764000;17596000;;0;17596000;124194000;;-103530000;20053000;37649000
PTE;184064;USD;2012;Q4;2012-10-31;2013-01-14;6875473;6887800;18038000;3936000;7762000;47707000;1003000;0;588000;1591000;49298000;15490000;0;19961000;;0;19961000;120797000;;-90888000;29337000;49298000
PTE;184064;USD;2011;Q4;2011-10-31;2012-01-17;6734979;6973152;13689000;3143000;11605000;50984000;1184000;;209000;1393000;52377000;20313000;1238000;27193000;;1949000;29142000;119263000;;-95501000;23235000;52377000
PTE;184064;USD;2010;Q4;2010-10-31;2011-09-14;6385550;6230679;8004000;725000;8418000;29440000;520000;;69000;589000;30029000;11375000;5557000;17877000;;144000;18021000;114863000;;-102333000;12008000;30029000
HPQ;184360;USD;2017;Q4;2017-10-31;2017-12-15;1679000000;1683000000;6997000000;4414000000;5786000000;22318000000;1878000000;;8717000000;10595000000;32913000000;13493000000;1072000000;22412000000;6747000000;13909000000;36321000000;396000000;;-2386000000;-3408000000;32913000000
HPQ;184360;USD;2016;Q4;2016-10-31;2016-12-15;1713000000;1731000000;6288000000;4114000000;4484000000;18468000000;1736000000;;8783000000;10519000000;28987000000;11334000000;78000000;18808000000;6735000000;14068000000;32876000000;1047000000;;-3498000000;-3889000000;28987000000
HPQ;184360;USD;2015;Q4;2015-10-31;2015-12-16;1804000000;1819000000;7584000000;4825000000;4288000000;51787000000;1492000000;;53603000000;55095000000;106882000000;10437000000;2194000000;42191000000;6677000000;36540000000;78731000000;1981000000;;32089000000;28151000000;106882000000
HPQ;184360;USD;2014;Q4;2014-10-31;2014-12-18;-4950734000;-5013500000;15133000000;13832000000;6415000000;50145000000;11340000000;;41721000000;53061000000;103206000000;16920000000;3486000000;43735000000;16039000000;32344000000;76079000000;3448000000;;29164000000;27127000000;103206000000
HPQ;184360;USD;2013;Q4;2013-10-31;2013-12-30;-5073034000;-5083902000;12163000000;15876000000;6046000000;50364000000;11463000000;;43849000000;55312000000;105676000000;15222000000;5979000000;45521000000;16608000000;32499000000;78020000000;5484000000;;25563000000;27656000000;105676000000
HPQ;184360;USD;2012;Q4;2012-10-31;2012-12-27;4326930000;4271880000;11301000000;16407000000;6317000000;50637000000;11954000000;;46177000000;58131000000;108768000000;14196000000;6647000000;46666000000;21789000000;39269000000;85935000000;6474000000;;21521000000;22833000000;108768000000
HPQ;184360;USD;2011;Q4;2011-10-31;2011-12-14;4381980000;4452444000;8043000000;18224000000;7490000000;51021000000;12292000000;;66204000000;78496000000;129517000000;15798000000;8083000000;50442000000;22551000000;40071000000;90513000000;6857000000;;35266000000;39004000000;129517000000
HPQ;184360;USD;2010;Q4;2010-10-31;2010-12-15;4956702000;5018358000;10929000000;18481000000;6466000000;54184000000;11763000000;;58556000000;70319000000;124503000000;15167000000;7046000000;49403000000;15258000000;34319000000;83722000000;11591000000;;32695000000;40781000000;124503000000
HPQ;184360;USD;2009;Q4;2009-10-31;2010-02-05;5209932000;5306820000;13334000000;16537000000;6128000000;52539000000;11262000000;;50998000000;62260000000;114799000000;15719000000;1850000000;43003000000;13980000000;31032000000;74035000000;13828000000;;29936000000;40764000000;114799000000
HPQ;184360;USD;2008;Q4;2008-10-31;2009-09-08;5375082000;5586474000;10246000000;16928000000;7879000000;51728000000;10838000000;;50765000000;61603000000;113331000000;25962000000;;52939000000;7676000000;21450000000;74389000000;14036000000;;24971000000;38942000000;113331000000
HPQ;184360;USD;2018;Q4;2018-10-31;2018-12-13;1579000000;1603000000;5166000000;5113000000;6062000000;21387000000;2198000000;;11037000000;13235000000;34622000000;15156000000;1463000000;25131000000;4524000000;10130000000;35261000000;679000000;;-473000000;-639000000;34622000000
JWN;184768;USD;2016;Q4;2017-02-28;2017-03-20;172800000;178500000;1007000000;199000000;1896000000;3242000000;3897000000;;719000000;4616000000;7858000000;1795000000;11000000;3029000000;2763000000;3959000000;6988000000;2707000000;;-1794000000;870000000;7858000000
JWN;184768;USD;2015;Q4;2016-02-29;2016-03-14;178000000;180700000;595000000;196000000;1945000000;3014000000;3735000000;;949000000;4684000000;7698000000;1740000000;10000000;2911000000;2795000000;3916000000;6827000000;2539000000;;-1610000000;871000000;7698000000
JWN;184768;USD;2014;Q4;2015-02-28;2015-03-16;189900000;194300000;827000000;2306000000;1733000000;5224000000;3340000000;;681000000;4021000000;9245000000;1744000000;8000000;2800000000;3123000000;4005000000;6805000000;2338000000;;166000000;2440000000;9245000000
JWN;184768;USD;2013;Q4;2014-02-28;2014-03-17;192600000;195700000;1194000000;2177000000;1531000000;5228000000;2949000000;;397000000;3346000000;8574000000;1658000000;7000000;2541000000;3106000000;3953000000;6494000000;1827000000;;292000000;2080000000;8574000000
JWN;184768;USD;2012;Q4;2013-02-28;2013-03-18;198600000;202000000;1285000000;2129000000;1360000000;5081000000;2579000000;;429000000;3008000000;8089000000;1415000000;7000000;2226000000;3124000000;3950000000;6176000000;1645000000;;315000000;1913000000;8089000000
JWN;184768;USD;2011;Q4;2012-02-29;2012-03-16;208200000;212200000;1877000000;2033000000;1148000000;5560000000;2469000000;;462000000;2931000000;8491000000;1305000000;506000000;2575000000;3141000000;3960000000;6535000000;1484000000;;517000000;1956000000;8491000000
JWN;184768;USD;2010;Q4;2011-02-28;2011-03-18;218600000;222700000;1506000000;2026000000;977000000;4824000000;2318000000;;320000000;2638000000;7462000000;1221000000;6000000;1879000000;2775000000;3562000000;5441000000;1168000000;;882000000;2021000000;7462000000
JWN;184768;USD;2009;Q4;2010-02-28;2010-03-22;217700000;221900000;795000000;2035000000;898000000;4054000000;2242000000;;283000000;2525000000;6579000000;1062000000;356000000;2014000000;2257000000;2993000000;5007000000;1066000000;;525000000;1572000000;6579000000
JWN;184768;USD;2008;Q4;2009-02-28;2009-09-09;215700000;217400000;72000000;1942000000;900000000;3217000000;2221000000;;223000000;2444000000;5661000000;777000000;299000000;1601000000;2214000000;2850000000;4451000000;997000000;;223000000;1210000000;5661000000
JWN;184768;USD;2017;Q4;2018-02-28;2018-03-19;166900000;169200000;1181000000;145000000;2027000000;3503000000;3939000000;;673000000;4612000000;8115000000;1987000000;56000000;3289000000;2681000000;3849000000;7138000000;2816000000;;-1810000000;977000000;8115000000
JWN;184768;USD;2018;Q4;2019-02-28;2019-03-18;164800000;167100000;957000000;148000000;1978000000;3374000000;3921000000;;591000000;4512000000;7886000000;2049000000;8000000;3381000000;2677000000;3632000000;7013000000;3048000000;;-2138000000;873000000;7886000000
AAP;184955;USD;2016;Q4;2016-12-31;2017-02-28;73633000;73882000;135178000;641252000;4325868000;5172764000;1446340000;;1695929000;3142269000;8315033000;3640574000;;3676046000;1042949000;1722795000;5398841000;631060000;-138102000;2462935000;2916192000;8315033000
AAP;184955;USD;2015;Q4;2015-12-31;2016-03-01;73240000;73834000;90782000;597788000;4174768000;4940746000;1434577000;;1752378000;3186955000;8127701000;3757085000;598000;3797477000;1206297000;1869576000;5667053000;603339000;-119709000;2021077000;2460648000;8127701000
AAP;184955;USD;2014;Q4;2014-12-31;2015-03-03;72974000;73475000;104671000;579825000;3936955000;4741040000;1432030000;;1789288000;3221318000;7962358000;3616038000;582000;3654416000;1636311000;2305030000;5959446000;562952000;-113044000;1565341000;2002912000;7962358000
AAP;184955;USD;2013;Q4;2013-12-31;2014-02-25;72849000;73379000;1112471000;277595000;2556557000;3989384000;1283970000;;291420000;1575390000;5564774000;2609239000;916000;2764785000;1052668000;1283784000;4048569000;531300000;-107890000;1089112000;1516205000;5564774000
AAP;184955;USD;2012;Q4;2012-12-31;2013-02-25;73160000;73949000;598111000;229866000;2308609000;3184200000;1291759000;;137855000;1429614000;4613814000;2409453000;627000;2559638000;604461000;843482000;3403120000;520222000;-27095000;714900000;1210694000;4613814000
AAP;184955;USD;2011;Q4;2011-12-31;2012-02-28;73652000;75109000;57901000;140007000;2043158000;2293820000;1223099000;;138835000;1361934000;3655754000;2038929000;848000;2187875000;415136000;619965000;2807840000;500248000;-1644767000;1989629000;847914000;3655754000
AAP;184955;USD;2010;Q4;2010-12-31;2011-03-01;175148288;177316527;59209000;124227000;1863870000;2124271000;1143170000;;86776000;1229946000;3354217000;1696199000;32621000;1848049000;300851000;466794000;2314843000;456656000;-1028612000;1612927000;1039374000;3354217000
AAP;184955;USD;2009;Q4;2009-12-31;2010-06-02;377552003;380165892;100018000;92560000;1631867000;1887618000;1100338000;;85007000;1185345000;3072963000;1359334000;33436000;1466027000;202927000;324571000;1790598000;392972000;-391176000;1287268000;1282365000;3072963000
AAP;184955;USD;2017;Q4;2017-12-31;2018-02-21;73888000;74148000;546937000;606357000;4168492000;5426892000;1394138000;;1661271000;3055409000;8482301000;3428130000;;3480097000;1044327000;1587008000;5067105000;664654000;-144600000;2920096000;3415196000;8482301000
AAP;184955;USD;2018;Q4;2018-12-31;2019-02-19;72991000;73325000;896527000;624972000;4362547000;6082454000;1368985000;;1589209000;2958194000;9040648000;3795931000;;3885950000;1045720000;1603885000;5489835000;694805000;-425954000;3326155000;3550813000;9040648000
ADSK;185035;USD;2016;Q4;2017-01-31;2016-03-23;224500000;220000000;1899900000;452300000;;2460600000;158600000;306200000;1872700000;2337500000;4798100000;516600000;398700000;2185400000;1092000000;1879100000;4064500000;1876300000;;-964200000;733600000;4798100000
ADSK;185035;USD;2015;Q4;2016-01-31;2015-03-18;227200000;234100000;2250900000;653600000;;2993100000;169300000;532300000;1820600000;2522200000;5515300000;522100000;0;1591000000;1487700000;2304700000;3895700000;1821500000;;-80800000;1619600000;5515300000
ADSK;185035;USD;2014;Q4;2015-01-31;2014-03-10;226000000;233100000;2267100000;423700000;;2835000000;130300000;277300000;1352400000;1760000000;4595000000;375300000;;1071500000;746400000;1262000000;2333500000;1637300000;;624800000;2261500000;4595000000
ADSK;185035;USD;2013;Q4;2014-01-31;2013-03-18;224200000;230700000;1954300000;495100000;;2552400000;114900000;411100000;1230000000;1756000000;4308400000;396700000;;1043700000;745600000;1221500000;2265200000;1449800000;;599100000;2043200000;4308400000
ADSK;185035;USD;2012;Q4;2013-01-31;2012-03-15;226100000;228800000;1411300000;395100000;;1895900000;104500000;192800000;1034600000;1331900000;3227800000;371800000;;954100000;0;390800000;1344900000;1365400000;;511600000;1882900000;3227800000
ADSK;185035;USD;2011;Q4;2012-01-31;2011-03-18;226900000;236000000;1274300000;318400000;;1714300000;84500000;192600000;796200000;1073300000;2787600000;373600000;;869800000;;308500000;1178300000;1267200000;;342700000;1609300000;2787600000
ADSK;185035;USD;2010;Q4;2011-01-31;2010-03-19;229200000;236100000;1000600000;277400000;;1379600000;101600000;125600000;840400000;1067600000;2447200000;259400000;;704000000;;269700000;973700000;1204300000;;272700000;1473500000;2447200000
ADSK;185035;USD;2009;Q4;2010-01-31;2009-06-03;226300000;226300000;981100000;316500000;;1388000000;120600000;7600000;904500000;1032700000;2420700000;309200000;;800100000;;309900000;1110000000;1080400000;;241500000;1310700000;2420700000
ADSK;185035;USD;2017;Q4;2018-01-31;2016-12-01;212600000;208100000;1323200000;438200000;;1877900000;145000000;190800000;1899900000;2235700000;4113600000;571600000;;2123200000;1586000000;2246400000;4369600000;1952700000;;-2084900000;-256000000;4113600000
ADSK;185035;USD;2018;Q4;2019-01-31;2019-03-25;219100000;219100000;953600000;474300000;;1620000000;149700000;;2959500000;3109200000;4729200000;537900000;0;2301200000;2087700000;2638900000;4940100000;2071500000;;-2147400000;-210900000;4729200000
M;185124;USD;2016;Q4;2017-02-28;2017-03-29;305600000;307800000;1297000000;522000000;5399000000;7626000000;7017000000;;5208000000;12225000000;19851000000;5338000000;309000000;5647000000;6562000000;9882000000;15529000000;;;;4322000000;19851000000
M;185124;USD;2015;Q4;2016-02-29;2016-03-30;311900000;314800000;1109000000;558000000;5506000000;7652000000;7616000000;;5308000000;12924000000;20576000000;5086000000;642000000;5728000000;6995000000;10595000000;16323000000;624000000;-1665000000;6334000000;4253000000;20576000000
M;185124;USD;2014;Q4;2015-02-28;2015-04-01;344100000;351100000;2246000000;424000000;5417000000;8580000000;7800000000;;4950000000;12750000000;21330000000;4999000000;76000000;5075000000;7233000000;10877000000;15952000000;1052000000;-1942000000;7340000000;5378000000;21330000000
M;185124;USD;2013;Q4;2014-02-28;2014-04-02;367700000;375200000;2273000000;438000000;5557000000;8688000000;7930000000;;5002000000;12932000000;21620000000;4863000000;463000000;5726000000;6714000000;9645000000;15371000000;2526000000;-1847000000;6235000000;6249000000;21620000000
M;185124;USD;2012;Q4;2013-02-28;2013-04-03;392400000;399500000;1836000000;371000000;5308000000;7876000000;8196000000;;4919000000;13115000000;20991000000;4544000000;124000000;5075000000;6806000000;9865000000;14940000000;3876000000;-2002000000;5108000000;6051000000;20991000000
M;185124;USD;2011;Q4;2012-02-29;2012-03-28;420100000;425200000;2827000000;368000000;5117000000;8777000000;8420000000;;4898000000;13318000000;22095000000;4752000000;1103000000;6263000000;6655000000;9899000000;16162000000;5413000000;-2434000000;4015000000;5933000000;22095000000
M;185124;USD;2010;Q4;2011-02-28;2011-03-30;424100000;428900000;1464000000;338000000;4758000000;6899000000;8813000000;;4919000000;13732000000;20631000000;4128000000;454000000;4991000000;6971000000;10110000000;15101000000;5701000000;-2431000000;2990000000;5530000000;20631000000
M;185124;USD;2009;Q4;2010-02-28;2010-03-31;422000000;428000000;1686000000;358000000;4615000000;6882000000;9507000000;;4911000000;14418000000;21300000000;4006000000;242000000;4462000000;8456000000;12185000000;16647000000;5694000000;-2515000000;2227000000;4653000000;21300000000
M;185124;USD;2008;Q4;2009-02-28;2009-09-08;;;1385000000;360000000;4769000000;6740000000;10442000000;;4963000000;15405000000;22145000000;3938000000;966000000;5126000000;8733000000;12373000000;17499000000;5668000000;-2544000000;2008000000;4646000000;22145000000
M;185124;USD;2017;Q4;2018-02-28;2018-04-04;305600000;307300000;1455000000;363000000;5178000000;7646000000;6672000000;;5265000000;11937000000;19583000000;5157000000;22000000;5179000000;5861000000;8671000000;13850000000;;;;5733000000;19583000000
M;185124;USD;2018;Q4;2019-02-28;2019-04-03;308400000;312000000;1162000000;400000000;5263000000;7445000000;6637000000;;5112000000;11749000000;19194000000;5189000000;43000000;5232000000;4708000000;7526000000;12758000000;;;;6436000000;19194000000
APD;185217;USD;2018;Q4;2018-09-30;2018-11-20;219400000;221100000;2976000000;1207200000;396100000;5082200000;9923700000;2290500000;1881900000;14096100000;19178300000;1877400000;460900000;2338300000;3351700000;5663700000;8002000000;1278700000;-2089200000;13409900000;11176300000;19178300000
APD;185217;USD;2017;Q4;2017-09-30;2017-11-16;218300000;220000000;3677600000;1174000000;335400000;5876700000;8440200000;2418700000;1731600000;12590500000;18467200000;1912900000;560400000;2489000000;3402400000;5792700000;8281700000;1250500000;-2163500000;12846600000;10185500000;18467200000
APD;185217;USD;2016;Q4;2016-09-30;2016-11-21;164571500;166226000;1293200000;1146200000;255000000;4317300000;8259700000;2505300000;2946300000;13711300000;18028600000;1770100000;1301200000;3283100000;3909700000;7532100000;10815200000;1219400000;-2227000000;10475500000;7213400000;18028600000
APD;185217;USD;2015;Q4;2015-09-30;2015-11-24;232739300;235441800;206400000;1406200000;657800000;2793500000;8745100000;2615900000;3180000000;14541000000;17334500000;1697500000;1929900000;3644400000;3949100000;6309000000;9953400000;1154100000;-2359600000;10580400000;7381100000;17334500000
APD;185217;USD;2014;Q4;2014-09-30;2014-11-24;231009700;233712200;336600000;1486000000;706000000;3294800000;9532100000;2672800000;2279400000;14484300000;17779100000;1669000000;1294000000;2963000000;4824500000;7007500000;9970500000;1091400000;-2476900000;9993200000;7808600000;17779100000
APD;185217;USD;2013;Q4;2013-09-30;2013-11-26;228091000;231009700;450400000;1544300000;706100000;3439100000;8974000000;2672400000;2764600000;14411000000;17850100000;2007900000;1217300000;3227600000;5056300000;7047800000;10275400000;1048600000;-2632300000;9646400000;7574700000;17850100000
APD;185217;USD;2012;Q4;2012-09-30;2012-11-20;229063900;232631200;454400000;1544700000;786600000;3415800000;8240600000;2504600000;2780800000;13526000000;16941800000;1976200000;707700000;2689900000;4584200000;7236100000;9926000000;1059900000;-2468400000;9234500000;7015800000;16941800000
APD;185217;USD;2011;Q4;2011-09-30;2011-11-22;228631500;232523100;421400000;1361600000;670200000;3189800000;7222700000;2054400000;1823800000;11100900000;14290700000;1664700000;634000000;2342000000;3927500000;6010000000;8352000000;1055000000;-2605300000;8599500000;5938700000;14290700000
APD;185217;USD;2010;Q4;2010-09-30;2010-11-23;229928700;235225600;374300000;1481900000;571600000;3033800000;7051300000;1683200000;1737600000;10472100000;13505900000;1775600000;468500000;2244100000;3659800000;5564200000;7808300000;1051600000;-2197500000;7852200000;5697600000;13505900000
APD;185217;USD;2009;Q4;2009-09-30;2009-11-25;227874800;233063600;488200000;1363200000;509600000;2997800000;6859600000;1555100000;1616600000;10031300000;13029100000;1717700000;785900000;2503600000;3715600000;5595500000;8099100000;1072300000;-2353200000;7234600000;4930000000;13029100000
APD;185217;USD;2008;Q4;2008-09-30;2009-11-25;;;103500000;1575200000;503700000;2848100000;6614800000;1327900000;1780500000;9723200000;12571300000;1752600000;451400000;2212000000;3515400000;5192400000;7404400000;1061100000;-2471300000;6990200000;5166900000;12571300000
SMTC;185350;USD;2016;Q4;2017-01-31;2017-03-23;65716000;66773000;297134000;51441000;65872000;438428000;108910000;;464204000;573114000;1011542000;96484000;14432000;122975000;226524000;283304000;406279000;391723000;-253107000;467941000;605263000;1011542000
SMTC;185350;USD;2015;Q4;2016-01-31;2016-03-31;64878000;65994000;211810000;44132000;63875000;341221000;101006000;;469290000;570296000;911517000;76690000;18569000;103887000;239177000;279579000;383466000;380293000;-266175000;413280000;528051000;911517000
SMTC;185350;USD;2014;Q4;2015-01-31;2015-03-30;66762000;67266000;230328000;69301000;73668000;396688000;115471000;;417272000;532743000;929431000;82202000;18547000;108041000;234746000;270032000;378073000;372381000;-222969000;401783000;551358000;929431000
SMTC;185350;USD;2013;Q4;2014-01-31;2014-03-27;67522000;63344000;243194000;66333000;60267000;393596000;110121000;3674000;441549000;555344000;948940000;84164000;18529000;110890000;273293000;302207000;413097000;362906000;-201152000;373836000;535843000;948940000
SMTC;185350;USD;2012;Q4;2013-01-31;2013-03-28;66371000;68025000;228165000;69160000;74878000;405993000;101837000;7907000;655276000;765020000;1171013000;101267000;48449000;157682000;282286000;318505000;476187000;356775000;-200604000;538302000;694826000;1171013000
SMTC;185350;USD;2011;Q4;2012-01-31;2012-03-29;64857000;66777000;310143000;49644000;46995000;427312000;69713000;17522000;211774000;299009000;726321000;59088000;0;66982000;0;29151000;96133000;359112000;-225822000;496363000;630188000;726321000
SMTC;185350;USD;2010;Q4;2011-01-31;2011-03-31;63510000;66804000;231256000;50610000;47719000;353698000;56778000;27086000;222381000;306245000;659943000;85471000;;93825000;;37503000;131328000;352863000;-232267000;407276000;528615000;659943000
SMTC;185350;USD;2009;Q4;2010-01-31;2010-09-10;61250000;64838000;136060000;31163000;33819000;219466000;38063000;26163000;230602000;294828000;514294000;68772000;;73380000;;35173000;108553000;349525000;-279306000;334704000;405741000;514294000
SMTC;185350;USD;2017;Q4;2018-01-31;2018-03-22;66312000;67757000;307923000;53183000;71067000;461232000;124586000;;499958000;624544000;1085776000;98040000;15410000;126208000;211114000;294555000;420763000;415841000;-251974000;502346000;665013000;1085776000
SMTC;185350;USD;2018;Q4;2019-01-31;2019-03-21;65527000;68118000;312120000;79223000;63679000;485304000;118488000;;459089000;577577000;1062881000;108206000;18269000;129914000;192845000;250286000;380200000;457576000;-346218000;574930000;682681000;1062881000
BFB;185450;USD;2016;Q4;2016-04-30;2017-06-15;288114000;290029000;182000000;557000000;1270000000;2351000000;713000000;;1561000000;2274000000;4625000000;510000000;460000000;970000000;1689000000;2285000000;3255000000;133000000;-2843000000;4470000000;1370000000;4625000000
BFB;185450;USD;2015;Q4;2015-04-30;2016-06-16;398811000;401322000;263000000;559000000;1054000000;2233000000;629000000;;1321000000;1950000000;4183000000;520000000;271000000;791000000;1230000000;1830000000;2621000000;148000000;-2301000000;4065000000;1562000000;4183000000
BFB;185450;USD;2014;Q4;2014-04-30;2015-06-18;1056083000;1063466000;370000000;583000000;953000000;2254000000;586000000;;1348000000;1934000000;4188000000;509000000;440000000;958000000;743000000;1325000000;2283000000;133000000;-1228000000;3300000000;1905000000;4188000000
BFB;185450;USD;2013;Q4;2013-04-30;2014-06-20;213369000;215012000;437000000;569000000;882000000;2177000000;526000000;;1400000000;1926000000;4103000000;545000000;8000000;561000000;997000000;1510000000;2071000000;115000000;-789000000;2894000000;2032000000;4103000000
BFB;185450;USD;2012;Q4;2012-04-30;2013-06-27;213573000;215204000;204000000;548000000;827000000;1821000000;450000000;;1355000000;1805000000;3626000000;461000000;5000000;473000000;997000000;1525000000;1998000000;105000000;-766000000;2500000000;1628000000;3626000000
BFB;185450;USD;2011;Q4;2011-04-30;2012-06-27;213170000;214756000;338000000;475000000;712000000;1749000000;399000000;;1329000000;1728000000;3477000000;396000000;7000000;404000000;503000000;1004000000;1408000000;73000000;-805000000;3031000000;2069000000;3477000000
BFB;185450;USD;2010;Q4;2010-04-30;2011-06-27;436340000;439151000;567000000;496000000;647000000;1976000000;393000000;;1343000000;1736000000;3712000000;444000000;255000000;707000000;504000000;945000000;1652000000;79000000;-598000000;2710000000;2060000000;3712000000
BFB;185450;USD;2009;Q4;2009-04-30;2010-09-02;;;232000000;418000000;651000000;1527000000;468000000;;1388000000;1856000000;3383000000;346000000;191000000;546000000;508000000;942000000;1488000000;83000000;-476000000;2464000000;1895000000;3383000000
BFB;185450;USD;2017;Q4;2017-04-30;2018-06-13;672757000;679734000;239000000;639000000;1379000000;2555000000;780000000;;1641000000;2421000000;4976000000;606000000;215000000;821000000;2341000000;2839000000;3660000000;76000000;-112000000;1730000000;1316000000;4976000000
BFB;185450;USD;2018;Q4;2018-04-30;2019-06-13;477123000;480137000;307000000;609000000;1520000000;2719000000;816000000;;1604000000;2420000000;5139000000;553000000;150000000;703000000;2290000000;2789000000;3492000000;72000000;-300000000;2238000000;1647000000;5139000000
SIG;185651;USD;2017;Q4;2018-01-31;2016-11-29;60000000;80400000;225100000;692500000;2280500000;3446100000;877900000;;1515600000;2393500000;5839600000;704600000;44000000;1037200000;688200000;1689000000;2726200000;305900000;-1942100000;4396200000;3113400000;5839600000
SIG;185651;USD;2016;Q4;2017-01-31;2016-03-24;68800000;77300000;98700000;1858000000;2449300000;4642600000;822900000;;1132300000;1955200000;6597800000;835700000;91100000;1203700000;1317900000;2292000000;3495700000;296400000;-1494800000;3995900000;3102100000;6597800000
SIG;185651;USD;2015;Q4;2016-01-31;2015-03-26;79000000;79200000;137700000;1756400000;2453900000;4588100000;727600000;;1149200000;1876800000;6464900000;833100000;57700000;1151100000;1321000000;2253100000;3404200000;295600000;-495800000;3534600000;3060700000;6464900000
SIG;185651;USD;2014;Q4;2015-01-31;2014-03-27;79900000;80400000;247600000;1374000000;1488000000;3257600000;487600000;;284000000;771600000;4029200000;595300000;19300000;900700000;0;565400000;1466100000;274500000;-346200000;2812900000;2563100000;4029200000
SIG;185651;USD;2013;Q4;2014-01-31;2013-03-28;79800000;80500000;301000000;1205300000;1397000000;3036100000;430400000;;252500000;682900000;3719000000;582600000;;871900000;;517200000;1389100000;262000000;-260000000;2268400000;2329900000;3719000000
SIG;185651;USD;2012;Q4;2013-01-31;2012-03-22;80600000;81000000;486800000;1088200000;1304100000;3016300000;383400000;;211700000;595100000;3611400000;568900000;;858000000;;474300000;1332300000;246500000;-12700000;1969300000;2279100000;3611400000
SIG;185651;USD;2011;Q4;2012-01-31;2011-03-30;86100000;86900000;302100000;935900000;1184200000;2542300000;379000000;;168500000;547500000;3089800000;456900000;31000000;711000000;;439800000;1150800000;212300000;;1662300000;1939000000;3089800000
SIG;185651;USD;2010;Q4;2011-01-31;2010-08-27;86000000;87000000;316200000;858000000;1173100000;2453200000;396900000;;194800000;591700000;3044900000;382400000;44100000;638900000;280000000;702400000;1341300000;185300000;-1100000;1462400000;1703600000;3044900000
OXM;185852;USD;2016;Q4;2017-02-28;2017-03-28;16539000;16825000;6332000;58279000;142175000;231628000;193931000;;259600000;453531000;685159000;128536000;;131396000;91509000;177633000;309029000;147913000;;233493000;376130000;685159000
OXM;185852;USD;2015;Q4;2016-02-29;2016-03-28;16471000;16707000;6323000;59065000;129136000;216796000;184094000;;181800000;365894000;582690000;126505000;;128899000;43975000;119391000;248290000;142078000;;199151000;334400000;582690000
OXM;185852;USD;2014;Q4;2015-02-28;2015-03-31;16438000;16539000;5281000;64587000;120613000;258545000;146039000;;217823000;363862000;622407000;130063000;;159942000;104842000;171860000;331802000;135530000;;185229000;290605000;622407000
OXM;185852;USD;2013;Q4;2014-02-28;2014-03-31;16414000;16459000;8483000;75277000;143712000;271032000;141519000;;214754000;356273000;627305000;126553000;3993000;133046000;137592000;234096000;367142000;130437000;;153344000;260163000;627305000
OXM;185852;USD;2012;Q4;2013-02-28;2013-04-04;16587000;16631000;7517000;62805000;109605000;222390000;128882000;;204798000;333680000;556070000;116322000;7944000;124266000;108552000;201959000;326225000;121486000;;132944000;229845000;556070000
OXM;185852;USD;2011;Q4;2012-02-29;2012-03-30;16509000;16543000;13373000;59706000;103420000;214070000;93206000;;201931000;295137000;509207000;112483000;2571000;117554000;103405000;187584000;305138000;116192000;;111551000;204069000;509207000
OXM;185852;USD;2010;Q4;2011-02-28;2011-09-01;16552000;16569000;44094000;50177000;85338000;268913000;83895000;;205663000;289558000;558471000;106306000;;147091000;147065000;231352000;378443000;113108000;;90739000;180028000;558471000
OXM;185852;USD;2017;Q4;2018-02-28;2018-04-02;16628000;16806000;6343000;67542000;126812000;236118000;193533000;;270290000;463823000;699941000;132918000;;135010000;45809000;135107000;270117000;153503000;;280395000;429824000;699941000
OXM;185852;USD;2018;Q4;2019-02-28;2019-04-01;16696000;16889000;8327000;69037000;160656000;269788000;192576000;;264890000;457466000;727254000;142209000;;142209000;12993000;106690000;248899000;159935000;;323515000;478355000;727254000
LB;185942;USD;2016;Q4;2017-02-28;2017-03-17;287000000;290000000;1934000000;294000000;1096000000;3465000000;2741000000;;1964000000;4705000000;8170000000;1978000000;36000000;2014000000;5700000000;6883000000;8897000000;807000000;-1753000000;205000000;-727000000;8170000000
LB;185942;USD;2015;Q4;2016-02-29;2016-03-18;289000000;296000000;2548000000;261000000;1122000000;4156000000;2330000000;;2007000000;4337000000;8493000000;1869000000;6000000;1875000000;5715000000;6876000000;8751000000;701000000;-1315000000;315000000;-258000000;8493000000
LB;185942;USD;2014;Q4;2015-02-28;2015-03-20;293000000;300000000;1681000000;252000000;1036000000;3199000000;2277000000;;2000000000;4277000000;7476000000;1679000000;0;1679000000;4722000000;5778000000;7457000000;582000000;-832000000;233000000;19000000;7476000000
LB;185942;USD;2013;Q4;2014-02-28;2014-03-21;291000000;296000000;1519000000;244000000;1165000000;3122000000;2045000000;;2031000000;4076000000;7198000000;1611000000;215000000;1826000000;4761000000;5741000000;7567000000;456000000;-748000000;-118000000;-369000000;7198000000
LB;185942;USD;2012;Q4;2013-02-28;2013-03-22;290000000;297000000;773000000;203000000;1004000000;2176000000;1803000000;;2040000000;3843000000;6019000000;1538000000;0;1538000000;4477000000;5495000000;7033000000;338000000;-685000000;-672000000;-1014000000;6019000000
LB;185942;USD;2011;Q4;2012-02-29;2012-03-23;296000000;305000000;935000000;218000000;997000000;2317000000;1644000000;;2147000000;3791000000;6108000000;1469000000;57000000;1526000000;3481000000;4444000000;5970000000;173000000;-60000000;24000000;138000000;6108000000
LB;185942;USD;2010;Q4;2011-02-28;2011-03-18;322000000;333000000;1130000000;232000000;1032000000;2557000000;1610000000;;2284000000;3894000000;6451000000;1504000000;0;1504000000;2507000000;3470000000;4974000000;328000000;-207000000;1354000000;1477000000;6451000000
LB;185942;USD;2009;Q4;2010-02-28;2010-03-26;322000000;330000000;1804000000;219000000;1037000000;3220000000;1723000000;;2230000000;3953000000;7173000000;1322000000;;1322000000;2723000000;3667000000;4989000000;161000000;0;2037000000;2184000000;7173000000
LB;185942;USD;2008;Q4;2009-02-28;2009-09-04;;;1173000000;236000000;1182000000;2790000000;1929000000;;2253000000;4182000000;6972000000;1255000000;;1255000000;2897000000;3842000000;5097000000;1806000000;-4681000000;4777000000;1875000000;6972000000
LB;185942;USD;2017;Q4;2018-02-28;2018-03-23;279000000;285000000;1515000000;310000000;1240000000;3293000000;2893000000;;1963000000;4856000000;8149000000;1944000000;87000000;2031000000;5707000000;6869000000;8900000000;819000000;-162000000;-1434000000;-751000000;8149000000
LB;185942;USD;2018;Q4;2019-02-28;2019-03-22;273000000;280000000;1413000000;367000000;1248000000;3260000000;2818000000;;2012000000;4830000000;8090000000;1914000000;72000000;1986000000;5739000000;6969000000;8955000000;912000000;-358000000;-1482000000;-865000000;8090000000
low;186050;USD;2016;Q4;2017-02-28;2017-04-04;867000000;866000000;658000000;;10458000000;12000000000;19949000000;366000000;2093000000;22408000000;34408000000;7441000000;1305000000;11974000000;14394000000;16000000000;27974000000;433000000;;6241000000;6434000000;34408000000
low;186050;USD;2015;Q4;2016-02-29;2016-03-29;909000000;910000000;712000000;;9458000000;10561000000;19577000000;222000000;906000000;20705000000;31266000000;6453000000;1104000000;10492000000;11545000000;13120000000;23612000000;455000000;;7593000000;7654000000;31266000000
low;186050;USD;2014;Q4;2015-02-28;2015-03-31;964000000;967000000;591000000;;8911000000;9851000000;20034000000;354000000;1482000000;21870000000;31721000000;5897000000;552000000;9348000000;10806000000;12405000000;21753000000;480000000;;9591000000;9968000000;31721000000
low;186050;USD;2013;Q4;2014-02-28;2014-03-31;1034000000;1037000000;576000000;;9127000000;10044000000;20834000000;279000000;1575000000;22688000000;32732000000;5793000000;435000000;8876000000;10086000000;12003000000;20879000000;515000000;;11355000000;11853000000;32732000000
low;186050;USD;2012;Q4;2013-02-28;2013-04-02;1111000000;1113000000;666000000;;8600000000;9567000000;21477000000;271000000;1351000000;23099000000;32666000000;5327000000;47000000;7708000000;9030000000;11101000000;18809000000;581000000;;13224000000;13857000000;32666000000
low;186050;USD;2011;Q4;2012-02-29;2012-04-02;1235000000;1234000000;1300000000;;8355000000;9889000000;21970000000;504000000;1196000000;23670000000;33559000000;4965000000;592000000;7891000000;7035000000;9135000000;17026000000;635000000;;15852000000;16533000000;33559000000
low;186050;USD;2010;Q4;2011-02-28;2011-03-29;1359000000;1360000000;1123000000;;8321000000;9774000000;22089000000;1008000000;828000000;23925000000;33699000000;5018000000;36000000;7119000000;6537000000;8468000000;15587000000;688000000;;17371000000;18112000000;33699000000
low;186050;USD;2009;Q4;2010-02-28;2010-03-30;1456000000;1457000000;1057000000;;8249000000;9524000000;22499000000;277000000;705000000;23481000000;33005000000;4864000000;552000000;7355000000;4528000000;6581000000;13936000000;735000000;;18307000000;19069000000;33005000000
low;186050;USD;2008;Q4;2009-02-28;2009-09-01;1460000000;1465000000;661000000;;8209000000;9085000000;22722000000;253000000;565000000;23540000000;32625000000;4543000000;1021000000;7560000000;5039000000;7010000000;14570000000;1012000000;;17049000000;18055000000;32625000000
low;186050;USD;2017;Q4;2018-02-28;2018-04-02;827000000;828000000;690000000;;11393000000;12772000000;19721000000;408000000;2390000000;22519000000;35291000000;7337000000;1431000000;12096000000;15564000000;17322000000;29418000000;437000000;;5425000000;5873000000;35291000000
KSS;186130;USD;2016;Q4;2017-02-28;2017-03-17;172000000;174000000;1074000000;;3795000000;5247000000;8103000000;;224000000;8327000000;13574000000;2843000000;131000000;2974000000;4480000000;5423000000;8397000000;3007000000;-10338000000;12522000000;5177000000;13574000000
KSS;186130;USD;2015;Q4;2016-02-29;2016-03-18;185000000;189000000;707000000;;4038000000;5076000000;8308000000;;222000000;8530000000;13606000000;2587000000;127000000;2714000000;4581000000;5401000000;8115000000;2948000000;-9769000000;12329000000;5491000000;13606000000
KSS;186130;USD;2014;Q4;2015-02-28;2015-03-20;200000000;200000000;1407000000;;3814000000;5580000000;8515000000;;238000000;8753000000;14333000000;2749000000;110000000;2859000000;4638000000;5483000000;8342000000;2747000000;-8744000000;12008000000;5991000000;14333000000
KSS;186130;USD;2013;Q4;2014-02-28;2014-03-21;214000000;217000000;971000000;;3874000000;5314000000;8745000000;;298000000;9043000000;14357000000;2619000000;139000000;2758000000;4722000000;5621000000;8379000000;2602000000;-8052000000;11462000000;5978000000;14357000000
KSS;186130;USD;2012;Q4;2013-02-28;2013-03-22;226000000;229000000;537000000;;3748000000;4719000000;8872000000;53000000;261000000;9186000000;13905000000;2430000000;105000000;2535000000;4448000000;5322000000;7857000000;2458000000;-7243000000;10878000000;6048000000;13905000000
KSS;186130;USD;2011;Q4;2012-02-29;2012-03-16;252000000;251000000;1205000000;;3216000000;4829000000;8905000000;153000000;261000000;9319000000;14148000000;2513000000;94000000;2607000000;4150000000;5033000000;7640000000;2343000000;-5977000000;10195000000;6508000000;14148000000
KSS;186130;USD;2010;Q4;2011-02-28;2011-03-18;295000000;299000000;2277000000;;3036000000;5642000000;8692000000;277000000;238000000;9207000000;14849000000;2295000000;486000000;2781000000;3512000000;4218000000;6999000000;2229000000;-3643000000;9301000000;7850000000;14849000000
KSS;186130;USD;2009;Q4;2010-02-28;2010-03-19;305000000;304000000;2267000000;;2923000000;5485000000;8506000000;321000000;153000000;8980000000;14465000000;2377000000;78000000;2455000000;3862000000;4415000000;6870000000;2089000000;-2639000000;8181000000;7595000000;14465000000
KSS;186130;USD;2008;Q4;2009-02-28;2009-09-04;306000000;307000000;643000000;;2799000000;3728000000;6984000000;333000000;318000000;7635000000;11363000000;1827000000;17000000;1844000000;2053000000;2780000000;4624000000;1975000000;-2638000000;7448000000;6739000000;11363000000
KSS;186130;USD;2017;Q4;2018-02-28;2018-03-23;164000000;167000000;1308000000;;3542000000;5331000000;7773000000;;236000000;8009000000;13340000000;2525000000;126000000;2651000000;4388000000;5263000000;7914000000;3082000000;-10651000000;13006000000;5426000000;13340000000
KSS;186130;USD;2018;Q4;2019-02-28;2019-03-22;162000000;162000000;934000000;;3475000000;4835000000;7428000000;;206000000;7634000000;12469000000;2615000000;;4253000000;1861000000;2689000000;6942000000;3208000000;-11076000000;13395000000;5527000000;12469000000
WDAY;186213;USD;2016;Q4;2017-01-31;2016-03-22;201625000;201625000;1969459000;293407000;;2362308000;214158000;;153628000;367786000;2730094000;153938000;;922679000;507476000;671258000;1593937000;2247647000;;-1112289000;1136157000;2730094000
WDAY;186213;USD;2015;Q4;2016-01-31;2015-03-25;192587000;192587000;1857709000;188357000;;2108387000;140136000;;101567000;241703000;2350090000;90907000;3207000;641265000;481958000;582850000;1224115000;1948486000;;-822371000;1125975000;2350090000
WDAY;186213;USD;2014;Q4;2015-01-31;2014-03-31;183095000;183095000;1886579000;92184000;;2023658000;77664000;;74943000;152607000;2176265000;79831000;9377000;421890000;472001000;567158000;989048000;1761337000;;-574389000;1187217000;2176265000
WDAY;186213;USD;2013;Q4;2014-01-31;2013-03-22;169354000;169354000;790339000;67437000;;884302000;44585000;;30193000;74778000;959080000;43426000;12008000;254774000;12972000;112023000;366797000;994095000;;-401880000;592283000;959080000
WDAY;186213;USD;2012;Q4;2013-01-31;2012-12-07;166339000;166339000;111163000;54467000;;183172000;25861000;;23605000;49466000;232638000;23429000;7075000;145238000;8641000;92055000;237293000;106558000;;-282122000;-4655000;232638000
WDAY;186213;USD;2017;Q4;2018-01-31;2016-12-02;211062000;211062000;3267850000;528208000;;3956978000;546609000;;443837000;990446000;4947424000;291124000;341509000;2058874000;1149845000;1308185000;3367059000;3354634000;;-1727856000;1580365000;4947424000
WDAY;186213;USD;2018;Q4;2019-01-31;2019-03-18;220475000;220475000;1778418000;704680000;;2700596000;796907000;;2023243000;2820150000;5520746000;360559000;232514000;2430691000;972264000;1131613000;3562304000;4105555000;;-2146304000;1958442000;5520746000
BRCD;186307;USD;2015;Q4;2015-10-31;2015-12-22;414771000;422316000;1440882000;235883000;40524000;1852199000;439224000;;1744730000;2183954000;4036153000;317444000;298000;562364000;793779000;940254000;1502618000;1633398000;;925139000;2533535000;4036153000
BRCD;186307;USD;2014;Q4;2014-10-31;2014-12-19;431844000;455931000;1255017000;224913000;38718000;1658005000;445433000;;1630237000;2075670000;3733675000;347315000;;587308000;595450000;738306000;1325614000;1774628000;;652247000;2408061000;3733675000
BRCD;186307;USD;2013;Q4;2013-10-31;2013-12-16;444642000;471714000;986997000;249598000;45344000;1422803000;472940000;;1725648000;2198588000;3621391000;333967000;;560663000;596208000;713915000;1274578000;1915597000;;444660000;2346813000;3621391000
BRCD;186307;USD;2012;Q4;2012-10-31;2012-12-14;459334000;474215000;713226000;233139000;68179000;1155579000;518940000;;1906742000;2425682000;3581261000;391232000;1977000;610468000;599203000;734973000;1345441000;2009647000;;236037000;2235820000;3581261000
BRCD;186307;USD;2011;Q4;2011-10-31;2011-12-20;474975000;485895000;414976000;249141000;74172000;844201000;532384000;;2097723000;2630107000;3474308000;322571000;40539000;565987000;748904000;894183000;1460170000;1985278000;;40856000;2014138000;3474308000
BRCD;186307;USD;2010;Q4;2010-10-31;2010-12-17;456599000;485673000;335982000;317363000;76808000;866288000;539117000;;2240607000;2779724000;3646012000;349951000;30540000;572106000;899273000;1038501000;1610607000;2047986000;;-9754000;2035405000;3646012000
BRCD;186307;USD;2009;Q4;2009-10-31;2010-09-02;425531000;425531000;338871000;297819000;72152000;885275000;442408000;;2343737000;2786145000;3671420000;447344000;208154000;855187000;860114000;1038229000;1893416000;1901672000;;-117748000;1778004000;3671420000
BRCD;186307;USD;2016;Q4;2016-10-31;2016-12-16;401105000;410123000;1257075000;284344000;69355000;1673010000;455326000;;2811475000;3266801000;4939811000;396020000;76692000;694652000;1502063000;1699584000;2394236000;1515132000;;1055194000;2545575000;4939811000
COO;186450;USD;2017;Q4;2017-10-31;2017-12-22;48900000;49901000;88800000;316600000;454100000;953200000;910100000;;2995400000;3905500000;4858700000;142100000;23400000;396100000;1149300000;1286800000;1682900000;1531900000;-415100000;2434200000;3175800000;4858700000
COO;186450;USD;2016;Q4;2016-10-31;2016-12-22;48802000;49299000;100800000;291400000;417700000;937100000;877700000;;2663800000;3541500000;4478600000;107400000;226300000;543200000;1107400000;1239500000;1782700000;1499200000;-360100000;2046300000;2695900000;4478600000
COO;186450;USD;2015;Q4;2015-10-31;2015-12-18;48543000;49271000;16426000;282918000;419692000;841428000;967097000;;2651339000;3618436000;4459864000;116912000;243803000;568782000;1105408000;1217178000;1785960000;1439861000;-360149000;1779440000;2673904000;4459864000
COO;186450;USD;2014;Q4;2014-10-31;2014-12-19;48277000;49318000;25222000;276280000;381474000;791617000;937325000;;2729398000;3666723000;4458340000;120387000;101518000;442182000;1280833000;1427718000;1869900000;1391899000;-294662000;1578823000;2588440000;4458340000
COO;186450;USD;2013;Q4;2013-10-31;2013-12-20;48699000;49875000;77393000;229537000;338917000;747241000;739867000;;1650153000;2390020000;3137261000;110690000;42987000;321253000;301670000;392514000;713767000;1334363000;-225917000;1311851000;2423494000;3137261000
COO;186450;USD;2012;Q4;2012-10-31;2012-12-20;48160000;49507000;12840000;234297000;320199000;657860000;640255000;;1643269000;2283524000;2941384000;88696000;25284000;262552000;348422000;465674000;728226000;1270147000;-64753000;1018618000;2213158000;2941384000
COO;186450;USD;2011;Q4;2011-10-31;2011-12-16;47802000;48597000;5175000;214779000;253584000;540347000;609205000;;1474966000;2084171000;2624518000;64583000;52979000;267206000;327453000;419824000;687030000;1185052000;-2590000;773136000;1937488000;2624518000
COO;186450;USD;2010;Q4;2010-10-31;2010-12-17;45741000;47128000;3573000;197490000;227902000;491340000;593887000;;1439791000;2033678000;2525018000;56286000;19159000;199520000;591977000;658722000;858242000;1088393000;-4805000;600522000;1666776000;2525018000
COO;186450;USD;2009;Q4;2009-10-31;2010-09-03;45200000;45808000;3932000;170941000;260846000;503878000;602568000;;1445461000;2048029000;2551907000;44877000;9844000;175414000;771630000;836151000;1011565000;1067846000;-5035000;490451000;1540342000;2551907000
COO;186450;USD;2018;Q4;2018-10-31;2018-12-21;49300000;50600000;77700000;374700000;468800000;1090900000;976000000;;4045900000;5021900000;6112800000;146400000;37100000;536500000;1985700000;2268500000;2805000000;1577400000;-415100000;2576000000;3307800000;6112800000
KEYS;186556;USD;2015;Q4;2015-10-31;2015-12-21;170000000;171000000;483000000;398000000;487000000;1579000000;518000000;70000000;1341000000;1929000000;3508000000;259000000;;686000000;1099000000;1520000000;2206000000;1167000000;0;614000000;1302000000;3508000000
KEYS;186556;USD;2014;Q4;2014-10-31;2015-03-05;167000000;167000000;810000000;357000000;498000000;1850000000;470000000;63000000;667000000;1200000000;3050000000;245000000;;769000000;1099000000;1512000000;2281000000;1004000000;;101000000;769000000;3050000000
KEYS;186556;USD;2016;Q4;2016-10-31;2016-12-19;169000000;172000000;783000000;437000000;474000000;1854000000;512000000;55000000;1382000000;1949000000;3803000000;230000000;;644000000;1100000000;1646000000;2290000000;1244000000;-62000000;949000000;1513000000;3803000000
KEYS;186556;USD;2017;Q4;2017-10-31;2017-12-20;186000000;190000000;818000000;547000000;588000000;2177000000;530000000;63000000;3163000000;3756000000;5933000000;239000000;10000000;819000000;2038000000;2804000000;3623000000;1788000000;-62000000;1041000000;2310000000;5933000000
KEYS;186556;USD;2018;Q4;2018-10-31;2018-12-18;185000000;194000000;913000000;624000000;619000000;2378000000;555000000;46000000;2845000000;3446000000;5824000000;284000000;499000000;1462000000;1291000000;1929000000;3391000000;1891000000;-182000000;1212000000;2433000000;5824000000
ABC;187024;USD;2018;Q4;2018-09-30;2018-11-20;215396000;217459000;2492516000;11314226000;11918508000;25894372000;1892424000;;9883042000;11775466000;37669838000;27718030000;151657000;27869687000;4510828000;6750190000;34619877000;4718309000;-5426814000;3720582000;3049961000;37669838000
ABC;187024;USD;2017;Q4;2017-09-30;2017-11-21;218513000;221335000;2435115000;10303324000;11461428000;24303299000;1797945000;;9215226000;11013171000;35316470000;26806044000;12121000;26818165000;3781569000;6433844000;33252009000;4520441000;-4755348000;2395218000;2064461000;35316470000
ABC;187024;USD;2016;Q4;2016-09-30;2016-11-22;219098000;226866000;2741832000;9175876000;10723920000;22851847000;1530682000;;9254972000;10785654000;33637501000;24670159000;610210000;25280369000;3852484000;6227728000;31508097000;4335779000;-4396008000;2303941000;2129404000;33637501000
ABC;187024;USD;2015;Q4;2015-09-30;2015-11-24;212086000;191209000;2167442000;8222951000;9755094000;20334488000;1192510000;;6435984000;7628494000;27962982000;21578227000;0;21578227000;3739225000;5768369000;27346596000;3739227000;-4150997000;1164489000;616386000;27962982000
ABC;187024;USD;2014;Q4;2014-09-30;2014-11-25;224055000;242613000;1808513000;6312883000;8593852000;16800205000;899582000;;3832396000;4731978000;21532183000;16154697000;;17250160000;1995632000;2325124000;19575284000;2751896000;-2313380000;1570429000;1956899000;21532183000
ABC;187024;USD;2013;Q4;2013-09-30;2013-11-26;-692860732;-705306620;1231006000;6051920000;6981494000;14393651000;803561000;;3721426000;4524987000;18918638000;13868356000;;14870635000;1396606000;1728258000;16598893000;2363670000;-1516856000;1508414000;2319745000;18918638000
ABC;187024;USD;2012;Q4;2012-09-30;2012-11-27;242885000;246440000;1066608000;3784619000;5472010000;11058464000;743684000;;3640108000;4383792000;15442256000;10062799000;;11265586000;1395931000;1721828000;12987414000;2255095000;-1038019000;1270423000;2454842000;15442256000
ABC;187024;USD;2011;Q4;2011-09-30;2011-11-22;266468000;271394000;1825990000;3793850000;5443101000;11375041000;672862000;;2934768000;3607630000;14982671000;9601919000;392089000;10875264000;972863000;1240549000;12115813000;4087943000;-5225881000;4055664000;2866858000;14982671000
ABC;187024;USD;2010;Q4;2010-09-30;2010-11-23;278956000;283842000;1658182000;3827484000;5210098000;10748350000;711712000;;2974781000;3686493000;14434843000;9202301000;422000;9906344000;1343158000;1574202000;11480546000;3904279000;-4373332000;3465886000;2954297000;14434843000
ABC;187024;USD;2009;Q4;2009-09-30;2009-11-25;292775000;295662000;1009368000;3916509000;4972820000;9953753000;619238000;;2999749000;3618987000;13572740000;8832819000;1068000;9479610000;1176933000;1376661000;10856271000;3742664000;-3899859000;2919760000;2716469000;13572740000
ABC;187024;USD;2008;Q4;2008-09-30;2009-08-06;312854000;315818000;878114000;3480267000;4211775000;8669761000;552159000;;2995866000;3548025000;12217786000;7597403000;1719000;8167589000;1187412000;1340152000;9507741000;3694429000;-3446972000;2479078000;2710045000;12217786000
CRL;187129;USD;2017;Q4;2017-12-31;2018-02-13;47336000;49103000;163794000;430016000;114956000;826625000;781973000;;1321324000;2103297000;2929922000;268662000;30998000;463504000;1114105000;1402402000;1865906000;2561067000;-1659914000;288658000;1064016000;2929922000
CRL;187129;USD;2016;Q4;2016-12-31;2017-02-14;47193000;48262000;117626000;364050000;95833000;656832000;755827000;;1299141000;2054968000;2711800000;246426000;27313000;429593000;1207696000;1428423000;1858016000;2478234000;-1553005000;165303000;853784000;2711800000
CRL;187129;USD;2015;Q4;2015-12-31;2016-02-12;46247000;-138263000;117947000;270068000;93735000;559234000;677959000;;831304000;1509263000;2068497000;199001000;17033000;311761000;845997000;991172000;1302933000;2398815000;-1540738000;10538000;765564000;2068497000
CRL;187129;USD;2014;Q4;2014-12-31;2015-02-17;46459000;-137913000;160023000;257991000;89043000;579254000;676797000;;614527000;1291324000;1870578000;172764000;31904000;294686000;740557000;871546000;1166232000;2308485000;-1423260000;-138775000;704346000;1870578000
CRL;187129;USD;2013;Q4;2013-12-31;2014-02-25;47109985;-141312667;155927000;220630000;89396000;552550000;676182000;;404024000;1080206000;1632756000;146943000;21437000;247034000;642352000;721064000;968098000;2206980000;-1305880000;-265473000;664658000;1632756000
CRL;187129;USD;2012;Q4;2012-12-31;2013-02-27;47738040;-93711607;109685000;203001000;88470000;485252000;717020000;;384072000;1101092000;1586344000;123377000;139384000;342247000;527136000;640897000;983144000;2098112000;-1135609000;-368301000;603200000;1586344000
CRL;187129;USD;2011;Q4;2011-12-31;2012-02-27;48277723;-100163613;68905000;184810000;92969000;425843000;738030000;;394447000;1132477000;1558320000;130311000;14758000;216797000;703187000;814160000;1030957000;2057706000;-1071120000;-465596000;527363000;1558320000
CRL;187129;USD;2010;Q4;2010-12-31;2011-02-23;57210266;-191573515;179160000;192972000;100297000;552894000;752657000;;427822000;1180479000;1733373000;138914000;30582000;259780000;670270000;784866000;1044646000;1997649000;-768699000;-575162000;688727000;1733373000
CRL;187129;USD;2009;Q4;2009-12-31;2010-08-03;;;182574000;190101000;102723000;595601000;863744000;;744748000;1608492000;2204093000;125264000;35413000;249773000;457419000;580496000;830269000;2039226000;-470527000;-238493000;1373824000;2204093000
CRL;187129;USD;2018;Q4;2018-12-31;2019-02-13;47495000;48875000;195442000;472248000;127892000;897836000;932877000;;2025166000;2958043000;3855879000;310387000;31416000;558222000;1636598000;1959354000;2517576000;1447994000;-55000;42096000;1338303000;3855879000
EXTR;187330;USD;2016;Q4;2016-06-30;2016-09-06;104838000;104838000;94122000;81419000;40989000;228968000;29580000;;116301000;145881000;374849000;67456000;17875000;211773000;37625000;72879000;284652000;884811000;;-791740000;90197000;374849000
EXTR;187330;USD;2015;Q4;2015-06-30;2015-09-14;100226000;100226000;76225000;92737000;58014000;237994000;39862000;;150804000;190666000;428660000;74006000;11375000;235430000;55500000;88995000;324425000;865382000;;-759856000;104235000;428660000
EXTR;187330;USD;2014;Q4;2014-06-30;2014-09-15;96713000;96713000;105882000;124664000;57109000;302856000;46554000;;177022000;223576000;526432000;71536000;29688000;246308000;91875000;123412000;369720000;845364000;;-688213000;156712000;526432000
EXTR;187330;USD;2013;Q4;2013-06-30;2013-08-30;93609000;97208000;138837000;47642000;16167000;208781000;23644000;66776000;12223000;102643000;311424000;43962000;0;112502000;0;9777000;122279000;821425000;;-630903000;189145000;311424000
EXTR;187330;USD;2012;Q4;2012-06-30;2012-08-23;94130000;95187000;77954000;41166000;26609000;169109000;25180000;75561000;14740000;115481000;284590000;35717000;;96748000;;8202000;104950000;970743000;-149666000;-640576000;179640000;284590000
EXTR;187330;USD;2011;Q4;2011-06-30;2011-11-10;92931000;97718000;91329000;33689000;21583000;157414000;41877000;55648000;16034000;113559000;270973000;31455000;;99853000;;9834000;109687000;963697000;-149666000;-656448000;161286000;270973000
EXTR;187330;USD;2017;Q4;2017-06-30;2017-09-13;110499000;110499000;130450000;93115000;47410000;298842000;30240000;;130618000;160858000;459700000;84833000;12280000;213205000;80422000;120817000;334022000;909266000;;-781286000;125678000;459700000
EXTR;187330;USD;2018;Q4;2018-06-30;2018-08-29;115963000;109773000;121139000;212423000;63867000;427913000;78519000;;263816000;342335000;770248000;138847000;9007000;359872000;188749000;297644000;657516000;942513000;;-828078000;112732000;770248000
EXTR;187330;USD;2019;Q4;2019-06-30;2019-08-29;118960000;116960000;169607000;174414000;63589000;441989000;73554000;;241331000;314885000;756874000;132108000;9011000;356029000;169739000;284858000;640887000;986894000;-15000000;-853434000;115987000;756874000
MEIP;187582;USD;2017;Q4;2017-06-30;2017-09-05;37160144;37616040;53565000;;;55323000;50000;;331000;381000;55704000;3870000;;4866000;;0;4866000;225169000;;-174331000;50838000;55704000
MEIP;187582;USD;2016;Q4;2016-06-30;2016-09-06;34420417;34420417;45918000;;;46749000;49000;;366000;415000;47164000;5512000;;5512000;;0;5512000;218653000;;-177001000;41652000;47164000
MEIP;187582;USD;2015;Q4;2015-06-30;2015-09-02;34107253;34107253;63779000;;;64281000;68000;;401000;469000;64750000;4959000;;4959000;;0;4959000;215930000;;-156139000;59791000;64750000
MEIP;187582;USD;2014;Q4;2014-06-30;2014-09-09;21559154;21559154;48793000;;;49290000;83000;;435000;518000;49808000;4616000;;4616000;;0;4616000;168637000;;-123445000;45192000;49808000
MEIP;187582;USD;2013;Q4;2013-06-30;2013-09-18;16665567;16665567;35573000;;;36029000;48000;;470000;518000;36547000;1675000;;1675000;;0;1675000;131169000;;-96297000;34872000;36547000
MEIP;187582;USD;2012;Q4;2012-06-30;2012-09-18;2968287;2968287;6202000;;;6348000;25000;;;25000;6373000;1774000;;1774000;;0;1774000;89710000;;-85111000;4599000;6373000
MEIP;187582;USD;2011;Q4;2011-06-30;2011-11-14;;;3858000;;;4130000;38000;;;38000;4168000;1249000;;2374000;;0;2374000;79382000;;-77588000;1794000;4168000
MEIP;187582;USD;2018;Q4;2018-06-30;2018-08-30;53616000;53616000;102743000;;;104329000;32000;;296000;328000;104657000;7097000;;7885000;;46313000;54198000;264858000;;-214399000;50459000;104657000
ELMD;187864;USD;2018;Q4;2018-06-30;2018-09-25;8218431;8603539;7455844;11563208;2360693;22211947;3091242;;1335015;4426257;26638204;3177772;1101043;4743172;0;0;4743172;15035990;;6859042;21895032;26638204
ELMD;187864;USD;2017;Q4;2017-06-30;2017-09-05;8171272;8511762;5573709;9949759;2559485;18476272;3303233;;1281144;4584377;23060649;2406523;50703;2895974;1097125;1097125;3993099;14110904;;4956646;19067550;23060649
ELMD;187864;USD;2016;Q4;2016-06-30;2016-09-06;8140485;8337254;5123355;7611437;2480443;15827536;3375189;;1374792;4749981;20577517;2739023;46309;3072526;1146395;1146395;4218921;13631422;;2727174;16358596;20577517
ELMD;187864;USD;2015;Q4;2015-06-30;2015-09-15;8119624;8203656;3598240;6518816;2072108;12586997;3635516;;1182541;4818057;17405054;2021545;48749;2279277;1202446;1202446;3481723;13408659;;514672;13923331;17405054
ELMD;187864;USD;2014;Q4;2014-06-30;2014-09-23;8114252;8114252;1502702;6487267;2235496;10623318;3935802;;1233046;5168848;15792166;1471622;46375;1820479;1251192;1251192;3071671;13298309;;-577814;12720495;15792166
ELMD;187864;USD;2013;Q4;2013-06-30;2013-09-25;8114252;8114252;503564;9014043;1379594;11864329;3743675;;1947823;5691498;17555827;1888704;57540;2193511;1332455;1435455;3628966;13216081;;710780;13926861;17555827
ELMD;187864;USD;2012;Q4;2012-06-30;2012-09-26;8114112;8091293;1702435;10850859;2392416;15646037;3170014;;2104973;5274987;20921024;1996980;254020;4170686;1390003;1670003;5840689;13040279;;2040056;15080335;20921024
ELMD;187864;USD;2011;Q4;2011-06-30;2011-11-10;8091033;8132803;4091739;9593105;1855957;15912058;2807082;;2149792;4956874;20868932;2045946;438267;4413507;1582102;1726602;6140109;12875373;;1853450;14728823;20868932
NDSN;188156;USD;2016;Q4;2016-10-31;2016-12-15;57206000;57865000;67239000;428560000;220361000;745575000;273129000;;1401879000;1675008000;2420583000;260690000;44678000;331543000;942771000;1237437000;1568980000;388878000;-1301663000;1932635000;851603000;2420583000
NDSN;188156;USD;2015;Q4;2015-10-31;2015-12-15;58906000;59331000;50268000;389550000;225672000;711591000;249940000;;1398913000;1648853000;2360444000;237802000;28834000;290776000;1102341000;1409652000;1700428000;361239000;-1273765000;1717228000;660016000;2360444000
NDSN;188156;USD;2014;Q4;2014-10-31;2014-12-15;62957000;63566000;42314000;365844000;210871000;672683000;224439000;;1383008000;1607447000;2280130000;222087000;122040000;370868000;693886000;1004465000;1375333000;340858000;-893828000;1560966000;904797000;2280130000
NDSN;188156;USD;2013;Q4;2013-10-31;2013-12-16;64126000;64859000;42375000;308707000;198401000;602066000;200979000;;1250134000;1451113000;2053179000;187173000;19957000;236797000;648270000;928519000;1165316000;316802000;-734143000;1362584000;887863000;2053179000
NDSN;188156;USD;2012;Q4;2012-10-31;2012-12-17;64108000;64881000;41518000;324563000;169585000;586623000;174931000;;1067961000;1242892000;1829515000;212173000;110617000;343684000;538986000;816061000;1159745000;299834000;-707083000;1181245000;669770000;1829515000
NDSN;188156;USD;2011;Q4;2011-10-31;2011-12-16;66395000;67039000;37408000;254310000;141912000;476957000;130883000;;696610000;827493000;1304450000;162958000;9828000;182161000;318661000;550966000;733127000;285181000;-624067000;990221000;571323000;1304450000
NDSN;188156;USD;2010;Q4;2010-10-31;2010-12-17;67105000;67915000;50169000;243790000;117721000;451031000;116395000;;418928000;535323000;986354000;160731000;20184000;191914000;99316000;289368000;481282000;267848000;-494165000;797695000;505072000;986354000
NDSN;188156;USD;2009;Q4;2009-10-31;2010-09-08;67234000;67066000;18824000;191201000;97636000;346671000;118291000;;425712000;544003000;890674000;138000000;9615000;156422000;155242000;364276000;520698000;253747000;-484387000;656086000;369976000;890674000
NDSN;188156;USD;2017;Q4;2017-10-31;2017-12-15;57644000;58302000;90383000;505087000;264266000;888372000;346411000;;2179756000;2526167000;3414539000;281692000;331400000;647746000;1266090000;1611300000;2259046000;425038000;-1299707000;2164597000;1155493000;3414539000
NDSN;188156;USD;2018;Q4;2018-10-31;2018-12-14;58083000;58993000;95678000;491423000;264477000;884102000;386666000;;2150244000;2536910000;3421012000;277994000;33289000;350280000;1294207000;1619991000;1970271000;458808000;-1317128000;2488375000;1450741000;3421012000
KIRK;188255;USD;2017;Q4;2018-02-28;2018-04-03;15992000;16764000;80156000;;81255000;177399000;113039000;;8759000;121798000;299197000;96940000;;96940000;;61496000;158436000;167501000;;-26740000;140761000;299197000
KIRK;188255;USD;2016;Q4;2017-02-28;2017-03-31;15905000;16728000;63937000;;73191000;153040000;110870000;;6236000;117106000;270146000;74441000;;74441000;;61892000;136333000;165245000;;-31432000;133813000;270146000
KIRK;188255;USD;2015;Q4;2016-02-29;2016-04-08;16766000;17951000;44352000;;68222000;127780000;105542000;;1934000;107476000;235256000;59495000;;59495000;;56066000;115561000;162173000;;-42478000;119695000;235256000
KIRK;188255;USD;2014;Q4;2015-02-28;2015-04-14;17147000;18278000;99138000;;55775000;167329000;90992000;;2166000;93158000;260487000;57380000;;57380000;;52045000;109425000;159015000;;-7953000;151062000;260487000
KIRK;188255;USD;2013;Q4;2014-02-28;2014-04-17;17302000;18370000;89050000;;52637000;153281000;80329000;;1838000;82167000;235448000;52647000;;52647000;;47572000;100219000;156193000;;-20964000;135229000;235448000
KIRK;188255;USD;2012;Q4;2013-02-28;2013-04-18;17046000;18115000;67797000;;49577000;129178000;78499000;;1559000;80058000;209236000;44003000;;44003000;;47358000;91361000;153369000;;-35494000;117875000;209236000
KIRK;188255;USD;2011;Q4;2012-02-29;2012-04-12;19038000;20087000;83123000;;47306000;139870000;60315000;;2404000;62719000;202589000;46543000;;46543000;;38384000;84927000;150352000;;-32690000;117662000;202589000
KIRK;188255;USD;2010;Q4;2011-02-28;2011-09-08;19903000;20548000;91222000;;44452000;146670000;46231000;;2176000;48407000;195077000;45889000;;45889000;;30899000;76788000;146747000;;-28458000;118289000;195077000
KIRK;188255;USD;2018;Q4;2019-02-28;2019-03-29;14760000;15244000;57946000;;84434000;157941000;110823000;;8384000;119207000;277148000;86536000;;86536000;;59812000;146348000;169477000;;-38677000;130800000;277148000
HURC;188434;USD;2016;Q4;2016-10-31;2017-01-06;6575000;6659000;41217000;48631000;117025000;224519000;12297000;;15133000;27430000;251949000;55954000;1476000;57968000;;8506000;66474000;59776000;;136742000;185475000;251949000
HURC;188434;USD;2015;Q4;2015-10-31;2016-01-08;6550000;6656000;55237000;41766000;106308000;220833000;13142000;;14602000;27744000;248577000;62432000;1583000;65086000;;8923000;74009000;58194000;;125760000;174568000;248577000
HURC;188434;USD;2014;Q4;2014-10-31;2015-01-09;6508000;6559000;53846000;45435000;95992000;210754000;11505000;;14672000;26177000;236931000;62826000;3272000;66803000;;5483000;72286000;56625000;;111580000;164645000;236931000
HURC;188434;USD;2013;Q4;2013-10-31;2014-01-10;-19331180;-19461012;42804000;36145000;95260000;185002000;12299000;;13934000;26233000;211235000;50809000;3665000;55686000;;4058000;59744000;55345000;;98130000;151491000;211235000
HURC;188434;USD;2012;Q4;2012-10-31;2013-01-11;6449000;6470000;35770000;35297000;91320000;173381000;12079000;;9852000;21931000;195312000;45597000;3206000;49372000;;2147000;51519000;54060000;;90586000;143793000;195312000
HURC;188434;USD;2011;Q4;2011-10-31;2012-01-13;6441000;6456000;44961000;27057000;81127000;164074000;11544000;;10927000;22471000;186545000;54754000;865000;57228000;;3105000;60333000;53258000;;74948000;126212000;186545000
HURC;188434;USD;2010;Q4;2010-10-31;2011-09-09;6441000;6441000;48255000;20114000;55866000;136208000;11752000;;12386000;24138000;160346000;40117000;;42240000;;3366000;45606000;52788000;;63824000;114740000;160346000
HURC;188434;USD;2017;Q4;2017-10-31;2018-03-09;6636000;6686000;66307000;50094000;119948000;252591000;12181000;;16873000;29054000;281645000;67650000;1507000;70889000;;7671000;78560000;62008000;;149267000;203085000;281645000
HURC;188434;USD;2018;Q4;2018-10-31;2019-01-04;6718000;6767000;77170000;54414000;137609000;283669000;12959000;;18779000;31738000;315407000;78169000;1434000;81623000;;10931000;92554000;64857000;;167859000;222853000;315407000
ANF;188522;USD;2017;Q4;2018-01-31;2016-12-05;67968000;69290000;547189000;93384000;399795000;1139300000;824738000;;331719000;1156457000;2295757000;465924000;20076000;486000000;385710000;557718000;1043718000;397623000;-1507589000;2474703000;1252039000;2295757000
ANF;188522;USD;2016;Q4;2017-01-31;2017-03-27;67431000;69180000;588578000;56868000;436701000;1178980000;894178000;;359881000;1254059000;2433039000;511400000;23303000;534703000;422931000;602614000;1137317000;408062000;-1532576000;2530196000;1295722000;2433039000
ANF;188522;USD;2015;Q4;2016-01-31;2015-03-30;69407000;71381000;520708000;52910000;460794000;1164972000;967001000;;373194000;1340195000;2505167000;457225000;28731000;485956000;448224000;629510000;1115466000;435170000;-1512562000;2550673000;1389701000;2505167000
ANF;188522;USD;2014;Q4;2015-01-31;2014-03-31;76466000;80617000;600116000;67965000;530192000;1320566000;1131341000;;399090000;1530431000;2850997000;517057000;51165000;568222000;321525000;553282000;1121504000;434653000;-1240513000;2556270000;1729493000;2850997000
ANF;188522;USD;2013;Q4;2014-01-31;2013-04-02;78943000;80553000;643505000;99622000;426962000;1307824000;1308232000;;371345000;1679577000;2987401000;651747000;39054000;690801000;232339000;478332000;1169133000;404304000;-1140009000;2567261000;1818268000;2987401000
ANF;188522;USD;2012;Q4;2013-01-31;2012-03-27;85881000;87647000;668145000;89350000;679935000;1557654000;1197271000;14858000;347249000;1559378000;3117032000;658359000;41047000;699406000;240873000;486291000;1185697000;370204000;-834774000;2389614000;1931335000;3117032000
ANF;188522;USD;2011;Q4;2012-01-31;2011-03-29;87693000;91854000;826353000;74777000;385857000;1426781000;1154759000;100534000;259341000;1514634000;2941415000;510826000;41538000;552364000;261185000;498267000;1050631000;350291000;-725308000;2272317000;1890784000;2941415000
ANF;188522;USD;2010;Q4;2011-01-31;2011-03-29;87979000;90919000;702306000;90865000;310645000;1225683000;1244019000;141794000;210370000;1596183000;2821866000;405775000;43597000;449372000;283265000;544577000;993949000;340486000;-687286000;2183690000;1827917000;2821866000
ANF;188522;USD;2018;Q4;2019-01-31;2019-04-01;66501000;72159000;723135000;73112000;437879000;1335950000;694855000;;354788000;1049643000;2385593000;540015000;18902000;558917000;372910000;608055000;1166972000;406412000;-1513604000;2418544000;1218621000;2385593000
CASY;188690;USD;2016;Q4;2016-04-30;2017-06-29;38957723;39364198;76717000;43244000;201644000;350685000;2513158000;;156259000;2669417000;3020102000;431125000;15421000;446546000;907356000;1382936000;1829482000;40074000;;1150546000;1190620000;3020102000
CASY;188690;USD;2015;Q4;2015-04-30;2016-06-27;39063898;39439603;75775000;27701000;204988000;325885000;2252475000;;147788000;2400263000;2726148000;340170000;15375000;387571000;822869000;1255114000;1642685000;72868000;;1010595000;1083463000;2726148000
CASY;188690;USD;2014;Q4;2014-04-30;2015-06-26;38854480;39232053;48541000;22609000;197331000;305260000;2019364000;;145341000;2164705000;2469965000;317399000;15398000;364889000;838245000;1229847000;1594736000;56274000;;818955000;875229000;2469965000
CASY;188690;USD;2013;Q4;2013-04-30;2014-06-27;38499458;38830795;121641000;25841000;204833000;389558000;1778965000;;136353000;1915318000;2304876000;362925000;553000;390889000;853642000;1210723000;1601612000;33878000;;669386000;703264000;2304876000
CASY;188690;USD;2012;Q4;2012-04-30;2012-09-10;38341744;38629388;41271000;20900000;189514000;278967000;1581925000;;129276000;1711201000;1990168000;380775000;15810000;412806000;653081000;983975000;1396781000;23119000;;570268000;593387000;1990168000
CASY;188690;USD;2011;Q4;2011-04-30;2012-06-26;38119977;38380623;55919000;21700000;170794000;279278000;1378749000;;116788000;1495537000;1774815000;280894000;10737000;306641000;667930000;962133000;1268774000;12199000;;493842000;506041000;1774815000
CASY;188690;USD;2010;Q4;2010-04-30;2011-06-28;37969908;38222539;59572000;20154000;159200000;293887000;1217305000;;99763000;1317068000;1610955000;280319000;1167000;294500000;678680000;912559000;1207059000;3996000;;399900000;403896000;1610955000
CASY;188690;USD;2009;Q4;2009-04-30;2010-09-09;50920260;51062618;151676000;12111000;124951000;310085000;1010911000;;67779000;1078690000;1388775000;204328000;24577000;240886000;154754000;323570000;564456000;64439000;;759880000;824319000;1388775000
CASY;188690;USD;2017;Q4;2017-04-30;2018-06-29;37368966;37552369;53679000;45045000;241668000;396840000;2902920000;;170167000;3073087000;3469927000;464772000;15374000;507850000;1291725000;1690936000;2198786000;0;;1271141000;1271141000;3469927000
CASY;188690;USD;2018;Q4;2018-04-30;2019-06-28;36754796;36889843;63296000;37856000;273040000;410580000;3122419000;;198377000;3320796000;3731376000;573727000;17205000;590932000;1283275000;1731675000;2322607000;15600000;;1393169000;1408769000;3731376000
NEE;188922;USD;2017;Q4;2017-12-31;2018-02-16;470400000;474600000;1714000000;2220000000;1273000000;7157000000;72416000000;2321000000;15933000000;90670000000;97827000000;4890000000;3363000000;10886000000;31463000000;57443000000;68329000000;9105000000;;18992000000;29498000000;97827000000
D;189087;USD;2017;Q4;2017-12-31;2018-02-27;644200000;644200000;120000000;1660000000;1477000000;4334000000;53758000000;;18493000000;72251000000;76585000000;875000000;6376000000;9636000000;30948000000;47579000000;57215000000;9865000000;;7936000000;19370000000;76585000000
D;189087;USD;2016;Q4;2016-12-31;2017-02-28;627500000;627200000;261000000;1523000000;1524000000;4248000000;49964000000;;17398000000;67362000000;71610000000;1798000000;4864000000;8115000000;30231000000;46655000000;54770000000;8550000000;;6854000000;16840000000;71610000000
D;189087;USD;2015;Q4;2015-12-31;2016-02-26;595600000;596900000;607000000;1200000000;1348000000;4189000000;41554000000;;12905000000;54459000000;58648000000;1241000000;5334000000;8119000000;23468000000;36927000000;45046000000;6680000000;;6458000000;13602000000;58648000000
D;189087;USD;2014;Q4;2014-12-31;2015-02-27;584200000;586600000;318000000;1514000000;1410000000;5615000000;36270000000;;12442000000;48712000000;54327000000;1518000000;4150000000;7198000000;21805000000;35172000000;42370000000;5876000000;;6095000000;11957000000;54327000000
D;189087;USD;2013;Q4;2013-12-31;2014-02-28;580700000;581500000;316000000;1695000000;1176000000;5940000000;32628000000;;11528000000;44156000000;50096000000;1777000000;3446000000;6994000000;19330000000;31203000000;38197000000;5783000000;;6183000000;11899000000;50096000000
D;189087;USD;2012;Q4;2012-12-31;2013-02-28;575300000;575900000;248000000;1621000000;1259000000;5140000000;30773000000;;10925000000;41698000000;46838000000;1773000000;4635000000;7763000000;16851000000;28193000000;35956000000;5655000000;;5790000000;10882000000;46838000000
D;189087;USD;2011;Q4;2011-12-31;2012-02-28;569800000;571500000;102000000;1780000000;1348000000;5430000000;29670000000;;10514000000;40184000000;45614000000;1898000000;3293000000;6962000000;17394000000;26892000000;33854000000;5359000000;;6697000000;11760000000;45614000000
D;189087;USD;2010;Q4;2010-12-31;2011-02-28;580300000;581700000;62000000;2158000000;1163000000;5400000000;26713000000;;10704000000;37417000000;42817000000;2543000000;1883000000;5773000000;15758000000;24790000000;30563000000;5909000000;;6418000000;12254000000;42817000000
D;189087;USD;2009;Q4;2009-12-31;2010-02-26;598100000;598800000;48000000;2050000000;1185000000;6817000000;25592000000;;10145000000;35737000000;42554000000;2081000000;2432000000;6833000000;15481000000;24279000000;31112000000;6710000000;;4686000000;11442000000;42554000000
D;189087;USD;2008;Q4;2008-12-31;2009-07-31;;;66000000;2354000000;1166000000;7661000000;23274000000;;11118000000;34392000000;42053000000;2253000000;2474000000;7794000000;14956000000;23925000000;31719000000;6176000000;;4170000000;10334000000;42053000000
D;189087;USD;2018;Q4;2018-12-31;2019-02-28;659600000;661100000;268000000;1749000000;1418000000;5161000000;54560000000;;18193000000;72753000000;77914000000;1750000000;3958000000;7647000000;31144000000;48219000000;55866000000;12588000000;;9219000000;22048000000;77914000000
SO;189248;USD;2013;Q4;2013-12-31;2014-02-27;886000000;889000000;659000000;;959000000;5471000000;51208000000;;7867000000;59075000000;64546000000;2616000000;1951000000;5525000000;21344000000;38882000000;44407000000;9823000000;-250000000;9510000000;20139000000;64546000000
SO;189248;USD;2012;Q4;2012-12-31;2013-02-28;868000000;876000000;628000000;;1000000000;6162000000;48390000000;;8597000000;56987000000;63149000000;2670000000;3160000000;7014000000;19274000000;36756000000;43770000000;9244000000;-450000000;9626000000;19379000000;63149000000
SO;189248;USD;2011;Q4;2011-12-31;2012-02-24;865000000;872000000;1315000000;;903000000;6272000000;45010000000;;7985000000;52995000000;59267000000;2894000000;2576000000;6577000000;18647000000;34030000000;40607000000;8738000000;-17000000;8968000000;18660000000;59267000000
SO;189248;USD;2010;Q4;2010-12-31;2011-02-25;841474000;848213000;447000000;;827000000;5883000000;42002000000;;7147000000;49149000000;55032000000;2767000000;2598000000;6472000000;18154000000;31276000000;37748000000;7921000000;-15000000;8366000000;17284000000;55032000000
SO;189248;USD;2009;Q4;2009-12-31;2010-02-25;810976000;810109000;690000000;;794000000;5873000000;39230000000;;6943000000;46173000000;52046000000;2556000000;1752000000;5584000000;18131000000;30502000000;36086000000;7096000000;-15000000;7885000000;15960000000;52046000000
SO;189248;USD;2008;Q4;2008-12-31;2009-08-27;776106000;779647000;417000000;;757000000;5358000000;35878000000;;7111000000;42989000000;48347000000;2796000000;1570000000;5226000000;16816000000;28763000000;33989000000;5781000000;-12000000;7612000000;14358000000;48347000000
SCG;190587;USD;2015;Q4;2015-12-31;2016-02-26;142900000;142900000;176000000;732000000;312000000;1378000000;13611000000;;2157000000;15768000000;17146000000;991000000;647000000;1952000000;5882000000;9751000000;11703000000;2390000000;;3118000000;5443000000;17146000000
SCG;190587;USD;2014;Q4;2014-12-31;2015-02-27;142700000;142700000;137000000;838000000;361000000;2145000000;12704000000;;1969000000;14673000000;16818000000;858000000;1084000000;2468000000;5497000000;9363000000;11831000000;2378000000;;2684000000;4987000000;16818000000
SCG;190587;USD;2013;Q4;2013-12-31;2014-02-28;140700000;140600000;136000000;802000000;362000000;1421000000;12147000000;;1596000000;13743000000;15164000000;782000000;430000000;1442000000;5395000000;9058000000;10500000000;2280000000;;2444000000;4664000000;15164000000
SCG;190587;USD;2012;Q4;2012-12-31;2013-02-28;131800000;134100000;72000000;780000000;440000000;1527000000;11383000000;;1706000000;13089000000;14616000000;740000000;795000000;1811000000;4949000000;8651000000;10462000000;;;;4154000000;14616000000
SCG;190587;USD;2011;Q4;2011-12-31;2012-02-29;129700000;131800000;29000000;756000000;442000000;1491000000;10523000000;;1520000000;12043000000;13534000000;665000000;684000000;1642000000;4622000000;8003000000;9645000000;;;;3889000000;13534000000
SCG;190587;USD;2010;Q4;2010-12-31;2011-03-01;127200000;128400000;55000000;837000000;441000000;1631000000;10115000000;;1222000000;11337000000;12968000000;805000000;757000000;1867000000;4152000000;7399000000;9266000000;;;;3702000000;12968000000
SCG;190587;USD;2009;Q4;2009-12-31;2010-08-04;123000000;123400000;162000000;694000000;491000000;1521000000;9440000000;;1133000000;10573000000;12094000000;692000000;363000000;1256000000;4483000000;7430000000;8686000000;;;;3408000000;12094000000
SCG;190587;USD;2016;Q4;2016-12-31;2017-02-24;142900000;;208000000;743000000;291000000;1506000000;14799000000;;2402000000;17201000000;18707000000;769000000;958000000;2065000000;6473000000;10917000000;12982000000;2390000000;;3384000000;5725000000;18707000000
SCG;190587;USD;2017;Q4;2017-12-31;2018-02-23;143200000;;409000000;770000000;304000000;1851000000;11122000000;;5766000000;16888000000;18739000000;825000000;1077000000;2113000000;5906000000;11371000000;13484000000;2390000000;;2915000000;5255000000;18739000000
DUK;191249;USD;2016;Q4;2016-12-31;2017-02-24;697000000;694000000;392000000;751000000;3522000000;8039000000;82520000000;29324000000;12878000000;124722000000;132761000000;3881000000;4806000000;11551000000;45576000000;80169000000;91720000000;38742000000;;2384000000;41041000000;132761000000
DUK;191249;USD;2015;Q4;2015-12-31;2016-02-25;688000000;688000000;383000000;515000000;3746000000;8322000000;73779000000;27639000000;11416000000;112834000000;121156000000;3051000000;5659000000;11400000000;36842000000;69985000000;81385000000;37969000000;;2564000000;39771000000;121156000000
DUK;191249;USD;2014;Q4;2014-12-31;2015-03-02;708000000;708000000;2036000000;791000000;3459000000;11575000000;70046000000;27875000000;11061000000;108982000000;120557000000;3258000000;5321000000;11233000000;37061000000;68425000000;79658000000;39406000000;;2012000000;40899000000;120557000000
DUK;191249;USD;2013;Q4;2013-12-31;2014-02-28;707000000;707000000;1545000000;1286000000;3250000000;10516000000;69490000000;25401000000;9372000000;104263000000;114779000000;3382000000;2943000000;8644000000;38152000000;64727000000;73371000000;39366000000;;2363000000;41408000000;114779000000
DUK;191249;USD;2012;Q4;2012-12-31;2013-03-01;705000000;709000000;1757000000;1516000000;3223000000;10122000000;68558000000;23994000000;11182000000;103734000000;113856000000;3351000000;4167000000;10029000000;36351000000;62793000000;72822000000;39280000000;;1889000000;41034000000;113856000000
DUK;191249;USD;2011;Q4;2011-12-31;2012-02-28;444711000;444088800;2300000000;784000000;1588000000;6880000000;42661000000;9160000000;3825000000;55646000000;62526000000;2116000000;2321000000;5528000000;18679000000;34133000000;39661000000;21133000000;;1873000000;22865000000;62526000000
DUK;191249;USD;2010;Q4;2010-12-31;2011-02-25;441464800;444464900;1670000000;764000000;1318000000;6223000000;40344000000;9255000000;3268000000;52867000000;59090000000;2036000000;491000000;3897000000;17935000000;32540000000;36437000000;21024000000;;1496000000;22653000000;59090000000
DUK;191249;USD;2009;Q4;2009-12-31;2010-02-26;434956500;435289800;1542000000;845000000;1515000000;5766000000;37950000000;9807000000;3517000000;51274000000;57040000000;2040000000;902000000;4088000000;16113000000;31066000000;35154000000;20662000000;;1460000000;21886000000;57040000000
DUK;191249;USD;2008;Q4;2008-12-31;2009-08-07;422624400;423291000;1037000000;1653000000;1135000000;5273000000;34036000000;10020000000;3748000000;47804000000;53077000000;2026000000;1189000000;4345000000;13250000000;27581000000;31926000000;20107000000;;1607000000;21151000000;53077000000
DUK;191249;USD;2017;Q4;2017-12-31;2018-02-21;700000000;700000000;358000000;779000000;3250000000;8453000000;86391000000;30628000000;12442000000;129461000000;137914000000;4119000000;5407000000;12482000000;49035000000;83695000000;96177000000;38793000000;;3013000000;41737000000;137914000000
DUK;191249;USD;2018;Q4;2018-12-31;2019-02-28;715000000;713000000;442000000;962000000;3084000000;9714000000;91694000000;30367000000;13617000000;135678000000;145392000000;4623000000;6816000000;15041000000;51123000000;86517000000;101558000000;40796000000;;3113000000;43834000000;145392000000
AMD;191397;USD;2016;Q4;2016-12-31;2017-02-21;938000000;911000000;1264000000;311000000;751000000;2530000000;164000000;59000000;568000000;791000000;3321000000;831000000;0;1346000000;1435000000;1559000000;2905000000;8343000000;-119000000;-7803000000;416000000;3321000000
AMD;191397;USD;2015;Q4;2015-12-31;2016-02-18;792000000;792000000;785000000;533000000;678000000;2320000000;188000000;0;576000000;764000000;3084000000;751000000;230000000;1403000000;2007000000;2093000000;3496000000;7025000000;-123000000;-7306000000;-412000000;3084000000
AMD;191397;USD;2014;Q4;2014-12-31;2015-02-19;777000000;762000000;1040000000;818000000;685000000;2736000000;302000000;;729000000;1031000000;3767000000;933000000;177000000;1440000000;2035000000;2140000000;3580000000;6957000000;-119000000;-6646000000;187000000;3767000000
AMD;191397;USD;2013;Q4;2013-12-31;2014-02-18;758000000;751000000;1097000000;832000000;884000000;2884000000;346000000;90000000;1017000000;1453000000;4337000000;1413000000;60000000;1618000000;1998000000;2175000000;3793000000;6901000000;-112000000;-6243000000;544000000;4337000000
AMD;191397;USD;2012;Q4;2012-12-31;2013-02-21;746000000;730000000;1002000000;630000000;562000000;2265000000;658000000;181000000;896000000;1735000000;4000000000;1284000000;5000000;1397000000;2037000000;2065000000;3462000000;6810000000;-109000000;-6160000000;538000000;4000000000
AMD;191397;USD;2011;Q4;2011-12-31;2012-02-24;735000000;720000000;1765000000;919000000;476000000;3229000000;726000000;427000000;572000000;1725000000;4954000000;1090000000;489000000;1774000000;1527000000;1590000000;3364000000;6679000000;-107000000;-4977000000;1590000000;4954000000
AMD;191397;USD;2010;Q4;2010-12-31;2011-02-18;715000000;756000000;1789000000;968000000;632000000;3594000000;700000000;;670000000;1370000000;4964000000;1279000000;233000000;1674000000;2188000000;2277000000;3951000000;6582000000;-102000000;-5468000000;1013000000;4964000000
AMD;191397;USD;2009;Q4;2009-12-31;2010-08-04;706000000;726000000;2676000000;745000000;567000000;4275000000;3809000000;;994000000;4803000000;9078000000;1442000000;479000000;2210000000;4252000000;5144000000;7354000000;6531000000;-98000000;-5939000000;1724000000;9078000000
AMD;191397;USD;2017;Q4;2017-12-31;2018-02-27;967000000;1230000000;1185000000;400000000;739000000;2622000000;261000000;58000000;599000000;918000000;3540000000;1337000000;70000000;1486000000;1325000000;1443000000;2929000000;8473000000;-108000000;-7760000000;611000000;3540000000
AMD;191397;USD;2018;Q4;2018-12-31;2019-02-08;1001000000;994000000;1156000000;1235000000;845000000;3540000000;348000000;58000000;610000000;1016000000;4556000000;1824000000;136000000;1984000000;1114000000;1306000000;3290000000;8760000000;-50000000;-7436000000;1266000000;4556000000
AE;191518;USD;2015;Q4;2015-09-30;2016-03-11;4217596;4217596;91877000;71813000;7671000;176537000;59715000;0;6963000;66678000;243215000;80002000;;80197000;;10508000;90705000;12115000;;140395000;152510000;243215000
AE;191518;USD;2014;Q4;2014-09-30;2015-03-13;4217596;4217596;80184000;144434000;13481000;250945000;84871000;;4998000;89869000;340814000;167002000;;168603000;0;14714000;183317000;12115000;;145382000;157497000;340814000
AE;191518;USD;2013;Q4;2013-09-30;2014-03-13;4217596;4217596;60733000;243930000;27616000;351730000;91865000;;4487000;96352000;448082000;271720000;;272169000;0;21228000;293397000;12115000;;142570000;154685000;448082000
AE;191518;USD;2012;Q4;2012-09-30;2013-03-15;;;47239000;228415000;28222000;324556000;90712000;;4233000;94945000;419501000;256215000;;266082000;0;17561000;283643000;12115000;;123743000;135858000;419501000
AE;191518;USD;2011;Q4;2011-09-30;2012-03-23;;;37066000;225393000;18464000;304965000;68857000;;5018000;73875000;378840000;249768000;;256094000;0;12064000;268158000;12115000;;98567000;110682000;378840000
AE;191518;USD;2010;Q4;2010-09-30;2011-08-12;;;29032000;190169000;14591000;246976000;47589000;;6740000;54329000;301305000;204666000;;206998000;0;4152000;211150000;12115000;;78040000;90155000;301305000
AE;191518;USD;2016;Q4;2016-09-30;2017-03-31;12644352;12644352;87342000;87162000;13070000;192518000;46325000;2500000;5529000;54354000;246872000;86010000;;86074000;;9486000;95560000;12115000;;139197000;151312000;246872000
AE;191518;USD;2017;Q4;2017-09-30;2018-03-12;12645968;12645968;109393000;121353000;12192000;245685000;29362000;425000;7232000;37019000;282704000;129115000;338000;129598000;1351000;5987000;135585000;12115000;;135004000;147119000;282704000
AE;191518;USD;2018;Q4;2018-09-30;2019-03-11;4218000;4217000;117066000;85622000;22779000;229590000;44623000;;4657000;49280000;278870000;116097000;883000;123267000;3209000;9005000;132272000;12370000;;134228000;146598000;278870000
ACET;191612;USD;2017;Q4;2017-06-30;2017-11-09;34816000;35538000;57726000;260889000;136387000;471555000;10428000;;556202000;566630000;1038185000;208339000;14466000;222805000;339200000;410313000;633118000;214499000;;195680000;405067000;1038185000
ACET;191612;USD;2016;Q4;2016-06-30;2016-08-26;29184000;29713000;67709000;163605000;98107000;350056000;10044000;;178073000;188117000;538173000;98709000;197000;98906000;118592000;137430000;236336000;115963000;;192199000;301837000;538173000
ACET;191612;USD;2015;Q4;2015-06-30;2015-09-11;28793000;29339000;37436000;161521000;95596000;310310000;10456000;;169008000;179464000;489774000;114803000;10197000;125000000;99960000;110563000;235563000;94099000;;167208000;254211000;489774000
ACET;191612;USD;2014;Q4;2014-06-30;2014-09-05;28287000;28789000;43643000;122694000;100683000;276354000;11573000;;180057000;191630000;467984000;110180000;8343000;118523000;97158000;115877000;234400000;87444000;;140768000;233584000;467984000
ACET;191612;USD;2013;Q4;2013-06-30;2013-08-29;27328000;27770000;35375000;90108000;83849000;218300000;11410000;;93720000;105130000;323430000;78193000;11714000;89907000;20355000;38883000;128790000;73123000;;118615000;194640000;323430000
ACET;191612;USD;2012;Q4;2012-06-30;2012-09-07;26673000;27006000;26380000;74744000;84687000;191969000;11705000;;95606000;107311000;299280000;66928000;6713000;73641000;39052000;57636000;131277000;64340000;;102344000;168003000;299280000
ACET;191612;USD;2011;Q4;2011-06-30;2011-11-04;26436000;26832000;29607000;83735000;77433000;198615000;12095000;;100955000;113050000;311665000;76633000;6247000;83186000;48750000;67658000;150844000;62595000;-230000;90713000;160821000;311665000
ACET;191612;USD;2018;Q4;2018-06-30;2018-09-28;35375000;35091000;103904000;247246000;137076000;502627000;14180000;;250217000;264397000;767024000;288036000;14482000;302518000;302916000;369221000;671739000;222907000;;-126737000;95285000;767024000
ARNC;195506;USD;2017;Q4;2017-12-31;2018-02-26;481000000;381000000;2150000000;1035000000;2480000000;6378000000;5594000000;0;6746000000;12340000000;18718000000;2362000000;38000000;2824000000;6806000000;10970000000;13794000000;8747000000;;-1248000000;4924000000;18718000000
ARNC;195506;USD;2016;Q4;2016-12-31;2016-11-09;145088236;111858726;1863000000;974000000;2253000000;5892000000;5499000000;1020000000;7627000000;14146000000;20038000000;2295000000;40000000;2749000000;8044000000;12151000000;14900000000;8652000000;;-1027000000;5138000000;20038000000
ARNC;195506;USD;2015;Q4;2015-12-31;2015-10-23;583344326;563336327;1362000000;960000000;2284000000;7953000000;5425000000;;23099000000;28524000000;36477000000;2090000000;41000000;5211000000;8786000000;17138000000;22349000000;11410000000;-2825000000;8834000000;14128000000;36477000000
ARNC;195506;USD;2014;Q4;2014-12-31;2014-10-23;532212773;544662195;1877000000;1395000000;3082000000;7848000000;16426000000;1944000000;11145000000;29515000000;37363000000;4089000000;83000000;5458000000;8769000000;17114000000;22572000000;10588000000;-3042000000;9379000000;14791000000;37363000000
ARNC;195506;USD;2013;Q4;2013-12-31;2013-10-18;476634998;428171179;1437000000;1221000000;2705000000;6969000000;17639000000;1907000000;9227000000;28773000000;35742000000;3973000000;712000000;6105000000;7607000000;16115000000;22220000000;8687000000;-3762000000;9272000000;13522000000;35742000000
ARNC;195506;USD;2012;Q4;2012-12-31;2012-10-25;474856510;447289933;1861000000;1399000000;2825000000;7700000000;18947000000;1860000000;11672000000;32479000000;40179000000;3760000000;518000000;5942000000;8311000000;17714000000;23656000000;8738000000;-3881000000;11689000000;16523000000;40179000000
ARNC;195506;USD;2011;Q4;2011-12-31;2011-10-20;473078021;516650996;1939000000;1571000000;2899000000;7713000000;19282000000;1626000000;11499000000;32407000000;40120000000;3677000000;731000000;6013000000;8640000000;16912000000;22925000000;8739000000;-3952000000;11629000000;17195000000;40120000000
ARNC;195506;USD;2010;Q4;2010-12-31;2010-10-22;454848511;421946468;1543000000;1591000000;2584000000;6919000000;20183000000;1340000000;10851000000;32374000000;39293000000;3263000000;323000000;5251000000;8842000000;16956000000;22207000000;8228000000;-4146000000;11149000000;17086000000;39293000000
ARNC;195506;USD;2009;Q4;2009-12-31;2009-10-23;;433062023;1481000000;1529000000;2328000000;7022000000;19828000000;1061000000;10561000000;31450000000;38472000000;2879000000;845000000;5414000000;8974000000;17538000000;22952000000;7705000000;-4268000000;11020000000;15520000000;38472000000
ARNC;195506;USD;2008;Q4;2008-12-31;2009-07-23;;;762000000;1883000000;3238000000;8150000000;17455000000;1915000000;10302000000;29672000000;37822000000;3384000000;2069000000;7279000000;8509000000;16211000000;23490000000;6775000000;-4326000000;12400000000;14332000000;37822000000
ARNC;195506;USD;2018;Q4;2018-12-31;2019-02-21;484000000;505000000;2277000000;1047000000;2492000000;6581000000;5704000000;;6408000000;12112000000;18693000000;2612000000;434000000;3520000000;5896000000;9588000000;13108000000;8802000000;;-358000000;5585000000;18693000000
AKRX;195622;USD;2016;Q4;2016-12-31;2017-03-01;124731000;125325000;201878000;283154000;174793000;685811000;238404000;;1049505000;1287909000;1973720000;170561000;;175555000;809979000;978981000;1154536000;521860000;;319291000;819184000;1973720000
AKRX;195622;USD;2015;Q4;2015-12-31;2016-05-10;354332932;377419190;352207000;150621000;185316000;708132000;179614000;129000;1154670000;1334413000;2042545000;173630000;52779000;231376000;994033000;1189604000;1420980000;458659000;;180048000;621565000;2042545000
AKRX;195622;USD;2014;Q4;2014-12-31;2015-03-17;317078379;321259379;77947000;187545000;135197000;476161000;144196000;211000;1273337000;1417744000;1893905000;129434000;10450000;150854000;1114481000;1386745000;1537599000;342252000;;29250000;356307000;1893906000
AKRX;195622;USD;2013;Q4;2013-12-31;2014-03-14;288605640;343814955;34178000;64998000;55982000;168856000;82108000;10006000;170835000;262949000;431805000;46517000;;61245000;108750000;128326000;189571000;239235000;;15366000;242234000;431805000
AKRX;195622;USD;2012;Q4;2012-12-31;2013-03-01;95521000;110970000;40781000;51017000;52495000;158707000;80679000;10299000;119880000;210858000;369565000;43291000;;62694000;104637000;123736000;186430000;226035000;;-36996000;183135000;369565000
AKRX;195622;USD;2011;Q4;2011-12-31;2012-03-15;94770000;102242000;83962000;25307000;35456000;155949000;44389000;10137000;96670000;151196000;307145000;28289000;;47171000;100808000;119712000;166883000;212636000;;-72374000;140262000;307145000
AKRX;195622;USD;2010;Q4;2010-12-31;2011-08-09;93884000;119680000;41623000;11270000;18917000;73613000;32731000;0;4772000;37503000;111116000;11763000;;24364000;0;19673000;44037000;182466000;;-115387000;67079000;111116000
AKRX;195622;USD;2017;Q4;2017-12-31;2018-02-28;125093000;124314000;368119000;141383000;183568000;730151000;313418000;;865942000;1179360000;1909511000;167188000;;171089000;815195000;907177000;1078266000;550472000;;294741000;831245000;1909511000
AKRX;195622;USD;2018;Q4;2018-12-31;2019-03-01;125498000;125498000;224868000;153126000;173645000;583819000;334853000;;576585000;911438000;1495257000;170823000;;170823000;820411000;880568000;1051391000;574553000;;-107168000;443866000;1495257000
JWA;195872;USD;2016;Q4;2016-04-30;2017-06-29;57148000;59070000;58516000;188679000;47852000;359735000;243058000;;2003424000;2246482000;2606217000;265389000;;787856000;365000000;815224000;1603080000;471078000;-676077000;1715423000;1003137000;2606217000
JWA;195872;USD;2015;Q4;2015-04-30;2016-06-29;57476000;58576000;363806000;167638000;57779000;670679000;214770000;;2035647000;2250417000;2921096000;279066000;;781807000;605007000;1102183000;1883990000;451888000;-640421000;1673325000;1037106000;2921096000
JWA;195872;USD;2014;Q4;2014-04-30;2015-06-26;58505000;59493000;457441000;147183000;63779000;740919000;193010000;;2070314000;2263324000;3004243000;269465000;100000000;803683000;650090000;1145520000;1949203000;436208000;-571974000;1597439000;1055040000;3004243000
JWA;195872;USD;2013;Q4;2013-04-30;2014-06-27;58828000;59793000;486377000;149733000;75495000;789662000;188718000;;2098985000;2287703000;3077365000;279032000;0;729587000;700100000;1165530000;1895117000;410778000;-527308000;1489069000;1182248000;3077365000
JWA;195872;USD;2012;Q4;2012-04-30;2013-06-26;58827000;59576000;334140000;161731000;82017000;634971000;189625000;;1981779000;2171404000;2806375000;249071000;;667169000;673000000;1150850000;1818019000;373952000;-494476000;1387512000;988356000;2806375000
JWA;195872;USD;2011;Q4;2011-04-30;2012-06-26;59557000;60987000;259830000;171561000;101237000;574600000;187979000;;1770367000;1958346000;2532946000;238233000;;640930000;475000000;874448000;1515378000;354999000;-437734000;1300713000;1017568000;2532946000
JWA;195872;USD;2010;Q4;2010-04-30;2011-06-24;120201123;122821095;201853000;168310000;106423000;527490000;165541000;;1737110000;1902651000;2430141000;253403000;123700000;756365000;330500000;695887000;1452252000;330236000;-360830000;1136224000;977889000;2430141000
JWA;195872;USD;2009;Q4;2009-04-30;2010-09-17;117526481;120298174;153513000;164827000;108073000;478122000;152684000;;1677804000;1830488000;2308610000;237546000;90000000;666780000;559000000;919394000;1586174000;294039000;-347056000;1003099000;722436000;2308610000
JWA;195872;USD;2017;Q4;2017-04-30;2018-06-29;57246000;58418000;169773000;212377000;39489000;479971000;289934000;;2069546000;2359480000;2839451000;293210000;;874311000;360000000;774583000;1648894000;490302000;-694222000;1834057000;1190557000;2839451000
JWA;195872;USD;2018;Q4;2018-04-30;2019-07-01;56801000;57750000;92890000;294867000;35582000;490780000;289021000;;2157201000;2446222000;2937002000;287297000;0;870562000;478790000;885093000;1755655000;505487000;-746476000;1931074000;1181347000;2937002000
PDCO;196179;USD;2017;Q4;2017-04-30;2018-06-27;91847000;92397000;62984000;826877000;779834000;1772724000;290590000;;1408350000;1698940000;3471664000;815783000;76598000;908381000;922030000;1101493000;2009874000;104724000;;1497766000;1461790000;3471664000
PDCO;196179;USD;2016;Q4;2016-04-30;2017-06-28;94100000;94915000;94959000;884803000;711903000;1803593000;298452000;;1405868000;1704320000;3507913000;830177000;14754000;903931000;998272000;1209549000;2113480000;73939000;;1481234000;1394433000;3507913000
PDCO;196179;USD;2015;Q4;2015-04-30;2016-06-29;95592000;96331000;137453000;796693000;722140000;1747541000;293315000;;1479948000;1773263000;3520804000;792835000;16500000;829335000;1022155000;1249723000;2079058000;49468000;;1529158000;1441746000;3520804000
PDCO;196179;USD;2014;Q4;2014-04-30;2015-06-24;98983000;99678000;400632000;586263000;408422000;1573225000;204133000;;1167890000;1372023000;2945248000;538369000;0;577685000;722542000;853440000;1431125000;22059000;;1630148000;1514123000;2945248000
PDCO;196179;USD;2013;Q4;2013-04-30;2014-06-25;99707000;100686000;305683000;607580000;436463000;1415717000;204939000;;1244021000;1448960000;2864677000;543463000;;543463000;725000000;849550000;1393013000;1040000;;1531198000;1471664000;2864677000
PDCO;196179;USD;2012;Q4;2012-04-30;2013-06-26;101249000;102134000;505228000;448158000;360563000;1361336000;192020000;;1128422000;1320442000;2681778000;448519000;;448519000;725000000;838804000;1287323000;1056000;;1463358000;1394455000;2681778000
PDCO;196179;USD;2011;Q4;2011-04-30;2012-06-27;105866000;106707000;573781000;464869000;319952000;1403513000;195465000;;1140390000;1335855000;2739368000;404648000;125000000;529648000;725000000;834518000;1364166000;1099000;;1456233000;1375202000;2739368000
PDCO;196179;USD;2010;Q4;2010-04-30;2011-06-29;117528000;118270000;388665000;465170000;336094000;1230709000;189583000;;1144676000;1334259000;2564968000;367431000;0;367431000;525000000;636997000;1004428000;1211000;;1632497000;1560540000;2564968000
PDCO;196179;USD;2009;Q4;2009-04-30;2010-09-09;118799000;119515000;340591000;452746000;288725000;1133758000;169598000;;1119613000;1289211000;2422969000;348351000;;348351000;525000000;633107000;981458000;42937000;;1493885000;1441511000;2422969000
PDCO;196179;USD;2018;Q4;2018-04-30;2019-06-26;92990000;94465000;95646000;582094000;761018000;1604363000;305790000;;1359116000;1664906000;3269269000;851737000;23975000;875712000;725341000;913050000;1788762000;132413000;;1483496000;1480507000;3269269000
BKE;196385;USD;2016;Q4;2017-02-28;2017-03-29;48179000;48335000;246530000;8210000;125694000;386457000;168995000;18092000;6303000;193390000;579847000;77417000;;98616000;;50692000;149308000;139884000;;290737000;430539000;579847000
BKE;196385;USD;2015;Q4;2016-02-29;2016-03-30;48095000;48207000;197650000;9651000;149566000;362897000;172781000;33826000;3269000;209876000;572773000;84768000;;107626000;;52504000;160130000;135348000;;277626000;412643000;572773000
BKE;196385;USD;2014;Q4;2015-02-28;2015-04-01;48040000;48166000;159565000;8567000;129921000;324589000;172663000;43698000;2043000;218404000;542993000;98279000;;122271000;;65444000;187715000;131596000;;224111000;355278000;542993000
BKE;196385;USD;2013;Q4;2014-02-28;2014-04-02;47866000;48026000;185065000;4318000;124141000;342137000;158569000;43436000;2151000;204156000;546293000;100250000;;123381000;;60982000;184363000;124617000;;238151000;361930000;546293000
BKE;196385;USD;2012;Q4;2013-02-28;2013-04-03;44191728;44446953;144022000;3470000;103853000;276873000;163103000;35735000;2263000;201101000;477974000;106735000;;128956000;;59369000;188325000;117872000;;172711000;289649000;477974000
BKE;196385;USD;2011;Q4;2012-02-29;2012-03-28;43649288;44095728;196509000;4584000;104209000;320127000;169034000;39985000;2393000;211412000;531539000;89545000;;109831000;;58561000;168392000;100807000;;263039000;363147000;531539000
BKE;196385;USD;2010;Q4;2011-02-28;2011-03-30;47565349;48267881;139362000;14363000;88593000;257036000;169234000;66162000;2412000;237808000;494844000;79160000;;96373000;;52806000;149179000;90190000;;256146000;345665000;494844000
BKE;196385;USD;2009;Q4;2010-02-28;2010-09-09;47024624;48035411;158027000;6911000;88187000;264809000;146582000;72770000;4742000;224094000;488903000;78523000;;92030000;;42614000;134644000;79301000;;275751000;354259000;488903000
BKE;196385;USD;2017;Q4;2018-02-28;2018-04-04;48346000;48499000;215919000;8588000;118007000;360584000;149546000;21453000;6533000;177532000;538116000;79704000;;97906000;;48962000;146868000;144767000;;246570000;391248000;538116000
BKE;196385;USD;2018;Q4;2019-02-28;2019-04-03;48515000;48703000;220017000;7089000;125190000;370432000;130682000;18745000;7443000;156870000;527302000;73584000;;90218000;;43207000;133425000;149054000;;244823000;393877000;527302000
AMSWA;196458;USD;2016;Q4;2016-04-30;2017-07-14;29522000;29836000;85333000;17060000;;109526000;2055000;4455000;32738000;39248000;148774000;8129000;;42737000;;2287000;45024000;124701000;-25559000;4608000;103750000;148774000
AMSWA;196458;USD;2015;Q4;2015-04-30;2016-07-14;28856000;29090000;69961000;17104000;;94095000;3396000;7924000;31309000;42629000;136724000;8516000;;39294000;;2536000;41830000;117556000;-25559000;2897000;94894000;136724000
AMSWA;196458;USD;2014;Q4;2014-04-30;2015-07-10;28390000;28710000;62239000;16018000;;85590000;3548000;13156000;31972000;48676000;134266000;6829000;;39250000;;2090000;41340000;114145000;-25378000;4159000;92926000;134266000
AMSWA;196458;USD;2013;Q4;2013-04-30;2014-07-14;28047000;28568000;70599000;15422000;;93347000;3681000;8975000;25217000;37873000;131220000;7736000;;34527000;;4133000;38660000;109470000;-24278000;7368000;92560000;131220000
AMSWA;196458;USD;2012;Q4;2012-04-30;2013-07-12;27276000;27708000;59766000;13179000;;79848000;4482000;6658000;22082000;33222000;113070000;4168000;;28760000;;1066000;29826000;102124000;-24278000;5398000;83244000;113070000
AMSWA;196458;USD;2011;Q4;2011-04-30;2012-07-12;26896000;27508000;59362000;15205000;;82392000;4912000;7508000;21741000;34161000;116553000;8644000;;32283000;;1240000;33523000;98525000;-23519000;8024000;83030000;116553000
AMSWA;196458;USD;2010;Q4;2010-04-30;2011-09-08;25951000;26511000;44567000;14409000;;66122000;5723000;10844000;22143000;38710000;104832000;7601000;;29401000;;1375000;30776000;91318000;-23519000;6257000;74056000;104832000
AMSWA;196458;USD;2017;Q4;2017-04-30;2018-07-13;30499000;30969000;78915000;18643000;;107525000;3034000;8893000;43513000;55440000;162965000;11651000;;46123000;;4258000;50381000;134777000;-25559000;3366000;112584000;162965000
AMSWA;196458;USD;2018;Q4;2018-04-30;2019-07-15;31139000;31509000;85998000;18819000;;112502000;3585000;2484000;42739000;48808000;161310000;8443000;;43101000;;3602000;46703000;141895000;-25559000;-1729000;114607000;161310000
TWMC;197548;USD;2017;Q4;2018-01-31;2018-05-04;90545;90453;31326000;4469000;109377000;153653000;13546000;;80972000;94518000;248171000;52818000;;61282000;;29131000;90413000;341746000;-230145000;47155000;157758000;248171000
TWMC;197548;USD;2016;Q4;2017-01-31;2017-04-13;90125;91293;27974000;7085000;126004000;169334000;45097000;;93379000;138476000;307810000;61505000;;70733000;;39141000;109874000;338718000;-230144000;90164000;197936000;307810000
TWMC;197548;USD;2015;Q4;2016-01-31;2016-04-14;77893;79045;104311000;4597000;120046000;230987000;30666000;;9952000;40618000;271605000;60862000;;69845000;;26492000;96337000;316624000;-227497000;86953000;175268000;271605000
TWMC;197548;USD;2014;Q4;2015-01-31;2015-04-16;;80103;118537000;3545000;126377000;255158000;15769000;;9082000;24851000;280009000;70924000;938000;81714000;;26555000;108269000;316069000;-226412000;84264000;171740000;280009000
TWMC;197548;USD;2013;Q4;2014-01-31;2014-04-17;;82860;131002000;2684000;150167000;290967000;11593000;;9031000;20624000;311591000;85498000;2004000;97594000;;23027000;120621000;315515000;-222948000;98522000;190970000;311591000
TWMC;197548;USD;2012;Q4;2013-01-31;2013-04-18;79203;82180;132982000;2631000;155429000;297776000;9057000;;8407000;17464000;315240000;97227000;2940000;110631000;;23849000;134480000;310018000;-217555000;91071000;180760000;315240000
TWMC;197548;USD;2011;Q4;2012-01-31;2012-04-12;79365;84525;88515000;6673000;191327000;288455000;16651000;;8014000;24665000;313120000;116377000;4444000;127101000;1068000;24173000;151274000;309357000;-217555000;72201000;161846000;313120000
TWMC;197548;USD;2010;Q4;2011-01-31;2011-09-09;;;75212000;5248000;234164000;317761000;21478000;;9485000;30963000;348724000;158032000;5126000;163158000;1748000;23768000;186926000;308898000;-217555000;70039000;161798000;348724000
TWMC;197548;USD;2018;Q4;2019-01-31;2019-05-14;;;4355000;5383000;94842000;115363000;7529000;;15121000;22650000;138013000;42461000;;49416000;;24867000;74283000;344858000;-230166000;-50227000;63730000;138013000
FCEL;197812;USD;2017;Q4;2017-10-31;2018-01-11;5169392;5169392;49294000;68521000;74496000;203510000;43565000;;136711000;180276000;383786000;60997000;28281000;98078000;14221000;96895000;194973000;1045204000;-280000;-943533000;188813000;383786000
FCEL;197812;USD;2016;Q4;2016-10-31;2016-09-08;2753132;2753132;84187000;24593000;73806000;202204000;36640000;;101885000;138525000;340729000;39375000;5010000;51998000;12649000;114478000;166476000;1004570000;-179000;-889630000;174253000;340729000
FCEL;197812;USD;2015;Q4;2015-10-31;2015-09-09;2092487;2092487;58852000;60790000;65754000;203898000;29002000;;44331000;73333000;277231000;34920000;7358000;74888000;12088000;47732000;122620000;934491000;-78000;-838673000;154611000;277231000
FCEL;197812;USD;2014;Q4;2014-10-31;2014-09-09;1950074;1950074;83710000;64375000;55895000;217031000;25825000;;37780000;63605000;280636000;35035000;1439000;75061000;13197000;47269000;122330000;909460000;-95000;-809314000;158306000;280636000
FCEL;197812;USD;2013;Q4;2013-10-31;2013-09-06;1223757;1223757;67696000;49116000;56185000;189329000;24225000;;24082000;48307000;237636000;46447000;6931000;106263000;13270000;84708000;190971000;758676000;53000;-771189000;46665000;237636000
FCEL;197812;USD;2012;Q4;2012-10-31;2012-09-07;1293475;967560;46879000;25984000;47701000;140626000;23258000;6115000;21486000;50859000;191485000;32519000;5161000;84897000;13095000;32603000;117500000;751274000;53000;-736831000;73985000;191485000
FCEL;197812;USD;2011;Q4;2011-10-31;2011-09-09;909500;909500;63431000;21950000;40101000;132948000;23925000;10466000;16291000;50682000;183630000;41037000;5056000;114165000;12878000;23983000;138148000;687870000;-53000;-701336000;45482000;183630000
FCEL;197812;USD;2010;Q4;2010-10-31;2011-09-09;;;45486000;18066000;33404000;102209000;26679000;18908000;2733000;48320000;150529000;26988000;976000;54038000;0;12098000;66136000;663962000;-53000;-655623000;84393000;150529000
FCEL;197812;USD;2018;Q4;2018-10-31;2019-01-10;7757855;7757855;39291000;23039000;53575000;130303000;48204000;;161914000;210118000;340421000;30226000;17596000;60121000;14965000;103377000;163498000;1073464000;-363000;-990867000;176923000;340421000
MRVL;198029;USD;2016;Q4;2017-01-31;2017-03-28;507833000;524853000;1668360000;335384000;170842000;2290434000;243397000;;2114819000;2358216000;4648650000;426622000;;496416000;;124583000;620999000;3017787000;;1009841000;4027651000;4648650000
MRVL;198029;USD;2015;Q4;2016-01-31;2016-07-21;506353000;495414000;2282749000;323300000;200958000;2954662000;296778000;11296000;2179391000;2487465000;5442127000;434063000;;1225785000;;76219000;1302004000;3029936000;;1110982000;4140123000;5442127000
MRVL;198029;USD;2014;Q4;2015-01-31;2015-03-26;513571000;522113000;2529555000;420955000;308162000;3344040000;340639000;10226000;2189482000;2540347000;5884387000;569256000;;637376000;;100922000;738298000;3100578000;;2045203000;5146089000;5884387000
MRVL;198029;USD;2013;Q4;2014-01-31;2014-03-27;497620000;510451000;1969405000;453496000;347861000;2839220000;356165000;16279000;2239346000;2611790000;5451010000;589559000;;651306000;;123794000;775100000;2942655000;;1732658000;4675910000;5451010000
MRVL;198029;USD;2012;Q4;2013-01-31;2013-03-29;525805000;528080000;1918990000;330238000;250420000;2585346000;372971000;16769000;2286678000;2676418000;5261764000;547738000;;607888000;;169281000;777169000;2946660000;;1536787000;4484595000;5261764000
MRVL;198029;USD;2011;Q4;2012-01-31;2012-03-27;583467000;599301000;2246498000;407263000;354119000;3078961000;383801000;23215000;2281642000;2688658000;5767619000;529595000;;589554000;;164047000;753601000;3684279000;;1328963000;5014018000;5767619000
MRVL;198029;USD;2010;Q4;2011-01-31;2011-03-28;654652000;679444000;2930030000;459406000;245448000;3712647000;358440000;26226000;2240844000;2625510000;6338157000;564525000;;640686000;;175602000;816288000;4806905000;;713872000;5521869000;6338157000
MRVL;198029;USD;2009;Q4;2010-01-31;2010-03-31;632565000;688438000;1796717000;356796000;241541000;2465545000;342497000;34281000;2328617000;2705395000;5170940000;490551000;1940000;551887000;511000;201074000;752961000;4609121000;;-190257000;4417979000;5170940000
MRVL;198029;USD;2008;Q4;2009-01-31;2009-09-10;614960000;628321000;927409000;222101000;310654000;1560315000;390853000;40541000;2422491000;2853885000;4414200000;349966000;1787000;409648000;2451000;175485000;585133000;4373498000;;-543713000;3829067000;4414200000
MRVL;198029;USD;2017;Q4;2018-01-31;2018-03-29;493329000;505864000;1841272000;280395000;170039000;2363955000;202222000;;2142110000;2344332000;4708287000;359905000;;421142000;0;145732000;566874000;2734283000;;1409452000;4141413000;4708287000
MRVL;198029;USD;2018;Q4;2019-01-31;2019-03-28;657836000;636544000;582410000;493122000;276005000;1395258000;318978000;;8302516000;8621494000;10016752000;636796000;;636796000;1732699000;2073546000;2710342000;6189915000;;1116495000;7306410000;10016752000
GMAN;198131;USD;2016;Q4;2017-01-31;2015-12-10;19439722;19279632;6969000;7701000;106566000;137155000;86375000;;5642000;92017000;229172000;96544000;18390000;114934000;27345000;79344000;194278000;54621000;;-19727000;34894000;229172000
GMAN;198131;USD;2015;Q4;2016-01-31;2014-12-10;19366851;19366851;7634000;5489000;94470000;127548000;91601000;;7728000;99329000;226877000;95702000;12463000;108165000;28827000;80225000;188390000;53890000;;-15403000;38487000;226877000
GMAN;198131;USD;2014;Q4;2015-01-31;2013-12-03;19347708;19214451;5759000;7471000;94711000;122926000;76393000;;7668000;84061000;206987000;71309000;7813000;79122000;44437000;86060000;165182000;53814000;;-12009000;41805000;206987000
GMAN;198131;USD;2013;Q4;2014-01-31;2012-11-29;19241401;19288052;40824000;10836000;78006000;140135000;45966000;;5025000;50991000;191126000;57000000;189000;57189000;0;31549000;88738000;52480000;;49908000;102388000;191126000
GMAN;198131;USD;2012;Q4;2013-01-31;2011-12-01;19080468;19495436;35413000;11726000;65335000;123482000;34507000;;4624000;39131000;162613000;62498000;655000;63153000;189000;21737000;84890000;51346000;;26377000;77723000;162613000
GMAN;198131;USD;2011;Q4;2012-01-31;2011-08-31;18659465;18935666;29368000;3634000;59775000;101963000;18240000;;4931000;23171000;125134000;63505000;1932000;65437000;956000;7644000;73081000;50849000;;1204000;52053000;125134000
MIND;198210;USD;2017;Q4;2018-01-31;2018-04-13;12089000;12089000;9902000;;10856000;33046000;22900000;;17733000;40633000;73679000;6782000;;7523000;;307000;7830000;122444000;-16860000;-42425000;65849000;73679000
MIND;198210;USD;2016;Q4;2017-01-31;2017-04-07;12076000;12076000;2902000;;11960000;35059000;43838000;;15817000;59655000;94714000;6443000;6371000;13465000;;317000;13782000;121541000;-16858000;-20451000;80932000;94714000
MIND;198210;USD;2015;Q4;2016-01-31;2016-04-07;12058000;12058000;3769000;;12944000;42884000;73516000;;18359000;91875000;134759000;8912000;3218000;12456000;17266000;17266000;29722000;120804000;-16854000;13188000;105037000;134759000
MIND;198210;USD;2014;Q4;2015-01-31;2015-04-08;12020000;11667000;5175000;;11451000;54149000;100087000;;25375000;125462000;179611000;6072000;3218000;10000000;23137000;23137000;33137000;119927000;-16851000;51924000;146474000;179611000
MIND;198210;USD;2013;Q4;2014-01-31;2014-04-03;12754000;13979000;15162000;;8338000;62160000;129573000;;13686000;143259000;205419000;12328000;75000;12438000;22125000;22533000;34971000;118295000;-7075000;61116000;170448000;205419000
MIND;198210;USD;2012;Q4;2013-01-31;2013-04-04;12798000;13609000;15150000;;6188000;57878000;119608000;;12921000;132529000;190407000;8796000;145000;9480000;4238000;4614000;14094000;116644000;-4860000;56348000;176313000;190407000
MIND;198210;USD;2011;Q4;2012-01-31;2012-04-04;12454000;13209000;15287000;;6708000;65278000;120377000;;12574000;132951000;198229000;22039000;1399000;23981000;12784000;18814000;42795000;113790000;-4857000;39297000;155434000;198229000
MIND;198210;USD;2010;Q4;2011-01-31;2011-09-08;9918000;10358000;14647000;;4813000;44754000;79095000;;14122000;93217000;137971000;11644000;3177000;15599000;23343000;27657000;43256000;77528000;-4843000;14976000;94715000;137971000
MIND;198210;USD;2018;Q4;2019-01-31;2019-04-05;12121000;12121000;9389000;;10774000;36342000;14155000;;14804000;28959000;65301000;5496000;;7428000;;1195000;8623000;123225000;-16860000;-63973000;56678000;65301000
VNCE;198318;USD;2017;Q4;2018-01-31;2018-04-25;11924621;11934602;5372000;20760000;48921000;81574000;31608000;;121352000;152960000;234534000;37177000;8000000;45177000;40682000;114588000;159765000;1113458000;;-1038624000;74769000;234534000
VNCE;198318;USD;2016;Q4;2017-01-31;2017-04-28;4942316;4923070;20978000;10336000;38529000;74611000;42945000;;121924000;164869000;239480000;50441000;;50441000;48298000;203020000;253461000;1083221000;;-1097137000;-13981000;239480000
VNCE;198318;USD;2015;Q4;2016-01-31;2016-04-14;3677841;3855357;6230000;9400000;36576000;60233000;37769000;;265566000;303335000;363568000;71648000;;71648000;57615000;213418000;285066000;1013045000;;-934478000;78502000;363568000
VNCE;198318;USD;2014;Q4;2015-01-31;2015-03-27;3674294;3834201;112000;33797000;37419000;81140000;28349000;;269159000;297508000;378648000;64490000;;64490000;84450000;242189000;306679000;1011611000;;-939577000;71969000;378648000
VNCE;198318;USD;2013;Q4;2014-01-31;2014-04-04;3382831;3385178;21484000;40198000;33956000;103731000;13615000;;296996000;310611000;414342000;38333000;;38333000;170000000;342458000;380791000;1008916000;;-975300000;33551000;414342000
VNCE;198318;USD;2012;Q4;2013-01-31;2014-01-03;2621113;2621113;317000;33933000;18887000;199792000;6988000;;235344000;242332000;442124000;30905000;;190046000;391434000;813343000;1003389000;386681000;;-947880000;-561265000;442124000
VNCE;198318;USD;2018;Q4;2019-01-31;2019-04-12;11622136;11395542;118000;28896000;53271000;88602000;25156000;;121173000;146329000;234931000;42832000;2750000;45582000;42340000;115249000;160831000;1114811000;;-1040646000;74100000;234931000
WSM;198669;USD;2017;Q4;2018-01-31;2018-03-29;84037000;84378000;390136000;90119000;1061593000;1636445000;932283000;;217021000;1149304000;2785749000;648134000;;1007823000;299422000;574360000;1582183000;563651000;-725000;647422000;1203566000;2785749000
WSM;198669;USD;2016;Q4;2017-01-31;2017-03-30;87657000;88454000;213713000;88803000;977505000;1367180000;923283000;;186416000;1109699000;2476879000;607142000;;961256000;;267403000;1228659000;557801000;-1380000;701702000;1248220000;2476879000
WSM;198669;USD;2015;Q4;2016-01-31;2016-03-31;89761000;90743000;193647000;79304000;978138000;1336100000;886813000;;194514000;1081327000;2417427000;641586000;;996427000;;222774000;1219201000;542203000;-1906000;668545000;1198226000;2417427000
WSM;198669;USD;2014;Q4;2015-01-31;2015-04-02;93497000;94423000;222927000;67465000;887701000;1391923000;883012000;;55342000;938354000;2330277000;565537000;1968000;875948000;;229623000;1105571000;528180000;-2140000;701214000;1224706000;2330277000
WSM;198669;USD;2013;Q4;2014-01-31;2014-04-03;96627000;98725000;330121000;60330000;813160000;1419103000;849293000;;68338000;917631000;2336734000;592337000;1785000;861096000;1968000;219636000;1080732000;523536000;-3101000;729043000;1256002000;2336734000
WSM;198669;USD;2012;Q4;2013-01-31;2013-04-04;99239000;101012000;424555000;62985000;640024000;1316772000;812037000;;58870000;870907000;2187679000;421643000;1724000;657127000;3753000;221414000;878541000;504593000;0;790912000;1309138000;2187679000
WSM;198669;USD;2011;Q4;2012-01-31;2012-03-29;104372000;106658000;502757000;45961000;553461000;1276366000;734672000;;49800000;784472000;2060838000;352538000;1795000;571799000;5478000;233777000;805576000;479725000;;762947000;1255262000;2060838000
WSM;198669;USD;2010;Q4;2011-01-31;2011-03-31;106875000;109317000;628403000;41565000;513381000;1347594000;730556000;;53612000;784168000;2131762000;392400000;1542000;611716000;7130000;261183000;872899000;467934000;;777939000;1258863000;2131762000
WSM;198669;USD;2009;Q4;2010-01-31;2010-09-10;105934000;112374000;513943000;44187000;466124000;1180193000;829027000;;69949000;898976000;2079169000;344211000;1587000;563482000;8672000;304092000;867574000;449918000;;751290000;1211595000;2079169000
WSM;198669;USD;2018;Q4;2019-01-31;2019-04-04;79471000;80378000;338954000;107102000;1124992000;1694343000;929635000;;188866000;1118501000;2812844000;711722000;;1074812000;299620000;582318000;1657130000;582689000;-235000;584333000;1155714000;2812844000
NSSC;198892;USD;2016;Q4;2016-06-30;2016-09-08;18789000;18805000;3805000;19012000;21428000;45884000;6049000;;12836000;18885000;64769000;8696000;300000;8996000;4500000;4500000;13496000;16833000;-11732000;46172000;51273000;64769000
NSSC;198892;USD;2015;Q4;2015-06-30;2015-09-10;18990000;19002000;2346000;17994000;22757000;45023000;6234000;;13780000;20014000;65037000;7833000;1600000;9433000;9100000;9100000;18533000;16343000;-10238000;40399000;46504000;65037000
NSSC;198892;USD;2014;Q4;2014-06-30;2014-09-15;19421000;19456000;2483000;16904000;21443000;42679000;6394000;;14291000;20685000;63364000;7643000;1600000;9243000;10200000;10369000;19612000;16242000;-8044000;35554000;43752000;63364000
NSSC;198892;USD;2013;Q4;2013-06-30;2013-09-17;19293000;19436000;3229000;18211000;18471000;41836000;6586000;;15481000;22067000;63903000;7015000;1600000;8615000;14800000;14953000;23568000;15564000;-7307000;32078000;40335000;63903000
NSSC;198892;USD;2012;Q4;2012-06-30;2012-09-21;19096000;19451000;2979000;16408000;19448000;40449000;7247000;;17054000;24301000;64750000;6644000;1600000;8244000;18657000;18783000;27027000;14281000;-5615000;29057000;37723000;64750000
NSSC;198892;USD;2011;Q4;2011-06-30;2011-11-09;19096000;19319000;3077000;17640000;19986000;42181000;7741000;;18873000;26614000;68795000;9424000;3572000;12996000;20205000;20370000;33366000;14273000;-5615000;26771000;35429000;68795000
NSSC;198892;USD;2017;Q4;2017-06-30;2017-09-13;18832000;18872000;3454000;20275000;26212000;51915000;6543000;;12404000;18947000;70862000;10473000;;10473000;3500000;3500000;13973000;16850000;-11732000;51771000;56889000;70862000
NSSC;198892;USD;2018;Q4;2018-06-30;2018-09-13;18720000;18766000;5308000;22738000;24533000;54267000;6791000;;12211000;19002000;73269000;9402000;;9402000;0;414000;9816000;17102000;-13069000;59420000;63453000;73269000
FNSR;198959;USD;2017;Q4;2017-04-30;2018-06-15;114743000;110106000;1197095000;233529000;348527000;1835152000;520849000;;227184000;748033000;2583185000;164686000;251278000;458323000;488877000;501245000;959568000;2850310000;;-1212033000;1623617000;2583185000
FNSR;198959;USD;2016;Q4;2016-04-30;2016-06-17;111437000;117502000;1236823000;272377000;331388000;1908857000;383919000;;247106000;631025000;2539882000;195088000;0;251801000;707782000;725376000;977177000;2784316000;;-1163747000;1562705000;2539882000
FNSR;198959;USD;2015;Q4;2015-04-30;2015-06-19;107611000;111752000;562476000;249257000;273291000;1148083000;348613000;;148675000;497288000;1645371000;177675000;;233410000;229393000;244275000;477685000;2605967000;;-1413093000;1167686000;1645371000
FNSR;198959;USD;2014;Q4;2014-04-30;2014-09-04;118688000;110698000;513023000;225020000;259759000;1064573000;273328000;;159645000;432973000;1497546000;157980000;40015000;246430000;212253000;235057000;481487000;2456207000;;-1460173000;1016059000;1497546000
FNSR;198959;USD;2013;Q4;2013-04-30;2014-06-26;;;513023000;225020000;259759000;1064573000;273328000;;159645000;432973000;1497546000;157980000;40015000;246430000;212253000;235057000;481487000;2456207000;;-1460173000;1016059000;1497546000
FNSR;198959;USD;2012;Q4;2012-04-30;2013-06-24;;;289076000;149612000;200670000;674298000;201442000;;132107000;333549000;1007847000;109122000;0;141837000;40015000;53495000;195332000;2350240000;;-1571960000;812515000;1007847000
FNSR;198959;USD;2011;Q4;2011-04-30;2012-06-29;91355000;95586000;234544000;167760000;218432000;666988000;163817000;;138622000;302439000;969427000;99429000;3150000;132420000;40015000;57162000;189582000;2309310000;;-1566506000;779845000;969427000
FNSR;198959;USD;2010;Q4;2010-04-30;2011-09-09;89371000;99736000;314765000;168386000;187617000;693407000;125693000;31142000;34907000;191742000;885149000;100813000;0;133989000;40015000;52003000;185992000;2275690000;;-1609499000;699157000;885149000
FNSR;198959;USD;2018;Q4;2018-04-30;2019-06-14;117953000;117953000;914185000;263394000;299028000;1520831000;622979000;;208357000;831336000;2352167000;213739000;;213739000;512105000;524267000;738006000;2919423000;;-1256694000;1614161000;2352167000
FIZZ;199147;USD;2016;Q4;2016-04-30;2017-07-13;46574000;46789000;136372000;71319000;53355000;268321000;65150000;;20512000;85662000;353983000;87206000;;87206000;;21159000;108365000;36144000;-18000000;227928000;245618000;353983000
FIZZ;199147;USD;2015;Q4;2015-04-30;2015-07-16;46547000;46739000;105577000;61046000;47922000;223671000;61932000;;19895000;81827000;305498000;75614000;;75614000;;23732000;99346000;35076000;-18000000;190733000;206152000;305498000
FIZZ;199147;USD;2014;Q4;2014-04-30;2014-07-17;46377000;46585000;52456000;59951000;42924000;167729000;60182000;;19839000;80021000;247750000;66251000;;66251000;10000000;33717000;99968000;38263000;-17880000;129773000;147782000;247750000
FIZZ;199147;USD;2013;Q4;2013-04-30;2013-09-05;46412000;46641000;18267000;64069000;39234000;130941000;57307000;;20394000;77701000;208642000;63437000;;63437000;50000000;74889000;138326000;50902000;-17600000;37828000;70316000;208642000
FIZZ;199147;USD;2012;Q4;2012-04-30;2013-07-11;;;18267000;64069000;39234000;130941000;57307000;;20394000;77701000;208642000;63437000;;63437000;50000000;74889000;138326000;50902000;-17600000;37828000;70316000;208642000
FIZZ;199147;USD;2011;Q4;2011-04-30;2012-07-12;;;35626000;61591000;40862000;146054000;56729000;;20205000;76934000;222988000;76236000;;76236000;;25116000;101352000;30928000;-18000000;109200000;121636000;222988000
FIZZ;199147;USD;2010;Q4;2010-04-30;2011-09-08;46229000;46389000;7372000;55912000;33353000;106533000;55337000;;20940000;76277000;182810000;75603000;;75603000;;26871000;102474000;30228000;-18000000;65207000;80336000;182810000
FIZZ;199147;USD;2017;Q4;2017-04-30;2018-06-27;46611000;46920000;189864000;84360000;60920000;352967000;85807000;;20058000;105865000;458832000;104670000;;104670000;;22722000;127392000;36865000;-18000000;307824000;331440000;458832000
PANW;199345;USD;2016;Q4;2016-07-31;2016-09-08;88900000;88900000;1285600000;348700000;;1774000000;117200000;652800000;314200000;1084200000;2858200000;142900000;;846800000;500200000;1116500000;1963300000;1515500000;;-621600000;894900000;2858200000
PANW;199345;USD;2015;Q4;2015-07-31;2015-09-17;83900000;83900000;789000000;212400000;;1074000000;62900000;538800000;289500000;891200000;1965200000;121200000;487100000;1032200000;0;445100000;1477300000;988700000;;-500700000;487900000;1965200000
PANW;199345;USD;2014;Q4;2014-07-31;2014-09-18;77698000;77698000;772502000;135518000;;958326000;48744000;201880000;269516000;520140000;1478466000;88253000;0;348171000;466875000;661712000;1009883000;804414000;;-335726000;468583000;1478466000
PANW;199345;USD;2013;Q4;2013-07-31;2013-09-25;70689000;70689000;419621000;87461000;;529699000;32086000;17314000;6507000;55907000;585606000;52157000;;206102000;0;107084000;313186000;381710000;;-109274000;272420000;585606000
PANW;199345;USD;2012;Q4;2012-07-31;2012-12-10;25910000;19481000;322642000;45642000;;381657000;20979000;0;5168000;26147000;407804000;35710000;;122006000;;56727000;178733000;309099000;;-80028000;229071000;407804000
PANW;199345;USD;2017;Q4;2017-07-31;2017-09-07;90900000;90900000;1375000000;432100000;;1976300000;211100000;789300000;461600000;1462000000;3438300000;232900000;;1201300000;524700000;1477400000;2678700000;1599700000;;-836700000;759600000;3438300000
PANW;199345;USD;2018;Q4;2018-07-31;2018-09-13;92900000;92900000;3403400000;467300000;;4132000000;273100000;547500000;870400000;1691000000;5823000000;320100000;550400000;2139400000;1369700000;2717200000;4856600000;1967400000;;-984600000;966400000;5823000000
PANW;199345;USD;2019;Q4;2019-07-31;2019-09-09;95800000;95800000;2803100000;582400000;;3664800000;296000000;575400000;2056000000;2927400000;6592200000;471200000;0;2053300000;1430000000;2952600000;5005900000;2490900000;;-900900000;1586300000;6592200000
VEEV;199530;USD;2016;Q4;2017-01-31;2017-03-30;138046000;150013000;518872000;182816000;;711865000;49907000;;155604000;205511000;917376000;33222000;;246784000;;17938000;264722000;439658000;;212884000;652653000;917375000
VEEV;199530;USD;2015;Q4;2016-01-31;2016-03-31;132705000;145240000;346203000;144798000;;500964000;47469000;;157366000;204835000;705799000;28860000;;186279000;;14271000;200550000;361691000;;143385000;505248000;705798000
VEEV;199530;USD;2014;Q4;2015-01-31;2015-04-01;130424000;146325000;397873000;92661000;;497022000;28203000;;19665000;47868000;544890000;22563000;;135523000;;2534000;138057000;317881000;;88925000;406832000;544889000
VEEV;199530;USD;2013;Q4;2014-01-31;2014-03-18;125070000;70107000;288132000;58433000;;351657000;2445000;;16206000;18651000;370308000;19237000;;86617000;;3595000;90212000;231534000;;48542000;280095000;370307000
VEEV;199530;USD;2012;Q4;2013-01-31;2013-12-13;24046000;34916000;46166000;37094000;;85721000;1379000;;2720000;4099000;89820000;15504000;;54289000;;1565000;55854000;2101000;;24927000;33966000;89820000
VEEV;199530;USD;2017;Q4;2018-01-31;2018-03-30;143281000;155634000;761962000;224668000;;1012421000;52284000;;165628000;217912000;1230333000;39230000;;306169000;;17926000;324095000;515272000;;389365000;906237000;1230332000
VEEV;199530;USD;2018;Q4;2019-01-31;2019-03-28;145714000;158092000;1090161000;303465000;;1433414000;54966000;;165386000;220352000;1653766000;44665000;;401022000;;14995000;416017000;617623000;;619197000;1237748000;1653765000
ABM;199984;USD;2015;Q4;2015-10-31;2015-12-17;56800000;57300000;55500000;742900000;;894000000;74000000;35700000;1127000000;1236700000;2130700000;478200000;;568200000;158000000;555000000;1123200000;276100000;;736500000;1007500000;2130700000
ABM;199984;USD;2014;Q4;2014-10-31;2014-12-17;56400000;57300000;36700000;687300000;;927200000;83000000;32900000;1149800000;1265700000;2192900000;427300000;;526400000;319800000;697700000;1224100000;274700000;;696900000;968800000;2192900000
ABM;199984;USD;2013;Q4;2013-10-31;2013-12-18;55375000;56803000;32600000;690800000;;864600000;77200000;32300000;1145100000;1254600000;2119200000;423900000;;508500000;314900000;693200000;1201700000;262400000;;656800000;917500000;2119200000
ABM;199984;USD;2012;Q4;2012-10-31;2012-12-20;54412000;55144000;43459000;561317000;;749334000;59909000;32643000;1009272000;1101824000;1851158000;375625000;;455817000;215000000;544943000;1000760000;235180000;;617372000;850398000;1851158000
ABM;199984;USD;2011;Q4;2011-10-31;2011-12-23;53332000;54159000;26467000;552098000;;733757000;60009000;30093000;1055739000;1145841000;1879598000;364368000;;443196000;300000000;640516000;1083712000;211922000;;586625000;795886000;1879598000
ABM;199984;USD;2010;Q4;2010-10-31;2010-12-23;52491000;53369000;39446000;450513000;;608756000;58088000;20171000;861655000;939914000;1548670000;256750000;;333851000;140500000;475794000;809645000;192944000;;547944000;739025000;1548670000
ABM;199984;USD;2009;Q4;2009-10-31;2010-09-03;51610000;52421000;34153000;445241000;;620997000;56892000;19531000;823733000;900156000;1521153000;263485000;;342694000;172500000;491409000;834103000;176997000;;512476000;687050000;1521153000
ABM;199984;USD;2017;Q4;2017-10-31;2017-12-22;62700000;63500000;62800000;1038100000;;1235500000;143100000;17600000;2416400000;2577100000;3812600000;628400000;16900000;757800000;1161300000;1679100000;2436900000;675900000;;720100000;1375700000;3812600000
ABM;199984;USD;2016;Q4;2016-10-31;2016-12-21;56000000;56800000;53500000;803700000;;991300000;81800000;17400000;1188300000;1287500000;2278800000;487800000;0;596800000;268300000;708000000;1304800000;249200000;;756400000;974000000;2278800000
ABM;199984;USD;2018;Q4;2018-10-31;2018-12-21;66400000;66800000;39100000;1014100000;;1171000000;140100000;16300000;2300100000;2456500000;3627500000;605900000;37000000;792400000;902000000;1380400000;2172800000;692500000;;771200000;1454700000;3627500000
ROST;200092;USD;2017;Q4;2018-02-28;2018-04-03;375820000;379883000;1290806000;87868000;1641735000;3151157000;2382464000;712000;187718000;2570894000;5722051000;1841429000;84973000;1926402000;311994000;746341000;2672743000;1296160000;-318279000;2071400000;3049308000;5722051000
ROST;200092;USD;2016;Q4;2017-02-28;2017-03-28;388259000;391718000;1111599000;75154000;1512886000;2813049000;2328048000;1288000;166966000;2496302000;5309351000;1752506000;0;1752506000;396493000;808828000;2561334000;1219634000;-272846000;1801138000;2748017000;5309351000
ROST;200092;USD;2015;Q4;2016-02-29;2016-03-29;398229000;402037000;763339000;73627000;1419104000;2372195000;2342906000;1331000;152687000;2496924000;4869119000;1602847000;;1602847000;396025000;794281000;2397128000;1126352000;-229525000;1574982000;2471991000;4869119000
ROST;200092;USD;2014;Q4;2015-02-28;2015-03-31;409452000;414044000;697108000;73278000;1372675000;2249839000;2273752000;3110000;160669000;2437531000;4687370000;1659368000;;1659368000;395562000;748792000;2408160000;1017756000;-160600000;1421724000;2279210000;4687370000
ROST;200092;USD;2013;Q4;2014-02-28;2014-04-01;420584000;426616000;435174000;62612000;1257155000;1867159000;1875299000;3710000;150629000;2029638000;3896797000;1393057000;;1393057000;150000000;496438000;1889495000;937725000;-121559000;1190747000;2007302000;3896797000
ROST;200092;USD;2012;Q4;2013-02-28;2013-04-02;433536000;440834000;647848000;59617000;1209237000;2031427000;1493284000;4374000;141476000;1639134000;3670561000;1422582000;;1422582000;150000000;481116000;1903698000;868726000;-91708000;989260000;1766863000;3670561000
ROST;200092;USD;2011;Q4;2012-02-29;2012-03-27;444574000;453490000;650493000;50848000;1130070000;1924371000;1241722000;5602000;129514000;1376838000;3301209000;1346052000;;1346052000;150000000;462145000;1808197000;791164000;-62262000;763475000;1493012000;3301209000
ROST;200092;USD;2010;Q4;2011-02-28;2011-03-29;463196000;470792000;837128000;45384000;1086917000;2043239000;983776000;14082000;75107000;1072965000;3116204000;1352320000;;1352320000;150000000;431192000;1783512000;741907000;-46408000;636705000;1332692000;3116204000
ROST;200092;USD;2009;Q4;2010-02-28;2010-06-09;484048000;492744000;770097000;44234000;872498000;1745447000;942999000;16848000;63339000;1023186000;2768633000;1187620000;;1190514000;150000000;420826000;1611340000;683137000;-36864000;510850000;1157293000;2768633000
ROST;200092;USD;2018;Q4;2019-02-28;2019-04-02;365202000;368872000;1412912000;96711000;1750442000;3404019000;2475201000;125000;194346000;2669672000;6073691000;2009484000;0;2009484000;312440000;758461000;2767945000;1379647000;-372663000;2298762000;3305746000;6073691000
EV;200412;USD;2018;Q4;2018-10-31;2018-12-28;113463000;121267000;817294000;;;817294000;52428000;1315363000;1414243000;2782034000;3599328000;91410000;;91410000;619678000;2064390000;2155800000;17971000;;1150698000;1443528000;3599328000
EV;200412;USD;2017;Q4;2017-10-31;2017-12-20;111246000;117988000;610555000;;;610555000;48989000;1098645000;572712000;1720346000;2330901000;68115000;;68115000;631441000;999703000;1067818000;148747000;;921235000;1263083000;2330901000
EV;200412;USD;2016;Q4;2016-10-31;2016-12-21;108023000;113848000;424174000;;;424174000;44427000;775945000;485836000;1306208000;1730382000;59927000;;59927000;571773000;856852000;916779000;446000;;773000000;813603000;1730382000
EV;200412;USD;2015;Q4;2015-10-31;2015-12-18;110859000;114919000;628262000;;;628262000;44943000;694773000;748493000;1488209000;2116471000;65249000;;65249000;573811000;1340353000;1405602000;453000;;679507000;710869000;2116471000
EV;200412;USD;2014;Q4;2014-10-31;2014-12-19;113061000;117866000;394178000;;;394178000;45651000;810949000;609308000;1465908000;1860086000;64598000;;64598000;573655000;1030541000;1095139000;462000;;681528000;764947000;1860086000
EV;200412;USD;2013;Q4;2013-10-31;2013-12-20;116767000;123462000;498547000;;;498547000;48746000;706543000;1153413000;1908702000;2407249000;58529000;;58529000;821288000;1602325000;1660854000;125313000;;551770000;746395000;2407249000
EV;200412;USD;2012;Q4;2012-10-31;2012-12-21;112140000;115131000;498834000;;;498834000;54889000;620522000;805246000;1480657000;1979491000;59397000;;59397000;500000000;1207744000;1267141000;27185000;;585119000;712350000;1979491000
EV;200412;USD;2011;Q4;2011-10-31;2011-12-21;112576000;114890000;527434000;;;527434000;67227000;418260000;818379000;1303866000;1831300000;51333000;;51333000;500000000;1217839000;1269172000;452000;;463064000;562128000;1831300000
EV;200412;USD;2010;Q4;2010-10-31;2010-12-22;116059000;121481000;307886000;;;307886000;71219000;463789000;415646000;950654000;1258540000;60843000;;60843000;500000000;719823000;780666000;50688000;;363190000;477874000;1258540000
EV;200412;USD;2009;Q4;2009-10-31;2010-09-03;116424000;122501000;360510000;;;360510000;75201000;241511000;397845000;714557000;1075067000;51881000;;67461000;500000000;656675000;724136000;45245000;;266196000;350931000;1075067000
BONT;200557;USD;2016;Q4;2017-01-31;2017-04-12;20005430;20005430;6736000;;724454000;829748000;584803000;;90512000;675315000;1505063000;362162000;6685000;368847000;982634000;1158997000;1527844000;167152000;-1387000;-115637000;-22781000;1505063000
BONT;200557;USD;2015;Q4;2016-01-31;2016-04-13;19742211;19742211;6879000;;711699000;815832000;635334000;;99460000;734794000;1550626000;338736000;5394000;344130000;982669000;1171580000;1515710000;164643000;-1387000;-52218000;34916000;1550626000
BONT;200557;USD;2014;Q4;2015-01-31;2015-04-15;19491508;19491508;8753000;;734956000;837103000;641996000;;113634000;755630000;1592733000;395752000;10749000;406501000;895979000;1098584000;1505085000;161567000;-1387000;7873000;87648000;1592733000
BONT;200557;USD;2013;Q4;2014-01-31;2014-04-16;19206766;19206766;7058000;;709733000;793076000;640004000;;144149000;784153000;1577229000;379403000;11160000;413307000;853349000;1035966000;1449273000;160980000;-1387000;18811000;127956000;1577229000
BONT;200557;USD;2012;Q4;2013-01-31;2013-04-17;18699065;18699065;7926000;;758400000;836927000;652822000;;144460000;797282000;1634209000;392583000;79811000;492650000;821342000;1030953000;1523603000;158933000;-1387000;26302000;110606000;1634209000
BONT;200557;USD;2011;Q4;2012-01-31;2012-04-11;18160472;18160472;14272000;;699504000;782808000;677133000;;158262000;835395000;1618203000;399983000;12431000;428645000;870948000;1057951000;1486596000;155601000;-1387000;51749000;131607000;1618203000
BONT;200557;USD;2010;Q4;2011-01-31;2011-09-07;;;16339000;;682324000;777081000;703432000;;175726000;879158000;1656239000;388359000;12803000;413871000;917730000;1059016000;1472887000;153526000;-1387000;67711000;183352000;1656239000
TOL;200636;USD;2017;Q4;2017-10-31;2017-12-21;159330000;164566000;712829000;132922000;7281453000;8773920000;189547000;;481758000;671305000;9445225000;1929501000;;2445672000;2462463000;2462463000;4908135000;721894000;-662854000;4474064000;4537090000;9445225000
TOL;200636;USD;2016;Q4;2016-10-31;2016-12-23;163968000;171682000;633715000;248601000;7353967000;8903389000;169576000;;663824000;833400000;9736789000;2288116000;;2807215000;2694372000;2694372000;5501587000;730243000;-474912000;3977297000;4235202000;9736789000
TOL;200636;USD;2015;Q4;2015-10-31;2015-12-21;176369000;184734000;928994000;123175000;6997516000;8458445000;136755000;;611315000;748070000;9206515000;1904326000;;2288635000;2689801000;2689801000;4978436000;729904000;-100040000;3595202000;4228079000;9206515000
TOL;200636;USD;2014;Q4;2014-10-31;2014-12-23;177539000;185669000;598341000;101944000;6490321000;7484148000;143010000;73800000;697499000;914309000;8398457000;1585439000;;1899519000;2638241000;2638241000;4537760000;713941000;-88762000;3232035000;3860697000;8398457000
TOL;200636;USD;2013;Q4;2013-10-31;2013-12-23;169440000;183812000;825480000;113517000;4650412000;5897628000;131320000;36374000;762137000;929831000;6827459000;879184000;;1166853000;2321442000;2321442000;3488295000;443371000;0;2892003000;3339164000;6827459000
TOL;200636;USD;2012;Q4;2012-10-31;2012-12-28;168415000;175573000;1217892000;86386000;3732703000;5286878000;109971000;37169000;747026000;894166000;6181044000;757069000;;972710000;2080463000;2080463000;3053173000;406105000;-983000;2721397000;3127871000;6181044000
TOL;200636;USD;2011;Q4;2011-10-31;2011-12-22;166898000;169155000;1139912000;63175000;3416723000;4760005000;99712000;69174000;126355000;295241000;5055246000;830490000;;971723000;1490972000;1490972000;2462695000;402069000;-47065000;2234251000;2592551000;5055246000
TOL;200636;USD;2010;Q4;2010-10-31;2010-12-22;166268000;164362000;1236927000;93644000;3241725000;4893197000;79916000;0;198442000;278358000;5171555000;918909000;;1068432000;1544110000;1544110000;2612542000;361670000;-96000;2194456000;2559013000;5171555000
TOL;200636;USD;2009;Q4;2009-10-31;2010-09-08;163118000;163118000;1908894000;43432000;3183566000;5411159000;70441000;;152844000;223285000;5634444000;1366802000;47872000;1530314000;1587648000;1587648000;3117962000;318165000;-159000;2197830000;2516482000;5634444000
TOL;200636;USD;2018;Q4;2018-10-31;2018-12-20;148066000;149605000;1182195000;170731000;7598219000;9619496000;193281000;;431813000;625094000;10244590000;2053439000;;2614303000;2861375000;2861375000;5475678000;728832000;-1130878000;5161551000;4768912000;10244590000
VAL;200824;USD;2016;Q4;2016-10-31;2016-12-20;79198605;81403058;174720000;815432000;473294000;1594624000;668443000;;2037457000;2705900000;4300524000;1044374000;221446000;1265820000;1542926000;1921281000;3187101000;555140000;-1682635000;2458101000;1113423000;4300524000
VAL;200824;USD;2015;Q4;2015-10-31;2015-12-18;79147730;81049103;185961000;857256000;451909000;1631230000;632765000;;2054580000;2687345000;4318575000;1032586000;334153000;1366739000;1706933000;2096827000;3463566000;533264000;-1692385000;2209628000;855009000;4318575000
VAL;200824;USD;2014;Q4;2014-10-31;2014-12-22;82335881;84541914;128203000;840447000;486262000;1577257000;645102000;;1811592000;2456694000;4033951000;1098065000;606356000;1704421000;950035000;1318439000;3022860000;517629000;-1393869000;1907001000;1011091000;4033951000
VAL;200824;USD;2013;Q4;2013-10-31;2013-12-20;86053313;88631286;216150000;771396000;438982000;1580290000;633475000;;1811744000;2445219000;4025509000;1039408000;441165000;1480573000;1037392000;1422386000;2902959000;503829000;-1083678000;1648980000;1122550000;4025509000
VAL;200824;USD;2012;Q4;2012-10-31;2012-12-19;90129434;93368976;253327000;681099000;360427000;1449177000;550968000;;1626691000;2177659000;3626836000;888241000;138531000;1026772000;1012578000;1376541000;2403313000;480501000;-748146000;1440896000;1223523000;3626836000
VAL;200824;USD;2011;Q4;2011-10-31;2011-12-21;92882808;84290046;178167000;664855000;336750000;1325137000;548253000;;1626761000;2175014000;3500151000;882614000;377319000;1259933000;679805000;1027668000;2287601000;457013000;-528992000;1221750000;1212550000;3500151000
VAL;200824;USD;2010;Q4;2010-10-31;2010-12-21;97758121;100352941;167621000;628589000;349149000;1284922000;567630000;;2015384000;2583014000;3867936000;876763000;8088000;884851000;943216000;1352720000;2237571000;442387000;-328624000;1428515000;1630365000;3867936000
VAL;200824;USD;2009;Q4;2009-10-31;2010-09-08;-299653582764;-301494978196;187719000;518188000;238449000;1062466000;471088000;;1977470000;2448558000;3511024000;704201000;7278000;711479000;873095000;1295038000;2006517000;412306000;-245534000;1269738000;1504507000;3511024000
SCWX;201339;USD;2016;Q4;2017-02-28;2017-03-29;80192000;80192000;116595000;113546000;1947000;284035000;31153000;;684112000;715265000;999300000;83823000;;203732000;;104144000;307876000;855714000;;-160859000;691424000;999300000
SCWX;201339;USD;2015;Q4;2016-02-29;2016-06-01;70000000;70000000;33422000;116357000;3549000;179539000;22766000;;715480000;738246000;917785000;82533000;27993000;219993000;;109336000;329329000;712623000;;-122646000;588456000;917785000
SCWX;201339;USD;2017;Q4;2018-02-28;2018-03-28;80356000;80356000;101539000;157764000;1030000;300884000;33457000;;722740000;756197000;1057081000;104891000;;242588000;;83403000;325991000;868222000;;-137162000;731090000;1057081000
SCWX;201339;USD;2018;Q4;2019-02-28;2019-03-28;80587000;80587000;129592000;141344000;468000;299008000;35978000;;701173000;737151000;1036159000;102672000;;260537000;;82915000;343452000;885377000;-13523000;-176263000;692707000;1036159000
PSTI;201828;USD;2016;Q4;2016-06-30;2016-09-07;8018106;8018106;32208000;2228000;;35596000;9216000;363000;766000;10345000;45941000;5775000;;5775000;;2010000;7785000;198433000;;-161757000;38156000;45941000
PSTI;201828;USD;2015;Q4;2015-06-30;2015-09-09;7126740;7126740;52043000;1691000;;56868000;10173000;360000;754000;11287000;68155000;5711000;;6183000;;3829000;10012000;195304000;;-138511000;58143000;68155000
PSTI;201828;USD;2014;Q4;2014-06-30;2014-09-11;6768496;6768496;53905000;2263000;;61987000;10823000;304000;909000;12036000;74023000;6771000;;7397000;;4503000;11900000;172998000;;-113834000;62123000;74023000
PSTI;201828;USD;2013;Q4;2013-06-30;2013-09-11;5822037;5822037;53897000;273000;;55085000;11866000;421000;944000;13231000;68316000;5149000;;5921000;;4929000;10850000;144109000;;-86902000;57466000;68316000
PSTI;201828;USD;2012;Q4;2012-06-30;2012-09-10;4537215;4537215;37809000;;;38192000;5019000;1287000;2922000;9228000;47420000;3167000;;5522000;;4156000;9678000;103619000;;-65747000;37742000;47420000
PSTI;201828;USD;2011;Q4;2011-06-30;2011-11-09;;;42829000;0;;43297000;2088000;179000;452000;2719000;46016000;2018000;;2018000;;576000;2594000;94375000;;-50953000;43422000;46016000
PSTI;201828;USD;2017;Q4;2017-06-30;2017-09-07;9623718;9623718;26106000;1036000;;29016000;7277000;403000;838000;8518000;37534000;5414000;;5414000;;1869000;7283000;217823000;;-189571000;30251000;37534000
PSTI;201828;USD;2018;Q4;2018-06-30;2018-09-12;11101054;11101054;29900000;58000;;32036000;5678000;383000;863000;6924000;38960000;8548000;;8548000;;1905000;10453000;244204000;;-215697000;28507000;38960000
TCMD;201913;USD;2017;Q4;2017-12-31;2018-02-26;17762578;20734469;43912000;17623000;11040000;76872000;3776000;;7799000;11575000;88447000;13769000;;13786000;;1874000;15660000;70242000;-493000;3082000;72787000;88447000
TCMD;201913;USD;2016;Q4;2016-12-31;2017-02-27;16698545;20912284;41695000;15003000;6554000;64233000;1563000;;8139000;9702000;73935000;12484000;;12551000;;1745000;14296000;62423000;;-2773000;59639000;73935000
TCMD;201913;USD;2015;Q4;2015-12-31;2016-09-07;3155416;3155416;7060000;14151000;5781000;29360000;1346000;;6267000;7613000;36973000;8511000;;9502000;;193000;9695000;3000;;-5652000;27278000;36973000
TCMD;201913;USD;2018;Q4;2018-12-31;2019-02-28;18513585;20555014;45885000;24332000;11189000;84961000;4810000;;17300000;22110000;107071000;15362000;;15367000;;2434000;17801000;79573000;;9705000;89270000;107071000
SCVL;201975;USD;2017;Q4;2018-01-31;2018-04-02;16018000;16030000;48254000;6270000;260500000;320586000;86276000;;8718000;94994000;415580000;56784000;;56784000;;51494000;108278000;65663000;-85099000;326738000;307302000;415580000
SCVL;201975;USD;2016;Q4;2017-01-31;2017-03-29;17407000;17412000;62944000;4424000;279646000;351751000;96216000;;10511000;106727000;458478000;86296000;;86296000;;53300000;139596000;65478000;-59237000;312641000;318882000;458478000
SCVL;201975;USD;2015;Q4;2016-01-31;2016-04-04;19043000;19049000;68814000;2131000;292878000;370077000;103386000;;7630000;111016000;481093000;87934000;;87934000;;53357000;141291000;67011000;-21517000;294308000;339802000;481093000
SCVL;201975;USD;2014;Q4;2015-01-31;2015-04-16;19576000;19588000;61376000;2928000;287877000;359129000;101294000;;4593000;105887000;465016000;83122000;;83122000;;50696000;133818000;67596000;-7084000;270686000;331198000;465016000
SCVL;201975;USD;2013;Q4;2014-01-31;2014-04-10;19949000;19972000;48253000;4337000;284801000;342515000;90193000;;4143000;94336000;436851000;77659000;;77659000;;42320000;119979000;66805000;-3000;250070000;316872000;436851000
SCVL;201975;USD;2012;Q4;2013-01-31;2013-04-15;39739120;39855029;45756000;2152000;272282000;328022000;77364000;;1810000;79174000;407196000;82021000;;82021000;;32807000;114828000;66738000;-2483000;228113000;292368000;407196000
SCVL;201975;USD;2011;Q4;2012-01-31;2012-04-12;78037587;78717032;70602000;2621000;237655000;316261000;69232000;;1069000;70301000;386562000;75760000;;75760000;;27118000;102878000;67779000;-6330000;222235000;283684000;386562000
SCVL;201975;USD;2010;Q4;2011-01-31;2011-09-07;;;60193000;1550000;212929000;281354000;62391000;;1400000;63791000;345145000;70676000;;70676000;;20126000;90802000;68970000;-10480000;195853000;254343000;345145000
SCVL;201975;USD;2018;Q4;2019-01-31;2019-04-02;14598000;15289000;67021000;1219000;257539000;337313000;70605000;;10081000;80686000;417999000;70784000;;70784000;0;42782000;113566000;75836000;-131846000;360443000;304433000;417999000
SIGM;202034;USD;2016;Q4;2017-01-31;2017-03-30;37996000;37661000;71206000;35860000;18147000;133533000;18523000;2000000;47718000;68241000;201774000;35964000;;35964000;;22264000;58228000;513168000;-88336000;-279108000;143546000;201774000
SIGM;202034;USD;2015;Q4;2016-01-31;2016-04-04;143560000;146676000;68595000;30362000;26709000;140651000;14086000;6411000;55521000;76018000;216669000;48173000;;48173000;;15691000;63864000;503809000;-88336000;-260793000;152805000;216669000
SIGM;202034;USD;2014;Q4;2015-01-31;2015-04-15;138772000;138772000;89849000;26415000;20445000;149233000;21594000;7516000;26990000;56100000;205333000;50907000;;50907000;;11136000;62043000;493550000;-88198000;-260951000;143290000;205333000
SIGM;202034;USD;2013;Q4;2014-01-31;2014-04-17;34135000;34135000;72117000;27647000;20403000;134155000;27089000;19378000;35153000;81620000;215775000;42285000;;42285000;;15099000;57384000;485188000;-88198000;-239250000;158391000;215775000
SIGM;202034;USD;2012;Q4;2013-01-31;2013-04-12;33724000;33724000;68673000;21648000;24929000;136465000;17106000;23196000;44064000;84366000;220831000;39837000;;39837000;;18976000;58813000;475070000;-85941000;-228201000;162018000;220831000
SIGM;202034;USD;2011;Q4;2012-01-31;2012-03-29;64060269;64060269;86417000;21180000;22037000;143469000;19609000;71465000;62681000;153755000;297224000;32519000;;32519000;;16230000;48749000;460246000;-85941000;-126433000;248475000;297224000
SIGM;202034;USD;2010;Q4;2011-01-31;2011-09-08;124886499;126833170;120214000;31348000;37714000;203055000;28392000;61608000;166184000;256184000;459239000;39859000;;39859000;;21339000;61198000;441249000;-85941000;41612000;398041000;459239000
SIGM;202034;USD;2017;Q4;2018-01-31;2018-04-24;39031000;39031000;38628000;9715000;3038000;80045000;4339000;;11713000;16052000;96097000;23248000;;37055000;;18922000;55977000;466298000;-88336000;-337860000;40120000;96097000
STRT;202406;USD;2016;Q4;2016-07-31;2016-09-08;3565000;3624000;15477000;63726000;38683000;134451000;85149000;;22576000;107725000;242176000;43626000;;64215000;20000000;23449000;87664000;92148000;-135871000;220728000;154512000;242176000
STRT;202406;USD;2015;Q4;2015-07-31;2015-09-04;3525000;3608000;25695000;58807000;34786000;128606000;71126000;;31102000;102228000;230834000;43945000;;64735000;10000000;13698000;78433000;89631000;-135902000;213442000;152401000;230834000
STRT;202406;USD;2014;Q4;2014-07-31;2014-09-05;3474000;3571000;19756000;68822000;30502000;135639000;55781000;;21616000;77397000;213036000;54638000;;65263000;2500000;12870000;78133000;87125000;-135919000;194498000;134903000;213036000
STRT;202406;USD;2013;Q4;2013-07-31;2013-09-09;3355000;3434000;20307000;47514000;24312000;106499000;51415000;;11586000;63001000;169500000;39536000;;50725000;;6895000;57620000;82754000;-135938000;179614000;111880000;169500000
STRT;202406;USD;2012;Q4;2012-07-31;2012-09-06;3302000;3332000;17487000;44496000;21236000;101291000;46330000;;18417000;64747000;166038000;46316000;;56973000;;21667000;78640000;80690000;-135971000;171590000;87398000;166038000
STRT;202406;USD;2011;Q4;2011-07-31;2011-11-10;3288000;3325000;17250000;39649000;22135000;94402000;40636000;;13050000;53686000;148088000;40131000;;50988000;0;7036000;58024000;79836000;-136009000;164138000;90064000;148088000
STRT;202406;USD;2017;Q4;2017-07-31;2017-09-07;3595000;3681000;8361000;64933000;35476000;129005000;111591000;;33118000;144709000;273714000;52734000;;67895000;30000000;33105000;101000000;93885000;-135822000;225913000;172714000;273714000
STRT;202406;USD;2018;Q4;2018-07-31;2018-09-06;3636000;3708000;8090000;73832000;46654000;151103000;116542000;;39530000;156072000;307175000;51832000;;68793000;51000000;55136000;123929000;95213000;-135778000;236162000;183246000;307175000
SHLO;202591;USD;2015;Q4;2015-10-31;2016-01-14;17495000;17503000;13456000;;58179000;322003000;280260000;;64326000;344586000;666589000;194864000;2080000;196944000;298873000;328730000;525674000;69507000;;121457000;140915000;666589000
SHLO;202591;USD;2014;Q4;2014-10-31;2015-01-13;17268000;17319000;13059000;;61843000;293762000;274828000;;60935000;335763000;629525000;187814000;1918000;189732000;268102000;295274000;485006000;68207000;;113193000;144519000;629525000
SHLO;202591;USD;2013;Q4;2013-10-31;2013-03-01;16935000;16986000;398000;;42924000;166779000;197874000;;27300000;225174000;391953000;116059000;882000;116941000;119384000;143863000;260804000;66482000;;90749000;131149000;391953000
SHLO;202591;USD;2012;Q4;2012-10-31;2012-12-21;16787000;16930000;174000;;44687000;127839000;117101000;;4162000;121263000;249102000;85028000;447000;85475000;21150000;56224000;141699000;65289000;;73425000;107403000;249102000
SHLO;202591;USD;2011;Q4;2011-10-31;2011-12-21;16748000;16858000;20000;;33976000;116703000;121467000;;2504000;123971000;240674000;80947000;428000;81375000;25700000;51647000;133022000;64118000;;68321000;107652000;240674000
SHLO;202591;USD;2010;Q4;2010-10-31;2011-08-26;16556000;16729000;34000;;20919000;100395000;125093000;;2159000;127252000;227647000;71824000;721000;72545000;26900000;52923000;125468000;62483000;;62480000;102179000;227647000
SHLO;202591;USD;2017;Q4;2017-10-31;2018-01-05;22795000;22765000;8930000;;61812000;294521000;266891000;;57171000;324062000;618583000;213858000;2027000;215885000;181065000;214377000;430262000;112582000;;117976000;188321000;618583000
SHLO;202591;USD;2016;Q4;2016-10-31;2017-01-17;17481000;17528000;8870000;;60547000;293153000;265837000;;67439000;333276000;626429000;201024000;2023000;203047000;256922000;290592000;493639000;70579000;;118673000;132790000;626429000
SHLO;202591;USD;2018;Q4;2018-10-31;2018-12-20;23309000;23379000;16843000;;71412000;332977000;316176000;;60522000;376698000;709675000;242305000;1327000;243632000;245351000;266521000;510153000;114639000;;135813000;199522000;709675000
FRAN;202677;USD;2017;Q4;2018-01-31;2018-03-28;2957900;2967146;31331000;16642000;26816000;84503000;87702000;;13035000;100737000;185240000;32455000;;32455000;;38337000;70792000;111902000;-156499000;159045000;114448000;185240000
FRAN;202677;USD;2016;Q4;2017-01-31;2017-03-22;3100509;3113254;53202000;5605000;23958000;100075000;80484000;;9034000;89518000;189593000;34966000;;34966000;;38092000;73058000;109469000;-136491000;143557000;116535000;189593000
FRAN;202677;USD;2015;Q4;2016-01-31;2016-03-25;3437541;3446204;56224000;9580000;31541000;110769000;77894000;;4914000;82808000;193577000;30633000;;30633000;;36552000;67185000;108152000;-83316000;101556000;126392000;193577000
FRAN;202677;USD;2014;Q4;2015-01-31;2015-03-27;3523340;3532087;39071000;12279000;23801000;85899000;74095000;;5551000;79646000;165545000;23454000;;23454000;;32877000;56331000;105953000;-60143000;63404000;109214000;165545000
FRAN;202677;USD;2013;Q4;2014-01-31;2014-03-28;3516759;3558076;37498000;8984000;24614000;82425000;64131000;;3989000;68120000;150545000;20030000;;20030000;25000000;52448000;72478000;101644000;-54873000;31296000;78067000;150545000
FRAN;202677;USD;2012;Q4;2013-01-31;2013-03-22;3654954;3738171;29877000;2504000;19049000;59685000;49559000;;3930000;53489000;113174000;19025000;;19025000;0;22092000;41117000;85600000;0;-13543000;72057000;113174000
FRAN;202677;USD;2011;Q4;2012-01-31;2012-03-21;3628132;3730091;14046000;2156000;14462000;36041000;33199000;;3072000;36271000;72312000;18520000;;18520000;22000000;36890000;55410000;77506000;;-60604000;16902000;72312000
FRAN;202677;USD;2010;Q4;2011-01-31;2011-09-07;3369485;3478025;12516000;4054000;11959000;31721000;21300000;;6103000;27403000;59124000;12556000;5938000;18494000;87875000;96098000;114592000;27637000;;-83105000;-55468000;59124000
FRAN;202677;USD;2018;Q4;2019-01-31;2019-05-03;2901256;2879514;20103000;16309000;30478000;77247000;71207000;;4588000;75795000;153042000;35663000;;35663000;10000000;43989000;79652000;113160000;-160021000;120251000;73390000;153042000
SNOW;203144;USD;2016;Q4;2016-06-30;2016-09-08;39779000;39885000;107066000;36660000;23620000;200902000;511486000;26398000;299019000;836903000;1037805000;64869000;3842000;136648000;572356000;641122000;777770000;2901149000;-50643000;-2726074000;260035000;1037805000
SNOW;203144;USD;2015;Q4;2015-06-30;2015-09-09;45182000;45182000;90580000;36176000;22913000;204544000;527186000;25394000;337871000;890451000;1094995000;62890000;10846000;146132000;602097000;671127000;817259000;2897795000;0;-2766947000;277736000;1094995000
SNOW;203144;USD;2014;Q4;2014-06-30;2014-09-23;44972278;44868000;56020000;40408000;37282000;169371000;490138000;121246000;315290000;926674000;1096045000;63060000;10573000;129321000;549461000;634830000;764151000;2894522000;;-2760027000;331894000;1096045000
SNOW;203144;USD;2013;Q4;2013-06-30;2014-03-17;41882000;41882000;59775000;38298000;29151000;162394000;475856000;124123000;363345000;963324000;1125718000;62196000;8201000;122507000;580662000;855160000;977667000;0;;0;148051000;1125718000
NAV;203261;USD;2015;Q4;2015-10-31;2015-12-17;163299970;163299984;1071000000;429000000;1135000000;4622000000;1345000000;13000000;712000000;2070000000;6692000000;1301000000;1110000000;3788000000;4188000000;8064000000;11852000000;2508000000;-210000000;-4866000000;-5160000000;6692000000
NAV;203261;USD;2014;Q4;2014-10-31;2014-12-16;162999961;162999968;1102000000;553000000;1319000000;5013000000;1562000000;25000000;843000000;2430000000;7443000000;1564000000;1295000000;4231000000;3929000000;7830000000;12061000000;2509000000;-221000000;-4682000000;-4618000000;7443000000
NAV;203261;USD;2013;Q4;2013-10-31;2013-12-20;160999962;160999975;1585000000;737000000;1210000000;5459000000;1741000000;29000000;1086000000;2856000000;8315000000;1502000000;1163000000;4261000000;3922000000;7655000000;11916000000;2486000000;-251000000;-4063000000;-3601000000;8315000000
NAV;203261;USD;2012;Q4;2012-10-31;2012-12-19;69100000;69100000;1553000000;749000000;1537000000;5837000000;1660000000;94000000;1511000000;3265000000;9102000000;1686000000;1205000000;4353000000;3566000000;8009000000;12362000000;2449000000;-272000000;-3165000000;-3260000000;9102000000
NAV;203261;USD;2011;Q4;2011-10-31;2011-12-20;72400000;76500000;1257000000;1219000000;1714000000;7235000000;1570000000;122000000;3364000000;5056000000;12291000000;2122000000;1379000000;4798000000;3477000000;7465000000;12263000000;2260000000;-191000000;-155000000;28000000;12291000000
NAV;203261;USD;2010;Q4;2010-10-31;2010-12-22;143599929;146399928;1171000000;987000000;1568000000;5835000000;1442000000;44000000;2409000000;3895000000;9730000000;1827000000;632000000;3589000000;4238000000;7065000000;10654000000;2213000000;-124000000;-1878000000;-924000000;9730000000
NAV;203261;USD;2009;Q4;2009-10-31;2010-09-08;71000000;72100000;1212000000;855000000;1666000000;5748000000;1467000000;26000000;2787000000;4280000000;10028000000;1872000000;1136000000;4185000000;4156000000;7517000000;11702000000;2188000000;-149000000;-2101000000;-1674000000;10028000000
NAV;203261;USD;2017;Q4;2017-10-31;2017-12-19;98600000;100300000;1076000000;391000000;857000000;4160000000;1326000000;13000000;636000000;1975000000;6135000000;1292000000;1169000000;3645000000;3889000000;7064000000;10709000000;2743000000;-179000000;-4933000000;-4574000000;6135000000
NAV;203261;USD;2016;Q4;2016-10-31;2016-12-20;81700000;81400000;850000000;276000000;944000000;3759000000;1241000000;16000000;637000000;1894000000;5653000000;1113000000;907000000;3203000000;3997000000;7743000000;10946000000;2508000000;-205000000;-4963000000;-5293000000;5653000000
NAV;203261;USD;2018;Q4;2018-10-31;2018-12-18;99200000;100600000;1421000000;456000000;1110000000;5136000000;1370000000;49000000;675000000;2094000000;7230000000;1606000000;946000000;3807000000;4521000000;7349000000;11156000000;2741000000;-161000000;-4593000000;-3926000000;7230000000
LUV;205563;USD;2017;Q4;2017-12-31;2018-02-07;590000000;595000000;3273000000;;420000000;4815000000;18539000000;;1756000000;20295000000;25110000000;3020000000;348000000;6863000000;3320000000;8606000000;15469000000;2259000000;-6462000000;13832000000;9641000000;25110000000
LUV;205563;USD;2016;Q4;2016-12-31;2016-10-31;617000000;620000000;3305000000;;337000000;4498000000;17044000000;;1744000000;18788000000;23286000000;3163000000;566000000;6844000000;2821000000;8001000000;14845000000;2218000000;-4872000000;11418000000;8441000000;23286000000
LUV;205563;USD;2015;Q4;2015-12-31;2015-10-29;650000000;658000000;3051000000;;311000000;4024000000;15601000000;;1687000000;17288000000;21312000000;3779000000;637000000;7406000000;2541000000;6548000000;13954000000;2182000000;-3182000000;9409000000;7358000000;21312000000
LUV;205563;USD;2014;Q4;2014-12-31;2014-10-29;677000000;688000000;2988000000;;342000000;3927000000;14292000000;;1504000000;15796000000;19723000000;2768000000;258000000;5923000000;2434000000;7025000000;12948000000;2123000000;-2026000000;7416000000;6775000000;19723000000
LUV;205563;USD;2013;Q4;2013-12-31;2013-10-30;698000000;712000000;3152000000;;467000000;4456000000;13389000000;;1500000000;14889000000;19345000000;2476000000;629000000;5676000000;2191000000;6333000000;12009000000;2039000000;-1131000000;6431000000;7336000000;19345000000
LUV;205563;USD;2012;Q4;2012-12-31;2012-10-26;733000000;752000000;2970000000;;469000000;4227000000;12766000000;;1603000000;14369000000;18596000000;2209000000;271000000;4650000000;2883000000;6954000000;11604000000;2018000000;-675000000;5768000000;6992000000;18596000000
LUV;205563;USD;2011;Q4;2011-12-31;2011-10-25;776000000;772000000;3144000000;;401000000;4345000000;12127000000;;1596000000;13723000000;18068000000;2053000000;644000000;4533000000;3107000000;6658000000;11191000000;2030000000;-324000000;5395000000;6877000000;18068000000
LUV;205563;USD;2010;Q4;2010-12-31;2010-10-28;1494999255;1496999254;3538000000;;243000000;4279000000;10578000000;;606000000;11184000000;15463000000;1602000000;505000000;3305000000;2875000000;5921000000;9226000000;1991000000;-891000000;5399000000;6237000000;15463000000
LUV;205563;USD;2009;Q4;2009-12-31;2009-10-23;2223998517;2223998517;2593000000;;221000000;3358000000;10634000000;;277000000;10911000000;14269000000;1461000000;190000000;2695000000;3325000000;6120000000;8815000000;2024000000;-963000000;4971000000;5454000000;14269000000
LUV;205563;USD;2008;Q4;2008-12-31;2009-04-29;-732998528;-733998517;1803000000;;203000000;2653000000;11040000000;;375000000;11415000000;14068000000;1680000000;163000000;2806000000;3498000000;6309000000;9115000000;2023000000;-1005000000;4919000000;4953000000;14068000000
LUV;205563;USD;2018;Q4;2018-12-31;2019-02-05;558000000;560000000;3689000000;;461000000;5028000000;19525000000;;1690000000;21215000000;26243000000;3165000000;606000000;7905000000;2771000000;8485000000;16390000000;2318000000;-8452000000;15967000000;9853000000;26243000000
VISI;207946;USD;2016;Q4;2016-10-31;2017-01-12;20851000;20851000;20334000;193866000;;260565000;30133000;;25767000;55900000;316465000;118669000;2050000;126479000;95000000;141021000;267500000;78938000;-40361000;21000000;48965000;316465000
VISI;207946;USD;2015;Q4;2015-10-31;2016-01-14;20800000;20800000;14987000;198385000;;278991000;24095000;;23740000;47835000;326826000;127480000;982000;135807000;106313000;126528000;262335000;78177000;-43726000;38034000;64491000;326826000
VISI;207946;USD;2014;Q4;2014-10-31;2015-01-20;20876000;20653000;12266000;230951000;;365348000;25556000;;33428000;58984000;424332000;145794000;129417000;305455000;7216000;27483000;332938000;75555000;-41880000;64119000;91394000;424332000
VISI;207946;USD;2013;Q4;2013-10-31;2014-01-31;20837000;20647000;15990000;282571000;;424386000;32526000;;44428000;76954000;501340000;163231000;168114000;362240000;8127000;28859000;391099000;74357000;-41880000;83007000;110241000;501340000
VISI;207946;USD;2012;Q4;2012-10-31;2013-11-15;20813000;20724000;32094000;334947000;;469396000;39052000;;49124000;88176000;557572000;208994000;145727000;378961000;9033000;35494000;414455000;73941000;-41880000;113795000;143117000;557572000
VISI;207946;USD;2011;Q4;2011-10-31;2013-11-15;20813000;21108000;50150000;320459000;;489282000;43270000;;46927000;90197000;579479000;224612000;113201000;378064000;9801000;44752000;422816000;73814000;-41880000;126800000;156663000;579479000
VISI;207946;USD;2017;Q4;2017-10-31;2018-01-12;20966000;21266000;40601000;173818000;;244837000;29121000;;10851000;39972000;284809000;112956000;50000000;162956000;0;37859000;200815000;81019000;-37607000;45843000;83994000;284809000
VISI;207946;USD;2018;Q4;2018-10-31;2019-01-09;21072000;21072000;27826000;157445000;;204496000;24392000;;7808000;32200000;236696000;100325000;0;100325000;49068000;85872000;186197000;81431000;-33600000;9738000;50499000;236696000
OOMA;208053;USD;2016;Q4;2017-01-31;2017-04-11;17972570;17972570;53201000;4714000;5830000;67256000;4176000;;1906000;6082000;73338000;17436000;;32957000;;561000;33518000;117641000;;-77810000;39820000;73338000
OOMA;208053;USD;2015;Q4;2016-01-31;2016-04-13;17164094;17164094;55404000;5609000;5011000;69355000;4291000;;2890000;7181000;76536000;17796000;632000;33464000;;182000;33646000;107681000;;-64808000;42890000;76536000
OOMA;208053;USD;2014;Q4;2015-01-31;2015-09-11;2472722;2472722;9133000;4394000;8081000;24801000;2893000;;3583000;6476000;31277000;14280000;2036000;30664000;11141000;12121000;42785000;5611000;;-50756000;-11508000;31277000
OOMA;208053;USD;2017;Q4;2018-01-31;2018-04-02;19066162;19066162;51790000;2858000;6079000;65124000;4732000;;3575000;8307000;73431000;20230000;;35786000;;577000;36363000;128083000;;-90931000;37068000;73431000
OOMA;208053;USD;2018;Q4;2019-01-31;2019-04-03;20244013;20244013;42623000;3723000;10117000;61913000;4563000;;11912000;16475000;78388000;29279000;;44722000;;619000;45341000;138852000;;-105795000;33047000;78388000
MCFT;208137;USD;2018;Q4;2018-06-30;2018-09-07;18622155;18740722;7909000;5515000;20467000;37186000;22265000;;117473000;139738000;176924000;45837000;5069000;50906000;70087000;73496000;124402000;114239000;;-61717000;52522000;176924000
MCFT;208137;USD;2017;Q4;2017-06-30;2017-09-08;18593500;18659247;4038000;3500000;11676000;21652000;14827000;;46842000;61669000;83321000;33198000;3687000;36885000;30790000;34675000;71560000;113131000;;-101370000;11761000;83321000
MCFT;208137;USD;2016;Q4;2016-06-30;2016-09-09;18559800;19377794;73000;2966000;13268000;21593000;13826000;;47114000;60940000;82533000;36496000;7885000;44381000;44342000;46531000;90912000;112561000;;-120940000;-8379000;82533000
MCFT;208137;USD;2015;Q4;2015-06-30;2015-11-06;11139000;12317635;1167000;2653000;11541000;29329000;13233000;;47114000;60347000;89676000;36345000;18275000;63767000;60487000;68162000;131929000;8952000;;-51205000;-42253000;89676000
AVNW;208290;USD;2016;Q4;2016-07-31;2016-09-09;5258280;5258280;30701000;63449000;30357000;140414000;18162000;;7535000;25697000;166111000;56422000;9000000;99947000;;12707000;112654000;811654000;;-747381000;53457000;166111000
AVNW;208290;USD;2015;Q4;2015-07-31;2015-10-01;5208880;5208880;34735000;83532000;39113000;191128000;24255000;;9332000;33587000;224715000;73794000;9000000;122708000;;18198000;140906000;809840000;;-717474000;83809000;224715000
AVNW;208290;USD;2014;Q4;2014-07-31;2014-12-22;5166820;5166820;48800000;77200000;49500000;218200000;29300000;;5700000;35000000;253200000;79300000;6000000;121600000;;19700000;141300000;807600000;;-692800000;111900000;253200000
AVNW;208290;USD;2013;Q4;2013-07-31;2013-09-23;5031320;5031320;90000000;86300000;51200000;274300000;28800000;;2700000;31500000;305800000;96700000;8800000;131100000;;24800000;155900000;804100000;;-650900000;149900000;305800000
AVNW;208290;USD;2012;Q4;2012-07-31;2012-09-04;4914700;4914700;96000000;90700000;75300000;304600000;21700000;;3300000;25000000;329600000;107200000;4100000;147400000;8800000;24700000;172100000;797400000;;-635900000;157500000;329600000
AVNW;208290;USD;2011;Q4;2011-07-31;2011-11-09;;;98200000;133000000;71800000;350300000;21600000;;12000000;33600000;383900000;131700000;0;191100000;6000000;15100000;206200000;792200000;;-611800000;177700000;383900000
AVNW;208290;USD;2017;Q4;2017-07-31;2017-09-06;5315000;5199000;35922000;45945000;23665000;124585000;16406000;;11585000;27991000;152576000;55539000;9000000;86018000;;12218000;98236000;813786000;;-748204000;54340000;152576000
AVNW;208290;USD;2018;Q4;2018-07-31;2018-08-28;5355000;6304000;37425000;43068000;22797000;123466000;17179000;;15416000;32595000;156061000;56742000;9000000;86468000;;12077000;98545000;816480000;;-746359000;57516000;156061000
AVNW;208290;USD;2019;Q4;2019-07-31;2019-08-27;5364000;5902000;31946000;51937000;9509000;125997000;17255000;;25941000;43196000;169193000;58160000;9000000;82211000;;15466000;97677000;815250000;;-730998000;71516000;169193000
VALU;208845;USD;2016;Q4;2016-04-30;2017-07-26;9714699;9714699;23133000;1018000;;25790000;1239000;58223000;1472000;60934000;86724000;4402000;;24590000;;24280000;48870000;1991000;-3781000;39186000;37854000;86724000
VALU;208845;USD;2015;Q4;2015-04-30;2016-07-15;9764356;9764356;16759000;1254000;;19952000;3621000;57942000;4992000;66555000;86507000;5782000;;26298000;;25609000;51907000;1991000;-3040000;35524000;34600000;86507000
VALU;208845;USD;2014;Q4;2014-04-30;2015-07-22;9812071;9812071;15506000;1409000;;18845000;3690000;58048000;6838000;68576000;87421000;4704000;;26214000;;26768000;52982000;1991000;-2244000;34587000;34439000;87421000
VALU;208845;USD;2013;Q4;2013-04-30;2014-07-21;9818945;9818945;15014000;1206000;;18266000;3863000;57850000;6896000;68609000;86875000;5566000;;27056000;;26521000;53577000;1991000;-2122000;33183000;33298000;86875000
VALU;208845;USD;2012;Q4;2012-04-30;2013-07-26;9879618;9879618;13522000;1278000;;16673000;3930000;57511000;6227000;67668000;84341000;5321000;;27394000;;23962000;51356000;1991000;-1572000;32315000;32985000;84341000
VALU;208845;USD;2011;Q4;2011-04-30;2012-07-27;9897034;9897034;15923000;902000;;19117000;3854000;56331000;5067000;65252000;84369000;5636000;;27184000;;24871000;52055000;1991000;-1390000;31628000;32314000;84369000
VALU;208845;USD;2010;Q4;2010-04-30;2011-09-13;;;19476000;1599000;;25222000;4084000;56367000;2130000;62581000;87803000;7510000;;31416000;;23133000;54549000;1991000;-444000;31644000;33254000;87803000
VALU;208845;USD;2017;Q4;2017-04-30;2018-07-26;9696959;9696959;23785000;1049000;;26561000;1371000;58233000;623000;60227000;86788000;5154000;;24871000;;18376000;43247000;1991000;-4135000;44902000;43541000;86788000
VALU;208845;USD;2018;Q4;2018-04-30;2019-07-26;9669164;9669164;28321000;1504000;;31414000;1146000;58625000;603000;60374000;91788000;5392000;;25400000;0;18864000;44264000;1991000;-4743000;48598000;47524000;91788000
PPIH;209037;USD;2016;Q4;2017-01-31;2014-04-15;7301000;7588000;7603000;31271000;13565000;57824000;36275000;;7512000;43787000;101611000;18181000;658000;30048000;7258000;12150000;42198000;55434000;-170000;6873000;59413000;101611000
PPIH;209037;USD;2015;Q4;2016-01-31;2014-12-09;7289000;7305000;16631000;36090000;15625000;92833000;25400000;;19865000;45265000;138098000;18604000;8767000;64085000;1470000;4985000;69070000;53105000;-290000;20193000;69028000;138098000
PPIH;209037;USD;2014;Q4;2015-01-31;2013-12-09;7127000;7233000;13395000;45659000;33547000;101092000;42541000;;19636000;62177000;163269000;24965000;8274000;53484000;23469000;33149000;86633000;52216000;;25580000;76636000;163269000
PPIH;209037;USD;2013;Q4;2014-01-31;2012-12-07;6926000;6926000;7034000;23278000;37529000;84346000;45582000;;19560000;65142000;149488000;24870000;5384000;49210000;35579000;46023000;95233000;50427000;;4553000;54255000;149488000
PPIH;209037;USD;2012;Q4;2013-01-31;2011-12-12;6914000;6914000;4209000;28109000;40204000;82670000;47842000;;26771000;74613000;157283000;27618000;2736000;39486000;34682000;45442000;84928000;49897000;;23038000;72355000;157283000
PPIH;209037;USD;2011;Q4;2012-01-31;2011-09-14;-20489632;-20567600;16718000;36634000;35509000;99068000;43655000;;20552000;64207000;163275000;26794000;3082000;40253000;36192000;44968000;85221000;49072000;;27789000;78054000;163275000
PPIH;209037;USD;2017;Q4;2018-01-31;2014-04-15;8174000;8052000;7084000;32936000;16856000;62318000;34509000;;7757000;42266000;104584000;21364000;753000;39180000;7728000;13592000;52772000;56381000;;-3103000;51812000;104584000
PPIH;209037;USD;2018;Q4;2019-01-31;2019-04-16;7833000;7833000;10156000;32508000;12289000;62960000;30398000;;8847000;39245000;102205000;18672000;640000;37088000;6751000;12757000;49845000;58872000;;-3632000;52360000;102205000
PERF;209149;USD;2016;Q4;2017-02-28;2015-12-15;15486785;15481722;5640000;29602000;221336000;266440000;25892000;;58714000;84606000;351046000;65680000;1248000;66928000;14301000;200141000;267069000;222125000;-8577000;-129571000;83977000;351046000
PERF;209149;USD;2015;Q4;2016-02-29;2014-12-16;15475714;15726121;1533000;27777000;253371000;296456000;24640000;;65136000;89776000;386232000;67786000;1104000;68890000;40020000;222048000;290938000;221771000;-8577000;-117900000;95294000;386232000
PERF;209149;USD;2014;Q4;2015-02-28;2014-05-01;15359847;15359848;1553000;34388000;282802000;333981000;18779000;;70644000;89423000;423404000;83185000;894000;84079000;71064000;248031000;332110000;220418000;-8577000;-120547000;91294000;423404000
PERF;209149;USD;2013;Q4;2014-02-28;2013-05-03;15437814;15437814;2447000;20417000;271881000;317230000;20060000;;82314000;102374000;419604000;79345000;874000;80219000;65088000;236263000;316482000;219781000;-8577000;-108082000;103122000;419604000
PERF;209149;USD;2012;Q4;2013-02-28;2011-12-13;8969177;;1682000;17671000;216850000;247586000;24493000;;14676000;39169000;286755000;61645000;1129000;62774000;31673000;159184000;221958000;125443000;-8577000;-52069000;64797000;286755000
PERF;209149;USD;2011;Q4;2012-02-29;2011-09-12;35839548305;;1236000;20305000;224645000;255955000;28050000;;16467000;44517000;300472000;57310000;1232000;58915000;59652000;181049000;239964000;125285000;-8577000;-56200000;60508000;300472000
CFI;209337;USD;2017;Q4;2017-04-30;2018-07-13;12449000;12926000;49438000;26307000;53454000;132069000;51794000;13862000;20259000;85915000;217984000;39775000;;40584000;;14024000;54608000;48826000;;114635000;163376000;217984000
CFI;209337;USD;2016;Q4;2016-04-30;2016-07-15;12341000;12558000;23238000;24577000;51482000;102191000;51651000;37517000;14275000;103443000;205634000;46102000;;46102000;;10902000;57004000;48033000;;100601000;148630000;205634000
CFI;209337;USD;2015;Q4;2015-04-30;2015-07-17;12257000;12474000;42146000;23481000;46531000;114790000;39973000;4025000;16354000;60352000;175142000;36320000;;36320000;;10010000;46330000;44409000;;84547000;128812000;175142000
CFI;209337;USD;2014;Q4;2014-04-30;2014-09-12;12349000;12528000;35597000;27409000;40674000;112375000;31376000;765000;16419000;48560000;160935000;36586000;2200000;38786000;2786000;10405000;49191000;43544000;;68260000;111744000;160935000
CFI;209337;USD;2013;Q4;2013-04-30;2014-07-11;;;35597000;27409000;40674000;112375000;31376000;765000;16419000;48560000;160935000;36586000;2200000;38786000;2786000;10405000;49191000;43544000;;68260000;111744000;160935000
CFI;209337;USD;2012;Q4;2012-04-30;2013-07-12;;;28816000;23392000;38418000;100746000;30594000;;13366000;43960000;144706000;34696000;2200000;36896000;4961000;12227000;49123000;42512000;;53017000;95583000;144706000
CFI;209337;USD;2011;Q4;2011-04-30;2012-07-12;12514000;12711000;30964000;25055000;36373000;96863000;31279000;;16574000;47853000;144716000;40795000;2404000;43239000;7608000;12477000;55716000;46691000;;42293000;89000000;144716000
CFI;209337;USD;2010;Q4;2010-04-30;2011-09-09;13029000;13278000;30880000;20209000;28723000;82635000;30296000;;17120000;47416000;130051000;33274000;2412000;35812000;9135000;13898000;49710000;51344000;;28997000;80341000;130051000
CFI;209337;USD;2019;Q4;2019-04-30;2019-07-12;12385000;12576000;45009000;23751000;50860000;123245000;48389000;8589000;39503000;96481000;219726000;34669000;;35192000;;20287000;55479000;44314000;;115579000;164247000;219726000
CFI;209337;USD;2018;Q4;2018-04-30;2019-07-12;12263000;12945000;49438000;26307000;53454000;132069000;51794000;13862000;20259000;85915000;217984000;39775000;;40584000;;14024000;54608000;48826000;;114635000;163376000;217984000
PSSR;210051;USD;2018;Q4;2018-10-31;2019-01-29;7696091;7696091;100856;1186664;;1486693;672601;;13054890;13727491;15214184;2179300;;5139896;;6459971;11599867;17430254;-1933678;-11882259;3614317;15214184
PSSR;210051;USD;2017;Q4;2017-10-31;2018-02-13;7696121;7696121;275146;1359447;;1886282;852147;;15067416;15919563;17805845;2257539;;5082424;;4270831;9353255;16784141;-1933678;-6397873;8452590;17805845
PSSR;210051;USD;2016;Q4;2016-10-31;2017-01-10;7690240;7715551;1523655;1073498;;3233452;1187158;;14530181;15717339;18950791;1292659;;4432951;;3123346;7556297;16167519;-1895428;-2877597;11394494;18950791
PSSR;210051;USD;2015;Q4;2015-10-31;2016-01-21;7652955;7699375;925508;1234986;;2870095;1353532;;15485772;16839304;19709399;1858719;;4538963;;3697336;8236299;15748080;-1895428;-2379552;11473100;19709399
PSSR;210051;USD;2014;Q4;2014-10-31;2015-01-28;7529996;7629258;648727;1368758;;2718947;1323349;;14450569;15773918;18492865;1483945;;3463818;;3955559;7419377;15355779;-1623475;-2658816;11073488;18492865
PSSR;210051;USD;2013;Q4;2013-10-31;2014-01-29;7346066;7423446;454650;1637844;;3194225;1346868;;13738612;15085480;18279705;1284457;;3215831;;4500602;7716433;15193905;-1623475;-3007158;10563272;18279705
PSSR;210051;USD;2012;Q4;2012-10-31;2013-01-29;7193288;7939118;261053;1475665;;2452110;1044463;;14619194;15663657;18115767;1395885;;2874026;;4954824;7828850;15199452;-1623475;-3289060;10286917;18115767
PSSR;210051;USD;2011;Q4;2011-10-31;2012-01-13;7232909;8012043;299455;1402521;;2532759;371330;;12214114;12585444;15118203;1668883;;2949717;;5003619;7953336;14938879;-1623475;-6150537;7164867;15118203
PSSR;210051;USD;2010;Q4;2010-10-31;2011-09-14;4662962;5246299;107069;1853901;;2230072;158737;;10889837;11048574;13278646;2327471;;3831221;;15042678;18873899;4812695;-1623475;-8784473;-5595253;13278646
PRXL;210352;USD;2016;Q4;2016-06-30;2016-09-09;52800000;53300000;248600000;506100000;;1181200000;259300000;;595700000;855000000;2036200000;310200000;16600000;769400000;484800000;633400000;1402800000;31900000;;737500000;633400000;2036200000
PRXL;210352;USD;2015;Q4;2015-06-30;2015-08-25;55200000;55900000;207400000;460600000;;1062000000;241200000;;561800000;803000000;1865000000;300600000;8900000;709500000;345400000;490200000;1199700000;38300000;;722900000;665300000;1865000000
PRXL;210352;USD;2014;Q4;2014-06-30;2014-08-20;56516000;57537000;283812000;497109000;;1122132000;234164000;;477704000;711868000;1834000000;313741000;12501000;771232000;334443000;485087000;1256319000;547000;;575044000;577681000;1834000000
PRXL;210352;USD;2013;Q4;2013-06-30;2013-08-22;56746000;57849000;274164000;457155000;;1077457000;224225000;;477942000;702167000;1779624000;245733000;20399000;674228000;424074000;566450000;1240678000;114334000;;454650000;538946000;1779624000
PRXL;210352;USD;2012;Q4;2012-06-30;2012-08-27;59895000;60882000;213579000;649217000;;942964000;207778000;;381414000;589192000;1532156000;219575000;5003000;583374000;211784000;339107000;922481000;280136000;;358678000;609675000;1532156000
PRXL;210352;USD;2011;Q4;2011-06-30;2011-08-26;58897000;60342000;89056000;649643000;;807578000;201342000;;420563000;621905000;1429483000;151904000;5867000;490280000;240102000;373199000;863479000;251629000;;295520000;566004000;1429483000
PRXL;210352;USD;2010;Q4;2010-06-30;2010-11-09;174316932;176771743;107413000;478926000;;651113000;187888000;;381709000;569597000;1220710000;168553000;32082000;483615000;183707000;297540000;781155000;234255000;;246734000;439555000;1220710000
PRXL;210352;USD;2017;Q4;2017-06-30;2017-08-29;50600000;51200000;302700000;588200000;;1280400000;252100000;;780900000;1033000000;2313400000;353200000;29200000;880400000;642300000;798500000;1678900000;22500000;;732200000;634500000;2313400000
PRCP;210612;USD;2018;Q4;2018-06-30;2018-08-30;9393000;9526000;6707000;31797000;13829000;54006000;6613000;725000;12860000;20198000;74204000;15771000;175000;25838000;;2768000;28606000;48206000;;-510000;45598000;74204000
PRCP;210612;USD;2017;Q4;2017-06-30;2017-09-07;9376000;9341000;5276000;31776000;11466000;50638000;7377000;725000;11875000;19977000;70615000;15309000;1705000;28155000;;2625000;30780000;46782000;;-4226000;39835000;70615000
PRCP;210612;USD;2016;Q4;2016-06-30;2016-09-09;9388000;9388000;8261000;23627000;12172000;46709000;7926000;770000;12517000;21213000;67922000;15129000;200000;25383000;;3985000;29368000;45832000;;-4058000;38554000;67922000
PRCP;210612;USD;2015;Q4;2015-06-30;2015-09-14;9348000;9203000;15636000;29182000;11898000;61419000;6840000;827000;25852000;33519000;94938000;17736000;0;28441000;;5705000;34146000;45108000;;18055000;60792000;94938000
PRCP;210612;USD;2014;Q4;2014-06-30;2014-09-15;9148000;9821000;33892000;19185000;7049000;63740000;5540000;725000;10061000;16326000;80066000;9715000;;17286000;;;17286000;43691000;;18516000;62780000;80066000
PRCP;210612;USD;2013;Q4;2013-06-30;2013-09-27;8581000;8624000;26685000;21499000;6783000;58038000;5578000;725000;9298000;15601000;73639000;10754000;;16744000;;;16744000;39528000;;17461000;56895000;73639000
PRCP;210612;USD;2012;Q4;2012-06-30;2012-09-28;8399000;8184000;24211000;14922000;5396000;50473000;5497000;2192000;8647000;16336000;66809000;5295000;;14550000;;;14550000;38485000;;14667000;52259000;66809000
PRCP;210612;USD;2011;Q4;2011-06-30;2011-11-14;8657000;9001000;24802000;14558000;5685000;54860000;5559000;2192000;7380000;15131000;69991000;6359000;;14511000;;;14511000;39374000;;15000000;55480000;69991000
KFY;211211;USD;2017;Q4;2017-04-30;2018-06-28;55267000;56638000;535141000;384996000;;1014259000;119901000;220709000;933045000;1273655000;2287914000;533549000;24911000;558460000;211311000;509839000;1068299000;683942000;;572800000;1219615000;2287914000
KFY;211211;USD;2016;Q4;2016-04-30;2017-06-28;55844000;57339000;415245000;345314000;;843674000;109567000;182231000;927426000;1219224000;2062898000;438825000;19754000;458579000;236222000;517271000;975850000;692527000;;461976000;1087048000;2062898000
KFY;211211;USD;2015;Q4;2015-04-30;2016-06-28;56011000;57337000;284590000;315975000;;664274000;95436000;181332000;957558000;1234326000;1898600000;446264000;30000000;476264000;110000000;375035000;851299000;702098000;;401113000;1047301000;1898600000
KFY;211211;USD;2014;Q4;2014-04-30;2015-06-26;49288000;50009000;406595000;188543000;;637158000;62088000;153682000;464873000;680643000;1317801000;306010000;;306010000;;196542000;502552000;463839000;;392033000;815249000;1317801000
KFY;211211;USD;2013;Q4;2013-04-30;2014-06-27;48524000;50064000;343283000;175986000;;561954000;60434000;154823000;456455000;671712000;1233666000;286933000;;286933000;;190709000;477642000;449631000;;308781000;756024000;1233666000
KFY;211211;USD;2012;Q4;2012-04-30;2013-06-25;47450000;48028000;244413000;161508000;;447100000;53628000;149945000;464556000;668129000;1115229000;268551000;;268551000;;181711000;450262000;431508000;;236090000;664967000;1115229000
KFY;211211;USD;2011;Q4;2011-04-30;2012-06-22;46592000;47286000;322941000;126579000;;500067000;49808000;132925000;331889000;514622000;1014689000;221724000;;221724000;;162979000;384703000;419998000;;202797000;629986000;1014689000
KFY;211211;USD;2010;Q4;2010-04-30;2011-06-29;45699000;46727000;267724000;128859000;;441597000;43142000;145295000;341646000;530083000;971680000;233866000;;233866000;;158957000;392823000;404703000;;148494000;578857000;971680000
KFY;211211;USD;2009;Q4;2009-04-30;2010-09-09;44784000;46950000;223347000;107215000;;380864000;24963000;94762000;326509000;446234000;827098000;198083000;;198083000;;137144000;335227000;388717000;;90220000;491871000;827098000
KFY;211211;USD;2018;Q4;2018-04-30;2019-06-28;55172000;57014000;634648000;404857000;;1136810000;131505000;155147000;911390000;1198042000;2334852000;550958000;;550958000;222878000;540507000;1091465000;656463000;;660845000;1243387000;2334852000
WEN;217619;USD;2016;Q4;2016-12-31;2017-03-02;251731000;257025000;198240000;98825000;2851000;452532000;1192339000;56981000;2237462000;3486782000;3939314000;129669000;24652000;230081000;2487630000;3181497000;3411578000;2925631000;-2043797000;-290857000;527736000;3939314000
WEN;217619;USD;2015;Q4;2015-12-31;2016-03-03;269466000;274199000;327216000;104854000;4312000;616569000;1227944000;58369000;2205838000;3492151000;4108720000;178085000;23290000;268774000;2402823000;3087032000;3355806000;2921794000;-1741425000;-356632000;752914000;4108720000
WEN;217619;USD;2014;Q4;2014-12-31;2015-02-26;365497000;371052000;267112000;68211000;6861000;562102000;1241170000;74054000;2260273000;3575497000;4137599000;203189000;53202000;340224000;1384972000;2079799000;2420023000;2874007000;-679220000;-445917000;1717576000;4137599000
WEN;217619;USD;2013;Q4;2013-12-31;2014-02-27;392089000;408563000;580152000;62885000;10226000;922411000;1165487000;83197000;2191945000;3440629000;4363040000;243800000;38543000;349526000;1425285000;2084028000;2433554000;2841487000;-409449000;-492215000;1929486000;4363040000
WEN;217619;USD;2012;Q4;2012-12-31;2013-02-28;391015000;395901000;453361000;61164000;13805000;709827000;1250338000;113283000;2229751000;3593372000;4303199000;208174000;12911000;286862000;1444651000;2030482000;2317344000;2829807000;-382926000;-467007000;1985855000;4303199000
WEN;217619;USD;2011;Q4;2011-12-31;2012-03-01;389023000;393062000;475231000;68349000;12903000;735397000;1192200000;119271000;2242261000;3553732000;4289129000;259599000;6597000;336743000;1350402000;1956317000;2293060000;2826913000;-395947000;-434999000;1996069000;4289129000
WEN;217619;USD;2010;Q4;2010-12-31;2011-03-03;418084000;418858000;512508000;84258000;22694000;754788000;1551261000;107223000;2319382000;3977866000;4732654000;326518000;18415000;421486000;1553987000;2147994000;2569480000;2818168000;-249547000;-412464000;2163174000;4732654000
WEN;217619;USD;2009;Q4;2009-12-31;2010-08-12;;;591719000;88004000;23024000;878992000;1619248000;107020000;2370156000;4096424000;4975416000;372544000;22127000;475147000;1500784000;2163930000;2639077000;2808475000;-85971000;-380480000;2336339000;4975416000
WEN;217619;USD;2017;Q4;2017-12-31;2018-02-28;241495000;257919000;171447000;114390000;3156000;404353000;1263059000;56002000;2373524000;3692585000;4096938000;134388000;30172000;227162000;2724230000;3296573000;3523735000;2932997000;-2150307000;-163289000;573203000;4096938000
WEN;217619;USD;2018;Q4;2018-12-31;2019-02-27;234573000;240515000;431405000;109805000;3687000;665718000;1213236000;47660000;2365421000;3626317000;4292035000;172377000;31655000;284185000;2752783000;3359401000;3643586000;2931738000;-2367893000;146277000;648449000;4292035000
Cost;217867;USD;2017;Q4;2017-09-30;2017-10-18;437797000;441510000;5779000000;1432000000;9834000000;17317000000;18161000000;;869000000;19030000000;36347000000;12311000000;86000000;17495000000;6573000000;7773000000;25268000000;5804000000;;5988000000;11079000000;36347000000
Cost;217867;USD;2016;Q4;2016-09-30;2016-10-12;437535000;441041000;4729000000;1252000000;8969000000;15218000000;17043000000;;902000000;17945000000;33163000000;10241000000;1100000000;15575000000;4061000000;5256000000;20831000000;5492000000;;7686000000;12332000000;33163000000
Cost;217867;USD;2015;Q4;2015-09-30;2015-10-14;438606000;442626000;6419000000;1224000000;8908000000;16779000000;15401000000;;837000000;16238000000;33017000000;11479000000;1283000000;16539000000;4852000000;5635000000;22174000000;5220000000;;6518000000;10843000000;33017000000
Cost;217867;USD;2014;Q4;2014-09-30;2014-10-15;437580000;441971000;7315000000;1148000000;8456000000;17588000000;14830000000;;606000000;15436000000;33024000000;10722000000;0;14412000000;5093000000;6097000000;20509000000;4921000000;;7458000000;12515000000;33024000000
Cost;217867;USD;2013;Q4;2013-09-30;2013-10-16;437078000;442813000;6124000000;1201000000;7894000000;15840000000;13881000000;;562000000;14443000000;30283000000;10291000000;;13257000000;4998000000;6014000000;19271000000;4672000000;;6283000000;11012000000;30283000000
Cost;217867;USD;2012;Q4;2012-09-30;2012-10-19;431932000;438243000;4854000000;1026000000;7096000000;13526000000;12961000000;;653000000;13614000000;27140000000;9532000000;;12260000000;1381000000;2362000000;14622000000;4371000000;;7834000000;12518000000;27140000000
Cost;217867;USD;2011;Q4;2011-09-30;2011-10-14;436718000;444260000;5613000000;965000000;6638000000;13706000000;12432000000;;623000000;13055000000;26761000000;8637000000;900000000;12050000000;1253000000;2138000000;14188000000;4518000000;;7111000000;12573000000;26761000000
Cost;217867;USD;2010;Q4;2010-09-30;2010-10-18;436512000;443722000;4749000000;884000000;5638000000;11708000000;11314000000;;793000000;12107000000;23815000000;7840000000;26000000;10063000000;2141000000;2822000000;12885000000;4117000000;;6590000000;10930000000;23815000000
Cost;217867;USD;2009;Q4;2009-09-30;2009-12-18;435671000;441598000;3727000000;834000000;5405000000;10337000000;10900000000;;742000000;11642000000;21979000000;7170000000;96000000;9281000000;2130000000;2594000000;11875000000;3813000000;;6101000000;10104000000;21979000000
Cost;217867;USD;2018;Q4;2018-09-30;2018-10-26;438333000;443202000;7259000000;1669000000;11040000000;20289000000;19681000000;;860000000;20541000000;40830000000;14231000000;;19926000000;6487000000;7801000000;27727000000;6111000000;;7887000000;13103000000;40830000000
HDS;218138;USD;2016;Q4;2017-02-28;2017-03-14;199889000;205207000;75000000;559000000;606000000;1847000000;253000000;;3607000000;3860000000;5707000000;418000000;14000000;843000000;3798000000;3904000000;4747000000;3964000000;-20000000;-2969000000;960000000;5707000000
HDS;218138;USD;2015;Q4;2016-02-29;2016-03-18;198275000;201161000;269000000;872000000;770000000;1983000000;310000000;;3723000000;4033000000;6016000000;632000000;9000000;871000000;4302000000;4401000000;5272000000;3911000000;-1000000;-3150000000;744000000;6016000000
HDS;218138;USD;2014;Q4;2015-02-28;2015-03-24;194474000;182384000;85000000;868000000;784000000;2298000000;340000000;;3339000000;3679000000;5977000000;654000000;34000000;1135000000;5140000000;5602000000;6737000000;3820000000;-12000000;-4540000000;-760000000;5977000000
HDS;218138;USD;2013;Q4;2014-02-28;2014-03-25;191859000;186217000;115000000;1046000000;1072000000;2303000000;405000000;;3616000000;4021000000;6324000000;813000000;10000000;1093000000;5534000000;5995000000;7088000000;3754000000;;-4503000000;-764000000;6324000000
HDS;218138;USD;2012;Q4;2013-02-28;2013-09-10;130579000;130579000;141000000;1008000000;987000000;3163000000;395000000;;3776000000;4171000000;7334000000;853000000;899000000;2043000000;6430000000;6882000000;8925000000;2696000000;;-4285000000;-1591000000;7334000000
HDS;218138;USD;2017;Q4;2018-02-28;2018-03-13;184833000;186049000;558000000;612000000;674000000;1875000000;325000000;;2118000000;2443000000;4318000000;472000000;11000000;621000000;2090000000;2231000000;2852000000;4031000000;-582000000;-1966000000;1466000000;4318000000
HDS;218138;USD;2018;Q4;2019-02-28;2019-03-19;174348000;175160000;38000000;732000000;766000000;1586000000;370000000;;2277000000;2647000000;4233000000;476000000;11000000;746000000;2129000000;2206000000;2952000000;4069000000;-1186000000;-1572000000;1281000000;4233000000
PEP;218222;USD;2016;Q4;2016-12-31;2017-02-15;1429000000;1441000000;16125000000;6694000000;2723000000;26450000000;16591000000;1950000000;28499000000;47040000000;73490000000;14243000000;6892000000;21135000000;30053000000;41156000000;62291000000;4115000000;-31660000000;52518000000;11199000000;73490000000
PEP;218222;USD;2015;Q4;2015-12-31;2016-02-11;1449000000;1463000000;12009000000;6437000000;2720000000;23031000000;16317000000;2311000000;28008000000;46636000000;69667000000;13507000000;4071000000;17578000000;29213000000;40059000000;57637000000;4100000000;-29371000000;50472000000;12030000000;69667000000
PEP;218222;USD;2014;Q4;2014-12-31;2015-02-12;1490000000;1511000000;8726000000;6651000000;3143000000;20663000000;17244000000;2689000000;29913000000;49846000000;70509000000;13016000000;5076000000;18092000000;23821000000;34869000000;52961000000;4140000000;-25166000000;49092000000;17548000000;70509000000
PEP;218222;USD;2013;Q4;2013-12-31;2014-02-14;1530000000;1549000000;9678000000;6954000000;3409000000;22203000000;18575000000;2623000000;34077000000;55275000000;77478000000;12533000000;5306000000;17839000000;24333000000;35250000000;53089000000;4120000000;-21175000000;46420000000;24389000000;77478000000
PEP;218222;USD;2012;Q4;2012-12-31;2013-02-21;1541000000;1560000000;6619000000;7041000000;3581000000;18720000000;19136000000;1633000000;35149000000;55918000000;74638000000;12274000000;4815000000;17089000000;23544000000;35150000000;52239000000;4204000000;-19622000000;43158000000;22399000000;74638000000
PEP;218222;USD;2011;Q4;2011-12-31;2012-02-27;1560000000;1579000000;4425000000;6912000000;3827000000;17441000000;19698000000;1477000000;34266000000;55441000000;72882000000;11949000000;6205000000;18154000000;20568000000;33829000000;51983000000;4487000000;-18027000000;40316000000;20899000000;72882000000
PEP;218222;USD;2010;Q4;2010-12-31;2011-02-18;1582000000;1604000000;6369000000;6323000000;3372000000;17569000000;19058000000;1368000000;30158000000;50584000000;68153000000;10994000000;4898000000;15892000000;19999000000;30785000000;46677000000;4558000000;-16895000000;37090000000;21476000000;68153000000
PEP;218222;USD;2009;Q4;2009-12-31;2010-02-22;1561000000;1589000000;4135000000;4624000000;2618000000;12571000000;12671000000;4484000000;10122000000;27277000000;39848000000;8292000000;464000000;8756000000;7400000000;13650000000;22406000000;280000000;-13528000000;33805000000;17442000000;39848000000
PEP;218222;USD;2008;Q4;2008-12-31;2009-10-08;;;2277000000;4683000000;2522000000;10806000000;11663000000;3883000000;9642000000;25188000000;35994000000;8418000000;369000000;8787000000;7858000000;14625000000;23412000000;381000000;-14260000000;30638000000;12582000000;35994000000
PEP;218222;USD;2017;Q4;2017-12-31;2018-02-13;1419000000;1433000000;19510000000;7024000000;2947000000;31027000000;17240000000;2042000000;29495000000;48777000000;79804000000;15017000000;5485000000;20502000000;33796000000;48321000000;68823000000;4020000000;-32954000000;52839000000;10981000000;79804000000
PEP;218222;USD;2018;Q4;2018-12-31;2019-02-15;1409000000;1420000000;8993000000;7142000000;3128000000;21893000000;17589000000;2409000000;35757000000;55755000000;77648000000;18112000000;4026000000;22138000000;28295000000;40908000000;63046000000;3976000000;-34286000000;59947000000;14602000000;77648000000
CSC;218339;USD;2016;Q4;2017-03-31;2016-06-15;141170000;133990000;1263000000;1643000000;;3247000000;903000000;;4513000000;5416000000;8663000000;1694000000;738000000;2950000000;2225000000;3547000000;6497000000;2717000000;-497000000;-170000000;2166000000;8663000000
CSC;218339;USD;2015;Q4;2016-03-31;2015-06-08;138040000;141510000;1178000000;1831000000;;3412000000;1025000000;;3299000000;4324000000;7736000000;1389000000;710000000;2608000000;1934000000;3096000000;5704000000;2588000000;-485000000;33000000;2032000000;7736000000
CSC;218339;USD;2014;Q4;2015-03-31;2014-08-12;125604000;117667000;2443000000;2759000000;;5628000000;2031000000;;3730000000;5761000000;11389000000;2157000000;681000000;3462000000;2207000000;3983000000;7445000000;2459000000;-418000000;1592000000;3944000000;11389000000
CSC;218339;USD;2013;Q4;2014-03-31;2014-05-22;;;2443000000;2759000000;;5628000000;2031000000;;3730000000;5761000000;11389000000;2157000000;681000000;3462000000;2207000000;3983000000;7445000000;2459000000;-418000000;1592000000;3944000000;11389000000
CSC;218339;USD;2012;Q4;2013-03-31;2013-05-15;;;2054000000;3199000000;;5673000000;2184000000;;3394000000;5578000000;11251000000;2485000000;234000000;3349000000;2498000000;4742000000;8091000000;2326000000;-401000000;1101000000;3160000000;11251000000
CSC;218339;USD;2011;Q4;2012-03-31;2011-06-15;309941846;309941845;1093000000;3257000000;;4883000000;2441000000;;3865000000;6306000000;11189000000;2663000000;1254000000;4536000000;1486000000;3819000000;8355000000;2332000000;-390000000;1930000000;2834000000;11189000000
CSC;218339;USD;2010;Q4;2011-03-31;2010-05-21;;;1837000000;3719000000;;7557000000;2496000000;;6067000000;8563000000;16120000000;3021000000;170000000;4178000000;2409000000;4382000000;8560000000;2283000000;-385000000;6296000000;7560000000;16120000000
CSC;218339;USD;2009;Q4;2010-03-31;2009-08-07;;;2297000000;3786000000;;7707000000;2353000000;;5559000000;7912000000;15619000000;3039000000;62000000;4016000000;4173000000;5985000000;10001000000;1996000000;-375000000;4893000000;5618000000;15619000000
CLX;218764;USD;2017;Q4;2017-06-30;2017-08-15;129114000;131934000;418000000;565000000;459000000;1514000000;931000000;;2128000000;3059000000;4573000000;1005000000;804000000;1809000000;1391000000;2222000000;4031000000;1087000000;-2442000000;2440000000;542000000;4573000000
CLX;218764;USD;2016;Q4;2016-06-30;2016-08-16;129500000;132455000;401000000;569000000;443000000;1485000000;906000000;;2119000000;3025000000;4510000000;1035000000;523000000;1558000000;1789000000;2655000000;4213000000;1027000000;-2323000000;2163000000;297000000;4510000000
CLX;218764;USD;2015;Q4;2015-06-30;2015-08-21;129540000;132801000;382000000;519000000;385000000;1429000000;918000000;;1817000000;2735000000;4164000000;979000000;395000000;1405000000;1796000000;2641000000;4046000000;934000000;-2237000000;1923000000;118000000;4164000000
CLX;218764;USD;2014;Q4;2014-06-30;2014-08-25;129004000;130898000;329000000;546000000;386000000;1395000000;977000000;;1886000000;2863000000;4258000000;912000000;718000000;1638000000;1595000000;2466000000;4104000000;868000000;-2036000000;1739000000;154000000;4258000000
CLX;218764;USD;2013;Q4;2013-06-30;2013-08-23;131422000;134255000;299000000;580000000;394000000;1420000000;1021000000;;1870000000;2891000000;4311000000;903000000;202000000;1134000000;2170000000;3031000000;4165000000;820000000;-1868000000;1561000000;146000000;4311000000
CLX;218764;USD;2012;Q4;2012-06-30;2012-08-24;261898032;265141389;267000000;576000000;384000000;1376000000;1081000000;;1898000000;2979000000;4355000000;906000000;1150000000;2061000000;1571000000;2429000000;4490000000;792000000;-1881000000;1350000000;-135000000;4355000000
CLX;218764;USD;2011;Q4;2011-06-30;2011-08-26;132279000;135105000;259000000;525000000;382000000;1279000000;1039000000;;1845000000;2884000000;4163000000;865000000;459000000;1365000000;2125000000;2884000000;4249000000;791000000;-1770000000;1143000000;-86000000;4163000000
CLX;218764;USD;2010;Q4;2010-06-30;2010-08-26;140278000;141733000;87000000;540000000;332000000;1489000000;966000000;;2093000000;3059000000;4548000000;900000000;671000000;1645000000;2124000000;2820000000;4465000000;776000000;-1242000000;920000000;83000000;4548000000
CLX;218764;USD;2009;Q4;2009-06-30;2009-11-03;277622543;280185140;206000000;486000000;366000000;1180000000;955000000;;2441000000;3396000000;4576000000;853000000;998000000;1937000000;2151000000;2814000000;4751000000;738000000;-1206000000;640000000;-175000000;4576000000
CLX;218764;USD;2018;Q4;2018-06-30;2018-08-14;129100000;131260000;131000000;600000000;506000000;1311000000;996000000;;2753000000;3749000000;5060000000;1001000000;199000000;1200000000;2284000000;3134000000;4334000000;1134000000;-2658000000;2797000000;726000000;5060000000
SCX;218861;USD;2017;Q4;2017-06-30;2017-08-25;7056000;7139000;14607000;30425000;58097000;110123000;39345000;;43197000;82542000;192665000;19225000;11514000;30739000;6095000;69900000;100639000;62609000;;79402000;92026000;192665000
SCX;218861;USD;2016;Q4;2016-06-30;2016-08-24;7019000;6980000;19794000;34367000;56321000;120911000;41010000;;39677000;80687000;201598000;20275000;1543000;21818000;17109000;88267000;110085000;62250000;;81228000;91513000;201598000
SCX;218861;USD;2015;Q4;2015-06-30;2015-08-25;7001000;7036000;18963000;40311000;63003000;133413000;44413000;;34446000;78859000;212272000;22047000;1552000;23599000;18552000;74243000;97842000;61882000;;98164000;114430000;212272000
SCX;218861;USD;2014;Q4;2014-06-30;2014-09-10;6947000;6927000;24956000;43712000;65582000;146902000;51537000;;33004000;84541000;231443000;25138000;10548000;35686000;10804000;59443000;95129000;61024000;;95715000;136314000;231443000
SCX;218861;USD;2013;Q4;2013-06-30;2013-09-05;6812000;6769000;27412000;37875000;56501000;133948000;51200000;;45646000;96846000;230794000;22388000;1557000;23945000;24252000;80107000;104052000;59440000;;91778000;126742000;230794000
SCX;218861;USD;2012;Q4;2012-06-30;2012-09-12;6770000;6854000;23784000;42167000;69895000;151230000;53597000;;47339000;100936000;252166000;28211000;1800000;30011000;29387000;94317000;124328000;58711000;;94661000;127838000;252166000
SCX;218861;USD;2011;Q4;2011-06-30;2011-11-08;6719000;6731000;27993000;45567000;58789000;143943000;56265000;;26971000;83236000;227179000;29159000;8238000;37397000;721000;37121000;74518000;58145000;;96477000;152661000;227179000
SCX;218861;USD;2018;Q4;2018-06-30;2018-08-24;7019000;6956000;14827000;33089000;58039000;113228000;36514000;;32544000;69058000;182286000;22532000;3655000;26187000;17307000;68228000;94415000;62663000;;74368000;87871000;182286000
SCX;218861;USD;2019;Q4;2019-06-30;2019-08-26;6893000;6995000;15582000;35980000;61790000;119975000;36679000;;33433000;70112000;190087000;28615000;4065000;32680000;17541000;74028000;106708000;62173000;;80487000;83379000;190087000
ESP;230667;USD;2017;Q4;2017-06-30;2017-09-14;2321992;2328965;19485131;3399613;9678811;33228599;2265096;;;2265096;35493695;2297054;;3375581;;220571;3596152;18660293;-7779099;21670196;31897543;35493695
ESP;230667;USD;2016;Q4;2016-06-30;2016-09-12;2322690;2335530;15611703;4957464;10733681;32104392;2348525;;;2348525;34452917;602140;;1861442;;203237;2064679;18263030;-7803239;22820938;32388238;34452917
ESP;230667;USD;2015;Q4;2015-06-30;2015-09-24;2278190;2313339;13018462;6694401;11585897;31845381;2498863;;;2498863;34344244;1616582;;3188619;;224751;3413370;17795562;-7582296;21865951;30930874;34344244
ESP;230667;USD;2014;Q4;2014-06-30;2014-09-17;2258205;2284238;14467784;3194678;10611250;29719545;2678901;;;2678901;32398446;780834;;2468062;;283439;2751501;17439178;-7328864;20946940;29646945;32398446
ESP;230667;USD;2013;Q4;2013-06-30;2013-09-12;2222543;2249887;13781596;7204226;11373770;33094421;2421332;;25194;2446526;35540947;1754496;;3502968;;195385;3698353;16789967;-7522079;24260121;31842594;35540947
ESP;230667;USD;2012;Q4;2012-06-30;2012-09-13;2178913;2219137;14708135;3217875;11645706;30195036;2523196;;67371;2590567;32785603;1427519;;2995651;;222504;3218155;16103470;-7616432;23053762;29567448;32785603
ESP;230667;USD;2011;Q4;2011-06-30;2011-11-09;2154628;2184466;11642025;6266765;10579060;29057307;2703014;;108303;2811317;31868624;1775538;;2932876;;270729;3203605;15684147;-7523282;22780026;28665019;31868624
SHOR;231330;USD;2016;Q4;2016-06-30;2016-09-12;67284000;63682000;108159000;32902000;12488000;166969000;21551000;;153818000;175369000;342338000;58171000;;114936000;;24673000;139609000;379871000;-819000;-176359000;202729000;342338000
SHOR;231330;USD;2015;Q4;2015-06-30;2015-09-11;64820000;63216000;90187000;36494000;15053000;156049000;20419000;;149988000;170407000;326456000;61039000;;111655000;;24673000;136328000;361691000;0;-171567000;190128000;326456000
SHOR;231330;USD;2014;Q4;2014-06-30;2014-09-11;185098442;185098442;56145000;33758000;26501000;130001000;19601000;;154348000;173949000;303950000;46901000;;106024000;;20533000;126557000;344546000;;-167154000;177393000;303950000
SHOR;231330;USD;2013;Q4;2013-06-30;2013-09-12;59025000;59025000;51276000;37118000;18891000;119979000;15625000;;164183000;179808000;299787000;40715000;3577000;95296000;29004000;48351000;143647000;322260000;;-166118000;156140000;299787000
SHOR;231330;USD;2012;Q4;2012-06-30;2012-09-13;57764000;57764000;55495000;34198000;20212000;121750000;10495000;;170908000;181403000;303153000;37982000;9398000;91061000;19946000;41860000;132921000;310646000;;-140416000;170232000;303153000
SHOR;231330;USD;2011;Q4;2011-06-30;2011-11-09;;;105752000;33812000;19062000;162166000;8236000;;16699000;24935000;187101000;25949000;0;52311000;0;13366000;65677000;241063000;;-119679000;121424000;187101000
SHOR;231330;USD;2017;Q4;2017-06-30;2017-09-08;68512000;68512000;115888000;31393000;11624000;171924000;19066000;;148462000;167528000;339452000;46384000;;111522000;;25737000;137259000;394184000;-3117000;-188802000;202193000;339452000
TWIN;231580;USD;2017;Q4;2017-06-30;2017-08-31;22485750;22485750;16367000;31392000;66193000;129434000;48212000;;33252000;81464000;210898000;44523000;;44523000;6323000;42808000;87331000;10429000;-24205000;169368000;123567000;210898000
TWIN;231580;USD;2016;Q4;2016-06-30;2016-09-13;22290793;22290793;18273000;25363000;66569000;125035000;51665000;;37222000;88887000;213922000;36131000;;36131000;8501000;60738000;96869000;11761000;-26790000;175662000;117053000;213922000
TWIN;231580;USD;2015;Q4;2015-06-30;2015-09-14;33799443;33809437;22936000;43883000;80241000;164967000;56427000;;28468000;84895000;249862000;53483000;3571000;57054000;10231000;52641000;109695000;12259000;-28057000;190807000;140167000;249862000
TWIN;231580;USD;2014;Q4;2014-06-30;2014-09-15;11269000;11281000;24757000;40219000;97579000;175318000;60267000;;31400000;91667000;266985000;53376000;3604000;56980000;14800000;57694000;114674000;11973000;-28141000;183695000;152311000;266985000
TWIN;231580;USD;2013;Q4;2013-06-30;2013-09-13;11239000;11385000;20724000;46331000;102774000;183192000;62315000;;39951000;102266000;285458000;59822000;3681000;63503000;23472000;78393000;141896000;13183000;-28890000;184110000;143562000;285458000
TWIN;231580;USD;2012;Q4;2012-06-30;2012-10-09;34221145;34659856;15701000;63438000;103178000;193416000;66356000;;44060000;110416000;303832000;62881000;3744000;66625000;28401000;100698000;167323000;12759000;-26781000;184306000;136509000;303832000
TWIN;231580;USD;2011;Q4;2011-06-30;2011-11-09;45242440;45817975;20167000;61007000;99139000;191822000;65791000;;51507000;117298000;309120000;80045000;3915000;83960000;25784000;87106000;171066000;10863000;-25252000;162857000;138054000;309120000
TWIN;231580;USD;2018;Q4;2018-06-30;2018-08-27;11314000;11680000;15171000;45422000;84001000;159269000;48940000;;26504000;75444000;234713000;62344000;;62344000;4824000;28753000;91097000;11570000;-23677000;178896000;143616000;234713000
TWIN;231580;USD;2019;Q4;2019-06-30;2019-08-29;12739000;12786000;12362000;44013000;125893000;202369000;71258000;;73243000;144501000;346870000;71077000;2000000;73077000;40491000;90975000;164052000;45047000;-21332000;196472000;182818000;346870000
DAL;231789;USD;2016;Q4;2016-12-31;2017-02-13;732000000;733000000;3249000000;2064000000;891000000;7451000000;24375000000;;19435000000;43810000000;51261000000;7834000000;1131000000;15239000000;6201000000;23735000000;38974000000;12294000000;-274000000;7903000000;12287000000;51261000000
DAL;231789;USD;2015;Q4;2015-12-31;2016-02-05;779000000;784000000;3437000000;2020000000;697000000;9056000000;23039000000;;21039000000;44078000000;53134000000;7244000000;1563000000;17526000000;6766000000;24758000000;42284000000;12936000000;-373000000;5562000000;10850000000;53134000000
DAL;231789;USD;2014;Q4;2014-12-31;2015-02-11;825000000;834000000;3305000000;2297000000;852000000;9158000000;21929000000;;22918000000;44847000000;54005000000;7015000000;1184000000;16847000000;8477000000;28345000000;45192000000;12981000000;-313000000;3456000000;8813000000;54005000000
DAL;231789;USD;2013;Q4;2013-12-31;2014-02-24;847000000;857000000;3803000000;1609000000;1063000000;9651000000;21854000000;;20747000000;42601000000;52252000000;6476000000;1547000000;14152000000;9795000000;26457000000;40609000000;13982000000;-258000000;3049000000;11643000000;52252000000
DAL;231789;USD;2012;Q4;2012-12-31;2013-02-13;846000000;858000000;3374000000;1693000000;1023000000;8272000000;20713000000;;15565000000;36278000000;44550000000;5101000000;2082000000;13270000000;11082000000;33411000000;46681000000;14069000000;-234000000;-7389000000;-2131000000;44550000000
DAL;231789;USD;2011;Q4;2011-12-31;2012-02-10;839000000;851000000;3615000000;1563000000;535000000;7729000000;20223000000;;15547000000;35770000000;43499000000;4516000000;2262000000;12701000000;11847000000;32194000000;44895000000;13999000000;-231000000;-8398000000;-1396000000;43499000000
DAL;231789;USD;2010;Q4;2010-12-31;2011-03-04;834000000;846000000;3610000000;1456000000;318000000;7307000000;20307000000;;15574000000;35881000000;43188000000;3737000000;2073000000;11385000000;13179000000;30906000000;42291000000;13926000000;-199000000;-9252000000;897000000;43188000000
DAL;231789;USD;2009;Q4;2009-12-31;2010-08-02;;;4678000000;1353000000;327000000;7991000000;20433000000;;15365000000;35798000000;43789000000;3051000000;1533000000;9797000000;15665000000;33747000000;43544000000;13827000000;-174000000;-9845000000;245000000;43789000000
DAL;231789;USD;2017;Q4;2017-12-31;2018-02-23;708000000;711000000;2639000000;2377000000;1329000000;7844000000;26563000000;;19304000000;45867000000;53711000000;8564000000;3309000000;18999000000;6592000000;22182000000;41181000000;12053000000;-158000000;8256000000;12530000000;53711000000
DAL;231789;USD;2018;Q4;2018-12-31;2019-02-15;679000000;685000000;1768000000;2314000000;1055000000;6340000000;28335000000;;25591000000;53926000000;60266000000;7380000000;3548000000;18578000000;8253000000;28001000000;46579000000;11671000000;-198000000;10039000000;13687000000;60266000000
SGMA;231993;USD;2016;Q4;2016-04-30;2017-07-24;4188212;4197997;3493324;26656871;73571238;109031913;33008714;;9145037;42153751;151185664;53041920;2062766;55611214;30557071;33702305;89313519;22994237;;38877908;61872145;151185664
SGMA;231993;USD;2015;Q4;2015-04-30;2016-07-29;4174024;4258768;4325268;17844228;67649022;94090884;33080858;;9577599;42658457;136749341;43983234;1539898;45986309;26789910;30687154;76673463;22588176;;37487702;60075878;136749341
SGMA;231993;USD;2014;Q4;2014-04-30;2015-07-27;4061031;4123876;2868217;20170723;68669709;94379147;33864527;;10082879;43947406;138326553;41653118;1410632;43489632;34654706;38151534;81641166;21280344;;35405043;56685387;138326553
SGMA;231993;USD;2013;Q4;2013-04-30;2014-07-24;3988286;4160625;5440319;19293791;53728377;80645487;32692908;;12141036;44833944;125479431;33775089;2891978;37010798;26621501;33062290;70073088;20904712;;34501631;55406343;125479431
SGMA;231993;USD;2012;Q4;2012-04-30;2013-07-26;3937790;4160404;4607731;19421252;50644741;77308698;28567052;;11713167;40280219;117588917;37468073;329657;38129159;21152238;27476027;65605186;20400791;;31582940;51983731;117588917
SGMA;231993;USD;2011;Q4;2011-04-30;2012-08-14;3908889;3955562;4668931;27916288;37838378;72298379;24373494;;2475010;26848504;99146883;24220677;346285;24566962;18981895;23558850;48125812;19931092;;31089979;51021071;99146883
SGMA;231993;USD;2010;Q4;2010-04-30;2011-09-13;3845639;3919397;4138102;23549065;45021840;74332807;26189150;;2381772;28570922;102903729;23162598;1093252;24255850;25346022;28904302;53160152;19787921;;29955656;49743577;102903729
SGMA;231993;USD;2017;Q4;2017-04-30;2018-07-24;4214939;3869068;1721599;26638367;86929793;120029726;35288997;;5911247;41200244;161229970;56485949;2975728;59876486;41081725;42543533;102420019;23173913;;35636038;58809951;161229970
SGMA;231993;USD;2018;Q4;2018-04-30;2019-07-25;4230695;4230695;1005810;31441381;85579575;123545289;33232769;;4686707;37919476;161464765;52778645;2631075;55606766;45573738;47570550;103177316;23516525;;34770924;58287449;161464765
OCC;232540;USD;2015;Q4;2015-10-31;2016-01-28;6151797;6151797;1083072;9189498;17816080;29147426;13903919;;1977473;15881392;45028818;5362153;280999;5643152;6946008;13497116;19140268;10363012;;16267595;25888550;45028818
OCC;232540;USD;2014;Q4;2014-10-31;2014-12-19;8072710;8072710;1089507;14076349;17518119;35376606;13113445;;1548563;14662008;50038614;9031670;269996;9301666;7227023;10430658;19732324;9543686;;21462881;30306290;50038614
OCC;232540;USD;2013;Q4;2013-10-31;2013-12-20;4830700;4830700;750303;9951970;18234279;31809973;12827198;;777728;13604926;45414899;4565403;258628;4824031;7497042;11031152;15855183;8679435;;21519238;29559716;45414899
OCC;232540;USD;2012;Q4;2012-10-31;2012-12-21;6476850;6476850;591038;12601402;18464019;34764665;11648166;;1349514;12997680;47762345;7679022;247739;7926761;7755680;9800542;17727303;8024544;;22619814;30035042;47762345
OCC;232540;USD;2011;Q4;2011-10-31;2012-01-26;6302001;6302001;1091513;10797820;16497185;31523191;12544465;;877558;13422023;44945214;8006332;190593;8196925;8000311;9025314;17222239;6771565;;21437609;27722975;44945214
OCC;232540;USD;2010;Q4;2010-10-31;2011-09-12;;;2522058;10659623;14422787;30667010;13125114;;1498642;14623756;45290766;7584766;177350;7762116;8191785;9948588;17710704;5987777;;21869667;27580062;45290766
OCC;232540;USD;2017;Q4;2017-10-31;2017-12-20;6722176;6722176;891169;8940540;16781449;27103378;12210692;;825110;13035802;40139180;3946151;250726;4196877;6419607;12252781;16449658;11762021;;11927501;23689522;40139180
OCC;232540;USD;2016;Q4;2016-10-31;2016-12-20;6039516;6039516;1879064;8916245;15023966;26321883;13399158;;944747;14343905;40665788;3831895;294214;4126109;6651780;11774690;15900799;11080595;;13684394;24764989;40665788
OCC;232540;USD;2018;Q4;2018-10-31;2018-12-19;8334948;8334948;177413;12832890;17474755;31047030;11204639;;846791;12051430;43098460;6766889;260954;7027843;6158630;9259780;16287623;13816140;;12994697;26810837;43098460
PSDV;232734;USD;2018;Q4;2018-06-30;2018-09-18;55300000;55300000;38776000;353000;;39909000;253000;;31508000;31761000;71670000;6663000;;21663000;17309000;38320000;59983000;374840000;;-363991000;11687000;71670000
PSDV;232734;USD;2017;Q4;2017-06-30;2017-09-13;38658;141272342;16898000;251000;;17740000;313000;;624000;937000;18677000;5240000;;5290000;0;51000;5341000;323323000;;-310820000;13336000;18677000
PSDV;232734;USD;2016;Q4;2016-06-30;2016-05-06;34102892;34102892;28992000;488000;;29963000;290000;;1366000;1656000;31619000;4946000;;5093000;;5645000;10738000;312242000;;-292213000;20881000;31619000
PSDV;232734;USD;2015;Q4;2015-06-30;2015-05-08;29411000;32792560;28535000;622000;;29838000;338000;;2191000;2529000;32367000;3315000;;3348000;;5651000;8999000;293089000;;-270666000;23368000;32367000
PSDV;232734;USD;2014;Q4;2014-06-30;2014-05-14;29231368;29231368;18278000;517000;;19342000;297000;;3032000;3329000;22671000;1988000;;2126000;;5621000;7747000;290893000;;-277013000;14924000;22671000
PSDV;232734;USD;2013;Q4;2013-06-30;2013-05-14;23288608;23288608;10273000;597000;;12464000;179000;;3606000;3785000;16249000;2565000;;3303000;;5246000;8549000;270438000;;-263658000;7700000;16249000
PSDV;232734;USD;2012;Q4;2012-06-30;2012-05-10;20801000;20801000;14571000;967000;;15959000;335000;;4303000;4638000;20597000;1002000;;3178000;;3783000;6961000;264452000;;-251758000;13636000;20597000
PSDV;232734;USD;2011;Q4;2011-06-30;2011-11-09;20717000;20717000;24128000;843000;;25366000;123000;;21624000;21747000;47113000;1650000;;5032000;;4648000;9680000;262927000;;-226923000;37433000;47113000
EGAN;233349;USD;2016;Q4;2016-06-30;2016-09-13;27096000;27096000;11780000;11876000;;26354000;1688000;;20021000;21709000;48063000;13411000;329000;27240000;20376000;25019000;52259000;342716000;;-345249000;-4196000;48063000
EGAN;233349;USD;2015;Q4;2015-06-30;2015-09-14;26883000;26883000;8633000;13118000;;24685000;3136000;;21910000;25046000;49731000;11353000;471000;26724000;18554000;21830000;48554000;341356000;;-339009000;1177000;49731000
EGAN;233349;USD;2014;Q4;2014-06-30;2014-09-12;25460000;76183226;8785000;11163000;;20315000;4489000;;7843000;12332000;32647000;9347000;392000;24076000;4208000;5439000;29515000;330682000;;-326580000;3132000;32647000
EGAN;233349;USD;2013;Q4;2013-06-30;2013-09-23;25045000;27368000;16206000;12307000;;29318000;3544000;;10674000;14218000;43536000;9400000;;30643000;2000000;6818000;37461000;328577000;;-321334000;6075000;43536000
EGAN;233349;USD;2012;Q4;2012-06-30;2012-09-25;24448000;22612000;9911000;6535000;;17124000;2295000;;8524000;10819000;27943000;6809000;;15371000;1667000;8574000;23945000;326766000;;-322018000;3998000;27943000
EGAN;233349;USD;2011;Q4;2011-06-30;2011-11-14;24033000;25830000;13057000;8197000;;21293000;1015000;;5916000;6931000;28224000;6114000;28000;17999000;3333000;4131000;22130000;325593000;;-318699000;6094000;28224000
EGAN;233349;USD;2017;Q4;2017-06-30;2017-09-26;27113000;27113000;10627000;7201000;;20631000;1059000;;18061000;19120000;39751000;9066000;108000;28311000;14844000;20978000;49289000;343394000;;-351269000;-9538000;39751000
EGAN;233349;USD;2018;Q4;2018-06-30;2018-09-13;-81666668;27556000;11498000;7389000;;22538000;559000;;16525000;17084000;39622000;11896000;42000;30561000;8941000;17689000;48250000;346250000;;-353260000;-8628000;39622000
HOME;233408;USD;2016;Q4;2017-01-31;2017-04-05;60366768;63122804;7092000;;243795000;258877000;340358000;;614158000;954516000;1213393000;140129000;3691000;252477000;299606000;426046000;678523000;548905000;;-14035000;534870000;1213393000
HOME;233408;USD;2015;Q4;2016-01-31;2016-09-13;50836727;54420827;5428000;;176388000;191396000;272776000;;590638000;863414000;1054810000;85611000;3789000;170518000;422610000;515139000;685657000;410254000;;-41101000;369153000;1054810000
HOME;233408;USD;2017;Q4;2018-01-31;2018-03-23;60816801;65133188;8525000;;269844000;300933000;466263000;;607045000;1073308000;1374241000;169127000;3474000;343673000;289902000;439689000;783362000;573102000;;17777000;590879000;1374241000
HOME;233408;USD;2018;Q4;2019-01-31;2019-03-27;63601148;69813759;10951000;;382023000;414549000;682663000;;628994000;1311657000;1726206000;233329000;4049000;469752000;336435000;545368000;1015120000;644313000;;66773000;711086000;1726206000
MMMB;233893;USD;2016;Q4;2017-01-31;2016-04-21;26301388;26301388;666580;1817820;443623;5143478;1175508;;;1175508;6318986;484752;1401906;3389807;1812147;1929803;5319610;15825308;-149500;-14676432;999376;6318986
MMMB;233893;USD;2015;Q4;2016-01-31;2015-05-01;25971250;25971250;587422;1476582;252752;4719995;1047455;;;1047455;5767450;894551;2806808;4754360;389767;389767;5144127;14955194;-149500;-14182371;623323;5767450
MMMB;233893;USD;2014;Q4;2015-01-31;2014-06-12;;;1541640;1029632;159829;4244648;978027;;46264;1024291;5268939;595297;;818001;0;0;818001;10994223;;-6543285;4450938;5268939
MMMB;233893;USD;2013;Q4;2014-01-31;2014-03-20;24132056;24132056;1741935;1063849;112279;4194615;929496;;;929496;5124111;823044;;823044;;0;823044;10600708;;-6299641;4301067;5124111
MMMB;233893;USD;2012;Q4;2013-01-31;2012-10-01;19325427;19341461;2008161;463565;76570;2964630;17451;;;17451;2982081;329233;;529233;;0;529233;5804881;;-3352033;2452848;2982081
MMMB;233893;USD;2011;Q4;2012-01-31;2012-02-24;-253351656;;16505;581479;101110;881336;20015;;;20015;901351;352038;;852038;;;852038;1401723;;-1352410;49313;901351
MMMB;233893;USD;2017;Q4;2018-01-31;2018-05-16;34195704;41992483;581322;3084715;824276;4772470;2499875;;;2499875;7272345;3456918;1403082;7655702;901677;1551333;9207035;16345113;-149500;-18130303;-1934690;7272345
MMMB;233893;USD;2018;Q4;2019-01-31;2019-04-23;31868856;31082704;609409;2698562;1396400;4859549;2884594;;20177;2904771;7764320;3703776;53730;4257506;4688962;4688962;8946468;16547607;-149500;-17580255;-1182148;7764320
USAT;234192;USD;2017;Q4;2017-12-31;2017-08-23;40316704;39894926;12745000;7193000;4586000;36502000;12111000;;49078000;61189000;97691000;20194000;3230000;30699000;1061000;1214000;31913000;245999000;;-183359000;65778000;97691000
USAT;234192;USD;2016;Q4;2016-12-31;2016-09-13;37316234;36676750;19272000;4899000;2031000;30777000;9765000;;44291000;54056000;84833000;15830000;629000;28177000;1576000;1631000;29808000;233394000;;-181507000;55025000;84833000
USAT;234192;USD;2015;Q4;2015-12-31;2015-09-30;35760285;35760285;11374000;5971000;4216000;24334000;12869000;;37931000;50800000;75134000;12704000;478000;18042000;1854000;3781000;21823000;224874000;;-174701000;53311000;75134000
USAT;234192;USD;2014;Q4;2014-12-31;2014-09-29;35704986;37072146;9072320;2683579;1486777;14633527;21138580;;34992135;56130715;70764242;9690731;172911;15244537;249865;1783038;17027575;224210197;;-173611586;53736667;70764242
USAT;234192;USD;2013;Q4;2013-12-31;2013-09-30;33076723;36379415;5981000;2620684;1823615;10726079;17240065;;8610052;25850117;36576196;8769431;247152;12667221;122754;529784;13197005;221383373;;-201142238;23379191;36576196
USAT;234192;USD;2012;Q4;2012-12-31;2012-09-26;32492742;32492742;6426645;2441941;2511748;12142806;11800108;;9276743;21076851;33219657;9478899;466056;10863521;262274;701114;11564635;220513327;;-201996361;21655022;33219657
USAT;234192;USD;2011;Q4;2011-12-31;2011-11-08;;;12991511;1634719;2670332;18428381;7395775;;10179849;17575624;36004005;6726451;155428;9614132;97633;264342;9878474;219772598;;-196785123;26125531;36004005
GD;234391;USD;2016;Q4;2016-12-31;2017-02-06;302492000;308113000;2334000000;3399000000;5817000000;16534000000;3477000000;;13161000000;16638000000;33172000000;2538000000;900000000;13450000000;2988000000;9421000000;22871000000;3301000000;-14156000000;24543000000;10301000000;33172000000
GD;234391;USD;2015;Q4;2015-12-31;2016-02-08;313265000;318562000;2785000000;3446000000;3366000000;14571000000;3466000000;;13960000000;17426000000;31997000000;1964000000;501000000;12445000000;2898000000;8814000000;21259000000;3212000000;-12392000000;23204000000;10738000000;31997000000
GD;234391;USD;2014;Q4;2014-12-31;2015-02-09;330033000;337110000;4388000000;4050000000;3221000000;17407000000;3329000000;;14601000000;17930000000;35337000000;2057000000;501000000;13751000000;3392000000;9757000000;23508000000;3030000000;-9396000000;21127000000;11829000000;35337000000
GD;234391;USD;2013;Q4;2013-12-31;2014-02-07;350536000;354629000;5301000000;4370000000;2890000000;18162000000;3359000000;;13973000000;17332000000;35494000000;2216000000;1000000;12259000000;3908000000;8734000000;20993000000;2708000000;-6450000000;19428000000;14501000000;35494000000
GD;234391;USD;2012;Q4;2012-12-31;2013-02-08;350879000;343825000;3296000000;4204000000;2776000000;15744000000;3403000000;;15162000000;18565000000;34309000000;2469000000;;11620000000;3908000000;11299000000;22919000000;2470000000;-6165000000;17860000000;11390000000;34309000000
GD;234391;USD;2011;Q4;2011-12-31;2012-02-17;356237000;359431000;2649000000;4429000000;2310000000;15368000000;3284000000;;16231000000;19515000000;34883000000;2895000000;;11145000000;3907000000;10506000000;21651000000;2370000000;-5743000000;18917000000;13232000000;34883000000
GD;234391;USD;2010;Q4;2010-12-31;2011-02-18;376745000;380888000;2613000000;3848000000;2158000000;14186000000;2971000000;;15388000000;18359000000;32545000000;2736000000;773000000;11177000000;2430000000;8052000000;19229000000;2211000000;-4535000000;17076000000;13316000000;32545000000
GD;234391;USD;2009;Q4;2009-12-31;2010-02-19;385778000;390050000;2263000000;3678000000;2126000000;13249000000;2912000000;;14916000000;17828000000;31077000000;2365000000;705000000;10371000000;3159000000;8283000000;18654000000;2000000000;-3463000000;15093000000;12423000000;31077000000
GD;234391;USD;2008;Q4;2008-12-31;2009-08-04;;;1621000000;3469000000;2029000000;11950000000;2872000000;;13551000000;16423000000;28373000000;2443000000;911000000;10360000000;3113000000;7960000000;18320000000;1828000000;-3349000000;13287000000;10053000000;28373000000
GD;234391;USD;2017;Q4;2017-12-31;2018-02-12;296982000;302165000;2983000000;3617000000;5303000000;18328000000;3517000000;;13201000000;16718000000;35046000000;3207000000;2000000;13099000000;3980000000;10512000000;23611000000;3354000000;-15543000000;26444000000;11435000000;35046000000
GD;234391;USD;2018;Q4;2018-12-31;2019-02-13;293157000;296310000;963000000;3759000000;5977000000;18189000000;4348000000;;22871000000;27219000000;45408000000;3179000000;973000000;14739000000;11444000000;18937000000;33676000000;3428000000;-17244000000;29326000000;11732000000;45408000000
GILD;239284;USD;2016;Q4;2016-12-31;2017-02-27;1316000000;1326000000;11895000000;4514000000;1587000000;19588000000;2865000000;20485000000;14039000000;37389000000;56977000000;9218000000;0;9218000000;26346000000;28396000000;37614000000;455000000;;18154000000;19363000000;56977000000
GILD;239284;USD;2015;Q4;2015-12-31;2016-02-24;1433000000;1472000000;14607000000;5854000000;1955000000;24762000000;2276000000;11601000000;13077000000;26954000000;51716000000;8468000000;982000000;9890000000;21073000000;22713000000;32603000000;445000000;;18001000000;19113000000;51716000000
GILD;239284;USD;2014;Q4;2014-12-31;2015-02-25;1504000000;1607000000;10128000000;4635000000;1386000000;17714000000;1674000000;1598000000;13678000000;16950000000;34664000000;5144000000;483000000;5761000000;11921000000;13084000000;18845000000;2393000000;;12732000000;15819000000;34664000000
GILD;239284;USD;2013;Q4;2013-12-31;2014-02-25;1535578000;1728465000;2132000000;2182000000;1697000000;6997000000;1166000000;439000000;13977000000;15582000000;22579000000;3599000000;2697000000;6407000000;3939000000;4427000000;10834000000;5388000000;;6106000000;11745000000;22579000000
GILD;239284;USD;2012;Q4;2012-12-31;2013-02-27;1518756000;1631604000;1862250000;1751388000;1744982000;6156347000;1100259000;719836000;13263396000;15083491000;21239838000;2965245000;1169490000;4237897000;7054555000;7458219000;11696116000;5643463000;;3704744000;9543722000;21239838000
GILD;239284;USD;2011;Q4;2011-12-31;2012-02-23;1503314000;1533006000;9900268000;1951167000;1389983000;13918785000;774406000;63704000;2546239000;3384349000;17303134000;2438553000;1572000;2514790000;7605734000;7920995000;10435785000;4903896000;;1776760000;6867349000;17303134000
GILD;239284;USD;2010;Q4;2010-12-31;2011-02-28;1615652000;1638470000;2098668000;1621966000;1203809000;5708082000;701235000;3219403000;1963910000;5884548000;11592630000;1715430000;646345000;2464950000;2838573000;3005843000;5470793000;4649088000;;1183730000;6121837000;11592630000
GILD;239284;USD;2009;Q4;2009-12-31;2010-03-01;1799412000;1854110000;1656975000;1389534000;1051771000;4812558000;699970000;2247871000;1938160000;4886001000;9698559000;1743323000;5587000;1871631000;1155443000;1321770000;3193401000;4377551000;;1995272000;6505158000;9698559000
GILD;239284;USD;2008;Q4;2008-12-31;2009-08-05;1822180000;1884998000;1790062000;1023397000;927868000;4278408000;528799000;1449577000;680047000;2658423000;6936831000;1172398000;5631000;1220992000;1098025000;1250256000;2471248000;3931019000;;300314000;4465583000;6936831000
GILD;239284;USD;2017;Q4;2017-12-31;2018-02-27;1307000000;1320000000;25510000000;3851000000;801000000;31823000000;3295000000;11184000000;23981000000;38460000000;70283000000;8888000000;2747000000;11635000000;30795000000;38147000000;49782000000;1265000000;;19012000000;20501000000;70283000000
GILD;239284;USD;2018;Q4;2018-12-31;2019-02-26;1291000000;1297000000;30089000000;3327000000;814000000;35836000000;4006000000;1423000000;22410000000;27839000000;63675000000;7857000000;2748000000;10605000000;24574000000;31536000000;42141000000;2283000000;;19024000000;21534000000;63675000000
BSX;239516;USD;2017;Q4;2017-12-31;2018-02-20;1373200000;1395400000;188000000;1548000000;1078000000;3822000000;1697000000;;13523000000;15220000000;19042000000;2986000000;1801000000;5654000000;3815000000;6376000000;12030000000;17177000000;-1717000000;-8390000000;7011000000;19041000000
BSX;239516;USD;2016;Q4;2016-12-31;2017-02-23;1362000000;1401800000;196000000;1472000000;955000000;3239000000;1630000000;;13227000000;14857000000;18096000000;2759000000;64000000;3587000000;5420000000;7776000000;11363000000;17030000000;-1717000000;-8581000000;6733000000;18096000000
BSX;239516;USD;2015;Q4;2015-12-31;2016-02-24;1345800000;1325300000;319000000;1275000000;1016000000;3471000000;1490000000;;13172000000;14662000000;18133000000;2179000000;3000000;2430000000;5674000000;9383000000;11813000000;16876000000;-1717000000;-8927000000;6320000000;18133000000
BSX;239516;USD;2014;Q4;2014-12-31;2015-02-25;1326800000;1255400000;587000000;1183000000;946000000;3606000000;1507000000;;11911000000;13418000000;17024000000;2212000000;403000000;2846000000;3841000000;7721000000;10567000000;16719000000;-1717000000;-8689000000;6457000000;17024000000
BSX;239516;USD;2013;Q4;2013-12-31;2014-02-26;1329100000;1314000000;217000000;1307000000;897000000;3011000000;1546000000;;12014000000;13560000000;16571000000;1594000000;3000000;1824000000;4237000000;8208000000;10032000000;16595000000;-1592000000;-8570000000;6539000000;16571000000
BSX;239516;USD;2012;Q4;2012-12-31;2013-02-22;1365900000;1357000000;207000000;1217000000;884000000;3022000000;1564000000;;12568000000;14132000000;17154000000;1516000000;4000000;1772000000;4252000000;8512000000;10284000000;16444000000;-1092000000;-8449000000;6870000000;17154000000
BSX;239516;USD;2011;Q4;2011-12-31;2012-02-17;1467700000;1479900000;267000000;1246000000;931000000;3105000000;1670000000;;16515000000;18185000000;21290000000;1530000000;4000000;1807000000;4257000000;8130000000;9937000000;16364000000;-492000000;-4381000000;11353000000;21290000000
BSX;239516;USD;2010;Q4;2010-12-31;2011-02-17;1520300000;1502100000;213000000;1320000000;894000000;3615000000;1697000000;;16816000000;18513000000;22128000000;1810000000;504000000;2609000000;4934000000;8223000000;10832000000;16247000000;;-4822000000;11296000000;22128000000
BSX;239516;USD;2009;Q4;2009-12-31;2010-02-26;1510700000;1503000000;864000000;1375000000;891000000;4599000000;1722000000;;18856000000;20578000000;25177000000;2821000000;3000000;3022000000;5915000000;9854000000;12876000000;16101000000;;-3757000000;12301000000;25177000000
BSX;239516;USD;2008;Q4;2008-12-31;2009-08-06;1501500000;1480800000;1641000000;1402000000;853000000;5452000000;1728000000;;19959000000;21687000000;27139000000;2851000000;2000000;3233000000;6743000000;10732000000;13965000000;15959000000;;-2732000000;13174000000;27139000000
BSX;239516;USD;2018;Q4;2018-12-31;2019-02-19;1384200000;1406000000;146000000;1608000000;1166000000;4002000000;1782000000;;15215000000;16997000000;20999000000;2595000000;2253000000;5260000000;4803000000;7013000000;12273000000;17362000000;-1717000000;-6953000000;8725000000;20998000000
CENT;239618;USD;2017;Q4;2017-09-30;2017-11-29;50669000;51662000;32397000;237868000;382101000;683056000;180913000;;442937000;623850000;1306906000;219832000;375000;220207000;395278000;449557000;669764000;397308000;;239329000;637142000;1306906000
CENT;239618;USD;2016;Q4;2016-09-30;2016-12-02;49453000;54226000;92982000;201151000;362004000;683296000;158224000;;339163000;497387000;1180683000;201756000;463000;202219000;394806000;423877000;626096000;393807000;;160501000;554587000;1180683000
CENT;239618;USD;2015;Q4;2015-09-30;2015-12-10;48318000;50444000;47584000;207402000;335946000;653820000;162809000;;314968000;477777000;1131597000;176613000;291000;176904000;396691000;448313000;625217000;389135000;;115987000;506380000;1131597000
CENT;239618;USD;2014;Q4;2014-09-30;2014-12-11;49316000;50263000;88666000;193729000;326386000;671552000;166849000;;310326000;477175000;1148727000;173098000;;173098000;449948000;489176000;662274000;;;;486453000;1148727000
CENT;239618;USD;2013;Q4;2013-09-30;2013-12-12;48268000;46943000;32976000;194260000;391934000;672654000;188913000;;299593000;488506000;1161160000;182187000;142000;182329000;472445000;508807000;691136000;389644000;;77592000;470024000;1161160000
CENT;239618;USD;2012;Q4;2012-09-30;2012-12-13;47661000;49249000;71180000;202422000;330032000;651783000;191163000;0;306601000;497764000;1149547000;206484000;;206484000;449483000;478180000;684664000;;;;464883000;1149547000
CENT;239618;USD;2011;Q4;2011-09-30;2011-11-21;51952000;52708000;29851000;195417000;329546000;602586000;176402000;;314015000;490417000;1093003000;191652000;279000;191931000;435330000;444290000;636221000;396712000;;59045000;456782000;1093003000
CENT;239618;USD;2010;Q4;2010-09-30;2011-08-04;62451000;63216000;106780000;192422000;285964000;627899000;165281000;;337704000;502985000;1130884000;194029000;165000;194194000;400106000;404547000;598741000;484433000;;45319000;532143000;1130884000
CENT;239618;USD;2018;Q4;2018-09-30;2018-11-28;54129000;55436000;482106000;275908000;427823000;1217298000;217647000;;472264000;689911000;1907209000;212842000;122000;212964000;692031000;741411000;954375000;590744000;;362923000;952834000;1907209000
WMT;239962;USD;2017;Q4;2018-01-31;2018-03-30;2956000000;2976000000;6756000000;5614000000;43783000000;59664000000;107675000000;;37183000000;144858000000;204522000000;68859000000;9662000000;78521000000;36825000000;45179000000;123700000000;2943000000;;85107000000;80822000000;204522000000
WMT;239962;USD;2016;Q4;2017-01-31;2017-03-31;3062000000;3075000000;6867000000;5835000000;43046000000;57689000000;107710000000;;33426000000;141136000000;198825000000;63008000000;3920000000;66928000000;42018000000;51362000000;118290000000;2676000000;;89354000000;80535000000;198825000000
WMT;239962;USD;2015;Q4;2016-01-31;2016-03-30;3166000000;3175000000;8705000000;5624000000;44469000000;60239000000;110171000000;;29171000000;139342000000;199581000000;58615000000;6004000000;64619000000;44030000000;51351000000;115970000000;2122000000;;90021000000;83611000000;199581000000
WMT;239962;USD;2014;Q4;2015-01-31;2015-04-01;3228000000;3243000000;9135000000;6778000000;45141000000;63278000000;114280000000;;25932000000;140212000000;203490000000;58583000000;6670000000;65253000000;43495000000;52300000000;117553000000;2785000000;;85777000000;85937000000;203490000000
WMT;239962;USD;2013;Q4;2014-01-31;2014-03-21;3240000000;3252000000;7281000000;6677000000;44858000000;61185000000;115364000000;;28202000000;143566000000;204751000000;57174000000;12082000000;69345000000;44559000000;52576000000;121921000000;2685000000;;76566000000;82830000000;204751000000
WMT;239962;USD;2012;Q4;2013-01-31;2013-03-26;3339000000;3354000000;8855000000;6191000000;43138000000;60176000000;113692000000;;28319000000;142011000000;202187000000;61019000000;12533000000;73552000000;44551000000;52245000000;125797000000;3728000000;;68489000000;76390000000;202187000000
WMT;239962;USD;2011;Q4;2012-01-31;2012-03-27;3426000000;3440000000;6550000000;5937000000;40714000000;54975000000;109603000000;;28828000000;138431000000;193406000000;55952000000;6348000000;62300000000;47079000000;54941000000;117241000000;4034000000;;68691000000;76165000000;193406000000
WMT;239962;USD;2010;Q4;2011-01-31;2011-03-30;3546000000;3561000000;7395000000;5089000000;36437000000;52012000000;105098000000;;23672000000;128770000000;180782000000;52534000000;6022000000;58603000000;43842000000;50524000000;109127000000;3929000000;;63967000000;71655000000;180782000000
WMT;239962;USD;2009;Q4;2010-01-31;2010-03-30;3802000000;3817000000;7907000000;4144000000;32713000000;48032000000;99544000000;;22831000000;122375000000;170407000000;50532000000;4919000000;55543000000;36401000000;41909000000;97452000000;4181000000;;66357000000;72955000000;170407000000
WMT;239962;USD;2008;Q4;2009-01-31;2009-09-09;3924000000;3936000000;7275000000;3905000000;34511000000;48949000000;92856000000;;21624000000;114480000000;163429000000;47638000000;7669000000;55390000000;34549000000;40563000000;95953000000;4313000000;;63660000000;67476000000;163429000000
WMT;239962;USD;2018;Q4;2019-01-31;2019-03-28;2896000000;2926000000;7722000000;6283000000;44269000000;61897000000;104317000000;;53081000000;157398000000;219295000000;69647000000;7830000000;77477000000;50203000000;62184000000;139661000000;3253000000;;80785000000;79634000000;219295000000
CHKE;240259;USD;2017;Q4;2018-02-28;2018-04-19;13993000;13993000;3174000;9805000;;16577000;1090000;;85930000;87020000;103597000;7205000;46105000;64012000;;15470000;79482000;74657000;;-50542000;24115000;103597000
CHKE;240259;USD;2016;Q4;2017-02-28;2017-05-18;11540000;11404000;8378000;11759000;;41140000;1300000;;123576000;124876000;166016000;12635000;5137000;40170000;41595000;53528000;93698000;66871000;;5447000;72318000;166016000
CHKE;240259;USD;2015;Q4;2016-02-29;2016-04-14;8727000;8845000;6534000;7365000;;15031000;1151000;;54366000;55517000;70548000;3086000;8456000;12021000;15068000;16456000;28477000;27996000;;14075000;42071000;70548000
CHKE;240259;USD;2014;Q4;2015-02-28;2015-04-16;8482000;8726000;7581000;7425000;;16356000;1165000;;41139000;42304000;58660000;3150000;7308000;10475000;17836000;18348000;28823000;24195000;;5642000;29837000;58660000
CHKE;240259;USD;2013;Q4;2014-02-28;2014-04-17;8394000;8403000;3634000;6056000;;10474000;1222000;;42415000;43637000;54111000;2695000;6991000;9780000;25144000;26432000;36212000;21236000;;-3337000;17899000;54111000
CHKE;240259;USD;2012;Q4;2013-02-28;2013-04-30;8402000;8413000;2424000;5147000;;8824000;945000;;23883000;24828000;33652000;2028000;3291000;5399000;13228000;14727000;20126000;20416000;;-6890000;13526000;33652000
CHKE;240259;USD;2011;Q4;2012-02-29;2012-04-12;8392794;8350735;7421000;5320000;;14334000;733000;;7196000;7929000;22263000;3853000;500000;4673000;6438000;6839000;11512000;19438000;;-8687000;10751000;22263000
CHKE;240259;USD;2010;Q4;2011-02-28;2011-09-08;8833132;8882115;9587000;6644000;;18943000;173000;;8067000;8240000;27183000;7955000;7260000;15601000;;549000;16150000;18694000;-7260000;-401000;11033000;27183000
CHKE;240259;USD;2018;Q4;2019-02-28;2019-04-23;14343000;14343000;4284000;4363000;;9843000;620000;;82648000;83268000;93111000;3120000;1300000;10760000;53154000;68016000;78776000;76927000;;-62592000;14335000;93111000
RFIL;241093;USD;2016;Q4;2016-10-31;2017-01-27;8835011;8835011;5258000;4077000;6022000;16793000;828000;;8216000;9044000;25837000;3908000;;3908000;;537000;4445000;19467000;;1925000;21392000;25837000
RFIL;241093;USD;2015;Q4;2015-10-31;2016-01-28;8634343;8981272;7595000;3980000;6928000;19657000;921000;;11674000;12595000;32252000;4361000;;4361000;;1520000;5881000;19216000;;7155000;26371000;32252000
RFIL;241093;USD;2014;Q4;2014-10-31;2015-01-29;8260792;8685735;14718000;2428000;5259000;23439000;829000;;4761000;5590000;29029000;2289000;;2362000;;811000;3173000;17313000;;8543000;25856000;29029000
RFIL;241093;USD;2013;Q4;2013-10-31;2014-01-17;7917104;8797179;11881000;3160000;5924000;23047000;1053000;;4990000;6043000;29090000;2553000;;2604000;;950000;3554000;16130000;;9406000;25536000;29090000
RFIL;241093;USD;2012;Q4;2012-10-31;2013-01-22;6893119;7753548;5492000;5167000;6984000;19044000;1204000;;5215000;6419000;25463000;4141000;;4141000;;1092000;5233000;12077000;;8153000;20230000;25463000
RFIL;241093;USD;2011;Q4;2011-10-31;2012-01-27;7135548;7854143;1760816;2605965;6189601;16413206;2442738;;5522002;7964740;24377946;2100619;1394230;3494849;;1205069;4699918;11453710;;8010701;19678028;24377946
RFIL;241093;USD;2010;Q4;2010-10-31;2011-09-14;;;4728884;2557822;4607843;17533406;530327;946491;99139;1575957;19109363;1879213;;1879213;;316190;2195403;7055274;;9858686;16913960;19109363
RFIL;241093;USD;2017;Q4;2017-10-31;2018-03-13;8856059;9035314;6039000;3901000;6109000;16793000;711000;;7556000;8267000;25060000;3598000;;3598000;;119000;3717000;19743000;;1600000;21343000;25060000
RFIL;241093;USD;2018;Q4;2018-10-31;2018-12-20;9285307;10157161;16334000;4255000;7113000;28530000;559000;;3413000;3972000;32502000;4719000;;4719000;;0;4719000;21067000;;6716000;27783000;32502000
CSBR;241725;USD;2016;Q4;2016-04-30;2017-07-28;10967072;10967072;3295000;2274000;;5869000;1216000;;926000;2142000;8011000;2537000;;7447000;;164000;7611000;71002000;-1252000;-69350000;400000;8011000
CSBR;241725;USD;2015;Q4;2015-04-30;2016-07-29;8674085;8674085;2585000;1312000;;4340000;618000;;819000;1437000;5777000;2167000;;5306000;;233000;5539000;63956000;-1252000;-62466000;238000;5777000
CSBR;241725;USD;2014;Q4;2014-04-30;2015-07-29;7219171;8619579;9357000;1060000;;10763000;452000;;832000;1284000;12047000;1787000;;3796000;;192000;3988000;61331000;-1252000;-52020000;8059000;12047000
CSBR;241725;USD;2013;Q4;2013-04-30;2014-07-28;-462951462;-462951462;5891000;1325000;;7599000;434000;;834000;1268000;8867000;1568000;;3659000;;2011000;5670000;43329000;-1252000;-38880000;3197000;8867000
CSBR;241725;USD;2012;Q4;2012-04-30;2013-07-26;-652155393;-652155393;9561000;500000;;10376000;414000;;861000;1275000;11651000;1815000;;2929000;;1046000;3975000;23619000;-1252000;-31473000;7676000;11651000
CSBR;241725;USD;2011;Q4;2011-04-30;2012-07-18;328293;328293;4754000;584000;;5543000;560000;;819000;1379000;6922000;2301000;;3486000;;555000;4041000;21242000;-1252000;-25143000;2881000;6922000
CSBR;241725;USD;2010;Q4;2010-04-30;2011-09-13;;;10457000;585000;;11835000;146000;;669000;815000;12650000;1882000;;3500000;;972000;4472000;17821000;-1252000;-16482000;8178000;12650000
CSBR;241725;USD;2017;Q4;2017-04-30;2018-07-30;10999506;10999506;856000;3917000;;5060000;2083000;;935000;3018000;8078000;2723000;26000;7453000;17000;622000;8075000;72081000;-1252000;-70826000;3000;8078000
CSBR;241725;USD;2018;Q4;2018-04-30;2019-07-29;11561963;18221177;3237000;4377000;;7922000;2546000;;797000;3343000;11265000;3987000;16000;8025000;;1002000;9027000;72936000;;-70698000;2238000;11265000
LAKE;243284;USD;2016;Q4;2017-01-31;2015-12-15;7245384;7314417;10365000;10704000;35535000;60086000;8527000;;15941000;24468000;84554000;7257000;203000;12325000;716000;722000;13047000;64840000;-3352000;12401000;71507000;84554000
LAKE;243284;USD;2015;Q4;2016-01-31;2014-12-10;7057851;7502739;7022000;11476000;40841000;62117000;9268000;;16875000;26143000;88260000;7224000;3276000;19958000;691000;786000;20744000;64544000;-3352000;8508000;67516000;88260000
LAKE;243284;USD;2014;Q4;2015-01-31;2013-12-12;5940889;5832226;4555097;13795301;39844309;65481005;12069107;;2932869;15001976;80482981;10810766;2608545;26834735;2636026;9171472;36006207;53422418;-3352291;-3744673;44476774;80482981
LAKE;243284;USD;2013;Q4;2014-01-31;2012-12-13;5333567;5127440;6736962;13782908;39270675;63871883;14089987;;5356133;19446120;83318003;10089213;7229260;27902396;1298085;9424507;37326903;51029951;-3352291;-472445;45991100;83318003
LAKE;243284;USD;2012;Q4;2013-01-31;2011-12-07;5225529;5387728;5711038;12576362;45668355;73707953;13914826;;14782075;28696901;102404854;7490149;1898259;9453188;16272489;19684809;29137997;50828413;-3352291;25816224;73266857;102404854
LAKE;243284;USD;2011;Q4;2012-01-31;2011-09-19;5440268;5540347;5953069;14377188;45295295;75724999;11096329;;14554655;25650984;101375983;10583512;100050;10717502;13078159;16491240;27208742;50335300;-3012920;26193049;74167241;101375983
LAKE;243284;USD;2017;Q4;2018-01-31;2018-04-16;8149313;8208066;15788000;14119000;42919000;76500000;8789000;;9242000;18031000;94531000;10010000;369000;10379000;1312000;1312000;11691000;75002000;-3352000;12841000;82840000;94531000
LAKE;243284;USD;2018;Q4;2019-01-31;2019-04-16;8093946;8157959;12831000;16477000;42365000;73992000;10781000;;9950000;20731000;94723000;10176000;158000;10334000;1161000;1161000;11495000;75697000;-4517000;14300000;83228000;94723000
MCD;243628;USD;2016;Q4;2016-12-31;2017-03-01;823300000;831000000;1223400000;1474100000;58900000;4848600000;21257600000;;4917700000;26175300000;31023900000;2696300000;77200000;3468300000;25878500000;29759900000;33228200000;6774500000;-52108600000;46222700000;-2204300000;31023900000
MCD;243628;USD;2015;Q4;2015-12-31;2016-02-25;913500000;920500000;7685500000;1298700000;100100000;9643000000;23117600000;;5178100000;28295700000;37938700000;2950400000;0;2950400000;24122100000;27900400000;30850800000;6550000000;-41176800000;44594500000;7087900000;37938700000
MCD;243628;USD;2014;Q4;2014-12-31;2015-02-24;966300000;972300000;2077900000;1214400000;110000000;4185500000;24557500000;;5484400000;30041900000;34227400000;2747900000;;2747900000;14935700000;18626100000;21374000000;6255700000;-35177100000;43294500000;12853400000;34227400000
MCD;243628;USD;2013;Q4;2013-12-31;2014-02-24;992200000;1000300000;2798700000;1319800000;123700000;5050100000;25747300000;;5828900000;31576200000;36626300000;3170000000;;3170000000;14129800000;17446600000;20616600000;6010700000;-32179800000;41751200000;16009700000;36626300000
MCD;243628;USD;2012;Q4;2012-12-31;2013-02-25;1002300000;1011500000;2336100000;1375300000;121700000;4922100000;24677200000;;5787200000;30464400000;35386500000;3403100000;;3403100000;13632500000;16689800000;20092900000;5795500000;-30576300000;39278000000;15293600000;35386500000
MCD;243628;USD;2011;Q4;2011-12-31;2012-02-24;1021600000;1036000000;2335700000;1334700000;116800000;4403000000;22834500000;;5752400000;28586900000;32989900000;3142600000;366600000;3509200000;12133800000;15090500000;18599700000;5503900000;-28270900000;36707500000;14390200000;32989900000
MCD;243628;USD;2010;Q4;2010-12-31;2011-02-25;1054900000;1070300000;2387000000;1179100000;109900000;4368500000;22060600000;;5546100000;27606700000;31975200000;2916400000;8300000;2924700000;11497000000;14416300000;17341000000;5213000000;-25143400000;33811700000;14634200000;31975200000
MCD;243628;USD;2009;Q4;2009-12-31;2010-02-26;1077400000;1095600000;1796000000;1060400000;106200000;3416300000;21531500000;;5277100000;26808600000;30224900000;2970600000;18100000;2988700000;10560300000;13202300000;16191000000;4870500000;-22854800000;31270800000;14033900000;30224900000
MCD;243628;USD;2008;Q4;2008-12-31;2009-08-06;1115500000;1132800000;2063400000;931200000;111500000;3517600000;20254500000;;4689400000;24943900000;28461500000;2506100000;31800000;2537900000;10186000000;12541000000;15078900000;4616800000;-20289400000;28953900000;13382600000;28461500000
MCD;243628;USD;2017;Q4;2017-12-31;2018-02-23;793900000;804100000;2463800000;1976200000;58800000;5327200000;22448300000;;6028200000;28476500000;33803700000;2890600000;;2890600000;29536400000;34181100000;37071700000;7089000000;-56504400000;48325800000;-3268000000;33803700000
MCD;243628;USD;2018;Q4;2018-12-31;2019-02-22;769100000;777000000;866000000;2441500000;51100000;4053200000;22842700000;;5915300000;28758000000;32811200000;2973500000;;2973500000;31075300000;36096100000;39069600000;7392600000;-61528500000;50487000000;-6258400000;32811200000
RP;243720;USD;2015;Q4;2015-12-31;2016-02-29;76437000;76437000;30911000;74192000;;221943000;82198000;;319060000;401258000;623201000;45742000;0;215347000;40000000;81402000;296749000;471751000;-24338000;-120415000;326452000;623201000
RP;243720;USD;2014;Q4;2014-12-31;2015-03-02;76679000;76679000;26936000;64845000;;186819000;72616000;;306859000;379475000;566294000;37735000;;196709000;20000000;40805000;237514000;437747000;-33398000;-75360000;328780000;566294000
RP;243720;USD;2013;Q4;2013-12-31;2014-03-03;76062000;77166000;34502000;66635000;;183815000;54775000;;264623000;319398000;503213000;35100000;;173095000;0;15614000;188709000;390935000;-11183000;-65086000;314504000;503213000
RP;243720;USD;2012;Q4;2012-12-31;2013-02-27;73482000;77454000;33804000;51937000;;127484000;32487000;;242226000;274713000;402197000;29051000;;124857000;10000000;22269000;147126000;347280000;-6323000;-85778000;255071000;402197000
RP;243720;USD;2011;Q4;2011-12-31;2012-02-24;138259327;138255988;51273000;43883000;;124758000;27974000;;247333000;275307000;400065000;38034000;;114376000;50312000;62808000;177184000;317037000;-3138000;-90961000;222881000;400065000
RP;243720;USD;2010;Q4;2010-12-31;2011-08-09;63314000;63314000;118010000;29577000;;170522000;24515000;;147755000;172270000;342792000;20223000;10781000;93974000;55258000;76234000;170208000;263288000;-958000;-89730000;172584000;342792000
RP;243720;USD;2016;Q4;2016-12-31;2017-03-01;77574000;78940000;104886000;92367000;;297455000;130428000;;360215000;490643000;788098000;71885000;5469000;250527000;116657000;152808000;403335000;534434000;-30358000;-119260000;384763000;788098000
RP;243720;USD;2017;Q4;2017-12-31;2018-03-01;80613000;83521000;69343000;124505000;;308579000;148428000;;1059286000;1207714000;1516293000;106112000;14116000;332907000;634460000;681511000;1014418000;637938000;-61260000;-75046000;501875000;1516293000
RP;243720;USD;2018;Q4;2018-12-31;2019-02-27;91648000;94712000;228159000;123596000;;540753000;153528000;;1403492000;1557020000;2097773000;120794000;16133000;412232000;580425000;622517000;1034749000;1187779000;-65470000;-58793000;1063024000;2097773000
PIR;244053;USD;2016;Q4;2017-03-31;2017-04-25;4044800;4057650;154460000;22945000;400976000;609988000;191476000;;41618000;233094000;843082000;228905000;2000000;291303000;199077000;259751000;551054000;191626000;-629349000;737165000;292028000;843082000
PIR;244053;USD;2015;Q4;2016-03-31;2016-04-26;4077300;4078600;115221000;22639000;405859000;574894000;207633000;;36664000;244297000;819191000;180606000;2000000;246687000;200255000;287747000;534434000;211144000;-645287000;729537000;284757000;819191000
PIR;244053;USD;2014;Q4;2015-03-31;2015-04-28;4421200;4471050;100064000;29405000;478843000;653585000;214048000;;39251000;253299000;906884000;223048000;2000000;288050000;201426000;281567000;569617000;222563000;-588886000;713575000;337267000;906884000
PIR;244053;USD;2013;Q4;2014-03-31;2014-04-29;5071550;5261850;126695000;24614000;377650000;576506000;183352000;;43765000;227117000;803623000;208541000;;265969000;9500000;88222000;354191000;235762000;-440256000;660040000;449432000;803623000
PIR;244053;USD;2012;Q4;2013-03-31;2013-04-30;5254300;5385850;231556000;22309000;356053000;658934000;150615000;;47666000;198281000;857215000;196387000;;248127000;9500000;71957000;320084000;233643000;-265890000;574206000;537131000;857215000
PIR;244053;USD;2011;Q4;2012-03-31;2012-04-25;5441750;5546700;287868000;16282000;322482000;650314000;103640000;;69409000;173049000;823363000;192265000;;245388000;9500000;84332000;329720000;232044000;-196679000;462751000;493643000;823363000
PIR;244053;USD;2010;Q4;2011-03-31;2011-07-05;5838700;5920600;287868000;16282000;322482000;650314000;103640000;;69409000;173049000;823363000;192265000;;245388000;9500000;84332000;329720000;232044000;-196679000;462751000;493643000;823363000
PIR;244053;USD;2017;Q4;2018-03-31;2018-05-02;3990200;3996400;135379000;22149000;347440000;553762000;178767000;;39790000;218557000;772319000;179848000;2000000;237129000;197906000;257620000;494749000;168549000;-609734000;726232000;277570000;772319000
PIR;244053;USD;2018;Q4;2019-03-31;2019-04-29;4065350;4065350;54878000;21189000;347584000;473527000;149356000;;33407000;182763000;656290000;229810000;2000000;269465000;245624000;297296000;566761000;138475000;-575504000;534419000;89529000;656290000
GE;244314;USD;2018;Q4;2018-12-31;2019-02-26;7656400000;7631440000;68855000000;33791000000;19271000000;126527000000;50749000000;0;131853000000;182602000000;309129000000;17248000000;12849000000;128249000000;95234000000;129017000000;257266000000;36206000000;-83925000000;93109000000;51864000000;309130000000
SWK;244442;USD;2016;Q4;2016-12-31;2017-02-15;147749000;149971000;1131800000;1302800000;1478000000;4788500000;1451200000;;9395200000;10846400000;15634900000;2741900000;12100000;2807500000;3815300000;6453800000;9261300000;5216700000;-2029900000;5127300000;6373600000;15634900000
SWK;244442;USD;2015;Q4;2015-12-31;2016-02-19;146794000;150843000;465400000;1331800000;1526400000;3662100000;1450200000;;10015500000;11465700000;15127800000;2795000000;7600000;2802600000;3792100000;6466000000;9268600000;4864000000;-1815000000;4491700000;5859200000;15127800000
SWK;244442;USD;2014;Q4;2014-12-31;2015-02-19;155511000;159749000;496600000;1396700000;1562700000;3948800000;1454100000;;10446200000;11900300000;15849100000;2801100000;7500000;2832000000;3839800000;6505200000;9337200000;5169400000;-1352800000;3926300000;6511900000;15849100000
SWK;244442;USD;2013;Q4;2013-12-31;2014-02-21;155289000;158834000;496200000;1578500000;1473300000;4016600000;1478600000;;11039900000;12518500000;16535100000;2772400000;402600000;3236000000;3799400000;6418600000;9654600000;5320900000;-1454400000;3484900000;6880500000;16535100000
SWK;244442;USD;2012;Q4;2012-12-31;2013-02-20;160666000;163892000;716000000;1525800000;1304600000;4111300000;1329900000;;10402800000;11732700000;15844000000;3025900000;11500000;3074700000;3526500000;6042200000;9116900000;4915800000;-1097400000;3299500000;6727100000;15844000000
SWK;244442;USD;2011;Q4;2011-12-31;2011-05-12;162988000;166504000;906900000;1445000000;1270900000;5089500000;1142600000;;9716900000;10859500000;15949000000;2589400000;526600000;3329900000;2925800000;5552300000;8882200000;5022000000;-308000000;2707300000;7066800000;15949000000
SWK;244442;USD;2010;Q4;2010-12-31;2011-02-18;162584000;168023000;1742800000;1399700000;1262000000;4851200000;1156000000;;9132200000;10288200000;15139400000;2329700000;417700000;2747400000;3018100000;5322300000;8069700000;5326400000;-420400000;2301800000;7069700000;15139400000
SWK;244442;USD;2009;Q4;2009-12-31;2010-07-30;80655000;81731000;400700000;532000000;366200000;1411900000;575900000;;2781300000;3357200000;4769100000;893600000;298400000;1192000000;1084700000;1565600000;2757600000;357600000;-509700000;2295500000;2011500000;4769100000
SWK;244442;USD;2017;Q4;2017-12-31;2018-02-27;150105000;153422000;637500000;1628700000;2018400000;4559000000;1742500000;;12796200000;14538700000;19097700000;3408700000;982800000;4391500000;2828200000;6401200000;10792700000;5085500000;-1924100000;5998700000;8305000000;19097700000
SWK;244442;USD;2018;Q4;2018-12-31;2019-02-26;147352000;149574000;288700000;1607800000;2373500000;4569400000;1915200000;;12923400000;14838600000;19408000000;3623000000;378600000;4001600000;3819800000;7566500000;11568100000;5063300000;-2371300000;6219000000;7839900000;19408000000
IHT;244789;USD;2017;Q4;2018-01-31;2018-05-16;9334053;19736925;5576078;78731;;8066321;9771216;;5240535;15011751;23078072;1986526;1168896;4052461;4922010;10906642;14959103;22333905;-12662996;;8118969;23078072
IHT;244789;USD;2016;Q4;2017-01-31;2017-05-01;12305321;23357528;478835;626174;;1464967;13694268;;7013597;20707865;22172832;1908498;885850;4405500;7762975;14142083;18547583;16794132;-12362952;;3625249;22172832
IHT;244789;USD;2015;Q4;2016-01-31;2016-04-29;8283497;11967566;1955534;250470;;3325922;19614767;;1000000;20614767;23940689;2163144;526795;3649473;13320487;13320487;16969960;18769849;-12285915;;6970729;23940689
IHT;244789;USD;2014;Q4;2015-01-31;2015-04-30;8040665;8040665;147684;117903;;1133271;76092;;25818446;25894538;27027809;690351;592447;10210600;5150425;13851982;24062582;13812470;-12193491;;2965227;27027809
IHT;244789;USD;2013;Q4;2014-01-31;2014-04-28;8345869;8345869;395903;644566;;1538865;89348;;23780290;23869638;25408503;2221638;11834549;15406502;7099589;7099589;22506091;14024668;-11973459;;2902412;25408503
IHT;244789;USD;2012;Q4;2013-01-31;2013-05-01;-16818466778877;-16818466778877;493953;568186;;1344321;112977;;24824664;24937641;26281962;2298497;1398164;4146661;18909016;18909016;23055677;14940048;-11877886;;3226285;26281962
IHT;244789;USD;2011;Q4;2012-01-31;2012-04-30;8443039;8443039;983424;619916;;1982514;149377;;25250367;25399744;27382258;2414763;2503939;4918702;19317969;19317969;24236671;14646261;-11682575;;3145587;27382258
IHT;244789;USD;2010;Q4;2011-01-31;2011-10-04;;;494844;661024;;1736085;139887;;26059126;26199013;27935098;2093228;8387698;10480926;14173571;14173571;24654497;15412926;-11456375;;3280601;27935098
IHT;244789;USD;2018;Q4;2019-01-31;2019-06-19;8887322;5578908;2645631;236942;;5146128;9532793;;2520833;12053626;17199754;1258677;1661913;3476693;4974546;4974546;8451239;23738260;-13517833;;8748515;17199754
BMRA;245138;USD;2017;Q4;2017-05-31;2017-08-29;8526405;8526405;1225462;1060011;1729121;4210351;331857;165324;310458;807639;5017990;528866;;528866;;0;528866;20232748;;-15727790;4489124;5017990
BMRA;245138;USD;2016;Q4;2016-05-31;2016-08-29;7718349;7718349;1888925;969474;1863091;4835068;380659;165324;345454;891437;5726505;506027;;506027;;0;506027;20053293;;-14819229;5220478;5726505
BMRA;245138;USD;2015;Q4;2015-05-31;2015-08-31;7554634;7554634;1088307;1111570;2027372;4391601;445386;165324;1122142;1732852;6124453;523933;;523933;;0;523933;18932226;;-13319442;5600520;6124453
BMRA;245138;USD;2014;Q4;2014-05-31;2014-08-29;7544912;7192063;1509125;1447705;1765772;4913174;614337;165324;777478;1557139;6470313;555844;;555844;;0;555844;18912650;;-12988032;5914469;6470313
BMRA;245138;USD;2013;Q4;2013-05-31;2013-08-29;7179137;8116168;2469796;871660;1571221;5253355;654620;165324;321588;1141532;6394887;559893;;559893;;0;559893;18616372;;-12772372;5834994;6394887
BMRA;245138;USD;2012;Q4;2012-05-31;2012-08-29;6937084;7481827;1077342;1200516;1821072;4486630;584824;165324;334144;1084292;5570922;549288;;592288;;0;592288;18293993;;-13309329;4978634;5570922
BMRA;245138;USD;2011;Q4;2011-05-31;2011-10-27;;6804075;989270;747075;1785525;3886433;567323;165324;336298;1068945;4955378;625015;;625015;;0;625015;18192587;;-13857764;4330363;4955378
BMRA;245138;USD;2018;Q4;2018-05-31;2018-08-29;8692592;8692592;1204903;799940;2178777;4484029;351149;165324;222080;738553;5222582;896808;;896808;;0;896808;21554590;;-17193618;4325774;5222582
BMRA;245138;USD;2019;Q4;2019-05-31;2019-08-29;9535811;9535811;686785;1454652;2151090;4494929;351070;165324;234041;750435;5245364;1264394;;1264394;;0;1264394;23604179;;-19586678;3980970;5245364
BRO;245531;USD;2016;Q4;2016-12-31;2017-02-24;273110000;277026000;530694000;;;1736128000;75807000;23048000;3427751000;3526606000;5262734000;1227809000;55500000;1445157000;1018372000;1457366000;2902523000;483254000;-257683000;2134640000;2360211000;5262734000
BRO;245531;USD;2015;Q4;2015-12-31;2016-02-26;273356000;278184000;457154000;;;1537389000;81753000;18092000;3367245000;3467090000;5004479000;1140356000;73125000;1328547000;1071618000;1526156000;2854703000;441140000;-238775000;1947411000;2149776000;5004479000
BRO;245531;USD;2014;Q4;2014-12-31;2015-03-02;280002000;284518000;481205000;;;1570108000;84668000;19862000;3281820000;3386350000;4956458000;1127187000;45625000;1269153000;1152846000;1573560000;2842713000;420569000;-75025000;1768201000;2113745000;4956458000
BRO;245531;USD;2013;Q4;2013-12-31;2014-02-28;282722000;283478000;213576000;;;928036000;74733000;16000;2646723000;2721472000;3649508000;725918000;100000000;906877000;380000000;735490000;1642367000;386502000;;1620639000;2007141000;3649508000
BRO;245531;USD;2012;Q4;2012-12-31;2013-03-01;279808000;285230000;228004000;;;759512000;74337000;;2294209000;2368546000;3128058000;534821000;93000;567781000;450000000;752944000;1320725000;350260000;;1457073000;1807333000;3128058000
BRO;245531;USD;2011;Q4;2011-12-31;2012-02-29;277816000;280046000;293932000;;;708127000;61360000;;1837524000;1898884000;2607011000;450345000;1227000;481620000;250033000;481428000;963048000;321394000;;1322562000;1643963000;2607011000
BRO;245531;USD;2010;Q4;2010-12-31;2011-03-01;276590000;281738000;280662000;;;652809000;59713000;;1688292000;1748005000;2400814000;439986000;1662000;470157000;250067000;424313000;894470000;301276000;;1205061000;1506344000;2400814000
BRO;245531;USD;2009;Q4;2009-12-31;2010-08-04;275072000;275638000;205326000;;;613699000;61467000;;1549060000;1610527000;2224226000;424114000;17124000;478953000;250209000;375399000;854352000;282064000;;1087805000;1369874000;2224226000
BRO;245531;USD;2017;Q4;2017-12-31;2018-02-28;270756000;276304000;598348000;;;2242156000;77086000;13949000;3414359000;3505394000;5747550000;1299105000;120000000;1987474000;856141000;1177377000;3164851000;512422000;-386322000;2456599000;2582699000;5747550000
BRO;245531;USD;2018;Q4;2018-12-31;2019-02-26;272623000;275180000;451829000;;;2167311000;100395000;17394000;4403568000;4521357000;6688668000;1562134000;50000000;1782986000;1456990000;1905114000;3688100000;644518000;-477572000;2833622000;3000568000;6688668000
PDEX;246198;USD;2017;Q4;2017-06-30;2017-09-14;12089317;12238316;4205000;3538000;3085000;13251000;1429000;718000;953000;3100000;16351000;2503000;58000;2580000;61000;61000;2641000;17704000;;-4027000;13710000;16351000
PDEX;246198;USD;2016;Q4;2016-06-30;2016-05-12;12415614;12544360;2294000;1469000;3364000;9291000;1222000;0;634000;1856000;11147000;1918000;26000;2156000;46000;114000;2270000;17988000;;-9111000;8877000;11147000
PDEX;246198;USD;2015;Q4;2015-06-30;2015-05-14;12460019;12460019;697000;2326000;4310000;8408000;1470000;1652000;986000;4108000;12516000;3069000;31000;3694000;70000;344000;4038000;18411000;;-9933000;8478000;12516000
PDEX;246198;USD;2014;Q4;2014-06-30;2014-05-12;10621222;10612472;3188000;1776000;2600000;8893000;1575000;1058000;182000;2815000;11708000;1887000;8000;2127000;7000;365000;2492000;18582000;;-9568000;9216000;11708000
PDEX;246198;USD;2013;Q4;2013-06-30;2013-05-13;6684829;6684829;1680000;1339000;3834000;7347000;2065000;370000;813000;3248000;10595000;2168000;5000;2314000;15000;344000;2658000;17012000;;-9080000;7937000;10595000
PDEX;246198;USD;2012;Q4;2012-06-30;2012-05-10;3272350;3264655;4112000;1581000;2791000;9497000;2539000;0;786000;3325000;12822000;2085000;0;2879000;0;393000;3272000;16846000;;-7296000;9550000;12822000
PDEX;246198;USD;2011;Q4;2011-06-30;2011-11-09;3272107;3324818;4689000;3128000;3703000;11840000;3661000;;60000;3721000;15561000;3664000;;4021000;774000;1216000;5237000;16744000;;-6420000;10324000;15561000
PDEX;246198;USD;2018;Q4;2018-06-30;2018-09-13;4149116;4309768;5188000;2955000;4393000;15691000;1755000;2220000;251000;4226000;19917000;2472000;35000;2538000;6000;103000;2641000;19835000;;-2406000;17276000;19917000
SANW;246310;USD;2016;Q4;2016-06-30;2016-09-15;16740933;16740933;6904500;27619599;21846130;57588509;13121699;;56294777;69416476;127004985;17085064;7115702;41398096;13382749;17845445;59243541;78299547;-134196;-4614244;67761444;127004985
SANW;246310;USD;2015;Q4;2015-06-30;2015-09-28;14716212;14716212;3535458;26728741;25521747;56869653;11476936;;53996478;65473414;122343067;16654349;11489394;42484189;21537113;27983273;70467462;62085858;-134196;-4979471;51875605;122343067
SANW;246310;USD;2014;Q4;2014-06-30;2014-09-29;11605521;11858408;1167503;24255596;28485584;55440255;10356809;;23503345;33860154;89300409;16899273;267764;33055677;4602631;4730497;37786174;55133542;-134196;-1816344;51514235;89300409
SANW;246310;USD;2013;Q4;2013-06-30;2013-09-30;11356841;10692871;11781074;12700106;25822467;51767558;10239435;;23576226;33815661;85583219;22068806;746788;30234635;4868958;5291521;35526156;54350343;0;-2189444;50057063;85583219
SANW;246310;USD;2012;Q4;2012-06-30;2012-09-27;6216440;6106888;8235495;2716985;6116785;17423189;2441186;;2169320;4610506;22033695;1903263;0;1903263;0;0;1903263;19803849;;326583;20130432;22033695
SANW;246310;USD;2011;Q4;2011-06-30;2011-11-14;5800000;5800000;3738544;1803909;5664119;11617416;2299306;;1240539;3539845;15157261;594997;;594997;;;594997;14610516;;-48252;14562264;15157261
SANW;246310;USD;2017;Q4;2017-06-30;2017-09-20;17827991;17796833;745001;23239325;31489945;56724192;13581576;;46794520;60376096;117100288;10223157;12809664;51312931;1096155;4565702;55878633;83330522;-134196;-16436286;61221655;117100288
SANW;246310;USD;2018;Q4;2018-06-30;2018-09-20;24302725;24285464;4320894;13861932;60419276;79881896;13180132;;44705180;57885312;137767208;9050253;503012;42396217;12977087;13628867;56025084;108828358;-134196;-21161376;81742124;137767208
BRC;246429;USD;2016;Q4;2016-07-31;2016-09-15;50357000;50835000;141228000;147333000;99427000;407424000;102444000;;534096000;636540000;1043964000;75784000;4928000;166727000;211982000;273639000;440366000;313686000;-108714000;453371000;603598000;1043964000
BRC;246429;USD;2015;Q4;2015-07-31;2015-09-21;51316000;51421000;114492000;157386000;104507000;396140000;111214000;;555543000;666757000;1062897000;87846000;52925000;208992000;200774000;266217000;475209000;311887000;-93234000;414069000;587688000;1062897000
BRC;246429;USD;2014;Q4;2014-07-31;2014-09-29;51252000;50551000;81834000;177648000;113275000;463842000;134171000;;655652000;789823000;1253665000;103986000;103936000;291945000;159296000;228644000;520589000;310200000;-93337000;452057000;733076000;1253665000
BRC;246429;USD;2013;Q4;2013-07-31;2013-09-30;51689000;50790000;91058000;169261000;94707000;512490000;122158000;;804035000;926193000;1438683000;97818000;111877000;323497000;201150000;284389000;607886000;306019000;-69797000;538512000;830797000;1438683000
BRC;246429;USD;2012;Q4;2012-07-31;2012-09-27;52195000;52880000;305900000;199006000;105524000;650854000;130015000;;826850000;956865000;1607719000;110310000;61264000;267018000;254944000;331348000;598366000;310252000;-92600000;732290000;1009353000;1607719000
BRC;246429;USD;2011;Q4;2011-07-31;2011-09-27;52814000;53332000;389971000;228483000;104186000;758287000;139915000;;963303000;1103218000;1861505000;116413000;61264000;301881000;331914000;403432000;705313000;303211000;-50017000;789100000;1156192000;1861505000
BRC;246429;USD;2010;Q4;2010-07-31;2010-12-07;52474000;52872000;314840000;221621000;94672000;668972000;145502000;;932057000;1077559000;1746531000;114377000;61264000;293788000;382940000;447716000;741504000;301924000;-66314000;718512000;1005027000;1746531000
BRC;246429;USD;2017;Q4;2017-07-31;2017-09-13;51309000;52214000;133944000;149638000;107024000;407814000;98103000;;544306000;642409000;1050223000;82160000;3228000;187198000;104536000;162885000;350083000;323156000;-85470000;507136000;700140000;1050223000
BRC;246429;USD;2018;Q4;2018-07-31;2018-09-13;51823000;52265000;181427000;161282000;113071000;471339000;97945000;;487647000;585592000;1056931000;78741000;0;190927000;52618000;113892000;304819000;326179000;-71120000;553454000;752112000;1056931000
BRC;246429;USD;2019;Q4;2019-07-31;2019-09-06;52885000;53648000;279072000;158114000;120037000;573279000;110048000;;473981000;584029000;1157308000;79474000;50166000;241945000;0;64589000;306534000;330517000;-46332000;637843000;850774000;1157308000
LPTH;246855;USD;2017;Q4;2017-06-30;2017-09-14;24031276;25981382;8085015;5890113;5074576;19720375;10324558;;16627281;26951839;46672214;5511080;239332;5750412;10068945;11200633;16951045;225734409;;-196308636;29721169;46672214
LPTH;246855;USD;2016;Q4;2016-06-30;2016-05-05;15587486;18304300;2908024;3545871;3836809;11152184;4370045;;66964;4437009;15589193;3046313;166454;3212767;178919;1444514;4657281;214817526;;-204011722;10931912;15589193
LPTH;246855;USD;2015;Q4;2015-06-30;2015-05-07;15200067;13400466;1643920;3048754;3181377;8372006;4275552;;66964;4342516;12714522;2530015;166454;2696469;310260;2018409;4714878;213375301;;-205426337;7999644;12714522
LPTH;246855;USD;2014;Q4;2014-06-30;2014-05-08;14283819;14283819;1197080;2472876;3322983;7491118;3173905;;27737;3201642;10692760;2466719;6196;2472915;116233;924154;3397069;211955067;;-204711057;7295691;10692760
LPTH;246855;USD;2013;Q4;2013-06-30;2013-05-02;12951868;13691940;1565215;2126907;1770681;6078569;2235781;;63134;2298915;8377484;1616741;3602;1622309;3302;1325539;2947848;209774708;;-204397808;5429636;8377484
LPTH;246855;USD;2018;Q4;2018-06-30;2018-09-13;25718459;27305915;5508620;5370508;6404741;19389053;11809241;;15918820;27728061;47117114;5405184;307199;5712383;5669923;6047287;11759670;230132468;;-195248532;35357444;47117114
FLWS;247341;USD;2017;Q4;2017-06-30;2017-09-15;65312000;72906000;149732000;14073000;75862000;257402000;161381000;;133687000;295068000;552470000;117987000;7188000;125175000;101377000;145056000;270231000;338578000;-88790000;32638000;282239000;552470000
FLWS;247341;USD;2016;Q4;2016-06-30;2016-09-16;65403000;71841000;27826000;19123000;103328000;166659000;171362000;;164920000;336282000;502941000;101267000;19594000;120861000;94396000;139494000;260355000;332190000;-78055000;-11403000;242586000;502941000
FLWS;247341;USD;2015;Q4;2015-06-30;2015-09-11;66604000;74490000;27940000;16191000;93163000;155095000;170100000;;171878000;341978000;497073000;109064000;14543000;123607000;117563000;163210000;286817000;319930000;-62832000;-48278000;210256000;497073000
FLWS;247341;USD;2014;Q4;2014-06-30;2014-09-12;64111000;71732000;5203000;13339000;58520000;91818000;60147000;;115604000;175751000;267569000;73964000;343000;74307000;0;7144000;81451000;306311000;-54472000;-68565000;186118000;267569000
FLWS;247341;USD;2013;Q4;2013-06-30;2013-09-13;63891000;69995000;154000;14957000;55756000;92649000;52943000;;104481000;157424000;250073000;71279000;;75763000;;5039000;80802000;299363000;-46155000;-83937000;169271000;250073000
FLWS;247341;USD;2012;Q4;2012-06-30;2012-09-14;64741000;68389000;28854000;11887000;53933000;113106000;48550000;;100557000;149107000;262213000;66430000;15756000;83385000;13500000;17080000;100465000;294579000;-36556000;-96258000;161748000;262213000
FLWS;247341;USD;2011;Q4;2011-06-30;2011-11-10;64145000;65363000;21442000;11916000;51185000;101625000;49908000;;107542000;157450000;259075000;66878000;16488000;84322000;29250000;32242000;116564000;289852000;-33279000;-113904000;142511000;259075000
FLWS;247341;USD;2018;Q4;2018-06-30;2018-09-14;64582000;71489000;147240000;12935000;88825000;273021000;163340000;;134528000;297868000;570889000;114736000;10063000;124799000;92267000;131186000;255985000;342641000;-100966000;73429000;314904000;570889000
XCRA;247530;USD;2016;Q4;2016-07-31;2016-09-16;53528000;54292000;139421000;76817000;69986000;297218000;25483000;;55382000;80865000;378083000;57512000;2822000;66530000;21197000;29715000;96245000;806994000;;-509610000;281838000;378083000
XCRA;247530;USD;2015;Q4;2015-07-31;2015-10-14;54594000;56023000;138451000;81639000;60593000;299530000;31450000;;56495000;87945000;387475000;63071000;2509000;74193000;23938000;34814000;109007000;812676000;;-520784000;278468000;387475000
XCRA;247530;USD;2014;Q4;2014-07-31;2014-10-14;48380000;52124000;98928000;88219000;67684000;275276000;32153000;;56714000;88867000;364143000;69056000;3831000;83167000;64917000;76357000;159524000;753933000;;-549010000;204619000;364143000
XCRA;247530;USD;2013;Q4;2013-07-31;2013-10-11;47601000;47193000;124394000;29065000;29139000;185095000;16647000;;45859000;62506000;247601000;32618000;;37702000;;11402000;49104000;748404000;;-549843000;198497000;247601000
XCRA;247530;USD;2012;Q4;2012-07-31;2012-10-15;48855000;48855000;137174000;31922000;28850000;201386000;18229000;;47453000;65682000;267068000;32470000;;37817000;;13547000;51364000;753190000;;-537716000;215704000;267068000
XCRA;247530;USD;2011;Q4;2011-07-31;2011-12-09;49556000;51362000;162615000;43054000;21145000;231182000;20827000;;50106000;70933000;302115000;39909000;;45498000;;15897000;61395000;758526000;;-517847000;240720000;302115000
XCRA;247530;USD;2017;Q4;2017-07-31;2017-09-11;54264000;55858000;160724000;92963000;81509000;355277000;28509000;;54827000;83336000;438613000;86511000;3779000;98375000;17547000;26559000;124934000;812630000;;-487055000;313679000;438613000
BLL;247618;USD;2017;Q4;2017-12-31;2018-03-01;349635000;352471000;448000000;1634000000;1526000000;3758000000;4610000000;;8801000000;13411000000;17169000000;3114000000;453000000;4107000000;6518000000;9016000000;13123000000;1084000000;-1474000000;4987000000;4046000000;17169000000
BLL;247618;USD;2016;Q4;2016-12-31;2016-11-08;349378000;362092000;597000000;1491000000;1413000000;3653000000;4387000000;;8133000000;12520000000;16173000000;2348000000;222000000;2969000000;7310000000;9663000000;12632000000;1038000000;-1401000000;4739000000;3541000000;16173000000
BLL;247618;USD;2015;Q4;2015-12-31;2015-10-30;273952000;280924000;224000000;885000000;898000000;2184000000;2686000000;;4827000000;7513000000;9697000000;1730000000;77000000;2142000000;4974000000;6294000000;8436000000;962000000;-3628000000;4557000000;1261000000;9697000000
BLL;247618;USD;2014;Q4;2014-12-31;2014-11-03;273210000;281424000;191400000;957100000;1016700000;2313500000;2430700000;;2826800000;5257500000;7571000000;1609900000;175100000;2006800000;2993800000;4324600000;6331400000;1131300000;-3923000000;4346900000;1239600000;7571000000
BLL;247618;USD;2013;Q4;2013-12-31;2013-10-30;285988000;292752000;416000000;859400000;1028300000;2470900000;2372300000;;2977200000;5349500000;7820400000;1240100000;422600000;1927400000;3182500000;4477000000;6404400000;1078400000;-3551600000;3947700000;1416000000;7820400000
BLL;247618;USD;2012;Q4;2012-12-31;2012-11-09;303864000;310604000;174100000;930100000;1044400000;2339400000;2276700000;;2891000000;5167700000;7507100000;1225300000;219800000;1685800000;3085300000;4531300000;6217100000;1026300000;-3140100000;3580800000;1290000000;7507100000
BLL;247618;USD;2011;Q4;2011-12-31;2011-11-07;321632000;326784000;165800000;910400000;1072500000;2321900000;2220200000;;2742500000;4962700000;7284600000;1095600000;447400000;1856100000;2696700000;4050500000;5906600000;941700000;-2615700000;3228300000;1378000000;7284600000
BLL;247618;USD;2010;Q4;2010-12-31;2010-11-04;347092000;353540000;152000000;849700000;1083900000;2305700000;2048200000;;2573800000;4622000000;6927700000;958500000;110700000;1383300000;2701600000;3886300000;5269600000;893400000;-2123100000;2829800000;1658100000;6927700000
BLL;247618;USD;2009;Q4;2009-12-31;2010-08-04;;;210600000;534900000;881200000;2262200000;1751500000;;2474600000;4226100000;6488300000;793800000;312300000;1430200000;2283900000;3475100000;4905300000;830800000;-1582800000;2397100000;1583000000;6488300000
BLL;247618;USD;2018;Q4;2018-12-31;2019-02-22;337766000;347119000;721000000;1802000000;1271000000;3940000000;4542000000;;8072000000;12614000000;16554000000;3384000000;219000000;4095000000;6510000000;8897000000;12992000000;1157000000;-2205000000;5341000000;3562000000;16554000000
SYY;247719;USD;2018;Q4;2018-06-30;2018-08-27;521301128;528055840;552325000;4073723000;3125413000;8003453000;4521660000;;5545291000;10066951000;18070404000;5802241000;786505000;6588746000;7540765000;8937052000;15525798000;2148794000;-8581196000;10348628000;2544606000;18070404000
SYY;247719;USD;2017;Q4;2017-06-30;2017-08-30;534125177;538785058;869502000;4012393000;2995598000;8033438000;4377302000;;5345915000;9723217000;17756655000;5561873000;534013000;6095886000;7660877000;9196414000;15292300000;2092541000;-7896043000;9447755000;2464355000;17756655000
SYY;247719;USD;2016;Q4;2016-06-30;2016-08-30;562275877;566623029;3919300000;3380971000;2639174000;10053899000;3880442000;;2787463000;6667905000;16721804000;4335984000;98472000;4434456000;7336930000;8732354000;13166810000;2046315000;-6214727000;9006138000;3554994000;16721804000
SYY;247719;USD;2015;Q4;2015-06-30;2015-08-25;;;5130044000;3353381000;2691823000;11494304000;3982143000;;2512834000;6494977000;17989281000;4349563000;5050052000;9399615000;2271825000;3288138000;12687753000;1979174000;-4547738000;8751985000;5301528000;17989281000
SYY;247719;USD;2014;Q4;2014-06-30;2014-08-26;;;413046000;3398713000;2602018000;6681972000;3985618000;;2473523000;6459141000;13141113000;3991878000;375752000;4367630000;2357330000;3506788000;7874418000;1904393000;-4765786000;8770751000;5266695000;13141113000
SYY;247719;USD;2013;Q4;2013-06-30;2013-08-27;;;412285000;3183114000;2396188000;6221688000;3978071000;;2478449000;6456520000;12678208000;3413691000;248933000;3662624000;2639986000;3823774000;7486398000;1824799000;-4698838000;8512786000;5191810000;12678208000
SYY;247719;USD;2012;Q4;2012-06-30;2012-08-28;;;688867000;2966624000;2178830000;6084808000;3883750000;;2168649000;6052399000;12137207000;3168929000;254650000;3423579000;2763688000;4028588000;7452167000;1704354000;-4531678000;8175230000;4685040000;12137207000
SYY;247719;USD;2011;Q4;2011-06-30;2011-08-30;;;639765000;2898283000;2073766000;5732882000;3512389000;;2140284000;5652673000;11385555000;3039986000;389006000;3575075000;2279517000;3105238000;6680313000;1652929000;-4369398000;7681669000;4705242000;11385555000
SYY;247719;USD;2010;Q4;2010-06-30;2010-08-31;;;608954000;2617352000;1771539000;5076258000;3203823000;;2033620000;5237443000;10313701000;2823206000;7970000;3009198000;2472662000;3476977000;6486175000;1582008000;-4408370000;7134139000;3827526000;10313701000
SYY;247719;USD;2009;Q4;2009-06-30;2010-08-31;;;1018651000;2468511000;1650666000;5202246000;2979200000;;1966740000;4945940000;10148186000;2910193000;9163000;3081721000;2467486000;3616763000;6698484000;1525527000;-4337729000;6539890000;3449702000;10148186000
TRN;247970;USD;2016;Q4;2016-12-31;2017-02-17;206683200;207794400;798100000;378700000;665800000;2122900000;5966800000;;1035600000;7002400000;9125300000;582200000;;684700000;3056600000;4129500000;4814200000;;;;4311100000;9125300000
TRN;247970;USD;2015;Q4;2015-12-31;2016-02-19;206822100;207516600;870900000;369900000;943100000;2474600000;5348000000;;1063300000;6411300000;8885900000;746400000;;889600000;3195400000;3947600000;4837200000;550000000;-1000000;3220300000;4048700000;8885900000
TRN;247970;USD;2014;Q4;2014-12-31;2015-02-19;210155700;216406200;962900000;405300000;1068400000;2729900000;4902900000;;1062500000;5965400000;8695300000;1005000000;;1150800000;3514500000;4147100000;5297900000;618900000;-1000000;2489900000;3397400000;8695300000
TRN;247970;USD;2013;Q4;2013-12-31;2014-02-20;210016800;210016800;578200000;365000000;814700000;2026300000;4770600000;;516500000;5287100000;7313400000;783700000;;923800000;2989800000;3640500000;4564300000;768300000;-158000000;1870000000;2749100000;7313400000
TRN;247970;USD;2012;Q4;2012-12-31;2013-02-21;215017200;215295000;573000000;390000000;702100000;1888300000;4299000000;;482600000;4781600000;6669900000;771300000;;904900000;3055000000;3627400000;4532300000;734300000;-67900000;1536700000;2137600000;6669900000
TRN;247970;USD;2011;Q4;2011-12-31;2012-02-16;216128400;217239600;351100000;385900000;544600000;1521900000;4159100000;;440000000;4599100000;6121000000;628700000;;765800000;2972200000;3406900000;4172700000;708200000;-25100000;1314700000;1948300000;6121000000
TRN;247970;USD;2010;Q4;2010-12-31;2011-02-17;213628200;215017200;512000000;232000000;331300000;1289800000;4112000000;;358200000;4470200000;5760000000;508400000;;615600000;2907700000;3298700000;3914300000;687800000;-28000000;1200500000;1845700000;5760000000
TRN;247970;USD;2009;Q4;2009-12-31;2010-07-29;212239200;212239200;681800000;159800000;231500000;1222900000;3038200000;;395300000;3433500000;4656400000;451300000;;607100000;1845100000;2243000000;2850100000;680100000;-39700000;1263900000;1806300000;4656400000
TRN;247970;USD;2017;Q4;2017-12-31;2018-02-22;206405400;215433900;1098100000;369700000;640600000;2332600000;6134700000;;1075900000;7210600000;9543200000;615400000;;699600000;3242400000;3985600000;4685200000;484100000;-1600000;4123400000;4858000000;9543200000
TRN;247970;USD;2018;Q4;2018-12-31;2019-02-21;-33215400;-34588500;179200000;276600000;524700000;1192500000;6334400000;;462300000;6796700000;7989200000;580400000;;654900000;4029200000;4772300000;5427200000;2500000;-1000000;2326100000;2562000000;7989200000
CSX;248102;USD;2016;Q4;2016-12-31;2017-02-14;932000000;934000000;1020000000;938000000;407000000;2487000000;31150000000;;1777000000;32927000000;35414000000;1480000000;331000000;2040000000;10962000000;21680000000;23720000000;1066000000;;11253000000;11694000000;35414000000
CSX;248102;USD;2015;Q4;2015-12-31;2016-02-10;972000000;973000000;1438000000;982000000;350000000;2840000000;30174000000;;1731000000;31905000000;34745000000;1362000000;20000000;1952000000;10515000000;21125000000;23077000000;1079000000;;11238000000;11668000000;34745000000
CSX;248102;USD;2014;Q4;2014-12-31;2015-02-11;994000000;998000000;961000000;1129000000;273000000;2572000000;28584000000;;1897000000;30481000000;33053000000;1621000000;228000000;2107000000;9514000000;19770000000;21877000000;1084000000;;10734000000;11176000000;33053000000
CSX;248102;USD;2013;Q4;2013-12-31;2014-02-12;1015000000;1012000000;1079000000;1052000000;252000000;2602000000;27291000000;;1889000000;29180000000;31782000000;1635000000;533000000;2424000000;9022000000;18854000000;21278000000;1070000000;;9936000000;10504000000;31782000000
CSX;248102;USD;2012;Q4;2012-12-31;2013-02-19;1026000000;1028000000;1371000000;1114000000;274000000;2953000000;26050000000;;1720000000;27770000000;30723000000;1585000000;780000000;2645000000;9052000000;18942000000;21587000000;1048000000;;9010000000;9136000000;30723000000
CSX;248102;USD;2011;Q4;2011-12-31;2012-02-21;1051000000;1055000000;1306000000;1000000000;240000000;2806000000;24974000000;;1564000000;26538000000;29344000000;1688000000;507000000;2558000000;8734000000;18318000000;20876000000;1055000000;;8275000000;8468000000;29344000000
CSX;248102;USD;2010;Q4;2010-12-31;2011-02-18;1115271000;1128858000;1346000000;993000000;218000000;2855000000;23799000000;;1487000000;25286000000;28141000000;1651000000;613000000;2537000000;8051000000;16904000000;19441000000;370000000;;9087000000;8700000000;28141000000
CSX;248102;USD;2009;Q4;2009-12-31;2010-02-19;4700473383;4744442588;1090000000;995000000;203000000;2570000000;23064000000;;1253000000;24317000000;26887000000;1462000000;113000000;1865000000;7895000000;16254000000;18119000000;473000000;;9090000000;8768000000;26887000000
CSX;248102;USD;2008;Q4;2008-12-31;2009-04-15;4805241660;4899723576;745000000;1107000000;217000000;2391000000;22688000000;;1209000000;23897000000;26288000000;1563000000;319000000;2404000000;7512000000;15816000000;18220000000;391000000;;8398000000;8068000000;26288000000
CSX;248102;USD;2017;Q4;2017-12-31;2018-02-07;895000000;897000000;419000000;970000000;372000000;1915000000;31764000000;;2060000000;33824000000;35739000000;1606000000;19000000;1894000000;11790000000;19124000000;21018000000;1107000000;;14084000000;14721000000;35739000000
CSX;248102;USD;2018;Q4;2018-12-31;2019-02-06;829000000;834000000;1111000000;1010000000;263000000;2565000000;31998000000;;2166000000;34164000000;36729000000;1605000000;18000000;1915000000;14739000000;22234000000;24149000000;1067000000;;12157000000;12580000000;36729000000
IEHC;248180;USD;2017;Q4;2018-03-31;2018-07-12;2303000;2303000;1407013;4429267;10751498;17232332;2066155;;54489;2120644;19352976;1512391;;2280760;;;2280760;3790643;;13281573;17072216;19352976
IEHC;248180;USD;2016;Q4;2017-03-31;2017-07-14;-6899788;-6899788;1210761;3107670;8685988;14503887;2019150;;54451;2073601;16577488;834926;;1522944;;;1522944;3762663;;11291881;15054544;16577488
IEHC;248180;USD;2015;Q4;2016-03-31;2016-07-08;-6899788;-6899788;1753749;2212508;7250300;12780539;1867191;;54361;1921552;14702091;490243;;1121523;;;1121523;2767608;;10812960;13580568;14702091
IEHC;248180;USD;2014;Q4;2015-03-31;2015-07-10;2303000;2303000;1721410;2226707;6749659;11095268;1691541;;54361;1745902;12841170;320587;;950712;;;950712;2767608;;9122850;11890458;12841170
IEHC;248180;USD;2013;Q4;2014-03-31;2014-07-11;2303000;2303000;1733460;1655930;4581432;9381054;1576476;;46284;1622760;11003814;363768;;922911;;;922911;2767608;;7313295;10080903;11003814
IEHC;248180;USD;2012;Q4;2013-03-31;2013-07-10;2303000;2303000;415857;1817768;4463180;7688947;1497690;;34220;1531910;9220857;85548;;572303;;21358;593661;2767608;;5859588;8627196;9220857
IEHC;248180;USD;2011;Q4;2012-03-31;2012-07-09;6904394;6904394;286109;2043982;4233260;7099065;1445487;;31177;1476664;8575729;305786;54943;813040;;65423;878463;2767608;;4929658;7697266;8575729
IEHC;248180;USD;2010;Q4;2011-03-31;2011-09-09;;;157049;1986799;3713372;6183206;1268890;;27887;1296777;7479983;359977;0;772080;;113061;885141;2767608;;3827234;6594842;7479983
IEHC;248180;USD;2018;Q4;2019-03-31;2019-07-12;2323000;2438000;7080126;3833090;12021443;23469556;2560607;;54489;2615096;26084652;2156440;334306;3816396;;;3816396;3825907;;18442349;22268256;26084652
CVX;248396;USD;2015;Q4;2015-12-31;2016-02-25;1869340000;-5597623000;11332000000;12860000000;6334000000;34430000000;188396000000;29522000000;12192000000;230110000000;264540000000;19467000000;4927000000;25467000000;33622000000;85187000000;110654000000;17922000000;-42493000000;181578000000;153886000000;264540000000
CVX;248396;USD;2014;Q4;2014-12-31;2015-02-20;1872510000;-5652237000;13207000000;16736000000;6505000000;42232000000;183173000000;29729000000;10892000000;223794000000;266026000000;25561000000;3790000000;31926000000;24028000000;77909000000;109835000000;17633000000;-42733000000;184987000000;156191000000;266026000000
CVX;248396;USD;2013;Q4;2013-12-31;2014-02-21;1903548000;1917455000;16508000000;21622000000;6380000000;50250000000;164829000000;28335000000;10339000000;203503000000;253753000000;29552000000;374000000;33018000000;20057000000;70308000000;103326000000;17305000000;-38290000000;173677000000;150427000000;253753000000
CVX;248396;USD;2012;Q4;2012-12-31;2013-02-22;1936151000;1953088000;21205000000;20997000000;6144000000;55720000000;141348000000;26771000000;9143000000;177262000000;232982000000;29744000000;127000000;34212000000;12065000000;60938000000;95150000000;17047000000;-33884000000;159730000000;137832000000;232982000000
CVX;248396;USD;2011;Q4;2011-12-31;2012-02-23;1970615000;1987748000;16113000000;21793000000;5543000000;53234000000;122608000000;25101000000;8531000000;156240000000;209474000000;28676000000;340000000;33600000000;9812000000;53693000000;87293000000;16690000000;-29685000000;140399000000;122181000000;209474000000
CVX;248396;USD;2010;Q4;2010-12-31;2011-02-24;1998903000;2010998000;14215000000;20759000000;5493000000;48841000000;104504000000;23597000000;7827000000;135928000000;184769000000;26049000000;187000000;29012000000;11289000000;49946000000;78958000000;16317000000;-26411000000;119641000000;105811000000;184769000000
CVX;248396;USD;2009;Q4;2009-12-31;2010-02-25;1992815000;2004238000;8822000000;17703000000;5529000000;37216000000;96468000000;23440000000;7497000000;127405000000;164621000000;23203000000;384000000;26211000000;10130000000;45849000000;72060000000;16114000000;-26168000000;106289000000;92561000000;164621000000
CVX;248396;USD;2008;Q4;2008-12-31;2009-08-06;2002564000;2010553000;9560000000;15856000000;6854000000;36470000000;91780000000;23333000000;9582000000;124695000000;161165000000;26126000000;2818000000;32023000000;6083000000;42025000000;74048000000;15846000000;-26376000000;101102000000;87117000000;161165000000
CVX;248396;USD;2016;Q4;2016-12-31;2017-02-23;1876581000;1866888000;7001000000;14092000000;5419000000;29619000000;182186000000;32735000000;15538000000;230459000000;260078000000;19895000000;10840000000;31785000000;35286000000;81571000000;113356000000;18187000000;-41834000000;173046000000;146722000000;260078000000
CVX;248396;USD;2017;Q4;2017-12-31;2018-02-22;1888959000;1907714000;4822000000;15353000000;5585000000;28560000000;177712000000;35346000000;12188000000;225246000000;253806000000;20945000000;5192000000;27737000000;33571000000;76750000000;104487000000;18440000000;-40833000000;174106000000;149319000000;253806000000
CVX;248396;USD;2018;Q4;2018-12-31;2019-02-22;1894918000;1906359000;9395000000;15050000000;5704000000;34021000000;169207000000;37488000000;13147000000;219842000000;253863000000;19817000000;5726000000;27171000000;28733000000;71050000000;98221000000;18704000000;-41593000000;180987000000;155642000000;253863000000
HSY;248677;USD;2016;Q4;2016-12-31;2017-02-21;60620000;60620000;296967000;581381000;745678000;1816778000;2177248000;;1530307000;3707555000;5524333000;1276729000;632714000;1909443000;2347455000;2787203000;4696646000;1229758000;-6183975000;6115961000;827687000;5524333000
HSY;248677;USD;2015;Q4;2015-12-31;2016-02-26;-416508000;-419927000;346529000;599073000;750970000;1848598000;2240460000;;1255313000;3495773000;5344371000;1354476000;863436000;2217912000;1557091000;2078997000;4296909000;1143778000;-5672359000;5897603000;1047462000;5344371000
HSY;248677;USD;2014;Q4;2014-12-31;2015-02-20;221346000;223444000;471985000;596940000;801036000;2247047000;2151901000;;1223922000;3375823000;5622870000;1300146000;635501000;1935647000;1542317000;2167693000;4103340000;1114087000;-5161236000;5860784000;1519530000;5622870000
HSY;248677;USD;2013;Q4;2013-12-31;2014-02-21;224382000;227379000;1118508000;477912000;659541000;2487334000;1805345000;;1064809000;2870154000;5357488000;1241147000;166875000;1408022000;1795142000;2333414000;3741436000;1024845000;-4707730000;5454286000;1616052000;5357488000
HSY;248677;USD;2012;Q4;2012-12-31;2013-02-22;553567000;227232000;728272000;461383000;633262000;2113485000;1674071000;;967283000;2641354000;4754839000;1095212000;375898000;1471110000;1530967000;2235356000;3706466000;952876000;-4558668000;5027617000;1048373000;4754839000
HSY;248677;USD;2011;Q4;2011-12-31;2012-02-17;391596000;229332000;693686000;399499000;648953000;2046558000;1559717000;;800819000;2360536000;4407094000;1034102000;139673000;1173775000;1748500000;2352376000;3526151000;850718000;-4258962000;4707892000;880943000;4407094000
HSY;248677;USD;2010;Q4;2010-12-31;2011-02-18;455343292;230886000;884642000;390061000;533622000;2005217000;1437702000;;829813000;2267515000;4272732000;1013365000;285480000;1298845000;1541825000;2036286000;3335131000;794766000;-4052101000;4374718000;937601000;4272732000
HSY;248677;USD;2009;Q4;2009-12-31;2010-02-19;410468000;229654000;253605000;410390000;519712000;1385434000;1404767000;;884830000;2289597000;3675031000;871315000;39313000;910628000;1502730000;2004064000;2914692000;754579000;-3979629000;4148353000;760339000;3675031000
HSY;248677;USD;2008;Q4;2008-12-31;2009-08-13;409856000;;37103000;455153000;592530000;1344945000;1458949000;;830825000;2289774000;3634719000;768708000;501504000;1270212000;1505954000;2014563000;3284775000;712276000;-4009931000;3975762000;349944000;3634719000
HSY;248677;USD;2017;Q4;2017-12-31;2018-02-27;60620000;60620000;380179000;588262000;752836000;2001910000;2106697000;;1445119000;3551816000;5553726000;1217086000;859457000;2076543000;2061023000;2545618000;4622161000;1284879000;-6426877000;6371082000;931565000;5553726000
HSY;248677;USD;2018;Q4;2018-12-31;2019-02-22;60596000;60596000;587998000;594145000;784879000;2239181000;2130294000;;3333545000;5463839000;7703020000;1215250000;1203316000;2418566000;3254280000;3877188000;6295754000;1342106000;-6618625000;7032020000;1407266000;7703020000
HRS;248838;USD;2017;Q4;2017-06-30;2017-08-29;120200000;122200000;484000000;623000000;841000000;2073000000;904000000;;7113000000;8017000000;10090000000;888000000;634000000;1926000000;3396000000;5236000000;7162000000;1861000000;;1343000000;2928000000;10090000000
HRS;248838;USD;2016;Q4;2016-06-30;2016-08-29;123900000;125200000;487000000;674000000;867000000;2624000000;924000000;;8461000000;9385000000;12009000000;877000000;397000000;1981000000;4120000000;6971000000;8952000000;2221000000;;1330000000;3057000000;12009000000
HRS;248838;USD;2015;Q4;2015-06-30;2015-08-31;110600000;111500000;481000000;1168000000;1015000000;3183000000;1165000000;;8779000000;9944000000;13127000000;1128000000;163000000;2274000000;5053000000;7451000000;9725000000;2155000000;;1258000000;3402000000;13127000000
HRS;248838;USD;2014;Q4;2014-06-30;2014-08-25;;107200000;561000000;566000000;619000000;1991000000;728000000;;2200000000;2928000000;4919000000;574000000;60000000;1115000000;1564000000;1979000000;3094000000;615000000;;1226000000;1825000000;4919000000
HRS;248838;USD;2013;Q4;2013-06-30;2013-08-26;;108100000;321000000;696800000;668700000;1948100000;653200000;;2257100000;2910300000;4858400000;595300000;158000000;1297400000;1577100000;1999800000;3297200000;540000000;;1079900000;1561200000;4858400000
HRS;248838;USD;2012;Q4;2012-06-30;2012-08-27;;114100000;356000000;750200000;617800000;2600400000;659400000;;2333000000;2992400000;5592800000;662600000;164200000;1414400000;1883000000;2232300000;3646700000;544900000;;1416600000;1946100000;5592800000
HRS;248838;USD;2011;Q4;2011-06-30;2011-08-29;;124700000;366900000;836500000;720800000;2216800000;872800000;;3083200000;3956000000;6172800000;746600000;184900000;1430500000;1887200000;2230300000;3660800000;594300000;;1889000000;2512000000;6172800000
HRS;248838;USD;2010;Q4;2010-06-30;2010-08-30;;127300000;455200000;736000000;615300000;2004600000;609700000;;2129300000;2739000000;4743600000;605800000;30700000;1051800000;1176600000;1501700000;2553500000;588600000;;1621400000;2190100000;4743600000
HRS;248838;USD;2009;Q4;2009-06-30;2009-10-28;;130900000;281200000;770800000;607200000;1859400000;543200000;;2062500000;2605700000;4465100000;656700000;106400000;1109700000;1177300000;1486300000;2596000000;597700000;;1322800000;1869100000;4465100000
HRS;248838;USD;2018;Q4;2018-06-30;2018-08-27;118400000;121300000;288000000;735000000;925000000;2223000000;900000000;;6716000000;7616000000;9839000000;950000000;382000000;1788000000;3408000000;4729000000;6517000000;1832000000;;1692000000;3322000000;9839000000
CPB;249099;USD;2018;Q4;2018-07-31;2018-09-27;301000000;304000000;226000000;785000000;1199000000;2296000000;3233000000;;9000000000;12233000000;14529000000;1698000000;1896000000;3594000000;7998000000;9562000000;13156000000;361000000;-1103000000;2224000000;1373000000;14529000000
CPB;249099;USD;2017;Q4;2017-07-31;2017-09-27;302000000;303000000;319000000;605000000;902000000;1900000000;2454000000;;3372000000;5826000000;7726000000;1358000000;1037000000;2395000000;2499000000;3686000000;6081000000;371000000;-1066000000;2385000000;1645000000;7726000000
CPB;249099;USD;2016;Q4;2016-07-31;2016-06-07;307000000;309000000;296000000;626000000;940000000;1908000000;2407000000;;3522000000;5929000000;7837000000;1336000000;1219000000;2555000000;2314000000;3749000000;6304000000;366000000;-664000000;1927000000;1533000000;7837000000
CPB;249099;USD;2015;Q4;2015-07-31;2015-06-11;310000000;310000000;253000000;647000000;995000000;2093000000;2347000000;;3637000000;5984000000;8077000000;1263000000;1543000000;2806000000;2539000000;3894000000;6700000000;351000000;-556000000;1754000000;1377000000;8077000000
CPB;249099;USD;2014;Q4;2014-07-31;2014-09-24;314000000;315000000;232000000;670000000;1016000000;2100000000;2318000000;;3695000000;6013000000;8113000000;1218000000;1771000000;2989000000;2244000000;3521000000;6510000000;342000000;-356000000;2198000000;1603000000;8113000000
CPB;249099;USD;2013;Q4;2013-07-31;2013-06-05;314000000;319000000;333000000;635000000;925000000;2221000000;2260000000;;3842000000;6102000000;8323000000;1259000000;1909000000;3282000000;2544000000;3831000000;7113000000;374000000;-364000000;1772000000;1210000000;8323000000
CPB;249099;USD;2012;Q4;2012-07-31;2012-06-06;314000000;316000000;335000000;553000000;714000000;1771000000;2127000000;;2632000000;4759000000;6530000000;1284000000;786000000;2070000000;2004000000;3562000000;5632000000;349000000;-8259000000;9584000000;898000000;6530000000
CPB;249099;USD;2011;Q4;2011-07-31;2011-06-09;318000000;323000000;484000000;560000000;767000000;1963000000;2103000000;;2796000000;4899000000;6862000000;1332000000;657000000;1989000000;2427000000;3777000000;5766000000;351000000;-8021000000;9185000000;1096000000;6862000000
CPB;249099;USD;2010;Q4;2010-07-31;2010-06-10;337000000;340000000;254000000;512000000;724000000;1687000000;2051000000;;2538000000;4589000000;6276000000;1230000000;835000000;2065000000;1945000000;3282000000;5347000000;361000000;-7459000000;8760000000;929000000;6276000000
CPB;249099;USD;2009;Q4;2009-07-31;2010-06-10;346000000;345000000;51000000;528000000;824000000;1551000000;1977000000;;2528000000;4505000000;6056000000;1250000000;378000000;1628000000;2246000000;3697000000;5325000000;352000000;-7194000000;8288000000;731000000;6056000000
CPB;249099;USD;2019;Q4;2019-07-31;2019-09-26;301000000;303000000;31000000;574000000;863000000;1967000000;2455000000;;8726000000;11181000000;13148000000;1545000000;1371000000;3385000000;7103000000;8651000000;12036000000;384000000;-1076000000;1993000000;1112000000;13148000000
TIF;249289;USD;2017;Q4;2018-01-31;2018-03-16;124500000;125000000;1291200000;231200000;2253500000;3983300000;990500000;;494300000;1484800000;5468100000;526800000;120600000;724800000;882900000;1495100000;2219900000;1257200000;;2114200000;3248200000;5468100000
TIF;249289;USD;2016;Q4;2017-01-31;2017-03-17;124400000;125000000;985800000;226800000;2157600000;3573600000;931800000;;592200000;1524000000;5097600000;334900000;228700000;632800000;878400000;1436400000;2069200000;1191400000;;2078300000;3028400000;5097600000
TIF;249289;USD;2015;Q4;2016-01-31;2016-03-28;127600000;127900000;886600000;206400000;2225000000;3508400000;935800000;;677400000;1613200000;5121600000;356200000;305800000;729900000;790000000;1462200000;2192100000;1177000000;;2012500000;2929500000;5121600000
TIF;249289;USD;2014;Q4;2015-01-31;2015-03-20;129200000;129900000;731500000;195200000;2362100000;3508800000;899500000;;772300000;1671800000;5180600000;357900000;234000000;658000000;882500000;1671900000;2329900000;1174900000;;1950700000;2850700000;5180600000
TIF;249289;USD;2013;Q4;2014-01-31;2014-04-01;128052000;129414000;367035000;188814000;2326580000;3228388000;855095000;;668868000;1523963000;4752351000;374066000;252365000;696740000;751154000;1321643000;2018383000;1096587000;;1682398000;2733968000;4752351000
TIF;249289;USD;2012;Q4;2013-01-31;2013-03-28;126857000;127993000;506201000;173998000;2234334000;3151589000;818838000;;660423000;1479261000;4630850000;325911000;194034000;586592000;765238000;1432940000;2019532000;1021266000;;1671341000;2611318000;4630850000
TIF;249289;USD;2011;Q4;2012-01-31;2012-03-28;126747000;128345000;433954000;184085000;2073212000;2889675000;767174000;;502143000;1269317000;4158992000;389939000;173795000;626677000;538352000;1183410000;1810087000;971482000;;1462553000;2348905000;4158992000
TIF;249289;USD;2010;Q4;2011-01-31;2011-03-28;126628000;128791000;740871000;185969000;1625302000;2684545000;665588000;;385536000;1051124000;3735669000;314302000;99746000;479913000;588494000;1078281000;1558194000;865236000;;1324804000;2177475000;3735669000
TIF;249289;USD;2009;Q4;2010-01-31;2010-09-02;125095000;127264000;785702000;158706000;1427855000;2445666000;685101000;;357593000;1042694000;3488360000;299426000;234457000;600273000;519592000;1004848000;1605121000;765395000;;1151109000;1883239000;3488360000
TIF;249289;USD;2018;Q4;2019-01-31;2019-03-22;121700000;121900000;855300000;245400000;2428000000;3759500000;1026700000;;546800000;1573500000;5333000000;534800000;113400000;718100000;883400000;1484000000;2202100000;1276600000;;2045600000;3130900000;5333000000
NBL;249388;USD;2017;Q4;2017-12-31;2018-02-20;486000000;483000000;675000000;748000000;;2203000000;17502000000;;1771000000;19273000000;21476000000;1161000000;;1739000000;6746000000;9118000000;10857000000;8443000000;-725000000;2248000000;10619000000;21476000000
NBL;249388;USD;2016;Q4;2016-12-31;2017-02-14;431000000;431000000;1180000000;615000000;;1955000000;18548000000;;508000000;19056000000;21011000000;736000000;;1478000000;7011000000;9933000000;11411000000;6455000000;-692000000;3556000000;9600000000;21011000000
NBL;249388;USD;2015;Q4;2015-12-31;2016-02-17;431000000;431000000;1028000000;450000000;;2276000000;21300000000;;620000000;21920000000;24196000000;1128000000;;1805000000;7976000000;12021000000;13826000000;6365000000;-688000000;4726000000;10370000000;24196000000
NBL;249388;USD;2014;Q4;2014-12-31;2015-02-19;361000000;370000000;1183000000;857000000;;3075000000;18143000000;;1300000000;19443000000;22518000000;1578000000;;2522000000;6068000000;9671000000;12193000000;3628000000;-671000000;7458000000;10325000000;22518000000
NBL;249388;USD;2013;Q4;2013-12-31;2014-02-06;360000000;364000000;1117000000;947000000;;2611000000;15725000000;;1306000000;17031000000;19642000000;1354000000;;2342000000;4566000000;8116000000;10458000000;3467000000;-659000000;6493000000;9184000000;19642000000
NBL;249388;USD;2012;Q4;2012-12-31;2013-02-07;358000000;356000000;1387000000;964000000;;2771000000;13551000000;;1232000000;14783000000;17554000000;1508000000;;2532000000;3736000000;6764000000;9296000000;3306000000;-648000000;5713000000;8258000000;17554000000
NBL;249388;USD;2011;Q4;2011-12-31;2012-02-09;354000000;354000000;1455000000;783000000;;2418000000;12782000000;;1244000000;14026000000;16444000000;1343000000;;2268000000;4100000000;6911000000;9179000000;3153000000;-638000000;4850000000;7265000000;16444000000
NBL;249388;USD;2010;Q4;2010-12-31;2011-02-10;352000000;352000000;1081000000;556000000;;1838000000;10264000000;;1180000000;11444000000;13282000000;927000000;;1422000000;2272000000;5012000000;6434000000;3036000000;-624000000;4540000000;6848000000;13282000000
NBL;249388;USD;2009;Q4;2009-12-31;2010-02-18;346000000;342000000;1014000000;465000000;;1678000000;8916000000;;1213000000;10129000000;11807000000;548000000;;990000000;2037000000;4660000000;5650000000;2905000000;-615000000;3942000000;6157000000;11807000000
NBL;249388;USD;2008;Q4;2008-12-31;2009-07-30;352000000;352000000;1140000000;423000000;;2158000000;9004000000;;1222000000;10226000000;12384000000;579000000;;1174000000;2241000000;4901000000;6075000000;2834000000;-614000000;4199000000;6309000000;12384000000
AGYS;249502;USD;2017;Q4;2018-03-31;2018-05-25;22873000;;39943000;16389000;1999000;63924000;17512000;;75771000;93283000;157207000;17641000;120000;44581000;57000;4195000;48776000;7571000;-2486000;103601000;108431000;157207000
AGYS;249502;USD;2016;Q4;2017-03-31;2017-06-02;22644000;;49255000;15598000;2211000;73520000;16000000;;77785000;93785000;167305000;17033000;121000;46337000;116000;7299000;53636000;3700000;-2519000;112692000;113669000;167305000
AGYS;249502;USD;2015;Q4;2016-03-31;2016-06-10;22743000;;60608000;22017000;2692000;95501000;15252000;;74404000;89656000;185157000;20741000;118000;54100000;215000;7584000;61684000;1837000;-2600000;124413000;123473000;185157000
AGYS;249502;USD;2014;Q4;2015-03-31;2015-06-05;22345000;22345000;75067000;25481000;641000;105017000;11929000;;64579000;76508000;181525000;26587000;142000;50610000;47000;6727000;57337000;-1193000;-2646000;128178000;124188000;181525000
AGYS;249502;USD;2013;Q4;2014-03-31;2014-06-04;22243000;21973000;99566000;23615000;481000;129854000;12251000;;48790000;61041000;190895000;25305000;43000;48143000;292000;9879000;58022000;-3927000;-2741000;139675000;132873000;190895000
AGYS;249502;USD;2012;Q4;2013-03-31;2013-06-14;21901000;21901000;82444000;15591000;809000;146296000;13791000;;37411000;51202000;197498000;22698000;58000;74174000;28000;9468000;83642000;-4785000;-2838000;122578000;113856000;197498000
AGYS;249502;USD;2011;Q4;2012-03-31;2012-06-12;21774000;21774000;97587000;32531000;15710000;154295000;16504000;;33340000;49844000;204139000;48921000;647000;78009000;347000;11692000;89701000;-6550000;-2919000;123876000;114438000;204139000
AGYS;249502;USD;2010;Q4;2011-03-31;2011-08-09;;;74354000;31926000;10921000;229792000;24855000;;57751000;82606000;312398000;32788000;999000;146787000;907000;17507000;164294000;4061000;-2575000;146659000;148104000;312398000
AGYS;249502;USD;2018;Q4;2019-03-31;2019-05-24;22874000;;40771000;27000000;2044000;79008000;15838000;;68745000;84583000;163591000;19610000;22000;58301000;35000;4668000;62969000;10263000;-2433000;93051000;100622000;163591000
HAS;249756;USD;2016;Q4;2016-12-31;2017-02-22;124927000;124927000;1282285000;1319963000;387675000;3227607000;267398000;;1596361000;1863759000;5091366000;1095564000;522295000;1617859000;1198679000;1588067000;3205926000;1090265000;-3181681000;4148722000;1885440000;5091366000
HAS;249756;USD;2015;Q4;2015-12-31;2016-02-24;124978000;123161000;976750000;1217850000;384492000;2865598000;237527000;;1617592000;1855119000;4720717000;900084000;164563000;1064647000;1547115000;1951998000;3016645000;998477000;-3040895000;3852321000;1704072000;4720717000
HAS;249756;USD;2014;Q4;2014-12-31;2015-02-26;125738000;131638000;893167000;1094673000;339572000;2643505000;237489000;;1637106000;1874595000;4518100000;819203000;252481000;1071684000;1545853000;1938022000;3009706000;911112000;-2980066000;3630072000;1508394000;4518100000
HAS;249756;USD;2013;Q4;2013-12-31;2014-02-26;130828000;130828000;682449000;1093620000;348794000;2480457000;236263000;;1685547000;1921810000;4402267000;926558000;436722000;1363280000;959895000;1311199000;2674479000;839028000;-2554726000;3432176000;1727788000;4402267000
HAS;249756;USD;2012;Q4;2012-12-31;2013-02-27;129786000;137222000;849701000;1029959000;316049000;2508202000;230414000;;1586771000;1817185000;4325387000;736070000;224365000;960435000;1396421000;1857573000;2818008000;760790000;-2535649000;3354545000;1507379000;4325387000
HAS;249756;USD;2011;Q4;2011-12-31;2012-02-22;129126000;131670000;641688000;1034580000;333993000;2253692000;218021000;;1659061000;1877082000;4130774000;761914000;180430000;942344000;1400872000;1770915000;2713259000;734891000;-2486853000;3205420000;1417515000;4130774000
HAS;249756;USD;2010;Q4;2010-12-31;2011-02-23;136997000;141209000;727796000;961252000;364194000;2221049000;233580000;;1638597000;1872177000;4093226000;704233000;14568000;718801000;1397681000;1759005000;2477806000;730808000;-2101854000;2978317000;1615420000;4093226000
HAS;249756;USD;2009;Q4;2009-12-31;2010-07-30;;;636045000;1038802000;207895000;2045032000;220706000;;1631154000;1851860000;3896892000;801775000;14113000;815888000;1131998000;1486232000;2302120000;572030000;-1756438000;2720549000;1594772000;3896892000
HAS;249756;USD;2017;Q4;2017-12-31;2018-02-26;124541000;122494000;1581234000;1405399000;433293000;3633926000;259710000;;1396347000;1656057000;5289983000;1096740000;154957000;1251697000;1693609000;2208329000;3460026000;1155452000;-3346292000;4260222000;1829957000;5289983000
HAS;249756;USD;2018;Q4;2018-12-31;2019-02-26;126583000;126583000;1182371000;1188052000;443383000;3082504000;256473000;;1924011000;2180484000;5262988000;1264584000;9740000;1274324000;1695092000;2234178000;3508502000;1379906000;-3515280000;4184374000;1754486000;5262988000
UFI;249809;USD;2017;Q4;2017-06-30;2017-09-01;18240000;18484000;35425000;81121000;111405000;243637000;203388000;119513000;4965000;327866000;571503000;58994000;17060000;76054000;111382000;134643000;210697000;53746000;;339940000;360806000;571503000
UFI;249809;USD;2016;Q4;2016-06-30;2016-08-26;17846000;18236000;16646000;83422000;103532000;211892000;185101000;117412000;11037000;313550000;525442000;61522000;13786000;75308000;107805000;123189000;198497000;47717000;;307065000;326945000;525442000
UFI;249809;USD;2015;Q4;2015-06-30;2015-09-03;18173000;18843000;10013000;83863000;111615000;212964000;136222000;113901000;13285000;263408000;476372000;62339000;12385000;74724000;91725000;102555000;177279000;46062000;;278331000;299093000;476372000
UFI;249809;USD;2014;Q4;2014-06-30;2014-09-10;18451000;19020000;15907000;93925000;113370000;231227000;123802000;99229000;14809000;237840000;469067000;73087000;7215000;80302000;92273000;102027000;182329000;43961000;;245673000;286738000;469067000
UFI;249809;USD;2013;Q4;2013-06-30;2013-09-10;19364000;20934000;8755000;98392000;110667000;226830000;115164000;93261000;20211000;228636000;455466000;64880000;65000;64945000;97688000;104041000;168986000;38296000;;252112000;286480000;455466000
UFI;249809;USD;2012;Q4;2012-06-30;2012-08-30;;20696000;10886000;99236000;112750000;237997000;127090000;95763000;21383000;244236000;482233000;64275000;7237000;71512000;114315000;119941000;191453000;36732000;;252763000;290780000;482233000
UFI;249809;USD;2011;Q4;2011-06-30;2011-11-28;;;27490000;99815000;134883000;274069000;151027000;91258000;21022000;263307000;537376000;60758000;342000;61100000;168322000;176621000;237721000;34607000;;241272000;299655000;537376000
UFI;249809;USD;2018;Q4;2018-06-30;2018-08-22;18351000;18625000;44890000;86273000;126311000;274294000;205516000;112639000;9358000;327513000;601807000;68007000;16996000;85003000;113553000;127023000;212026000;58561000;;371753000;389781000;601807000
SVT;250129;USD;2016;Q4;2016-12-31;2017-03-15;2200;2307;3515000;7439000;13293000;24816000;9937000;;867000;10804000;35620000;4451000;548000;4999000;2976000;2741000;7740000;14683000;-1551000;14768000;27880000;35620000
SVT;250129;USD;2015;Q4;2015-12-31;2016-03-21;-2174630;-2256466;3268000;6838000;12487000;24251000;9755000;;368000;10123000;34374000;3744000;548000;4292000;3524000;3777000;8069000;14615000;-1702000;13395000;26305000;34374000
SVT;250129;USD;2014;Q4;2014-12-31;2015-03-20;2150;2274;4166000;6022000;12040000;25490000;9375000;;380000;9755000;35245000;8745000;548000;9293000;4072000;4108000;13401000;14591000;-1909000;9176000;21844000;35245000
SVT;250129;USD;2013;Q4;2013-12-31;2014-03-24;2286;2288;4502000;4990000;11929000;22789000;6860000;;354000;7214000;30003000;3125000;2641000;5766000;21000;-562000;5204000;14547000;-2024000;12302000;24799000;30003000
SVT;250129;USD;2012;Q4;2012-12-31;2013-03-21;4302849;4312842;5573000;4858000;11213000;22992000;5946000;;365000;6311000;29303000;2862000;192000;3054000;2663000;1818000;4872000;14510000;-1765000;11771000;24431000;29303000
SVT;250129;USD;2011;Q4;2011-12-31;2012-03-29;7982054;8429703;4948000;6031000;11607000;23978000;6103000;;342000;6445000;30423000;3212000;283000;3495000;3188000;2418000;5913000;14297000;-2210000;12490000;24510000;30423000
SVT;250129;USD;2010;Q4;2010-12-31;2011-08-12;;;4447000;5427000;11032000;22051000;6159000;;296000;6455000;28506000;2809000;404000;3213000;3472000;2614000;5827000;14014000;-2724000;11467000;22679000;28506000
SVT;250129;USD;2017;Q4;2017-12-31;2018-03-23;-2257434;-2286404;4707000;8424000;12791000;26171000;11021000;;794000;11815000;37986000;4447000;681000;5128000;2950000;4031000;9159000;14694000;-1544000;15709000;28827000;37986000
SVT;250129;USD;2018;Q4;2018-12-31;2019-03-14;2229;2388;2598000;10586000;15150000;29144000;11875000;;666000;12541000;41685000;5280000;723000;6003000;2410000;3608000;9611000;14773000;-1522000;18788000;32074000;41685000
IDSY;250487;USD;2016;Q4;2016-12-31;2017-03-29;13099000;13099000;5087000;9585000;3920000;27908000;3075000;1499000;11764000;16338000;44246000;7622000;2993000;17812000;;10432000;28244000;111973000;-4370000;-91498000;16002000;44246000
IDSY;250487;USD;2015;Q4;2015-12-31;2016-03-29;12887000;12887000;4748000;10901000;7152000;30628000;3119000;1339000;9342000;13800000;44428000;9173000;0;16556000;;7302000;23858000;110245000;-4047000;-85128000;20570000;44428000
IDSY;250487;USD;2014;Q4;2014-12-31;2015-03-27;;;9223000;14783000;6252000;36409000;1520000;4066000;10491000;16077000;52486000;10102000;149000;16993000;;8238000;25231000;106396000;-3590000;-75176000;27255000;52486000
IDSY;250487;USD;2013;Q4;2013-12-31;2014-03-28;;;10672000;9574000;5156000;32837000;2239000;3100000;17339000;22678000;55515000;6264000;144000;11049000;149000;7017000;18066000;104602000;-3446000;-63601000;37449000;55515000
IDSY;250487;USD;2012;Q4;2012-12-31;2013-03-29;;;6408000;8814000;7512000;30262000;2401000;9064000;18839000;30304000;60566000;5638000;;10327000;0;6212000;16539000;103257000;-3181000;-56102000;44027000;60566000
IDSY;250487;USD;2011;Q4;2011-12-31;2012-03-30;;;15290000;7947000;8114000;37400000;3092000;9779000;12560000;25431000;62831000;9482000;;12572000;;4659000;17231000;101887000;-2728000;-53510000;45600000;62831000
IDSY;250487;USD;2010;Q4;2010-12-31;2012-03-30;;;19056000;7044000;7295000;36171000;3853000;9364000;11497000;24714000;60885000;9141000;;11327000;;4813000;16140000;105277000;-11025000;-49470000;44745000;60885000
IDSY;250487;USD;2017;Q4;2017-12-31;2018-03-30;16943000;16943000;6298000;8746000;4586000;29154000;2747000;10278000;18753000;31778000;60932000;7440000;;19074000;;8887000;27961000;133752000;-4835000;-95368000;32971000;60932000
IDSY;250487;USD;2018;Q4;2018-12-31;2019-04-01;17573000;17573000;10553000;9247000;4649000;32660000;2149000;4131000;18863000;25143000;57803000;8027000;;16875000;0;9394000;26269000;138885000;-5736000;-101180000;31534000;57803000
WDC;250582;USD;2018;Q4;2018-06-30;2018-08-24;299000000;318000000;5005000000;2197000000;2944000000;10638000000;3095000000;;15502000000;18597000000;29235000000;4277000000;179000000;4456000000;10993000000;13248000000;17704000000;4257000000;-1444000000;8757000000;11531000000;29235000000
WDC;250582;USD;2017;Q4;2017-06-30;2017-08-29;292000000;306000000;6354000000;1948000000;2341000000;11056000000;3033000000;;15771000000;18804000000;29860000000;4111000000;233000000;4344000000;12918000000;14098000000;18442000000;4509000000;-1666000000;8633000000;11418000000;29860000000
WDC;250582;USD;2016;Q4;2016-06-30;2016-08-29;260000000;266000000;8378000000;1461000000;2129000000;12584000000;3503000000;;16775000000;20278000000;32862000000;6610000000;339000000;6949000000;13660000000;14768000000;21717000000;4432000000;-2238000000;8848000000;11145000000;32862000000
WDC;250582;USD;2015;Q4;2015-06-30;2015-08-21;230000000;234000000;5286000000;1532000000;1368000000;8513000000;2965000000;;3692000000;6657000000;15170000000;2831000000;152000000;3238000000;2149000000;2713000000;5951000000;2431000000;-2299000000;9107000000;9219000000;15170000000
WDC;250582;USD;2014;Q4;2014-06-30;2014-08-15;233000000;241000000;5088000000;1989000000;1226000000;8720000000;3293000000;;3486000000;6779000000;15499000000;3720000000;125000000;3845000000;2313000000;2812000000;6657000000;2334000000;-1570000000;8066000000;8842000000;15499000000
WDC;250582;USD;2013;Q4;2013-06-30;2013-08-19;237000000;241000000;4309000000;1793000000;1188000000;7598000000;3700000000;;2738000000;6438000000;14036000000;3743000000;230000000;3973000000;1725000000;2170000000;6143000000;2191000000;-1012000000;6749000000;7893000000;14036000000
WDC;250582;USD;2012;Q4;2012-06-30;2012-08-20;256000000;260000000;3208000000;2364000000;1210000000;7141000000;4067000000;;2998000000;7065000000;14206000000;3802000000;230000000;4032000000;1955000000;2505000000;6537000000;2226000000;-554000000;6012000000;7669000000;14206000000
WDC;250582;USD;2011;Q4;2011-06-30;2011-08-12;232000000;235000000;3490000000;1206000000;577000000;5487000000;2224000000;;407000000;2631000000;8118000000;2026000000;144000000;2170000000;150000000;460000000;2630000000;1093000000;;4400000000;5488000000;8118000000
WDC;250582;USD;2010;Q4;2010-06-30;2010-08-13;231000000;236000000;2734000000;1256000000;560000000;4720000000;2159000000;;449000000;2608000000;7328000000;1917000000;106000000;2023000000;294000000;596000000;2619000000;1024000000;;3674000000;4709000000;7328000000
WDC;250582;USD;2009;Q4;2009-06-30;2009-10-29;221000000;228000000;1794000000;926000000;376000000;3230000000;1584000000;;477000000;2061000000;5291000000;1443000000;82000000;1525000000;400000000;574000000;2099000000;898000000;;2292000000;3192000000;5291000000
WDC;250582;USD;2019;Q4;2019-06-30;2019-08-27;294000000;288000000;3455000000;1204000000;3283000000;8477000000;2843000000;;15050000000;17893000000;26370000000;3541000000;276000000;3817000000;10246000000;12586000000;16403000000;3854000000;-1268000000;7449000000;9967000000;26370000000
HEI;250786;USD;2017;Q4;2017-10-31;2017-12-21;101282000;104451000;52066000;222456000;343628000;631892000;129883000;;1750656000;1880539000;2512431000;248986000;451000;249437000;673528000;883579000;1133016000;324271000;;844247000;1379415000;2512431000
HEI;250786;USD;2016;Q4;2016-10-31;2016-12-15;33744000;34357000;42955000;202227000;286302000;543158000;121611000;;1333643000;1455254000;1998412000;214010000;411000;214421000;457814000;636774000;851195000;304541000;;681704000;1147217000;1998412000
HEI;250786;USD;2015;Q4;2015-10-31;2015-12-17;66841000;67873000;33603000;181593000;243517000;503612000;105670000;;1127105000;1232775000;1736387000;168030000;357000;168387000;367241000;583447000;751834000;285106000;;548054000;984553000;1736387000
HEI;250786;USD;2014;Q4;2014-10-31;2014-12-18;66525000;67531000;20229000;149669000;218042000;431293000;93865000;;964056000;1057921000;1489214000;151802000;418000;152220000;328691000;522409000;674629000;268878000;;437757000;814585000;1489214000
HEI;250786;USD;2013;Q4;2013-10-31;2013-12-19;66367000;67243000;15499000;157022000;218893000;441472000;97737000;;993806000;1091543000;1533015000;160589000;697000;161286000;376818000;589276000;750562000;255415000;;349649000;782453000;1533015000
HEI;250786;USD;2012;Q4;2012-10-31;2012-12-20;105490000;106627000;21451000;122214000;189704000;367911000;80518000;;744417000;824935000;1192846000;130888000;626000;131514000;131194000;274407000;405921000;244337000;;375085000;786925000;1192846000
HEI;250786;USD;2011;Q4;2011-10-31;2011-12-22;166626966;169981897;17500000;106414000;164967000;316638000;67074000;;557357000;624431000;941069000;123055000;335000;123390000;39823000;132095000;255485000;226019000;;299497000;685584000;941069000
HEI;250786;USD;2010;Q4;2010-10-31;2010-12-22;90400632;92918175;6543000;91815000;138215000;259249000;59003000;;463391000;522394000;781643000;81684000;148000;81832000;14073000;89937000;171769000;228323000;;240913000;609874000;781643000
HEI;250786;USD;2009;Q4;2009-10-31;2010-09-01;65382693;67449256;7167000;77864000;137585000;243577000;60528000;;428805000;489333000;732910000;65276000;237000;65513000;55194000;119802000;185315000;224886000;;189485000;547595000;732910000
HEI;250786;USD;2018;Q4;2018-10-31;2018-12-20;132905000;137073000;59599000;251469000;401553000;733808000;154739000;;1764849000;1919588000;2653396000;281570000;859000;282429000;531611000;735913000;1018342000;318396000;;1091183000;1635054000;2653396000
MOV;250875;USD;2016;Q4;2017-01-31;2017-03-20;23060000;23297000;256279000;66847000;153167000;504780000;34173000;;68849000;103022000;607802000;71402000;;71402000;25000000;62407000;133809000;185692000;-204398000;415919000;473993000;607802000
MOV;250875;USD;2015;Q4;2016-01-31;2016-03-31;23010000;23212000;228188000;71030000;162465000;489035000;38553000;;57582000;96135000;585170000;78182000;;78182000;35000000;65841000;144023000;178454000;-199195000;392788000;441147000;585170000
MOV;250875;USD;2014;Q4;2015-01-31;2015-03-31;25069000;25338000;199852000;74106000;170788000;478843000;46673000;;57507000;104180000;583023000;65847000;;65847000;;32891000;98738000;175160000;-149811000;358006000;484285000;583023000
MOV;250875;USD;2013;Q4;2014-01-31;2014-03-28;25442000;25835000;190758000;68683000;181305000;485310000;47796000;;45504000;93300000;578610000;83593000;;83593000;;29027000;112620000;165674000;-122406000;316334000;465990000;578610000
MOV;250875;USD;2012;Q4;2013-01-31;2013-03-26;25457000;25965000;167889000;61398000;167256000;434099000;44501000;;47762000;92263000;526362000;73486000;;73486000;;27184000;100670000;160026000;-110701000;272094000;425692000;526362000
MOV;250875;USD;2011;Q4;2012-01-31;2012-03-30;24992000;25193000;182201000;62754000;163680000;434151000;36290000;;37121000;73411000;507562000;87912000;;87912000;;25576000;113488000;153658000;-111909000;251695000;394074000;507562000
MOV;250875;USD;2010;Q4;2011-01-31;2011-09-01;24822000;24048000;103016000;59768000;181613000;374938000;38525000;;30742000;69267000;444205000;62897000;;62897000;;24829000;87726000;149817000;-111331000;222685000;356479000;444205000
MOV;250875;USD;2017;Q4;2018-01-31;2018-03-29;23053000;22726000;214811000;83098000;151676000;481600000;24671000;;139109000;163780000;645380000;100296000;;100296000;;74749000;175045000;190147000;-208894000;388739000;470335000;645380000
MOV;250875;USD;2018;Q4;2019-01-31;2019-03-28;23192000;23542000;189911000;84026000;165311000;468146000;26067000;;265488000;291555000;759701000;112683000;;112683000;50280000;146642000;259325000;202156000;-217188000;431180000;500376000;759701000
GPS;250974;USD;2016;Q4;2017-02-28;2017-03-20;401000000;402000000;1783000000;;1830000000;4315000000;2616000000;;679000000;3295000000;7610000000;2388000000;65000000;2453000000;1248000000;2253000000;4706000000;101000000;;2749000000;2904000000;7610000000
GPS;250974;USD;2015;Q4;2016-02-29;2016-03-21;400000000;402000000;1370000000;;1873000000;3985000000;2850000000;;638000000;3488000000;7473000000;2114000000;421000000;2535000000;1310000000;2393000000;4928000000;20000000;;2440000000;2545000000;7473000000
GPS;250974;USD;2014;Q4;2015-02-28;2015-03-23;424000000;429000000;1515000000;;1889000000;4317000000;2773000000;;600000000;3373000000;7690000000;2213000000;21000000;2234000000;1332000000;2473000000;4707000000;21000000;;2797000000;2983000000;7690000000
GPS;250974;USD;2013;Q4;2014-02-28;2014-03-24;449000000;456000000;1510000000;;1928000000;4430000000;2758000000;;661000000;3419000000;7849000000;2420000000;25000000;2445000000;1369000000;2342000000;4787000000;2954000000;-14245000000;14218000000;3062000000;7849000000
GPS;250974;USD;2012;Q4;2013-02-28;2013-03-26;472000000;479000000;1510000000;;1758000000;4132000000;2619000000;;719000000;3338000000;7470000000;2344000000;0;2344000000;1246000000;2232000000;4576000000;2919000000;-13465000000;13259000000;2894000000;7470000000
GPS;250974;USD;2011;Q4;2012-02-29;2012-03-26;488000000;494000000;1885000000;;1615000000;4309000000;2523000000;;590000000;3113000000;7422000000;2069000000;59000000;2128000000;1606000000;2539000000;4667000000;2922000000;-12760000000;12364000000;2755000000;7422000000
GPS;250974;USD;2010;Q4;2011-02-28;2011-03-28;608000000;611000000;1661000000;;1620000000;3926000000;2563000000;;576000000;3139000000;7065000000;2092000000;3000000;2095000000;;890000000;2985000000;2994000000;-10866000000;11767000000;4080000000;7065000000
GPS;250974;USD;2009;Q4;2010-02-28;2010-03-26;686000000;695000000;2573000000;;1477000000;4664000000;2628000000;;693000000;3321000000;7985000000;2131000000;;2131000000;;963000000;3094000000;2990000000;-9069000000;10815000000;4891000000;7985000000
GPS;250974;USD;2008;Q4;2009-02-28;2009-09-09;704000000;707000000;1715000000;;1506000000;4005000000;2933000000;;626000000;3559000000;7564000000;2108000000;50000000;2158000000;;1019000000;3177000000;2950000000;-8633000000;9947000000;4387000000;7564000000
GPS;250974;USD;2017;Q4;2018-02-28;2018-03-20;387000000;395000000;1783000000;;1997000000;4568000000;2805000000;;616000000;3421000000;7989000000;2461000000;0;2461000000;1249000000;2384000000;4845000000;27000000;;3081000000;3144000000;7989000000
GPS;250974;USD;2018;Q4;2019-02-28;2019-03-19;380000000;382000000;1369000000;;2131000000;4251000000;2912000000;;886000000;3798000000;8049000000;2174000000;;2174000000;1249000000;2322000000;4496000000;19000000;;3481000000;3553000000;8049000000
MKC;251282;USD;2017;Q4;2017-11-30;2018-01-25;131100000;132500000;186800000;555100000;793300000;1617000000;809100000;398500000;7561200000;8768800000;10385800000;1364100000;583200000;1947300000;4443900000;5867600000;7814900000;1672900000;;1166500000;2570900000;10385800000
MKC;251282;USD;2016;Q4;2016-11-30;2017-01-25;126000000;127500000;118400000;465200000;756300000;1421800000;669400000;348400000;2196300000;3214100000;4635900000;1029500000;393200000;1422700000;1054000000;1575100000;2997800000;1084200000;;1056800000;1638100000;4635900000
MKC;251282;USD;2015;Q4;2015-11-30;2016-01-28;127900000;129300000;112600000;455200000;710800000;1357400000;618400000;365400000;2131400000;3115200000;4472600000;895600000;343000000;1238600000;1051400000;1547100000;2785700000;1039600000;;1036700000;1686900000;4472600000
MKC;251282;USD;2014;Q4;2014-11-30;2015-01-29;128700000;130000000;77300000;493600000;713800000;1416200000;602700000;342400000;2053000000;2998100000;4414300000;851200000;270800000;1122000000;1014100000;1482900000;2604900000;995600000;;982600000;1809400000;4414300000
MKC;251282;USD;2013;Q4;2013-11-30;2014-01-29;131700000;133300000;63000000;495500000;676900000;1370200000;576600000;371000000;2131900000;3079500000;4449700000;849000000;214100000;1063100000;1019000000;1438900000;2502000000;962400000;;970400000;1947700000;4449700000
MKC;251282;USD;2012;Q4;2012-11-30;2013-01-25;132400000;134300000;79000000;465900000;615000000;1285400000;547300000;313900000;2018800000;2880000000;4165400000;795000000;392600000;1187600000;779200000;1277600000;2465200000;908200000;;934600000;1700200000;4165400000
MKC;251282;USD;2011;Q4;2011-11-30;2012-01-27;132900000;134400000;53900000;427000000;613700000;1222900000;523100000;297600000;2044200000;2864900000;4087800000;770900000;222400000;993300000;1029700000;1476000000;2469300000;821900000;;838800000;1618500000;4087800000
MKC;251282;USD;2010;Q4;2010-11-30;2011-01-27;132900000;135100000;50800000;386700000;477600000;1015900000;488000000;265900000;1649900000;2403800000;3419700000;734400000;100400000;834800000;779900000;1122200000;1957000000;756500000;;700900000;1462700000;3419700000
MKC;251282;USD;2009;Q4;2009-11-30;2010-10-01;131400000;132900000;39500000;365300000;457600000;970500000;489800000;210500000;1717000000;2417300000;3387800000;702100000;116100000;818200000;875000000;1226100000;2044300000;634000000;;591500000;1343500000;3387800000
MKC;251282;USD;2018;Q4;2018-11-30;2019-01-25;131800000;133800000;96600000;518100000;786300000;1479900000;985100000;390200000;7401200000;8776500000;10256400000;1358200000;643500000;2001700000;4052900000;5072500000;7074200000;1770600000;;1760200000;3182200000;10256400000
RDC;252069;USD;2016;Q4;2016-12-31;2017-02-24;125463000;126354000;1255500000;301300000;;1580300000;7060000000;;35300000;7095300000;8675600000;253100000;126800000;483800000;2553400000;3077900000;3561700000;1487700000;-7200000;3830400000;5113900000;8675600000
RDC;252069;USD;2015;Q4;2015-12-31;2016-02-26;124234000;125539000;484200000;410500000;;921300000;7405800000;;20200000;7426000000;8347300000;295600000;0;328700000;2692400000;3246100000;3574800000;1474200000;-12200000;3509800000;4772500000;8347300000
RDC;252069;USD;2014;Q4;2014-12-31;2015-03-02;124192000;121689000;339154000;545204000;;938939000;7432212000;;21199000;7453411000;8392350000;297032000;;333221000;2788482000;3367730000;3700951000;1452514000;-7990000;3466993000;4691399000;8392350000
RDC;252069;USD;2013;Q4;2013-12-31;2014-03-03;123612000;124684000;1092844000;344546000;;1528878000;6385755000;;61128000;6446883000;7975761000;279947000;;354584000;2008700000;2727416000;3082000000;1422628000;-5962000;3619540000;4893761000;7975761000
RDC;252069;USD;2012;Q4;2012-12-31;2013-03-01;123102000;123894000;1024008000;423839000;;1552550000;6071729000;;75208000;6146937000;7699487000;220499000;;294094000;2009598000;2873669000;3167763000;1387728000;-1886000;3366964000;4531724000;7699487000
RDC;252069;USD;2011;Q4;2011-12-31;2012-02-28;123256000;124357000;438853000;283592000;;821715000;5678713000;;97417000;5776130000;6597845000;242123000;45023000;348371000;1089335000;1923487000;2271858000;1494180000;-128884000;3186362000;4325987000;6597845000
RDC;252069;USD;2010;Q4;2010-12-31;2011-03-01;125289000;-342992000;437479000;269896000;;1775253000;4344522000;;97682000;4442204000;6217457000;206254000;52166000;644965000;1133745000;1820182000;2465147000;1449793000;-1509000;2449521000;3752310000;6217457000
RDC;252069;USD;2009;Q4;2009-12-31;2010-03-01;;;639681000;343642000;451659000;1549797000;3579485000;;81412000;3660897000;5210694000;338726000;64922000;568272000;787490000;1532052000;2100324000;1092574000;-1409000;2169526000;3110370000;5210694000
RDC;252069;USD;2008;Q4;2008-12-31;2009-08-10;;;222428000;484962000;551429000;1369187000;3147528000;;32177000;3179705000;4548892000;448515000;64922000;744642000;355560000;1144434000;1889076000;1077343000;-2533000;1802022000;2659816000;4548892000
RDC;252069;USD;2017;Q4;2017-12-31;2018-02-28;126200000;130900000;1332100000;212800000;;1560400000;6552700000;;345200000;6897900000;8458300000;256300000;;257400000;2510300000;2814800000;3072200000;1504600000;-9300000;4109700000;5386100000;8458300000
RDC;252069;USD;2018;Q4;2018-12-31;2019-02-27;127000000;127000000;1026700000;251200000;;1300300000;6201000000;;616400000;6817400000;8117700000;235700000;201200000;453600000;2309700000;2629100000;3082700000;1517500000;-7900000;3810500000;5035000000;8117700000
DY;252287;USD;2017;Q4;2018-01-31;2017-09-01;31087017;31667145;38608000;369800000;83204000;938518000;422107000;;538682000;960789000;1899307000;287598000;21656000;318538000;738265000;909186000;1227724000;20454000;;652287000;671583000;1899307000
DY;252287;USD;2016;Q4;2017-01-31;2016-08-31;31294802;32005203;33787000;328030000;73606000;851234000;326670000;;541812000;868482000;1719716000;289945000;13125000;322627000;706202000;839802000;1162429000;20681000;;537880000;557287000;1719716000
DY;252287;USD;2015;Q4;2016-01-31;2015-09-04;33938686;34832725;21289000;315134000;48650000;696632000;231564000;;425727000;657291000;1353923000;206064000;3750000;226710000;516900000;620013000;846723000;82131000;;426267000;507200000;1353923000
DY;252287;USD;2014;Q4;2015-01-31;2014-09-09;33972023;36027392;20672000;272741000;49095000;605736000;205413000;;401205000;606618000;1212354000;171712000;10938000;196532000;446863000;530888000;727420000;143149000;;341943000;484934000;1212354000
DY;252287;USD;2013;Q4;2014-01-31;2013-09-13;33146014;34051112;18607000;252202000;35999000;541134000;202703000;;410371000;613074000;1154208000;178214000;7813000;199815000;444169000;526032000;725847000;126293000;;301965000;428361000;1154208000
DY;252287;USD;2012;Q4;2013-01-31;2012-09-04;33603757;34391718;52581000;141788000;26274000;376947000;158247000;;236999000;395246000;772193000;112967000;74000;114563000;187500000;264699000;379262000;126016000;;266777000;392931000;772193000
DY;252287;USD;2011;Q4;2012-01-31;2011-11-23;33834619;34904042;44766000;138552000;20558000;330311000;149439000;;245005000;394444000;724755000;117532000;232000;118513000;187574000;254391000;372904000;124153000;;227399000;351851000;724755000
DY;252287;USD;2018;Q4;2019-01-31;2019-03-04;31358207;31764203;128342000;625258000;94385000;1096440000;424751000;;576312000;1001063000;2097503000;264241000;5625000;284991000;867574000;1008344000;1293335000;32966000;;772484000;804168000;2097503000
BMI;252337;USD;2016;Q4;2016-12-31;2017-02-28;28919896;29090395;7338000;59818000;77701000;151012000;90194000;;108493000;198687000;349699000;35109000;37950000;75838000;;17652000;93490000;65144000;-20562000;223876000;256209000;349699000
BMI;252337;USD;2015;Q4;2015-12-31;2016-02-26;28826516;28962212;8163000;56643000;78596000;149328000;90920000;;115232000;206152000;355480000;30051000;71360000;104544000;;18661000;123205000;72729000;-30950000;204044000;232275000;355480000
BMI;252337;USD;2014;Q4;2014-12-31;2015-03-04;28726848;28878990;6656000;53967000;71774000;141105000;81806000;;118247000;200053000;341158000;29409000;75927000;107075000;;19752000;126827000;68876000;-31132000;189365000;214331000;341158000
BMI;252337;USD;2013;Q4;2013-12-31;2014-02-20;29130680;29291018;7263000;50133000;60939000;127163000;76416000;;112479000;188895000;316058000;27114000;70045000;98041000;;21454000;119495000;66131000;-31287000;170318000;196563000;316058000
BMI;252337;USD;2012;Q4;2012-12-31;2013-03-05;28266530;28410490;6554000;45584000;60997000;121374000;70484000;;98595000;169079000;290453000;26469000;66730000;94080000;;25126000;119206000;62196000;-31461000;155694000;171247000;290453000
BMI;252337;USD;2011;Q4;2011-12-31;2012-03-08;29987124;30053002;4975000;41168000;49436000;101195000;66102000;;51613000;117715000;218910000;19030000;1790000;22413000;;17216000;39629000;60737000;-31676000;166271000;179281000;218910000
BMI;252337;USD;2010;Q4;2010-12-31;2011-08-03;29860594;30052884;3089000;40429000;48316000;97337000;66088000;;52439000;118527000;215864000;18912000;12878000;32679000;;14802000;47481000;58841000;-31886000;156101000;168383000;215864000
BMI;252337;USD;2017;Q4;2017-12-31;2018-03-01;28929555;29145151;11164000;58210000;85172000;158623000;93601000;;139503000;233104000;391727000;45192000;44550000;93109000;;21166000;114275000;69347000;-24766000;244224000;277452000;391727000
BMI;252337;USD;2018;Q4;2018-12-31;2019-02-26;29086635;29275351;13086000;66300000;80804000;164659000;90321000;;137711000;228032000;392691000;37749000;18060000;60015000;;29173000;89188000;75280000;-29364000;257313000;303503000;392691000
TXN;252464;USD;2017;Q4;2017-12-31;2018-02-22;984000000;1006000000;4469000000;1278000000;1957000000;8734000000;2664000000;268000000;5976000000;8908000000;17642000000;1316000000;500000000;2258000000;3577000000;5047000000;7305000000;3517000000;-27458000000;34662000000;10337000000;17642000000
TXN;252464;USD;2016;Q4;2016-12-31;2017-02-23;998000000;1033000000;3490000000;1267000000;1790000000;7457000000;2512000000;235000000;6227000000;8974000000;16431000000;1189000000;631000000;2264000000;2978000000;3694000000;5958000000;3415000000;-25523000000;33107000000;10473000000;16431000000
TXN;252464;USD;2015;Q4;2015-12-31;2016-02-24;1013000000;1025000000;3218000000;1165000000;1691000000;7074000000;2596000000;221000000;6339000000;9156000000;16230000000;1145000000;1000000000;2555000000;3120000000;3729000000;6284000000;3370000000;-24068000000;31176000000;9946000000;16230000000
TXN;252464;USD;2014;Q4;2014-12-31;2015-02-24;1048000000;1064000000;3541000000;1246000000;1784000000;7421000000;2840000000;224000000;6887000000;9951000000;17372000000;1159000000;1001000000;2658000000;3630000000;4324000000;6982000000;3109000000;-21840000000;29653000000;10390000000;17372000000
TXN;252464;USD;2013;Q4;2013-12-31;2014-02-24;1086000000;1101000000;3829000000;1203000000;1731000000;8019000000;3399000000;216000000;7304000000;10919000000;18938000000;1095000000;1000000000;2747000000;4158000000;5384000000;8131000000;2952000000;-19790000000;28173000000;10807000000;18938000000
TXN;252464;USD;2012;Q4;2012-12-31;2013-02-22;1115000000;1124000000;3965000000;1230000000;1757000000;8230000000;3912000000;215000000;7664000000;11791000000;20021000000;1047000000;1500000000;3430000000;4186000000;5630000000;9060000000;2917000000;-18462000000;27205000000;10961000000;20021000000
TXN;252464;USD;2011;Q4;2011-12-31;2012-02-24;1137000000;1153000000;2935000000;1545000000;1788000000;7828000000;4428000000;265000000;7976000000;12669000000;20497000000;1323000000;1381000000;3499000000;4211000000;6046000000;9545000000;2935000000;-17485000000;26278000000;10952000000;20497000000
TXN;252464;USD;2010;Q4;2010-12-31;2011-02-25;2403998767;2434998754;3072000000;1518000000;1520000000;7060000000;3680000000;453000000;2208000000;6341000000;13401000000;1359000000;0;1981000000;0;983000000;2964000000;2854000000;-16411000000;24695000000;10437000000;13401000000
TXN;252464;USD;2009;Q4;2009-12-31;2010-02-23;1243000000;1259000000;2925000000;1277000000;1202000000;6114000000;3158000000;637000000;2210000000;6005000000;12119000000;1017000000;;1587000000;;810000000;2397000000;2826000000;-14549000000;22066000000;9722000000;12119000000
TXN;252464;USD;2008;Q4;2008-12-31;2009-07-29;1281000000;1285000000;2540000000;913000000;1375000000;5790000000;3304000000;653000000;2176000000;6133000000;11923000000;498000000;;1532000000;;1065000000;2597000000;2762000000;-13814000000;21168000000;9326000000;11923000000
TXN;252464;USD;2018;Q4;2018-12-31;2019-02-22;951000000;969000000;4233000000;1207000000;2217000000;8097000000;3183000000;251000000;5606000000;9040000000;17137000000;1305000000;749000000;2474000000;4319000000;5669000000;8143000000;3691000000;-32130000000;37906000000;8994000000;17137000000
GIMO;252563;USD;2015;Q4;2015-12-31;2016-02-24;34219000;38932000;210213000;47947000;3813000;269594000;9416000;;901000;10317000;279911000;41058000;;103306000;;21249000;124555000;211405000;-12469000;-43533000;155356000;279911000
GIMO;252563;USD;2014;Q4;2014-12-31;2015-03-09;32596000;32596000;149406000;28686000;6551000;190109000;7387000;;490000;7877000;197986000;25229000;;67412000;;15139000;82551000;177717000;-12469000;-49719000;115435000;197986000
GIMO;252563;USD;2013;Q4;2013-12-31;2014-03-13;31301000;31301000;138150000;24528000;1484000;173342000;4389000;;17786000;22175000;195517000;23806000;;61874000;;10205000;72079000;144813000;-12469000;-8929000;123438000;195517000
GIMO;252563;USD;2012;Q4;2012-12-31;2013-08-12;17300000;17312000;18675000;20677000;3736000;46495000;2686000;;2316000;5002000;51497000;17110000;;45848000;;37319000;83167000;1522000;-12469000;-20723000;-31670000;51497000
GIMO;252563;USD;2016;Q4;2016-12-31;2017-02-24;36175000;38651000;258164000;75522000;11347000;354942000;11809000;;34248000;46057000;400999000;39857000;;108854000;;29485000;138339000;256778000;;5899000;262660000;400999000
BLOX;252645;USD;2015;Q4;2015-07-31;2015-09-25;58118000;;330836000;45881000;8588000;395764000;23225000;;40278000;63503000;459267000;42067000;;137197000;;46918000;184115000;438731000;;-163542000;275152000;459267000
BLOX;252645;USD;2014;Q4;2014-07-31;2014-09-25;54711000;;269851000;36420000;6345000;320122000;18785000;;41661000;60446000;380568000;28845000;;110809000;;40463000;151272000;365839000;;-136459000;229296000;380568000
BLOX;252645;USD;2013;Q4;2013-07-31;2013-09-20;50898000;;209336000;38728000;4478000;259919000;18370000;;42171000;60541000;320460000;24859000;;93338000;;37569000;130907000;302106000;;-112542000;189553000;320460000
BLOX;252645;USD;2012;Q4;2012-07-31;2012-09-14;45812000;;156613000;26819000;2560000;191728000;6498000;;44757000;51255000;242983000;21902000;;78086000;;22822000;100908000;250211000;;-108136000;142075000;242983000
BLOX;252645;USD;2011;Q4;2011-07-31;2012-06-01;10710048;;42207000;20683000;1506000;69834000;5087000;;45096000;50183000;120017000;16484000;;60578000;;128471000;189049000;30894000;;-99926000;-69032000;120017000
BLOX;252645;USD;2016;Q4;2016-07-31;2016-09-22;56702000;;258105000;59937000;6045000;336675000;22004000;;90424000;112428000;449103000;44291000;;166514000;;64081000;230595000;459817000;;-241339000;218508000;449103000
BGG;252726;USD;2017;Q4;2017-07-31;2017-08-29;42061000;42241000;61707000;230011000;374879000;689441000;364880000;;396658000;761538000;1450979000;330378000;0;330378000;221793000;561267000;891645000;74141000;-321814000;1107033000;559334000;1450979000
BGG;252726;USD;2016;Q4;2016-07-31;2016-08-30;42603000;42963000;89839000;191678000;386065000;696001000;326273000;;434393000;760666000;1456667000;318301000;;318301000;221339000;644740000;963041000;72599000;-314960000;1074437000;493626000;1456667000
BGG;252726;USD;2015;Q4;2015-07-31;2015-08-21;43716000;43785000;118390000;215841000;378688000;795243000;314838000;;346566000;661404000;1456647000;335116000;;335116000;222685000;547281000;882397000;77851000;-295984000;1071493000;574250000;1456647000
BGG;252726;USD;2014;Q4;2014-07-31;2014-08-26;45513000;44515000;194668000;220590000;376103000;870335000;297007000;;282364000;579371000;1449706000;303187000;;303187000;225000000;474085000;777272000;79045000;-259820000;1048466000;672434000;1449706000
BGG;252726;USD;2013;Q4;2013-07-31;2013-08-27;47310000;46937000;188445000;190800000;408095000;858981000;287195000;;301375000;588570000;1447551000;274455000;300000;274755000;225000000;504858000;779613000;77583000;-227634000;1042917000;667938000;1447551000
BGG;252726;USD;2012;Q4;2012-07-31;2012-08-28;47742000;49635000;156075000;223996000;433684000;911500000;301249000;;395482000;696731000;1608231000;302909000;3000000;305909000;225000000;670352000;976261000;82302000;-227487000;1099859000;631970000;1608231000
BGG;252726;USD;2011;Q4;2011-07-31;2011-09-16;49615000;51804000;209639000;249358000;427091000;978739000;329225000;;358254000;687479000;1666218000;341383000;3000000;344383000;225000000;583892000;928275000;79933000;-191356000;1092864000;737943000;1666218000
BGG;252726;USD;2010;Q4;2010-07-31;2010-11-03;49887000;50563000;116554000;286426000;400346000;905643000;337763000;;446651000;784414000;1690057000;357051000;206460000;563511000;;475969000;1039480000;80932000;-202489000;1090843000;650577000;1690057000
BGG;252726;USD;2018;Q4;2018-07-31;2018-08-28;41949000;41706000;44923000;182801000;411831000;679206000;422080000;;342680000;764760000;1443966000;336070000;48036000;384106000;199954000;489436000;873542000;76987000;-325771000;1071480000;570424000;1443966000
BGG;252726;USD;2019;Q4;2019-07-31;2019-08-27;41514000;41514000;29569000;198498000;502006000;762477000;411045000;;377909000;788954000;1551431000;417205000;160540000;577745000;194969000;526966000;1104711000;79481000;-334084000;993873000;446720000;1551431000
BKH;253495;USD;2016;Q4;2016-12-31;2017-03-01;;;234000;30614000;22389000;113518000;897559000;4841000;77831000;980231000;1093749000;83393000;;83477000;339756000;625610000;709087000;62991000;;322933000;384662000;1093749000
BKH;253495;USD;2015;Q4;2015-12-31;2016-02-29;;;297000;27856000;24282000;193432000;840052000;4725000;71869000;916646000;1110078000;114508000;;114508000;339616000;603591000;718099000;62991000;;330295000;391979000;1110078000
BKH;253495;USD;2014;Q4;2014-12-31;2015-02-26;;;6620000;34684000;20965000;165376000;805294000;4584000;80135000;890013000;1055389000;66200000;;69273000;342752000;611322000;680595000;62991000;;313622000;374794000;1055389000
BKH;253495;USD;2013;Q4;2013-12-31;2014-02-27;;;2259000;25799000;23278000;86135000;761710000;4431000;48897000;815038000;901173000;62192000;;62353000;269948000;496966000;559319000;62991000;;280060000;341854000;901173000
BKH;253495;USD;2012;Q4;2012-12-31;2013-03-06;;;3805000;23867000;20633000;113060000;701938000;4359000;53566000;759863000;872923000;51691000;;51728000;269944000;501737000;553465000;62991000;;257887000;319458000;872923000
BKH;253495;USD;2011;Q4;2011-12-31;2012-03-12;;;2812000;24668000;22074000;118675000;682191000;4592000;48972000;735755000;854430000;47606000;37000;49344000;276390000;468600000;517944000;62991000;;274785000;336486000;854430000
BKH;253495;USD;2010;Q4;2010-12-31;2011-08-11;;;2045000;28716000;21259000;108146000;657840000;4396000;41350000;703586000;811732000;42931000;81000;45803000;276422000;456512000;502315000;62991000;;247688000;309417000;811732000
BKH;253495;USD;2017;Q4;2017-12-31;2018-02-27;;;16000;29050000;23443000;81890000;952873000;4926000;63457000;1021256000;1103146000;78624000;;92863000;339895000;616051000;708914000;62991000;;332499000;394232000;1103146000
BKH;253495;USD;2018;Q4;2018-12-31;2019-02-21;;;112000;28431000;24853000;85105000;1004885000;4889000;66409000;1076183000;1161288000;85119000;;126383000;340035000;630660000;757043000;62991000;;342145000;404245000;1161288000
AWI;253579;USD;2017;Q4;2017-12-31;2018-02-26;52800000;53900000;159600000;90800000;53800000;648900000;499900000;;724700000;1224600000;1873500000;108900000;32500000;269900000;817700000;1184300000;1454200000;517400000;-385600000;633400000;419300000;1873500000
AWI;253579;USD;2016;Q4;2016-12-31;2017-02-27;54900000;55200000;141900000;58800000;46900000;406200000;465200000;;886600000;1351800000;1758000000;118300000;25000000;224100000;848600000;1267500000;1491600000;505500000;-305200000;469900000;266400000;1758000000
AWI;253579;USD;2015;Q4;2015-12-31;2015-04-30;55700000;56200000;209300000;114300000;101400000;880800000;648100000;;1158300000;1806400000;2687200000;234300000;52100000;436300000;936200000;1482100000;1918400000;1152400000;-261400000;365200000;768800000;2687200000
AWI;253579;USD;2014;Q4;2014-12-31;2015-02-23;55400000;55500000;185300000;195200000;335500000;811500000;1062400000;;732300000;1794700000;2606200000;348000000;39600000;388100000;1003000000;1569000000;1957100000;1135000000;-261400000;271000000;649100000;2606200000
AWI;253579;USD;2013;Q4;2013-12-31;2014-02-24;54300000;54900000;112300000;204600000;322100000;884000000;1014800000;;1017800000;2032600000;2916600000;338600000;23900000;410900000;1042600000;1832500000;2243400000;1099000000;-261400000;207200000;673200000;2916600000
AWI;253579;USD;2012;Q4;2012-12-31;2012-10-29;59300000;60100000;336400000;204600000;369800000;1019900000;1005000000;;829400000;1834400000;2854300000;350400000;33000000;384700000;1038000000;1750500000;2135200000;1077400000;;113100000;719100000;2854300000
AWI;253579;USD;2011;Q4;2011-12-31;2012-02-27;116699942;117599942;480600000;221400000;376100000;1209300000;887900000;;897500000;1785400000;2994700000;357300000;20100000;386200000;822900000;1478300000;1864500000;1468100000;;77100000;1130200000;2994700000
AWI;253579;USD;2010;Q4;2010-12-31;2011-08-01;58000000;58500000;315800000;229500000;398500000;1020700000;854900000;;1046800000;1901700000;2922400000;345200000;35300000;382900000;839600000;1448700000;1831600000;1451800000;;-35300000;1090800000;2922400000
AWI;253579;USD;2018;Q4;2018-12-31;2019-02-25;49600000;50100000;325700000;79900000;61200000;752800000;501000000;;619700000;1120700000;1873500000;384200000;55000000;549500000;764800000;1062800000;1612300000;548000000;-692200000;865000000;261200000;1873500000
MDP;253689;USD;2017;Q4;2017-06-30;2017-08-29;44715000;45370000;22300000;289100000;21900000;505300000;189800000;;2034500000;2224300000;2729600000;66600000;62500000;459700000;635700000;1274000000;1733700000;99200000;;915700000;995900000;2729600000
MDP;253689;USD;2016;Q4;2016-06-30;2016-08-26;44555000;45406000;24970000;273927000;20678000;481156000;190953000;;1954682000;2145635000;2626791000;82107000;75000000;477892000;618506000;1259856000;1737748000;98838000;;818706000;889043000;2626791000
MDP;253689;USD;2015;Q4;2015-06-30;2015-08-26;44597000;45480000;22833000;284646000;24681000;482531000;213736000;;2147015000;2360751000;2843282000;93944000;62500000;531001000;732500000;1360431000;1891432000;93639000;;870859000;951850000;2843282000
MDP;253689;USD;2014;Q4;2014-06-30;2014-08-27;44551000;45213000;36587000;257644000;24008000;493122000;204938000;;1845740000;2050678000;2543800000;81402000;87500000;483103000;627500000;1169045000;1652148000;86360000;;814050000;891652000;2543800000
MDP;253689;USD;2013;Q4;2013-06-30;2013-08-21;44513000;45282000;27674000;232305000;28386000;407692000;186317000;;1546050000;1732367000;2140059000;78458000;50000000;456671000;300000000;829092000;1285763000;94736000;;775901000;854296000;2140059000
MDP;253689;USD;2012;Q4;2012-06-30;2012-08-23;44653000;44873000;25820000;215526000;22559000;359436000;194304000;;1462559000;1656863000;2016299000;72911000;105000000;482586000;275000000;736268000;1218854000;97782000;;722778000;797445000;2016299000
MDP;253689;USD;2011;Q4;2011-06-30;2011-08-24;45340000;45670000;27721000;212365000;21529000;333738000;186438000;;1192653000;1379091000;1712829000;82878000;50000000;408992000;145000000;528852000;937844000;103332000;;687816000;774985000;1712829000
MDP;253689;USD;2010;Q4;2010-06-30;2010-10-27;45379000;45661000;48574000;223630000;26807000;381427000;187002000;;1158887000;1345889000;1727316000;109897000;50000000;438306000;250000000;600665000;1038971000;111726000;;604624000;688345000;1727316000
MDP;253689;USD;2018;Q4;2018-06-30;2018-09-04;44964000;44579000;437600000;542000000;44200000;1979100000;483800000;;4264300000;4748100000;6727200000;194700000;17700000;1190300000;3117900000;3916800000;5107100000;244400000;;889800000;1620100000;6727200000
AIT;253867;USD;2017;Q4;2017-06-30;2017-08-18;39024000;39401000;105057000;390931000;345145000;882542000;108068000;;396985000;505053000;1387595000;239399000;4814000;309753000;286769000;332586000;642339000;174655000;-381448000;1033751000;745256000;1387595000
AIT;253867;USD;2016;Q4;2016-06-30;2016-08-24;39034000;39430000;59861000;347857000;338221000;781521000;107765000;;422739000;530504000;1312025000;205730000;3247000;274283000;324583000;379826000;654109000;172529000;-373888000;944821000;657916000;1312025000
AIT;253867;USD;2015;Q4;2015-06-30;2015-08-26;40073000;40319000;69470000;376305000;362419000;846010000;104447000;;482099000;586546000;1432556000;243605000;3349000;310072000;317646000;381156000;691228000;170072000;-338121000;969548000;741328000;1432556000
AIT;253867;USD;2014;Q4;2014-06-30;2014-08-22;41655000;41983000;71189000;375732000;335747000;836148000;103596000;;394425000;498021000;1334169000;228161000;2720000;290955000;167992000;242906000;533861000;166999000;-261852000;896776000;800308000;1334169000
AIT;253867;USD;2013;Q4;2013-06-30;2013-08-20;42124000;42627000;73164000;329880000;281417000;737280000;83243000;;238183000;321426000;1058706000;200474000;;245900000;;53191000;299091000;163893000;-225219000;824362000;759615000;1058706000
AIT;253867;USD;2012;Q4;2012-06-30;2012-08-15;42085000;42918000;78442000;307043000;228506000;665762000;83103000;;213318000;296421000;962183000;184039000;;230169000;;59883000;290052000;160070000;-226730000;743360000;672131000;962183000
AIT;253867;USD;2011;Q4;2011-06-30;2011-08-17;42505000;43293000;91092000;290751000;204066000;618914000;69014000;;227003000;296017000;914931000;173922000;;214688000;;66680000;281368000;158307000;-198224000;668421000;633563000;914931000
AIT;253867;USD;2010;Q4;2010-06-30;2010-11-05;42352000;42925000;175777000;246402000;173253000;618860000;58471000;;214189000;272660000;891520000;144636000;75000000;271332000;;65149000;336481000;153185000;-193468000;601370000;555039000;891520000
AIT;253867;USD;2018;Q4;2018-06-30;2018-08-17;38686000;39296000;54150000;548811000;422069000;1058020000;121343000;;1106378000;1227721000;2285741000;330256000;19183000;432551000;944522000;1038227000;1470778000;179383000;-403875000;1129678000;814963000;2285741000
AIT;253867;USD;2019;Q4;2019-06-30;2019-08-16;38580000;38990000;108219000;540902000;447555000;1148138000;124303000;;1059256000;1183559000;2331697000;305267000;49036000;423794000;908850000;1010869000;1434663000;182931000;-415159000;1229148000;897034000;2331697000
CAT;253953;USD;2016;Q4;2016-12-31;2017-02-15;585600000;571300000;7168000000;5981000000;8614000000;31967000000;15322000000;1029000000;26386000000;42737000000;74704000000;9872000000;13249000000;26132000000;14382000000;35359000000;61491000000;5277000000;-17478000000;27377000000;13213000000;74704000000
CAT;253953;USD;2015;Q4;2015-12-31;2016-02-16;580700000;587000000;6460000000;6695000000;9700000000;33508000000;16090000000;1170000000;27574000000;44834000000;78342000000;11098000000;12318000000;26242000000;16209000000;37215000000;63457000000;5238000000;-17640000000;29246000000;14885000000;78342000000
CAT;253953;USD;2014;Q4;2014-12-31;2015-02-17;604300000;615200000;7341000000;7737000000;12205000000;38867000000;16577000000;1364000000;27873000000;45814000000;84681000000;13435000000;10982000000;27877000000;18291000000;39978000000;67855000000;5016000000;-15726000000;33887000000;16826000000;84681000000
CAT;253953;USD;2013;Q4;2013-12-31;2014-02-18;635400000;648200000;6081000000;8413000000;12625000000;38335000000;17075000000;1397000000;28089000000;46561000000;84896000000;12817000000;10255000000;27297000000;18720000000;36721000000;64018000000;4709000000;-11854000000;31854000000;20878000000;84896000000
CAT;253953;USD;2012;Q4;2012-12-31;2013-02-19;653900000;669900000;5490000000;9706000000;15547000000;42138000000;16461000000;1316000000;29055000000;46832000000;88970000000;13444000000;10642000000;29415000000;19086000000;41973000000;71388000000;4481000000;-10074000000;29558000000;17582000000;88970000000
CAT;253953;USD;2011;Q4;2011-12-31;2012-02-21;646500000;666300000;3057000000;10057000000;14544000000;37900000000;14395000000;1130000000;27793000000;43318000000;81218000000;14813000000;8997000000;28357000000;16529000000;39459000000;67816000000;4273000000;-10281000000;25219000000;13402000000;81218000000
CAT;253953;USD;2010;Q4;2010-12-31;2011-02-22;637200000;659500000;3592000000;8494000000;9587000000;31810000000;12539000000;793000000;18878000000;32210000000;64020000000;11182000000;7282000000;22020000000;15932000000;30675000000;52695000000;3888000000;-10397000000;21384000000;11325000000;64020000000
CAT;253953;USD;2009;Q4;2009-12-31;2010-02-19;624500000;646600000;4867000000;5611000000;6360000000;27217000000;12386000000;971000000;19464000000;32821000000;60038000000;6995000000;9049000000;18975000000;16195000000;31763000000;50738000000;3439000000;-10646000000;19711000000;9300000000;60038000000
CAT;253953;USD;2008;Q4;2008-12-31;2009-08-12;602400000;612000000;2736000000;9397000000;8781000000;31885000000;12524000000;1479000000;21894000000;35897000000;67782000000;10032000000;10613000000;25625000000;17098000000;35443000000;61068000000;3057000000;-11217000000;19826000000;6714000000;67782000000
CAT;253953;USD;2007;Q4;2007-12-31;2009-08-12;;;1122000000;8249000000;7204000000;25477000000;9997000000;685000000;19973000000;30655000000;56132000000;9432000000;10233000000;22245000000;14190000000;24891000000;47136000000;2744000000;-9451000000;17398000000;8996000000;56132000000
CAT;253953;USD;2017;Q4;2017-12-31;2018-02-15;596600000;608500000;8261000000;7436000000;10018000000;36244000000;14155000000;990000000;25573000000;40718000000;76962000000;12738000000;11024000000;26931000000;15918000000;36265000000;63196000000;5593000000;-17005000000;26301000000;13766000000;76962000000
CAT;253953;USD;2018;Q4;2018-12-31;2019-02-14;579300000;586000000;7857000000;8802000000;11529000000;38603000000;13574000000;1161000000;25171000000;39906000000;78509000000;13513000000;11543000000;28218000000;16995000000;36211000000;64429000000;5827000000;-20531000000;30427000000;14080000000;78509000000
NERV;254280;USD;2018;Q4;2018-12-31;2019-03-12;38889799;38889799;87997310;;;90018360;33478;;49084207;49117685;139136045;3609198;;3609198;;45262078;48871276;304817497;;-214552728;90264769;139136045
NERV;254280;USD;2017;Q4;2017-12-31;2018-03-12;38779263;38779263;128161240;;;129540424;50945;5022982;49084207;54158134;183698558;2875484;3962664;6838148;;45262966;52101114;295978885;;-164381441;131597444;183698558
NERV;254280;USD;2016;Q4;2016-12-31;2017-03-13;34925232;34925232;82980609;;;83863850;9640;;49069399;49079039;132942889;4832106;4853753;9685859;3841062;17274822;26960681;238840442;;-132858234;105982208;132942889
NERV;254280;USD;2015;Q4;2015-12-31;2015-11-05;24789809;24789809;32204686;;;33480822;26170;;49069399;49095569;82576391;3885207;1434756;5319963;8503111;21936871;27256834;157132419;;-101812862;55319557;82576391
NERV;254280;USD;2014;Q4;2014-12-31;2014-11-06;18637796;18637796;18545702;;;19337695;43446;;49069399;49112845;68450540;3509491;;3509491;;13441454;16950945;126230825;;-74731230;51499595;68450540
NERV;254280;USD;2013;Q4;2013-12-31;2014-08-07;5168355;5168355;1818317;;;1819169;3232;;27352385;27355617;29174786;1338220;58270;1406583;;7588600;8995183;38009394;;-17829791;20179603;29174786
SJM;254348;USD;2016;Q4;2016-04-30;2017-06-19;114285580;114413696;166800000;438700000;905700000;1641800000;1617500000;;12380400000;13997900000;15639700000;583200000;953000000;1832600000;4445500000;6956900000;8789500000;5753100000;;1240500000;6850200000;15639700000
SJM;254348;USD;2015;Q4;2015-04-30;2016-06-21;118258070;118346456;109800000;450100000;899400000;1573400000;1627700000;;12783000000;14410700000;15984100000;789200000;284000000;1213000000;5146000000;7762600000;8975600000;5889200000;;1267700000;7008500000;15984100000
SJM;254348;USD;2014;Q4;2014-04-30;2015-06-25;108810419;108819155;125600000;430100000;1163600000;1983900000;1678300000;;13144100000;14822400000;16806300000;684600000;226000000;1022600000;5944900000;8696800000;9719400000;6037600000;;1159200000;7086900000;16806300000
SJM;254348;USD;2013;Q4;2013-04-30;2014-06-23;100646996;100658751;153500000;309400000;931000000;1539100000;1265600000;;6255500000;7521100000;9060200000;464000000;343200000;885800000;1873100000;3144800000;4030600000;3991200000;;1091000000;5029600000;9060200000
SJM;254348;USD;2012;Q4;2012-04-30;2013-06-21;107246195;17233;256400000;313700000;945500000;1595200000;1142500000;;6294100000;7436600000;9031800000;468100000;50000000;596800000;1967800000;3286200000;3883000000;4151700000;;1075500000;5148800000;9031800000
SJM;254348;USD;2011;Q4;2011-04-30;2012-06-25;111446070;-341569702;229700000;347500000;961600000;1643500000;1096100000;;6375600000;7471700000;9115200000;473000000;50000000;616900000;2020500000;3334900000;3951800000;4288800000;;961200000;5163400000;9115200000
SJM;254348;USD;2010;Q4;2010-04-30;2011-06-28;115519043;115587176;319845000;344410000;863579000;1636999000;867882000;;5819704000;6687586000;8324585000;410053000;0;482676000;1304039000;2549546000;3032222000;4425135000;;866933000;5292363000;8324585000
SJM;254348;USD;2009;Q4;2009-04-30;2010-09-09;119115719;119262191;283570000;238867000;654939000;1223630000;858313000;;5892910000;6751223000;7974853000;415750000;10000000;478897000;900000000;2169636000;2648533000;4604907000;;746063000;5326320000;7974853000
SJM;254348;USD;2017;Q4;2017-04-30;2018-06-18;113100000;113000000;192600000;385600000;854400000;1555000000;1729100000;;12017100000;13746200000;15301200000;782100000;144000000;1033800000;4688000000;6376300000;7410100000;5768600000;;2239200000;7891100000;15301200000
SJM;254348;USD;2018;Q4;2018-04-30;2019-06-17;112900000;112900000;101300000;503800000;910300000;1625200000;1912400000;;13173700000;15086100000;16711300000;733700000;1224500000;2341500000;4686300000;6399300000;8740800000;5784700000;;2367600000;7970500000;16711300000
APA;254576;USD;2016;Q4;2016-12-31;2017-02-24;379000000;379000000;1377000000;1128000000;476000000;3241000000;18867000000;;411000000;19278000000;22519000000;585000000;;1843000000;8544000000;12997000000;14840000000;12622000000;-2887000000;-3385000000;7679000000;22519000000
APA;254576;USD;2015;Q4;2015-12-31;2016-02-26;379000000;379000000;1467000000;1253000000;570000000;3752000000;20838000000;;910000000;21748000000;25500000000;618000000;;1841000000;8716000000;14169000000;16010000000;12876000000;-2889000000;-1980000000;9490000000;25500000000
APA;254576;USD;2014;Q4;2014-12-31;2015-02-27;376000000;372000000;769000000;2024000000;708000000;6415000000;48076000000;;1461000000;49537000000;55952000000;1210000000;;3664000000;11245000000;24151000000;27815000000;12694000000;-2890000000;16249000000;28137000000;55952000000
APA;254576;USD;2013;Q4;2013-12-31;2014-02-28;397000000;407000000;1906000000;2952000000;891000000;6366000000;52421000000;;2850000000;55271000000;61637000000;1616000000;53000000;4700000000;9672000000;21544000000;26244000000;12506000000;-1027000000;22032000000;35393000000;61637000000
APA;254576;USD;2012;Q4;2012-12-31;2013-03-01;391000000;382000000;160000000;3086000000;908000000;4962000000;53280000000;;2495000000;55775000000;60737000000;1092000000;990000000;5536000000;11355000000;23870000000;29406000000;10104000000;-30000000;20161000000;31331000000;60737000000
APA;254576;USD;2011;Q4;2011-12-31;2012-02-29;385000000;406000000;295000000;3079000000;655000000;4803000000;45448000000;;1800000000;47248000000;52051000000;1048000000;431000000;4963000000;6785000000;18095000000;23058000000;9307000000;-32000000;18500000000;28993000000;52051000000
APA;254576;USD;2010;Q4;2010-12-31;2011-04-07;376000000;391000000;134000000;2134000000;564000000;3480000000;38151000000;;1794000000;39945000000;43425000000;2595000000;46000000;3524000000;8095000000;15524000000;19048000000;9104000000;-36000000;14223000000;24377000000;43425000000
APA;254576;USD;2009;Q4;2009-12-31;2010-02-26;337089000;337089000;2048000000;1546000000;533000000;4586000000;22901000000;;699000000;23600000000;28186000000;1562000000;117000000;2393000000;4950000000;10014000000;12407000000;4849000000;-217000000;11437000000;15779000000;28186000000
APA;254576;USD;2008;Q4;2008-12-31;2009-08-07;;;1973449000;1356979000;498567000;4450974000;23958517000;;776994000;24735511000;29186485000;1794242000;112598000;2520435000;4808975000;10157329000;12677764000;4687047000;-228304000;11929827000;16508721000;29186485000
APA;254576;USD;2017;Q4;2017-12-31;2018-02-23;382000000;383000000;1668000000;1345000000;368000000;3725000000;17759000000;;438000000;18197000000;21922000000;641000000;550000000;2564000000;7934000000;10567000000;13131000000;12387000000;-2887000000;-2088000000;8791000000;21922000000
APA;254576;USD;2018;Q4;2018-12-31;2019-03-01;381000000;382000000;714000000;1194000000;401000000;2687000000;18421000000;;474000000;18895000000;21582000000;709000000;150000000;2201000000;8054000000;10569000000;12770000000;12366000000;-3192000000;-2048000000;8812000000;21582000000
CACI;254661;USD;2017;Q4;2017-06-30;2017-08-21;24458000;25173000;65539000;757341000;;879902000;91749000;7886000;2931545000;3031180000;3911082000;472779000;53965000;526744000;1177598000;1590617000;2117361000;573270000;-576187000;1825619000;1793721000;3911082000
CACI;254661;USD;2016;Q4;2016-06-30;2016-08-24;24317000;24900000;49082000;803817000;;921838000;81362000;8330000;2975811000;3065503000;3987341000;511211000;53965000;565176000;1402079000;1814852000;2380028000;562500000;-576187000;1661948000;1607313000;3987341000
CACI;254661;USD;2015;Q4;2015-06-30;2015-08-21;24172000;24607000;35364000;596155000;;666110000;63689000;8188000;2504043000;2575920000;3242030000;360716000;38965000;399681000;1024599000;1362077000;1761758000;552141000;-576193000;1519149000;1480272000;3242030000
CACI;254661;USD;2014;Q4;2014-06-30;2014-08-28;23496000;24515000;64461000;615580000;;735849000;68485000;8714000;2546090000;2623289000;3359138000;381024000;41563000;422587000;1238728000;1577385000;1999972000;541478000;-577167000;1392954000;1359166000;3359138000
CACI;254661;USD;2013;Q4;2013-06-30;2013-08-27;23135000;24317000;64337000;614616000;;723781000;65510000;11330000;1696450000;1773290000;2497071000;446977000;295517000;742494000;300790000;547005000;1289499000;534271000;-577191000;1257638000;1207572000;2497071000
CACI;254661;USD;2012;Q4;2012-06-30;2012-08-28;26406000;27246000;15740000;628842000;;685792000;67449000;9942000;1625039000;1702430000;2388222000;477429000;7500000;484929000;527307000;738848000;1223777000;529183000;-465303000;1105949000;1164445000;2388222000
CACI;254661;USD;2011;Q4;2011-06-30;2011-08-29;30159000;31892000;164817000;573042000;;782078000;62755000;8657000;1466641000;1538053000;2320131000;429721000;7500000;437221000;402437000;573294000;1010515000;508183000;-136631000;938495000;1309616000;2320131000
CACI;254661;USD;2010;Q4;2010-06-30;2010-11-04;30238000;31019000;254543000;531033000;;840746000;58666000;9291000;1336063000;1404020000;2244766000;379770000;278653000;658423000;252451000;413188000;1071611000;472896000;-86653000;794277000;1173155000;2244766000
CACI;254661;USD;2018;Q4;2018-06-30;2018-08-20;24699000;25332000;66194000;806871000;;931191000;101140000;8620000;2993255000;3103015000;4034206000;492061000;46920000;538981000;1015420000;1388338000;1927319000;575178000;-576186000;2126790000;2106887000;4034206000
CACI;254661;USD;2019;Q4;2019-06-30;2019-08-21;24873000;25470000;72028000;869840000;;1031520000;149676000;7381000;3898266000;4055323000;5086843000;644802000;46920000;691722000;1618093000;2023655000;2715377000;580508000;-576185000;2410164000;2371466000;5086843000
BAX;254808;USD;2016;Q4;2016-12-31;2017-02-23;543000000;548000000;2801000000;1691000000;1430000000;6574000000;4289000000;;4683000000;8972000000;15546000000;2612000000;3000000;2744000000;2779000000;4522000000;7266000000;6641000000;-7995000000;14200000000;8280000000;15546000000
BAX;254808;USD;2015;Q4;2015-12-31;2016-02-26;547000000;550000000;7361000000;1731000000;1604000000;11796000000;4386000000;;4780000000;9166000000;20962000000;2666000000;2585000000;5750000000;3922000000;6347000000;12097000000;6585000000;-7646000000;9683000000;8865000000;20962000000
BAX;254808;USD;2014;Q4;2014-12-31;2015-02-26;86178000;84132000;2925000000;1884000000;1577000000;10162000000;4434000000;;11542000000;15976000000;26138000000;2677000000;1698000000;6037000000;7331000000;11945000000;17982000000;6536000000;-7993000000;13227000000;8156000000;26138000000
BAX;254808;USD;2013;Q4;2013-12-31;2014-02-21;-830671000;-839809000;2733000000;2911000000;3499000000;10195000000;7832000000;;7197000000;15029000000;25224000000;4208000000;1040000000;5248000000;8126000000;11490000000;16738000000;6501000000;-7914000000;11852000000;8486000000;25224000000
BAX;254808;USD;2012;Q4;2012-12-31;2013-02-21;1007027000;1023596000;3270000000;2425000000;2803000000;9260000000;6098000000;;5032000000;11130000000;20390000000;4409000000;350000000;4759000000;5580000000;8653000000;13412000000;6452000000;-7592000000;10888000000;6978000000;20390000000
BAX;254808;USD;2011;Q4;2011-12-31;2012-02-23;1036483000;1040165000;2905000000;2420000000;2628000000;8650000000;5525000000;;4898000000;10423000000;19073000000;4411000000;446000000;4857000000;4749000000;7388000000;12245000000;6466000000;-6719000000;9429000000;6828000000;19073000000
BAX;254808;USD;2010;Q4;2010-12-31;2011-02-23;1069621000;1088031000;2685000000;2265000000;2371000000;7989000000;5260000000;;4240000000;9500000000;17489000000;4017000000;24000000;4041000000;4363000000;6652000000;10693000000;6436000000;-5655000000;7925000000;6796000000;17489000000
BAX;254808;USD;2009;Q4;2009-12-31;2010-02-23;1110123000;1124851000;2786000000;2302000000;2557000000;8271000000;5159000000;;3924000000;9083000000;17354000000;3753000000;711000000;4464000000;3440000000;5470000000;9934000000;6366000000;-4741000000;7343000000;7420000000;17354000000
BAX;254808;USD;2008;Q4;2008-12-31;2009-10-29;1134056000;1156148000;2131000000;1980000000;2361000000;7148000000;4609000000;;3648000000;8257000000;15405000000;3241000000;394000000;3635000000;3362000000;5479000000;9114000000;6216000000;-3897000000;5795000000;6291000000;15405000000
BAX;254808;USD;2017;Q4;2017-12-31;2018-02-23;542000000;557000000;3394000000;1793000000;1475000000;7263000000;4588000000;;5260000000;9848000000;17111000000;2733000000;3000000;2821000000;3509000000;5174000000;7995000000;6623000000;-7981000000;14483000000;9116000000;17111000000
BAX;254808;USD;2018;Q4;2018-12-31;2019-02-21;528000000;540000000;1832000000;1812000000;1653000000;5919000000;4542000000;;5180000000;9722000000;15641000000;2728000000;4000000;2836000000;3473000000;4989000000;7825000000;6581000000;-9989000000;15626000000;7816000000;15641000000
BMY;255210;USD;2016;Q4;2016-12-31;2017-02-21;1674000000;1682000000;6350000000;5543000000;1241000000;13704000000;4980000000;2719000000;12304000000;20003000000;33707000000;7087000000;992000000;8841000000;5716000000;8519000000;17360000000;1946000000;-16779000000;33513000000;16347000000;33707000000
BMY;255210;USD;2015;Q4;2015-12-31;2016-02-12;1670000000;1695000000;4270000000;4299000000;1221000000;10415000000;4412000000;4660000000;12261000000;21333000000;31748000000;6875000000;139000000;8017000000;6550000000;9307000000;17324000000;1680000000;-16559000000;31613000000;14424000000;31748000000
BMY;255210;USD;2014;Q4;2014-12-31;2015-02-13;1661000000;1675000000;7435000000;3390000000;1560000000;14608000000;4417000000;4408000000;10316000000;19141000000;33749000000;6704000000;590000000;8461000000;7242000000;10305000000;18766000000;1728000000;-16992000000;32541000000;14983000000;33749000000
BMY;255210;USD;2013;Q4;2013-12-31;2014-02-14;1648000000;1671000000;4525000000;3360000000;1498000000;18916000000;4579000000;3747000000;11350000000;19676000000;38592000000;6394000000;359000000;12440000000;7981000000;10916000000;23356000000;2143000000;-17800000000;32952000000;15236000000;38592000000
BMY;255210;USD;2012;Q4;2012-12-31;2013-02-15;1644000000;1679000000;2829000000;3083000000;1657000000;9521000000;5333000000;3523000000;17520000000;26376000000;35897000000;6628000000;826000000;8279000000;6568000000;13980000000;22259000000;2915000000;-18823000000;32733000000;13638000000;35897000000
BMY;255210;USD;2011;Q4;2011-12-31;2012-02-17;1693000000;1717000000;8733000000;3743000000;1384000000;15318000000;4521000000;2909000000;10222000000;17652000000;32970000000;7328000000;115000000;7780000000;5376000000;9323000000;17103000000;3334000000;-17402000000;33069000000;15867000000;32970000000
BMY;255210;USD;2010;Q4;2010-12-31;2011-02-18;1707000000;1729000000;7301000000;3480000000;1204000000;13273000000;4664000000;2681000000;10458000000;17803000000;31076000000;6220000000;117000000;6739000000;5328000000;8699000000;15438000000;3902000000;-17454000000;31636000000;15638000000;31076000000
BMY;255210;USD;2009;Q4;2009-12-31;2010-02-19;;;8514000000;3164000000;1413000000;13958000000;5055000000;1369000000;10626000000;17050000000;31008000000;5845000000;231000000;6313000000;6130000000;9910000000;16223000000;3988000000;-17364000000;30760000000;14785000000;31008000000
BMY;255210;USD;2008;Q4;2008-12-31;2009-07-23;;;8265000000;3644000000;1765000000;14697000000;5405000000;188000000;9196000000;14789000000;29486000000;6279000000;154000000;6710000000;6585000000;10568000000;17278000000;2977000000;-10566000000;22549000000;12208000000;29486000000
BMY;255210;USD;2017;Q4;2017-12-31;2018-02-13;1635000000;1642000000;6812000000;6300000000;1166000000;14854000000;5001000000;2480000000;11216000000;18697000000;33551000000;8493000000;987000000;9563000000;6975000000;12141000000;21704000000;2119000000;-19249000000;31160000000;11847000000;33551000000
BMY;255210;USD;2018;Q4;2018-12-31;2019-02-25;1634000000;1636000000;8884000000;5965000000;1195000000;17160000000;5027000000;1775000000;11024000000;17826000000;34986000000;8779000000;1703000000;10654000000;5646000000;10205000000;20859000000;2302000000;-19574000000;34065000000;14127000000;34986000000
BRS;255858;USD;2016;Q4;2017-03-31;2016-05-27;35020737;35020737;96656000;198129000;124911000;507871000;2254364000;;351612000;2605976000;3113847000;217871000;131063000;416354000;1150956000;1396375000;1812729000;810374000;-184796000;991906000;1301118000;3113847000
BRS;255858;USD;2015;Q4;2016-03-31;2016-05-27;34858579;34492278;104310000;243425000;142503000;593096000;2283252000;;386597000;2669849000;3262945000;225973000;60394000;390368000;1071578000;1347212000;1737580000;801550000;-184796000;1172273000;1525365000;3262945000
BRS;255858;USD;2014;Q4;2015-03-31;2015-05-20;34722623;35527147;104146000;250610000;147169000;637851000;2157101000;;435768000;2592869000;3230720000;223249000;18730000;435006000;845692000;1150705000;1585711000;782213000;-184796000;1284442000;1645009000;3230720000
BRS;255858;USD;2013;Q4;2014-03-31;2014-05-21;36071957;36739751;204341000;292650000;137463000;721607000;2268751000;;407899000;2676650000;3398257000;217306000;14207000;457825000;827095000;1161563000;1619388000;763186000;-103965000;1245220000;1778869000;3398257000
BRS;255858;USD;2012;Q4;2013-03-31;2013-05-23;36425181;36602374;215623000;254520000;153969000;675758000;1921072000;;353862000;2274934000;2950692000;175142000;22323000;239825000;764946000;1099910000;1339735000;732250000;-26304000;1094803000;1610957000;2950692000
BRS;255858;USD;2011;Q4;2012-03-31;2012-05-23;35681799;36513565;261550000;280985000;157825000;736473000;1722775000;;281115000;2003890000;2740363000;132179000;14375000;199205000;742870000;1019334000;1218539000;703991000;-25085000;993435000;1521824000;2740363000
BRS;255858;USD;2010;Q4;2011-03-31;2011-05-20;35691618;37007301;116361000;247135000;196207000;628761000;1767882000;;278711000;2046593000;2675354000;129663000;8979000;180044000;698482000;976535000;1156579000;690158000;0;951660000;1518775000;2675354000
BRS;255858;USD;2009;Q4;2010-03-31;2010-08-04;;;77793000;203312000;186863000;516371000;1719345000;;258904000;1978249000;2494620000;106703000;15366000;166115000;701195000;971934000;1138049000;677756000;;820145000;1356571000;2494620000
BRS;255858;USD;2017;Q4;2018-03-31;2018-05-23;35240735;35240735;380223000;233386000;129614000;834399000;2068020000;;262583000;2330603000;3165002000;224386000;56700000;362897000;1429834000;1619012000;1981909000;852947000;-184796000;793783000;1183093000;3165002000
EMR;255983;USD;2015;Q4;2015-09-30;2015-11-18;655200000;658300000;3054000000;4319000000;1847000000;10049000000;3585000000;;8454000000;12039000000;22088000000;5247000000;2553000000;7800000000;4289000000;6160000000;13960000000;647000000;-12257000000;21308000000;8128000000;22088000000
EMR;255983;USD;2014;Q4;2014-09-30;2014-11-19;696000000;699800000;3149000000;5019000000;2057000000;10867000000;3802000000;;9508000000;13310000000;24177000000;5989000000;2465000000;8454000000;3559000000;5556000000;14010000000;638000000;-9811000000;19867000000;10167000000;24177000000
EMR;255983;USD;2013;Q4;2013-09-30;2013-11-19;711100000;717200000;3275000000;4808000000;1895000000;10999000000;3605000000;;10107000000;13712000000;24711000000;6038000000;1587000000;7625000000;4055000000;6368000000;13993000000;829000000;-8985000000;18930000000;10718000000;24711000000
EMR;255983;USD;2012;Q4;2012-09-30;2012-11-20;725000000;729000000;2367000000;4983000000;2125000000;10126000000;3509000000;;10183000000;13692000000;23818000000;5627000000;1506000000;7133000000;3787000000;6243000000;13376000000;801000000;-7882000000;18107000000;10442000000;23818000000
EMR;255983;USD;2011;Q4;2011-09-30;2011-11-22;741000000;745300000;2052000000;4502000000;2100000000;9345000000;3437000000;;11079000000;14516000000;23861000000;5588000000;877000000;6465000000;4324000000;6845000000;13310000000;794000000;-7143000000;17310000000;10551000000;23861000000
EMR;255983;USD;2010;Q4;2010-09-30;2010-11-23;750300000;757400000;1592000000;3989000000;2105000000;8363000000;3287000000;;11193000000;14480000000;22843000000;5369000000;480000000;5849000000;4586000000;7042000000;12891000000;669000000;-6320000000;15869000000;9952000000;22843000000
EMR;255983;USD;2009;Q4;2009-09-30;2009-11-23;749800000;755400000;1560000000;3623000000;1855000000;7653000000;3500000000;;8610000000;12110000000;19763000000;4379000000;577000000;4956000000;3998000000;6101000000;11057000000;634000000;-6297000000;14714000000;8706000000;19763000000
EMR;255983;USD;2008;Q4;2008-09-30;2009-08-05;;;1777000000;4618000000;2348000000;9331000000;3507000000;;8202000000;11709000000;21040000000;5352000000;1221000000;6573000000;3297000000;5354000000;11927000000;623000000;-5653000000;14002000000;9113000000;21040000000
EMR;255983;USD;2016;Q4;2016-09-30;2016-11-16;641800000;644800000;3182000000;2701000000;1208000000;9960000000;2931000000;;8852000000;11783000000;21743000000;3823000000;2584000000;8008000000;4062000000;6117000000;14125000000;682000000;-12831000000;21716000000;7618000000;21743000000
EMR;255983;USD;2017;Q4;2017-09-30;2017-11-20;639200000;640700000;3062000000;3072000000;1696000000;8252000000;3321000000;;8016000000;11337000000;19589000000;4127000000;862000000;5045000000;3794000000;5774000000;10819000000;774000000;-13032000000;21995000000;8770000000;19589000000
EMR;255983;USD;2018;Q4;2018-09-30;2018-11-19;627800000;631800000;1093000000;3344000000;1813000000;6619000000;3562000000;;10209000000;13771000000;20390000000;4541000000;1623000000;6164000000;3137000000;5236000000;11400000000;825000000;-13935000000;23072000000;8990000000;20390000000
PPG;256062;USD;2017;Q4;2017-12-31;2018-02-15;253300000;254500000;1491000000;2903000000;1730000000;6477000000;2824000000;268000000;6969000000;10061000000;16538000000;3781000000;12000000;3895000000;4134000000;6971000000;10866000000;1725000000;-11251000000;17140000000;5672000000;16538000000
PPG;256062;USD;2016;Q4;2016-12-31;2017-02-16;261300000;264800000;1863000000;2654000000;1514000000;6574000000;2608000000;179000000;6410000000;9197000000;15771000000;3460000000;629000000;4253000000;3787000000;6603000000;10856000000;1676000000;-10472000000;15980000000;4915000000;15771000000
PPG;256062;USD;2015;Q4;2015-12-31;2016-02-18;268800000;271000000;1455000000;2709000000;1659000000;6712000000;2822000000;367000000;7175000000;10364000000;17076000000;3419000000;281000000;4695000000;4026000000;7312000000;12007000000;1604000000;-9440000000;15521000000;5069000000;17076000000
PPG;256062;USD;2014;Q4;2014-12-31;2015-02-19;274600000;277400000;1183000000;2815000000;1825000000;6443000000;3092000000;443000000;7557000000;11092000000;17535000000;3547000000;481000000;4875000000;3533000000;7395000000;12270000000;1512000000;-8714000000;14498000000;5265000000;17535000000
PPG;256062;USD;2013;Q4;2013-12-31;2014-02-20;281800000;285600000;1745000000;2736000000;1824000000;7214000000;2876000000;393000000;5380000000;8649000000;15863000000;3265000000;34000000;4135000000;3372000000;6530000000;10665000000;1437000000;-8002000000;12757000000;5198000000;15863000000
PPG;256062;USD;2012;Q4;2012-12-31;2013-02-21;306800000;309800000;2393000000;2813000000;1687000000;7715000000;2888000000;422000000;4853000000;8163000000;15878000000;3061000000;642000000;4461000000;3368000000;7095000000;11556000000;1354000000;-5496000000;9871000000;4322000000;15878000000
PPG;256062;USD;2011;Q4;2011-12-31;2012-02-16;307600000;311600000;1482000000;2830000000;1607000000;6694000000;2721000000;387000000;4580000000;7688000000;14382000000;2996000000;108000000;3702000000;3574000000;7234000000;10936000000;1267000000;-5506000000;9288000000;3446000000;14382000000
PPG;256062;USD;2010;Q4;2010-12-31;2011-02-17;325000000;329200000;1978000000;2778000000;1573000000;7058000000;2686000000;550000000;4681000000;7917000000;14975000000;3002000000;28000000;3625000000;4043000000;7517000000;11142000000;1209000000;-4708000000;8548000000;3833000000;14975000000
PPG;256062;USD;2009;Q4;2009-12-31;2010-02-18;332000000;333400000;1064000000;2628000000;1548000000;5981000000;2754000000;499000000;5006000000;8259000000;14240000000;2648000000;272000000;3577000000;3074000000;6741000000;10318000000;1093000000;-4218000000;8139000000;3922000000;14240000000
PPG;256062;USD;2008;Q4;2008-12-31;2009-07-27;;;1021000000;2804000000;1702000000;6348000000;2798000000;509000000;5043000000;8350000000;14698000000;2724000000;903000000;4210000000;3009000000;6999000000;11209000000;1064000000;-4259000000;8156000000;3489000000;14698000000
PPG;256062;USD;2018;Q4;2018-12-31;2019-02-21;238700000;240200000;963000000;2845000000;1783000000;5961000000;2805000000;251000000;6998000000;10054000000;16015000000;3623000000;651000000;4373000000;4365000000;6910000000;11283000000;1757000000;-12958000000;18131000000;4732000000;16015000000
CVS;256275;USD;2018;Q4;2018-12-31;2019-02-28;1122000000;1117000000;6581000000;17631000000;16450000000;45243000000;11349000000;15732000000;124132000000;151213000000;196456000000;19636000000;4924000000;44009000000;71444000000;93904000000;137913000000;45440000000;-28228000000;40911000000;58543000000;196456000000
CVS;256275;USD;2017;Q4;2017-12-31;2018-02-14;1015000000;1017000000;1807000000;13181000000;15296000000;31229000000;10292000000;112000000;53498000000;63902000000;95131000000;25799000000;4821000000;30648000000;22181000000;26788000000;57436000000;32096000000;-37796000000;43556000000;37695000000;95131000000
CVS;256275;USD;2016;Q4;2016-12-31;2017-02-09;1062000000;1069000000;3458000000;12164000000;14760000000;31042000000;10175000000;;53245000000;63420000000;94462000000;24334000000;1916000000;26250000000;25615000000;31378000000;57628000000;31604000000;-33452000000;38983000000;36834000000;94462000000
CVS;256275;USD;2015;Q4;2015-12-31;2016-02-09;1106000000;1115000000;2547000000;11888000000;14001000000;29158000000;9855000000;;53424000000;63279000000;92437000000;21972000000;1197000000;23169000000;26267000000;32026000000;55195000000;30934000000;-28886000000;35506000000;37242000000;92437000000
CVS;256275;USD;2014;Q4;2014-12-31;2015-02-10;1142000000;1148000000;2515000000;9687000000;11930000000;25983000000;8843000000;;39361000000;48204000000;74187000000;17767000000;1260000000;19027000000;11630000000;17197000000;36224000000;30404000000;-24078000000;31849000000;37963000000;74187000000
CVS;256275;USD;2013;Q4;2013-12-31;2014-02-11;1191000000;1201000000;4177000000;8729000000;11045000000;25325000000;8615000000;;37586000000;46201000000;71526000000;14864000000;561000000;15425000000;12841000000;18163000000;33588000000;29763000000;-20169000000;28493000000;37938000000;71526000000
CVS;256275;USD;2012;Q4;2012-12-31;2013-02-15;1242000000;1250000000;1380000000;6479000000;11032000000;20161000000;8632000000;;37428000000;46060000000;66221000000;13455000000;695000000;14150000000;9133000000;14418000000;28568000000;29106000000;-16270000000;24998000000;37653000000;66221000000
CVS;256275;USD;2011;Q4;2011-12-31;2012-02-17;1303000000;1313000000;1418000000;6047000000;10046000000;18594000000;8467000000;;37482000000;45949000000;64543000000;11150000000;806000000;11956000000;9208000000;14536000000;26492000000;28086000000;-11953000000;22090000000;38051000000;64543000000
CVS;256275;USD;2010;Q4;2010-12-31;2011-02-18;1363000000;1375000000;1431000000;4925000000;10695000000;17706000000;8322000000;;36141000000;44463000000;62169000000;9665000000;1405000000;11070000000;8652000000;13399000000;24469000000;27570000000;-9030000000;19303000000;37700000000;62169000000
CVS;256275;USD;2009;Q4;2009-12-31;2010-02-26;1400000000;1414000000;1091000000;5457000000;10343000000;17537000000;7923000000;;36181000000;44104000000;61641000000;9881000000;2419000000;12300000000;8756000000;13573000000;25873000000;27158000000;-7610000000;16355000000;35768000000;61641000000
CVS;256275;USD;2008;Q4;2008-12-31;2009-08-04;1438800000;1469000000;1352000000;5384000000;9153000000;16526000000;8125000000;;36309000000;44434000000;60960000000;9793000000;3697000000;13490000000;8057000000;12896000000;26386000000;27240000000;-5812000000;13098000000;34574000000;60960000000
CRWS;256343;USD;2016;Q4;2016-04-30;2017-06-14;10031000;10025000;7892000;;15821000;41110000;441000;;5633000;6074000;47184000;7573000;;7573000;0;688000;8261000;52344000;-12175000;-1246000;38923000;47184000
CRWS;256343;USD;2015;Q4;2015-04-30;2016-06-09;9997000;9944000;7574000;;14785000;44844000;433000;;7138000;7571000;52415000;12185000;;12185000;;211000;12396000;50846000;-11228000;401000;40019000;52415000
CRWS;256343;USD;2014;Q4;2014-04-30;2015-06-12;10067000;10088000;1807000;;15468000;41551000;528000;;7867000;8395000;49946000;10374000;;10374000;;0;10374000;48681000;-8390000;-719000;39572000;49946000
CRWS;256343;USD;2013;Q4;2013-04-30;2014-06-18;19706141;19718123;560000;;13607000;37270000;586000;;8359000;8945000;46215000;10298000;;10298000;;;10298000;47280000;-8147000;-3216000;35917000;46215000
CRWS;256343;USD;2012;Q4;2012-04-30;2013-06-19;9828000;9679000;340000;;10930000;35067000;738000;;8358000;9096000;44163000;11351000;;11351000;;0;11351000;46336000;-7690000;-5834000;32812000;44163000
CRWS;256343;USD;2011;Q4;2011-04-30;2012-06-20;9660000;9736000;214000;;11839000;35078000;514000;;9069000;9583000;44661000;9818000;;9945000;;0;9945000;43775000;-5391000;-3668000;34716000;44661000
CRWS;256343;USD;2010;Q4;2010-04-30;2011-08-17;9590000;9797000;205000;;13560000;35053000;472000;;10177000;10649000;45702000;8019000;1952000;9971000;4336000;4336000;14307000;42335000;-4358000;-6582000;31395000;45702000
CRWS;256343;USD;2017;Q4;2017-04-30;2018-06-13;10084000;10093000;215000;;19788000;39754000;1778000;;15049000;16827000;56581000;6788000;;6788000;9458000;10475000;17263000;52999000;-12231000;-1450000;39318000;56581000
TJX;256569;USD;2016;Q4;2017-01-31;2016-03-29;1298794000;1318026000;3473091000;258831000;3644959000;7750774000;4532894000;;600140000;5133034000;12883808000;4757656000;;4757656000;2227599000;3615553000;8373209000;646319000;;4558506000;4510599000;12883808000
TJX;256569;USD;2015;Q4;2016-01-31;2016-03-29;1330662000;1351264000;2447786000;238072000;3695113000;6772560000;4137575000;;580296000;4717871000;11490431000;4402230000;;4402230000;1615003000;2781126000;7183356000;663496000;;4311051000;4307075000;11490431000
TJX;256569;USD;2014;Q4;2015-01-31;2015-03-31;1370674000;1390146000;2776398000;213824000;3217923000;6577444000;3868365000;;542941000;4411306000;10988750000;3929634000;;3929634000;1623864000;2794886000;6724520000;684733000;;4133882000;4264230000;10988750000
TJX;256569;USD;2013;Q4;2014-01-31;2014-04-01;1414102000;1440484000;2444448000;210094000;2966490000;6067998000;3594501000;;538523000;4133024000;10201022000;3517843000;;3517843000;1274216000;2453286000;5971129000;705017000;;3724408000;4229893000;10201022000
TJX;256569;USD;2012;Q4;2013-01-31;2013-04-02;1447428000;1474440000;2047810000;222788000;3014214000;5711543000;3223242000;;577070000;3800312000;9511855000;3760596000;;3760596000;774552000;2085322000;5845918000;723902000;;3155427000;3665937000;9511855000
TJX;256569;USD;2011;Q4;2012-01-31;2012-03-27;1500984000;1531552000;1601803000;204304000;2950523000;5132632000;2715125000;;433848000;3148973000;8281605000;3060453000;2970000;3063423000;784623000;2008892000;5072315000;746702000;;2655163000;3209290000;8281605000
TJX;256569;USD;2010;Q4;2011-01-31;2011-03-30;1566416000;1593880000;1818012000;200147000;2765464000;5099527000;2460782000;;411454000;2872236000;7971763000;3130394000;2727000;3133121000;787517000;1738743000;4871864000;389657000;;2801997000;3099899000;7971763000
TJX;256569;USD;2009;Q4;2010-01-31;2010-03-30;1652380000;1680052000;1745243000;148126000;2532318000;4803856000;2287097000;;373024000;2660121000;7463977000;2892631000;2355000;2894986000;790169000;1679715000;4574701000;409386000;;2614014000;2889276000;7463977000
TJX;256569;USD;2008;Q4;2009-01-31;2009-08-28;1648764000;1726924000;453527000;143500000;2619336000;3626129000;2201204000;;350909000;2552113000;6178242000;2372864000;395027000;2767891000;383782000;1275794000;4043685000;412822000;;1939516000;2134557000;6178242000
TJX;256569;USD;2017;Q4;2018-01-31;2018-04-04;1259468000;1276846000;3264642000;327166000;4187243000;8485727000;5006053000;;566235000;5572288000;14058015000;5125537000;;5125537000;2230607000;3784169000;8909706000;628009000;;4962159000;5148309000;14058015000
TJX;256569;USD;2018;Q4;2019-01-31;2019-04-03;1227694000;1244654000;3030229000;346298000;4579033000;8469222000;5255208000;;601599000;5856807000;14326029000;5531374000;;5531374000;2233616000;3746049000;9277423000;1217183000;;4461744000;5048606000;14326029000
FUL;256748;USD;2017;Q4;2017-11-30;2018-01-31;50357000;51725000;194398000;473700000;359505000;1144992000;670194000;;2545460000;3215654000;4360646000;451930000;52983000;504913000;2398927000;2811713000;3316626000;125051000;;1119231000;1044020000;4360646000
FUL;256748;USD;2016;Q4;2016-11-30;2017-01-31;50180000;51379000;142245000;351130000;247399000;811253000;515275000;;729340000;1244615000;2055868000;274332000;117512000;391844000;585759000;721478000;1113322000;109705000;;1090900000;942546000;2055868000
FUL;256748;USD;2015;Q4;2015-11-30;2016-01-27;50142000;51192000;119168000;364704000;248504000;801051000;512860000;;728341000;1241201000;2042252000;296268000;53257000;349525000;669606000;815202000;1164727000;105596000;;994608000;877525000;2042252000
FUL;256748;USD;2014;Q4;2014-11-30;2015-01-28;50105000;51293000;77569000;341307000;251290000;765136000;502634000;;601236000;1103870000;1869006000;285050000;27149000;317199000;547735000;656703000;973902000;103580000;;933819000;895104000;1869006000
FUL;256748;USD;2013;Q4;2013-11-30;2014-01-24;49907000;51238000;155121000;331125000;221537000;794694000;434387000;;643947000;1078334000;1873028000;335189000;20589000;360778000;472315000;577072000;937850000;94719000;;907308000;935178000;1873028000
FUL;256748;USD;2012;Q4;2012-11-30;2013-01-29;49640000;50798000;200436000;320152000;208531000;799344000;329016000;;657960000;986976000;1786320000;304932000;45113000;350119000;475112000;653522000;1003641000;87868000;;830031000;782679000;1786320000
FUL;256748;USD;2011;Q4;2011-11-30;2012-01-27;48937000;49820000;154649000;217424000;116443000;596590000;242587000;;388532000;631119000;1227709000;179700000;52685000;254985000;179611000;263260000;518245000;73220000;;720989000;709464000;1227709000
FUL;256748;USD;2010;Q4;2010-11-30;2011-01-20;48738000;49740000;133277000;221020000;121621000;533617000;251075000;;368765000;619840000;1153457000;181590000;49743000;231333000;200978000;287734000;519067000;71895000;;646596000;634390000;1153457000
FUL;256748;USD;2009;Q4;2009-11-30;2011-01-20;48364000;49375000;100154000;203898000;116907000;473656000;253300000;;373489000;626789000;1100445000;184693000;51315000;236008000;162713000;270195000;506203000;60967000;;589451000;594242000;1100445000
FUL;256748;USD;2018;Q4;2018-11-30;2019-01-28;50710000;52018000;150793000;485719000;355563000;1087732000;636549000;;2450990000;3087539000;4175271000;440128000;105995000;546123000;2141532000;2476980000;3023103000;146673000;;1285246000;1152168000;4175271000
STZ;256994;USD;2016;Q4;2017-02-28;2017-04-27;195574000;223277000;177400000;737000000;1955100000;3230000000;3932800000;;11439600000;15372400000;18602400000;1180200000;1517400000;2697600000;7720700000;9020000000;11717600000;2758400000;-2777700000;7310000000;6884500000;18602100000
STZ;256994;USD;2015;Q4;2016-02-29;2016-04-25;199344000;228577000;83100000;732500000;1851600000;2977600000;3333400000;;10654000000;13987400000;16965000000;1415600000;856700000;2272300000;6816200000;8000900000;10273200000;2591600000;-1670300000;6090500000;6691500000;16964700000
STZ;256994;USD;2014;Q4;2015-02-28;2015-04-28;193784000;225847000;110100000;598900000;1827200000;2910800000;2681600000;;9500600000;12182200000;15093000000;972600000;158100000;1130700000;7086000000;8081000000;9211700000;2272300000;-1648500000;5277500000;5881000000;15092700000
STZ;256994;USD;2013;Q4;2014-02-28;2014-04-29;189922000;223983000;63900000;626200000;1743800000;2747200000;2014300000;;9540600000;11554900000;14302100000;1435700000;590000000;2025700000;6373300000;7295100000;9320800000;2119100000;-1662300000;4438200000;4981000000;14301800000
STZ;256994;USD;2012;Q4;2013-02-28;2013-04-29;182823000;220145000;331500000;471900000;1480900000;2471200000;1229000000;;3937900000;5166900000;7638100000;650300000;27600000;677900000;3277800000;4099900000;4777800000;1909500000;-1676700000;2495100000;2860000000;7637800000
STZ;256994;USD;2011;Q4;2012-02-29;2012-04-30;196506000;226706000;85800000;437600000;1374500000;2034300000;1255800000;;3819800000;5075600000;7109900000;869400000;330200000;1199600000;2421400000;3234300000;4433900000;1693700000;-1299000000;2107300000;2675700000;7109600000
STZ;256994;USD;2010;Q4;2011-02-28;2011-04-29;208082000;235571000;9200000;417400000;1369300000;2083000000;1219600000;;3865000000;5084600000;7167600000;647000000;15900000;662900000;3136700000;3952800000;4615700000;1604700000;-904200000;1662300000;2551600000;7167300000
STZ;256994;USD;2009;Q4;2010-02-28;2010-10-12;220470000;246023000;43500000;514700000;1879900000;2589100000;1567200000;;3938000000;5505200000;8094300000;1185400000;187200000;1372600000;3277100000;4145400000;5518000000;1495500000;-609500000;1102800000;2576000000;8094000000
STZ;256994;USD;2017;Q4;2018-02-28;2018-04-23;193593000;222756000;90300000;776200000;2084000000;3474000000;4789700000;;12275000000;17064700000;20538700000;1175600000;769100000;1944700000;9417600000;10531300000;12476000000;2827900000;-3807400000;9228200000;8062400000;20538400000
STZ;256994;USD;2018;Q4;2019-02-28;2019-04-23;190714000;217658000;93600000;846900000;2130400000;3684000000;5267300000;3465600000;16814600000;25547500000;29231500000;1307100000;1856700000;3163800000;11759800000;13230500000;16394300000;1410800000;-2782100000;14276200000;12837200000;29231500000
NAII;257524;USD;2017;Q4;2017-06-30;2017-09-18;6599349;6678018;27843000;8410000;13729000;51699000;18136000;;2776000;20912000;72611000;9848000;;10270000;;1193000;11463000;22339000;-6074000;45788000;61148000;72611000
NAII;257524;USD;2016;Q4;2016-06-30;2016-09-19;6552758;6676264;19747000;13217000;20768000;55882000;15167000;;3126000;18293000;74175000;19205000;;19205000;;1244000;20449000;21215000;-5362000;38553000;53726000;74175000
NAII;257524;USD;2015;Q4;2015-06-30;2015-09-18;6621188;6728737;18551000;9895000;12564000;43600000;7633000;;2583000;10216000;53816000;9093000;;9093000;;863000;9956000;20333000;-4714000;29007000;43860000;53816000
NAII;257524;USD;2014;Q4;2014-06-30;2014-09-25;6828936;6919570;19512000;6835000;12840000;40903000;8811000;;2544000;11355000;52258000;9600000;;9600000;;220000;9820000;19939000;-2693000;25661000;42438000;52258000
NAII;257524;USD;2013;Q4;2013-06-30;2013-09-19;6826983;6866795;16697000;6605000;10035000;35323000;9205000;;2112000;11317000;46640000;5942000;;5942000;;359000;6301000;19735000;-2633000;23667000;40339000;46640000
NAII;257524;USD;2012;Q4;2012-06-30;2012-09-21;6960446;6974920;14478000;8751000;8355000;34519000;10647000;;2031000;12678000;47197000;6836000;;6836000;;493000;7329000;19602000;-1930000;22097000;39868000;47197000
NAII;257524;USD;2011;Q4;2011-06-30;2011-11-14;7105729;7107161;15461000;3287000;6499000;27828000;11411000;;1905000;13316000;41144000;4947000;;4947000;;719000;5666000;19429000;-1525000;17939000;35478000;41144000
NAII;257524;USD;2018;Q4;2018-06-30;2018-09-19;6701361;7188444;23613000;14621000;23567000;65183000;19290000;;734000;20024000;85207000;14280000;;14280000;;2679000;16959000;24571000;-6584000;50839000;68248000;85207000
SINO;257712;USD;2016;Q4;2016-06-30;2016-09-19;9513830;9513830;1385994;2333024;;8651985;176367;;225792;402159;9054144;2413009;;2437382;;-3880;2433502;16645233;-417538;-4518799;6620642;9054144
SINO;257712;USD;2015;Q4;2015-06-30;2015-09-18;7449752;7449752;730322;3082219;;8105688;214003;;3490859;3704862;11810550;1787843;;1914044;;-7760;1906284;17448169;-372527;-2552870;9904266;11810550
SINO;257712;USD;2014;Q4;2014-06-30;2014-09-15;4776169;4776169;902531;481885;;4957798;294722;;461434;756156;5713954;1142318;;1230795;;-11640;1219155;12806999;-372527;-3270260;4494799;5713954
SINO;257712;USD;2013;Q4;2013-06-30;2013-09-27;10103841;10103841;3048831;3142203;;7145165;267662;;123378;391040;7536205;3694733;;4404905;;-15520;4389385;11894999;-372527;-4856613;3146820;7536205
SINO;257712;USD;2012;Q4;2012-06-30;2012-10-12;2903841;2903841;4433333;3788966;;9786401;415672;;374457;790129;10576530;7728990;;8032427;;-202089;7830338;8901541;-372527;-3056858;2746192;10576530
SINO;257712;USD;2011;Q4;2011-06-30;2011-11-15;;;4878828;1847990;;7985470;587024;186514;294922;1068460;9053930;3167948;;3878839;;-397558;3481281;8901541;-372527;-1288783;5572649;9053930
SINO;257712;USD;2017;Q4;2017-06-30;2017-09-27;10090760;10147507;8733742;2569141;3333038;16754888;187373;;873760;1061133;17816021;2510456;;3086496;;0;3086496;21224313;-417538;-893907;14729525;17816021
SINO;257712;USD;2018;Q4;2018-06-30;2018-09-28;12840810;16648795;7098259;8428853;3414619;23832388;956429;;1369010;2325439;26157827;6207168;;6622553;;0;6622553;25472903;-417538;-434856;19535274;26157827
YHOO;257807;USD;2016;Q4;2016-12-31;2017-03-01;953800000;947917000;6820394000;1084267000;;8126160000;1209937000;34976645000;3770337000;39956919000;48083079000;1178196000;;1287424000;1299945000;15711579000;16999003000;9126428000;-908996000;4353958000;31084076000;48083079000
YHOO;257807;USD;2015;Q4;2015-12-31;2016-02-29;943425000;924085000;5857023000;1047504000;;7507319000;1547323000;32490712000;3658612000;37696647000;45203966000;1143349000;;1277380000;1233485000;14847166000;16124546000;8808232000;-911533000;4570807000;29079420000;45203966000
YHOO;257807;USD;2014;Q4;2014-12-31;2015-02-27;948078000;962627000;7991510000;1032704000;;9444421000;1487684000;42662241000;8112990000;52262915000;61707336000;4178020000;;4514983000;1170423000;18406761000;22921744000;8500420000;-712455000;8934244000;38785592000;61707336000
YHOO;257807;USD;2013;Q4;2013-12-31;2014-02-28;1012972000;1038757000;3407894000;979559000;;5025857000;1488518000;1766781000;8523803000;11779102000;16804959000;1045813000;;1340312000;1110585000;2334050000;3674362000;8689319000;-200228000;4267429000;13130597000;16804959000
YHOO;257807;USD;2012;Q4;2012-12-31;2013-03-01;1155951000;1168334000;4183953000;1008448000;;5652713000;1685845000;2943816000;6820879000;11450540000;17103253000;993306000;;1290232000;;1207418000;2497650000;9564535000;-1368043000;5792459000;14605603000;17103253000
YHOO;257807;USD;2011;Q4;2011-12-31;2012-02-29;1234905000;1241008000;2055579000;1037474000;;3452536000;1730888000;694966000;8904396000;11330250000;14782786000;1012639000;;1207361000;;994078000;2201439000;9827141000;-416237000;2432294000;12581347000;14782786000
YHOO;257807;USD;2010;Q4;2010-12-31;2011-02-28;1306037000;1311682000;2884088000;1028900000;;4345548000;1653422000;979730000;7949404000;10582556000;14928104000;1371216000;;1625872000;;705822000;2331694000;10111219000;0;1942656000;12596410000;14928104000
YHOO;257807;USD;2009;Q4;2009-12-31;2010-02-26;1402338000;1416973000;3291085000;1003362000;;4594772000;1426862000;1421852000;7492544000;10341258000;14936030000;1306584000;;1717728000;;699666000;2417394000;10641777000;-117331000;1599638000;12518636000;14936030000
YHOO;257807;USD;2008;Q4;2008-12-31;2009-08-07;1387758000;1408210000;3451987000;1060450000;;4745498000;1536181000;303975000;7104194000;8944350000;13689848000;1291791000;;1705015000;;715872000;2420887000;11645230000;-5267484000;4752920000;11268961000;13689848000
ORCL;257930;USD;2016;Q4;2016-05-31;2016-06-22;4146000000;4236000000;56125000000;5385000000;212000000;64313000000;4000000000;;43867000000;47867000000;112180000000;2470000000;3750000000;17208000000;40105000000;47182000000;64390000000;24217000000;;23888000000;47790000000;112180000000
ORCL;257930;USD;2015;Q4;2015-05-31;2015-06-25;4359000000;4465000000;54368000000;5618000000;314000000;62520000000;3686000000;;44697000000;48383000000;110903000000;2645000000;1999000000;15206000000;39959000000;46599000000;61805000000;23156000000;;26503000000;49098000000;110903000000
ORCL;257930;USD;2014;Q4;2014-05-31;2014-06-26;4473000000;4567000000;38819000000;6087000000;189000000;48128000000;3061000000;;39077000000;42138000000;90266000000;2827000000;1508000000;14389000000;22589000000;28430000000;42819000000;21077000000;;25965000000;47447000000;90266000000
ORCL;257930;USD;2013;Q4;2013-05-31;2013-06-26;4682000000;4757000000;32216000000;6049000000;240000000;41692000000;3053000000;;37067000000;40120000000;81812000000;3181000000;;12872000000;18494000000;23795000000;36667000000;18893000000;;25854000000;45145000000;81812000000
ORCL;257930;USD;2012;Q4;2012-05-31;2012-06-26;4950000000;5027000000;30676000000;6377000000;158000000;40023000000;3021000000;;35283000000;38304000000;78327000000;2968000000;2950000000;15388000000;13524000000;18852000000;34240000000;17489000000;;26087000000;44087000000;78327000000
ORCL;257930;USD;2011;Q4;2011-05-31;2011-06-28;5065000000;5163000000;28848000000;6628000000;303000000;39174000000;2857000000;;31504000000;34361000000;73535000000;2814000000;1150000000;14192000000;14772000000;19098000000;33290000000;16653000000;;22581000000;40245000000;73535000000
ORCL;257930;USD;2010;Q4;2010-05-31;2010-07-01;5022000000;5089000000;18469000000;5585000000;259000000;27004000000;2763000000;;31811000000;34574000000;61578000000;2670000000;3145000000;14691000000;11510000000;15688000000;30379000000;14648000000;;16146000000;31199000000;61578000000
ORCL;257930;USD;2009;Q4;2009-05-31;2009-09-21;4996000000;5042000000;12624000000;4430000000;0;18581000000;1922000000;;26913000000;28835000000;47416000000;1680000000;1001000000;9149000000;9237000000;12822000000;21971000000;12980000000;;11894000000;25445000000;47416000000
ORCL;257930;USD;2017;Q4;2017-05-31;2017-06-27;4130000000;4248000000;66078000000;5300000000;300000000;74515000000;5315000000;;55161000000;60476000000;134991000000;2565000000;9797000000;24178000000;48112000000;56567000000;80745000000;27065000000;;27598000000;54246000000;134991000000
ORCL;257930;USD;2018;Q4;2018-05-31;2018-06-22;4046000000;4263000000;67261000000;5279000000;;75964000000;5897000000;;55403000000;61300000000;137264000000;2318000000;4491000000;19195000000;56128000000;71845000000;91040000000;28950000000;;18412000000;46224000000;137264000000
ORCL;257930;USD;2019;Q4;2019-05-31;2019-06-21;3386000000;3495000000;37827000000;5134000000;;46386000000;6252000000;;56071000000;62323000000;108709000000;2208000000;4494000000;18630000000;51673000000;67716000000;86346000000;26909000000;;-3496000000;22363000000;108709000000
KR;258154;USD;2017;Q4;2018-02-28;2018-04-03;877000000;886000000;347000000;1637000000;6533000000;11117000000;21071000000;;5009000000;26080000000;37197000000;6957000000;3560000000;14197000000;12029000000;16095000000;30292000000;5079000000;-14684000000;17007000000;6905000000;37197000000
KR;258154;USD;2016;Q4;2017-02-28;2017-03-28;930000000;946000000;322000000;1649000000;6561000000;10340000000;21016000000;;5149000000;26165000000;36505000000;7052000000;2252000000;12860000000;11825000000;16935000000;29795000000;4988000000;-13118000000;15543000000;6710000000;36505000000
KR;258154;USD;2015;Q4;2016-02-29;2016-03-29;966000000;980000000;277000000;1734000000;6168000000;9892000000;19619000000;;4386000000;24005000000;33897000000;7154000000;2370000000;12971000000;9709000000;14128000000;27099000000;4898000000;-11409000000;14011000000;6798000000;33897000000
KR;258154;USD;2014;Q4;2015-02-28;2015-03-31;975000000;987000000;268000000;1266000000;5688000000;8911000000;17912000000;;3674000000;21586000000;30497000000;6343000000;1874000000;11392000000;9723000000;13663000000;25055000000;4666000000;-10809000000;12367000000;5442000000;30497000000
KR;258154;USD;2013;Q4;2014-02-28;2014-04-01;1022000000;1034000000;401000000;1116000000;5651000000;8830000000;16893000000;;3558000000;20451000000;29281000000;6031000000;1657000000;10705000000;9653000000;13181000000;23886000000;4508000000;-9641000000;10981000000;5395000000;29281000000
KR;258154;USD;2012;Q4;2013-02-28;2013-04-02;1030000000;1038000000;238000000;1051000000;5146000000;7959000000;14848000000;;1827000000;16675000000;24634000000;5501000000;2734000000;11061000000;6145000000;9359000000;20420000000;4410000000;-9237000000;9787000000;4214000000;24634000000
KR;258154;USD;2011;Q4;2012-02-29;2012-03-27;1138000000;1138000000;188000000;949000000;5114000000;7325000000;14464000000;;1687000000;16151000000;23476000000;5385000000;1315000000;9105000000;6850000000;10405000000;19510000000;4386000000;-8132000000;8571000000;3966000000;23476000000
KR;258154;USD;2010;Q4;2011-02-28;2011-03-29;1252000000;1258000000;825000000;845000000;4966000000;7621000000;14147000000;;1737000000;15884000000;23505000000;5115000000;588000000;8070000000;7304000000;10137000000;18207000000;4353000000;-6732000000;8225000000;5298000000;23505000000
KR;258154;USD;2009;Q4;2010-02-28;2010-03-30;1294000000;1318000000;424000000;909000000;4935000000;7483000000;13929000000;;1714000000;15643000000;23126000000;4676000000;579000000;7727000000;7477000000;10473000000;18200000000;4319000000;-6238000000;7364000000;4926000000;23126000000
KR;258154;USD;2008;Q4;2009-02-28;2009-09-23;1298000000;1310000000;263000000;944000000;4905000000;7252000000;13161000000;;2844000000;16005000000;23257000000;4650000000;558000000;7646000000;7505000000;10311000000;17957000000;4221000000;-6039000000;7518000000;5300000000;23257000000
KR;258154;USD;2018;Q4;2019-02-28;2019-04-02;798000000;806000000;429000000;1589000000;6846000000;10803000000;21635000000;;5680000000;27315000000;38118000000;7286000000;3157000000;15836000000;12072000000;14447000000;30283000000;5163000000;-16612000000;19681000000;7835000000;38118000000
IVDN;258246;USD;2018;Q4;2018-10-31;2019-03-13;27495105;27495105;112203;13455;722887;917544;131532;;625200;756732;1674276;228623;18628;392601;100858;100858;493459;10109511;;-8928694;1180817;1674276
EVI;258455;USD;2016;Q4;2016-06-30;2016-09-20;7034536;7034268;3942000;1833000;2627000;9878000;135000;;148000;283000;10161000;3859000;0;5072000;0;0;5072000;2272000;-4000;2821000;5089000;10161000
EVI;258455;USD;2015;Q4;2015-06-30;2015-09-23;7033732;7033732;3908974;1924517;2808910;9044380;188243;;50149;238392;9282772;2027254;;4527226;;0;4527226;2271707;-3938;2487777;4755546;9282772
EVI;258455;USD;2014;Q4;2014-06-30;2014-09-22;7033732;7033732;9224340;923788;2836220;13574578;181629;;61880;243509;13818087;5656647;;9327612;;0;9327612;2271707;-3938;2222706;4490475;13818087
EVI;258455;USD;2013;Q4;2013-06-30;2013-09-23;7033732;7033732;5944260;2240632;1997818;10789262;164069;;98999;263068;11052330;2713300;;5368665;;0;5368665;2271707;-3938;3415896;5683665;11052330
EVI;258455;USD;2012;Q4;2012-06-30;2012-09-24;7033732;7033732;6527940;1400773;2371444;10555618;185703;;131276;316979;10872597;1487105;;2575932;;0;2575932;2271707;-3938;6028896;8296665;10872597
EVI;258455;USD;2011;Q4;2011-06-30;2011-11-14;7033732;7033732;6907020;1227491;2290904;10677614;156792;;161095;317887;10995501;1642536;;2858838;;0;2858838;2271707;-3938;5868894;8136663;10995501
KOOL;258731;USD;2017;Q4;2017-12-31;2017-09-22;989928;989928;3623000;3701000;3617000;11178000;2330000;;33424000;35754000;46932000;1986000;;4520000;3500000;11575000;16095000;216232000;;-185357000;30837000;46932000
KOOL;258731;USD;2016;Q4;2016-12-31;2016-09-21;300949;300949;5835000;3169000;3593000;12843000;2962000;;34094000;37056000;49899000;3097000;;5542000;2489000;12084000;17626000;188572000;;-156262000;32273000;49899000
KOOL;258731;USD;2015;Q4;2015-12-31;2015-09-17;202292;202292;3357000;5133000;4598000;13251000;2937000;;34569000;37506000;50757000;5784000;;7946000;0;7909000;15855000;172581000;;-137674000;34902000;50757000
KOOL;258731;USD;2014;Q4;2014-12-31;2014-09-29;175805;175805;14811000;4693000;5606000;25327000;2298000;;35263000;37561000;62888000;4189000;;6380000;;7810000;14190000;171462000;;-122822000;48698000;62888000
KOOL;258731;USD;2013;Q4;2013-12-31;2013-09-04;82710;82687;6884000;4898000;4259000;16273000;2208000;;48000;2256000;18529000;3583000;;5148000;;63000;5211000;127509000;;-114191000;13318000;18529000
KOOL;258731;USD;2012;Q4;2012-12-31;2012-09-21;82043;82043;7879000;4558000;6290000;19065000;1652000;;363000;2015000;21080000;3379000;;5031000;;151000;5182000;127003000;;-111105000;15898000;21080000
KOOL;258731;USD;2011;Q4;2011-12-31;2011-11-10;80697;80697;12309000;3963000;6348000;23040000;1310000;;49000;1359000;24399000;2175000;;4064000;;242000;4306000;126212000;;-106119000;20093000;24399000
KOOL;258731;USD;2018;Q4;2018-12-31;2019-03-26;2519341;2519341;2400000;1509000;4493000;8626000;2562000;;3423000;5985000;14611000;4639000;;6365000;1174000;1515000;7880000;235890000;;-227435000;6731000;14611000
FDX;259098;USD;2018;Q4;2018-05-31;2018-07-16;264000000;271000000;3265000000;8481000000;;13341000000;28154000000;;10835000000;38989000000;52330000000;8285000000;1342000000;9627000000;15243000000;23287000000;32914000000;3149000000;-7978000000;24823000000;19416000000;52330000000
FDX;259098;USD;2017;Q4;2017-05-31;2017-07-17;267000000;270000000;3969000000;7599000000;;12628000000;25981000000;;9943000000;35924000000;48552000000;7896000000;22000000;7918000000;14909000000;24561000000;32479000000;3037000000;-7382000000;20833000000;16073000000;48552000000
FDX;259098;USD;2016;Q4;2016-05-31;2016-07-18;271000000;272000000;3534000000;7252000000;;11989000000;24284000000;;9686000000;33970000000;45959000000;7979000000;29000000;8008000000;13733000000;24167000000;32175000000;2924000000;-7342000000;18371000000;13784000000;45959000000
FDX;259098;USD;2015;Q4;2015-05-31;2015-07-14;281000000;285000000;3763000000;5719000000;;10335000000;20875000000;;5321000000;26196000000;36531000000;5937000000;19000000;5956000000;7249000000;15582000000;21538000000;2818000000;-4897000000;16900000000;14993000000;36531000000
FDX;259098;USD;2014;Q4;2014-05-31;2014-07-14;294000000;295000000;2908000000;5460000000;;9683000000;19550000000;;3837000000;23387000000;33070000000;5311000000;1000000;5312000000;4736000000;12481000000;17793000000;2675000000;-4133000000;16229000000;15277000000;33070000000
FDX;259098;USD;2013;Q4;2013-05-31;2013-07-15;316000000;320000000;4917000000;5044000000;;11274000000;18484000000;;3809000000;22293000000;33567000000;5499000000;251000000;5750000000;2739000000;10419000000;16169000000;2700000000;-1000000;18519000000;17398000000;33567000000
FDX;259098;USD;2012;Q4;2012-05-31;2012-07-16;315000000;318000000;2843000000;4704000000;;9056000000;17248000000;;3599000000;20847000000;29903000000;4957000000;417000000;5374000000;1250000000;9802000000;15176000000;2627000000;-81000000;17134000000;14727000000;29903000000
FDX;259098;USD;2011;Q4;2011-05-31;2011-07-12;317000000;320000000;2328000000;4581000000;;8285000000;15543000000;;3557000000;19100000000;27385000000;4864000000;18000000;4882000000;1667000000;7283000000;12165000000;2516000000;-12000000;15266000000;15220000000;27385000000
FDX;259098;USD;2010;Q4;2010-05-31;2010-07-15;312000000;315000000;1952000000;4163000000;;7284000000;14385000000;;3233000000;17618000000;24902000000;4383000000;262000000;4645000000;1668000000;6446000000;11091000000;2292000000;-7000000;13966000000;13811000000;24902000000
FDX;259098;USD;2009;Q4;2009-05-31;2009-09-18;;;2292000000;3391000000;;7116000000;13417000000;;3711000000;17128000000;24244000000;3871000000;653000000;4524000000;1930000000;6094000000;10618000000;2084000000;-4000000;12919000000;13626000000;24244000000
FDX;259098;USD;2019;Q4;2019-05-31;2019-07-16;260000000;262000000;2319000000;9116000000;;13086000000;30429000000;;10888000000;41317000000;54403000000;8049000000;964000000;9013000000;16617000000;27633000000;36646000000;3263000000;-9289000000;24648000000;17757000000;54403000000
AMRK;259435;USD;2018;Q4;2018-06-30;2018-09-19;7031800;6940800;6291000;35856000;280116000;706983000;8018000;8388000;19612000;36018000;743001000;51126000;200000000;665869000;0;8024000;673893000;24788000;;40910000;69108000;743001000
AMRK;259435;USD;2017;Q4;2017-06-30;2017-09-15;7047700;7139100;13059000;39295000;284659000;447021000;6607000;7967000;16905000;31479000;478500000;48310000;180000000;404360000;0;1117000;405477000;23597000;;45994000;73023000;478500000
AMRK;259435;USD;2016;Q4;2016-06-30;2016-09-23;6997200;7157400;17142000;43302000;245057000;418261000;3482000;7873000;7531000;18886000;437147000;54429000;212000000;366593000;;7245000;373838000;22291000;;41018000;63309000;437147000
AMRK;259435;USD;2015;Q4;2015-06-30;2015-09-24;6963516;7063300;20927000;30025000;191501000;312626000;2850000;2500000;8686000;14036000;326662000;55969000;147000000;269791000;;909000;270700000;22540000;;33422000;55962000;326662000
AMRK;259435;USD;2014;Q4;2014-06-30;2014-09-26;7213469;7085359;13193000;102824000;175554000;295323000;1678000;500000;7637000;9815000;305138000;87130000;135200000;255649000;;33000;255682000;22387000;;27069000;49456000;305138000
AMRK;259435;USD;2013;Q4;2013-06-30;2014-03-27;7632084;7760226;21565000;109947000;162378000;294377000;1213000;0;14018000;15231000;309608000;102131000;95000000;255802000;;552000;256354000;24444000;;28810000;53254000;309608000
IPI;260195;USD;2016;Q4;2016-12-31;2017-02-28;75807849;75807849;4464000;10343000;94355000;123743000;388490000;;28668000;417158000;540901000;23125000;;24120000;133434000;153410000;177530000;583729000;;-220358000;363371000;540901000
IPI;260195;USD;2015;Q4;2015-12-31;2016-02-29;75704299;75610391;59830000;9743000;106531000;195715000;419476000;3799000;20979000;444254000;639969000;38547000;;39139000;149485000;174304000;213443000;580303000;;-153725000;426526000;639969000
IPI;260195;USD;2014;Q4;2014-12-31;2015-02-19;75530529;75974186;78023000;28561000;84094000;199131000;785250000;11856000;170482000;967588000;1166719000;44505000;;46635000;150000000;172799000;219434000;576262000;;371051000;947285000;1166719000
IPI;260195;USD;2013;Q4;2013-12-31;2014-02-13;75396576;75430677;15608000;20837000;105011000;178629000;826569000;9505000;160570000;996644000;1175273000;66519000;;68628000;150000000;172674000;241302000;572691000;;361290000;933971000;1175273000
IPI;260195;USD;2012;Q4;2012-12-31;2013-02-14;75301137;75372167;57747000;31508000;53275000;162356000;637265000;0;195002000;832267000;994623000;63607000;;67388000;0;21499000;88887000;568450000;;339015000;905736000;994623000
IPI;260195;USD;2011;Q4;2011-12-31;2012-02-16;75204904;75292202;170614000;29304000;55390000;276645000;420905000;6180000;229140000;656225000;932870000;48065000;;49675000;;12062000;61737000;564360000;;308204000;871133000;932870000
IPI;260195;USD;2010;Q4;2010-12-31;2011-02-24;75106579;75216312;121690000;23767000;48094000;208822000;320292000;21298000;278472000;620062000;828884000;43701000;;45405000;;25638000;71043000;559750000;;198793000;757841000;828884000
IPI;260195;USD;2009;Q4;2009-12-31;2010-08-05;75032962;75098660;100947000;19169000;61949000;204339000;255332000;6189000;303130000;564651000;768990000;32954000;;35932000;;23836000;59768000;556403000;;153508000;709222000;768990000
IPI;260195;USD;2017;Q4;2017-12-31;2018-02-27;128020643;128020643;1068000;17777000;83126000;111484000;364542000;;34566000;399108000;510592000;23494000;10000000;37487000;49437000;71015000;108502000;645941000;;-243851000;402090000;510592000
IPI;260195;USD;2018;Q4;2018-12-31;2019-03-12;128528430;134423890;33222000;25161000;82046000;145358000;346209000;;33664000;379873000;525231000;22862000;0;34781000;49642000;73187000;107968000;649331000;;-232068000;417263000;525231000
CLNE;260313;USD;2017;Q4;2017-12-31;2018-03-13;151359205;147234555;178670000;63961000;35238000;304897000;367305000;51792000;67918000;487015000;791912000;60169000;139699000;203300000;120388000;138954000;342254000;1111447000;;-683570000;449658000;791912000
CLNE;260313;USD;2016;Q4;2016-12-31;2017-03-07;140693980;135580298;109837000;79432000;29544000;261764000;483923000;19852000;131718000;635493000;897257000;76238000;5943000;89222000;306433000;314348000;403570000;1090376000;;-603836000;493687000;897257000
CLNE;260313;USD;2015;Q4;2015-12-31;2015-11-05;92070648;92070648;146668000;73645000;29289000;329166000;516324000;20427000;134611000;671362000;1000528000;85988000;149856000;246393000;417294000;425190000;671583000;915208000;;-591683000;328945000;1000528000
CLNE;260313;USD;2014;Q4;2014-12-31;2014-10-23;91119320;91119320;214927000;81970000;34696000;413639000;514269000;78414000;154087000;746770000;1160409000;100682000;4846000;120211000;565824000;575163000;695374000;898115000;;-457441000;465035000;1160409000
CLNE;260313;USD;2013;Q4;2013-12-31;2013-11-07;94378615;94378615;378273000;53473000;33822000;521096000;487854000;73697000;168318000;729869000;1250965000;80286000;23401000;120106000;597017000;612321000;732427000;883054000;;-367782000;518538000;1250965000
CLNE;260313;USD;2012;Q4;2012-12-31;2012-11-09;90511523;90511523;146697000;57594000;38152000;284698000;428177000;73970000;188355000;690502000;975200000;70010000;30389000;113920000;300636000;314650000;428570000;837376000;;-300814000;546630000;975200000
CLNE;260313;USD;2011;Q4;2011-12-31;2011-11-08;70898740;70898740;271454000;56455000;35287000;409841000;257463000;33109000;230648000;521220000;931061000;64923000;22925000;97469000;266497000;289184000;386653000;741659000;;-199559000;544408000;931061000
CLNE;260313;USD;2010;Q4;2010-12-31;2011-08-08;67286854;67286854;55194000;45645000;20483000;162061000;211643000;25807000;183988000;421438000;583499000;56772000;22712000;96991000;41704000;70292000;167283000;569209000;;-151926000;416216000;583499000
CLNE;260313;USD;2018;Q4;2018-12-31;2019-03-12;204344507;199896110;65646000;68865000;34975000;225606000;350568000;43549000;79359000;473476000;699082000;67493000;5405000;80259000;78779000;93814000;174073000;1198789000;;-688653000;525009000;699082000
LNG;260533;USD;2016;Q4;2016-12-31;2017-02-24;229687000;229687000;876000000;218000000;160000000;2238000000;20635000000;;830000000;21465000000;23703000000;686000000;247000000;1077000000;21688000000;21787000000;22864000000;3211000000;-374000000;-4234000000;838000000;23702000000
LNG;260533;USD;2015;Q4;2015-12-31;2016-02-19;227677000;227677000;1201112000;5749000;18125000;1782586000;16193907000;;832560000;17026467000;18809053000;450019000;1673379000;2185268000;14920427000;15062382000;17247650000;3076025000;-353927000;-3623948000;1561403000;18809053000
LNG;260533;USD;2014;Q4;2014-12-31;2015-02-20;226234000;226234000;1747583000;4419000;7786000;2258877000;9246753000;;1068053000;10314806000;12573683000;182555000;0;232475000;9806084000;9839691000;10072166000;2777414000;-292752000;-2648839000;2501517000;12573683000
LNG;260533;USD;2013;Q4;2013-12-31;2014-02-21;221711000;221711000;960842000;4486000;10563000;1591180000;6454399000;;1627658000;8082057000;9673237000;196919000;;237011000;6576273000;6596169000;6833180000;2460415000;-179826000;-2100907000;2840057000;9673237000
LNG;260533;USD;2012;Q4;2012-12-31;2013-02-22;216252000;216252000;201711000;3486000;7045000;748563000;3282305000;;608217000;3890522000;4639085000;133097000;;159763000;2167113000;2217717000;2377480000;2169452000;-39115000;-1592985000;2261605000;4639085000
LNG;260533;USD;2011;Q4;2011-12-31;2012-03-22;87879000;87879000;459160000;3043000;6562000;591452000;2107129000;;216744000;2323873000;2915325000;64177000;492724000;584960000;2465113000;2503357000;3088317000;899091000;-20195000;-1260205000;-172992000;2915325000
LNG;260533;USD;2010;Q4;2010-12-31;2011-08-05;57112000;39118000;74161000;4699000;1212000;165610000;2157597000;;230300000;2387897000;2553507000;39742000;0;66334000;2918579000;2959783000;3026117000;404329000;-4338000;-1061449000;-472610000;2553507000
LNG;260533;USD;2017;Q4;2017-12-31;2018-02-21;234900000;234600000;722000000;371000000;243000000;3369000000;23978000000;;559000000;24537000000;27906000000;1103000000;0;1251000000;25336000000;25415000000;26666000000;3248000000;-386000000;-4627000000;1239000000;27905000000
LNG;260533;USD;2018;Q4;2018-12-31;2019-02-26;256900000;261000000;981000000;585000000;316000000;4234000000;27245000000;;508000000;27753000000;31987000000;1227000000;239000000;1742000000;28236000000;28316000000;30058000000;4035000000;-406000000;-4156000000;1928000000;31986000000
SYNA;260659;USD;2017;Q4;2017-06-30;2017-08-18;34500000;35500000;367800000;255200000;131400000;792000000;113800000;;360900000;474700000;1266700000;286700000;15000000;310400000;202000000;216100000;526500000;1004900000;-980300000;714100000;740200000;1266700000
SYNA;260659;USD;2016;Q4;2016-06-30;2016-08-26;36400000;37800000;352200000;252600000;146400000;780100000;112700000;;407400000;520100000;1300200000;306500000;18800000;350800000;216700000;244400000;595200000;928700000;-892300000;665300000;705000000;1300200000
SYNA;260659;USD;2015;Q4;2015-06-30;2015-08-25;37400000;39700000;399900000;324600000;140200000;916000000;123400000;;480000000;603400000;1519400000;333200000;11300000;446700000;231100000;279600000;726300000;843900000;-651700000;593100000;793100000;1519400000
SYNA;260659;USD;2014;Q4;2014-06-30;2014-08-22;36567000;41636000;447200000;195100000;82300000;742500000;80800000;;197000000;277800000;1020300000;197000000;;254400000;;64700000;319100000;740400000;-530400000;482700000;701200000;1020300000
SYNA;260659;USD;2013;Q4;2013-06-30;2013-08-19;33147000;35338000;355303000;148454000;49948000;560420000;58035000;16969000;55842000;130846000;691266000;149430000;;149626000;2305000;19785000;169411000;539221000;-460160000;435992000;521855000;691266000
SYNA;260659;USD;2012;Q4;2012-06-30;2012-09-21;33287000;34779000;305005000;104140000;31667000;446177000;24903000;15321000;55104000;95328000;541505000;105598000;;105598000;2305000;39117000;144715000;471618000;-413885000;337059000;396790000;541505000
SYNA;260659;USD;2011;Q4;2011-06-30;2011-08-22;33820000;35210000;247153000;93808000;28850000;374184000;26222000;25876000;29919000;82017000;456201000;92761000;;92761000;2305000;23447000;116208000;406700000;-352142000;282915000;339993000;456201000
SYNA;260659;USD;2010;Q4;2010-06-30;2010-11-02;33866000;35693000;209858000;101509000;18667000;334505000;25821000;28012000;26341000;80174000;414679000;105971000;;105971000;2305000;22197000;128168000;347809000;-281932000;219119000;286511000;414679000
SYNA;260659;USD;2018;Q4;2018-06-30;2018-08-24;34700000;34700000;301000000;289100000;131200000;739500000;117800000;;642500000;760300000;1499800000;275100000;;283800000;450700000;486700000;770500000;1195300000;-1073900000;606400000;729300000;1499800000
FSLR;260908;USD;2017;Q4;2017-12-31;2018-02-23;104439000;102631000;2988913000;211797000;201210000;3832772000;1154537000;217230000;1659962000;3031729000;6864501000;506628000;13075000;650276000;380465000;1115528000;1765804000;2799211000;;2297227000;5098697000;6864501000
FSLR;260908;USD;2016;Q4;2016-12-31;2016-11-03;103985000;101111000;1955146000;266687000;425995000;3787829000;629142000;;2407397000;3036539000;6824368000;424269000;27966000;907881000;160422000;698138000;1606019000;2765414000;;2462842000;5218349000;6824368000
FSLR;260908;USD;2015;Q4;2015-12-31;2015-11-09;101411000;102979000;1830280000;500629000;517313000;3345586000;1284136000;;2686609000;3970745000;7316331000;748450000;38090000;960800000;251325000;807044000;1767844000;2742897000;;2790110000;5548487000;7316331000
FSLR;260908;USD;2014;Q4;2014-12-31;2014-11-07;100256000;101521000;1991086000;135434000;630171000;3077654000;1419988000;;2223349000;3643337000;6720991000;604539000;51399000;1000539000;162074000;728965000;1729504000;2697658000;;2243689000;4991487000;6720991000
FSLR;260908;USD;2013;Q4;2013-12-31;2013-11-01;99661000;100975000;1764174000;136383000;522682000;3792764000;1385084000;;1705654000;3090738000;6883502000;588117000;60543000;1588061000;162780000;792324000;2380385000;2646122000;;1882771000;4503117000;6883502000
FSLR;260908;USD;2012;Q4;2012-12-31;2012-11-02;87086000;85515000;1003872000;553567000;533824000;2832324000;1525382000;;1990986000;3516368000;6348692000;910137000;62349000;1101374000;500223000;1641792000;2743166000;2065614000;;1529733000;3605526000;6348692000
FSLR;260908;USD;2011;Q4;2011-12-31;2011-11-04;86442000;82938000;671765000;310568000;529651000;2613261000;1815958000;116192000;1232203000;3164353000;5777614000;592648000;44505000;973724000;619143000;1160027000;2133751000;2022829000;;1626071000;3643863000;5777614000
FSLR;260908;USD;2010;Q4;2010-12-31;2010-11-01;85135000;86861000;933578000;305537000;200442000;1584460000;1430789000;180271000;1184883000;2795943000;4380403000;343414000;26587000;469677000;210804000;456899000;926576000;1815506000;;1665564000;3453827000;4380403000
FSLR;260908;USD;2009;Q4;2009-12-31;2009-10-30;84413000;86004000;784735000;226826000;152821000;1351271000;988782000;329608000;679851000;1998241000;3349512000;277761000;28559000;394927000;146399000;304642000;699569000;1658176000;;1001363000;2649943000;3349512000
FSLR;260908;USD;2008;Q4;2008-12-31;2009-08-03;81345000;82448000;792260000;61703000;121554000;1077401000;842622000;29559000;164920000;1037101000;2114502000;287088000;34951000;381777000;163519000;219683000;601460000;1176238000;;361225000;1513042000;2114502000
FSLR;260908;USD;2018;Q4;2018-12-31;2019-02-22;104850000;107208000;2547266000;128282000;444818000;3859523000;1756211000;3186000;1502442000;3261839000;7121362000;695752000;5570000;845457000;461221000;1063502000;1908959000;2825316000;;2441553000;5212403000;7121362000
BKNG;261036;USD;2017;Q4;2017-12-31;2018-02-27;48672000;49763000;7401477000;1217801000;;9034805000;480081000;10872527000;5063850000;16416458000;25451263000;1806503000;;3497868000;10063597000;10692797000;14190665000;5783576000;-8698829000;13938869000;11260598000;25451263000
BKNG;261036;USD;2016;Q4;2016-12-31;2016-11-07;49310000;50089000;4299955000;860115000;;5401519000;347017000;9591067000;4499370000;14437454000;19838973000;1276575000;;2858670000;6199060000;7160161000;10018831000;5483138000;-6855164000;11326852000;9820142000;19838973000
BKNG;261036;USD;2015;Q4;2015-12-31;2015-11-09;49712000;50798000;2648511000;645169000;;3553237000;274786000;7931363000;5661189000;13867338000;17420575000;1004429000;;1439310000;6158443000;7185796000;8625106000;5185392000;-5826640000;9191865000;8795469000;17420575000
BKNG;261036;USD;2014;Q4;2014-12-31;2014-11-04;52249000;53095000;4290833000;643894000;;5113620000;198953000;3755653000;5702751000;9657357000;14770977000;880995000;;1378703000;3824199000;4825580000;6204283000;4923676000;-2737585000;6640505000;8566694000;14770977000
BKNG;261036;USD;2013;Q4;2013-12-31;2013-11-07;51634000;53204000;6752714000;535962000;;7480941000;135053000;0;2828466000;2963519000;10444460000;792687000;;1381745000;1750580000;2152986000;3534731000;4593455000;-1987207000;4218752000;6909729000;10444460000
BKNG;261036;USD;2012;Q4;2012-12-31;2012-11-01;49870000;51546000;5183194000;367512000;;5682375000;89269000;;798098000;887367000;6569742000;572559000;;1461726000;936651000;1050754000;2512480000;2612647000;-1060607000;2368611000;4057262000;6569742000
BKNG;261036;USD;2011;Q4;2011-12-31;2011-11-07;49800000;51396000;2657663000;264453000;;3066844000;64322000;;839505000;903827000;3970671000;369001000;;1105798000;77360000;163533000;1269331000;2431725000;-803586000;1033738000;2701340000;3970671000
BKNG;261036;USD;2010;Q4;2010-12-31;2010-11-09;49150000;51684000;1662218000;162426000;;1957464000;39739000;;908750000;948489000;2905953000;334078000;;471168000;476268000;575698000;1046866000;2417530000;-640415000;69110000;1859087000;2905953000
BKNG;261036;USD;2009;Q4;2009-12-31;2010-08-04;44374000;51673000;800155000;118659000;;1022941000;30489000;;780794000;811283000;1834224000;188129000;;408765000;35985000;103830000;512595000;2290272000;-510970000;-454673000;1321629000;1834224000
BKNG;261036;USD;2018;Q4;2018-12-31;2019-02-27;46112000;46562000;6284000000;1523000000;;8407000000;656000000;8408000000;5216000000;14280000000;22687000000;2533000000;;3555000000;9815000000;10347000000;13902000000;5445000000;-14711000000;18367000000;8785000000;22687000000
BRCM;261267;USD;2014;Q4;2014-10-31;2015-01-29;598000000;620000000;3606000000;804000000;531000000;5072000000;516000000;2383000000;4500000000;7399000000;12471000000;1294000000;;1550000000;1593000000;1870000000;3420000000;12595000000;;-3455000000;9051000000;12471000000
BRCM;261267;USD;2013;Q4;2013-10-31;2014-01-30;577000000;595000000;2432000000;795000000;525000000;3915000000;593000000;1939000000;5048000000;7580000000;11495000000;1232000000;;1496000000;1394000000;1628000000;3124000000;12475000000;;-4107000000;8371000000;11495000000
BRCM;261267;USD;2012;Q4;2012-10-31;2013-01-30;568000000;580000000;2374000000;740000000;527000000;3781000000;485000000;1348000000;5594000000;7427000000;11208000000;1119000000;300000000;1682000000;1393000000;1687000000;3369000000;12403000000;;-4531000000;7839000000;11208000000
BRCM;261267;USD;2011;Q4;2011-10-31;2012-02-01;545000000;561000000;4529000000;678000000;421000000;5752000000;368000000;676000000;2244000000;3288000000;9040000000;903000000;0;1099000000;1196000000;1420000000;2519000000;11821000000;;-5250000000;6521000000;9040000000
BRCM;261267;USD;2010;Q4;2010-10-31;2011-02-02;527000000;571000000;2657000000;820000000;598000000;4184000000;266000000;1401000000;2093000000;3760000000;7944000000;1008000000;;1271000000;697000000;847000000;2118000000;11994000000;;-6177000000;5826000000;7944000000
BRCM;261267;USD;2009;Q4;2009-10-31;2010-02-03;495204000;532369000;1929374000;508627000;362428000;2914332000;229317000;438616000;1544977000;2212910000;5127242000;870647000;;1148350000;0;87046000;1235396000;11153060000;;-7259069000;3891846000;5127242000
BRCM;261267;USD;2008;Q4;2008-10-31;2009-10-22;498338000;503271000;1898122000;372311000;366106000;2751213000;234691000;0;1407361000;1642052000;4393265000;553214000;;717103000;;69095000;786198000;10930315000;;-7324330000;3607067000;4393265000
DIS;261356;USD;2016;Q4;2016-10-31;2016-11-23;1608000000;1614000000;4610000000;9065000000;1390000000;16966000000;27349000000;4280000000;43438000000;75067000000;92033000000;9130000000;3687000000;16842000000;16483000000;27868000000;44710000000;35859000000;-54703000000;66088000000;47323000000;92033000000
DIS;261356;USD;2015;Q4;2015-10-31;2015-11-25;1681000000;1693000000;4269000000;8019000000;1571000000;16758000000;25179000000;2643000000;43602000000;71424000000;88182000000;7844000000;4563000000;16334000000;12773000000;23193000000;39527000000;35122000000;-47204000000;59028000000;48655000000;88182000000
DIS;261356;USD;2014;Q4;2014-10-31;2014-11-19;1716000000;1734000000;3421000000;7822000000;1574000000;15169000000;23332000000;2696000000;42944000000;68972000000;84141000000;7595000000;2164000000;13292000000;12631000000;22671000000;35963000000;34301000000;-41109000000;53734000000;48178000000;84141000000
DIS;261356;USD;2013;Q4;2013-10-31;2013-11-20;1785000000;1806000000;3931000000;6967000000;1487000000;14109000000;22380000000;2849000000;41903000000;67132000000;81241000000;6803000000;1512000000;11704000000;12776000000;21387000000;33091000000;33440000000;-34582000000;47758000000;48150000000;81241000000
DIS;261356;USD;2012;Q4;2012-10-31;2012-11-21;1794000000;1818000000;3387000000;6540000000;1537000000;13709000000;21512000000;2723000000;36954000000;61189000000;74898000000;6393000000;3614000000;12813000000;10697000000;20127000000;32940000000;31731000000;-31671000000;42965000000;41958000000;74898000000
DIS;261356;USD;2011;Q4;2011-10-31;2011-11-23;1839000000;1863000000;3185000000;6182000000;1595000000;13757000000;19695000000;2435000000;36237000000;58367000000;72124000000;6362000000;3055000000;12088000000;10922000000;20583000000;32671000000;30296000000;-28656000000;38375000000;39453000000;72124000000
DIS;261356;USD;2010;Q4;2010-10-31;2010-11-24;1908000000;1938000000;2722000000;5784000000;1442000000;12225000000;17806000000;2513000000;36662000000;56981000000;69206000000;6109000000;2350000000;11000000000;10130000000;18864000000;29864000000;28736000000;-23663000000;34327000000;39342000000;69206000000
DIS;261356;USD;2009;Q4;2009-10-31;2009-12-02;1860000000;1886000000;3417000000;4854000000;1271000000;11889000000;17597000000;2554000000;31077000000;51228000000;63117000000;5616000000;1206000000;8934000000;11495000000;18758000000;27692000000;27038000000;-22693000000;31033000000;35425000000;63117000000
DIS;261356;USD;2008;Q4;2008-10-31;2009-07-30;1872000000;1903000000;3001000000;5373000000;1124000000;11666000000;17532000000;2249000000;31050000000;50831000000;62497000000;5980000000;3529000000;11591000000;11110000000;17239000000;28830000000;26546000000;-22555000000;28413000000;33667000000;62497000000
DIS;261356;USD;2017;Q4;2017-10-31;2017-11-22;1538000000;1546000000;4017000000;8633000000;1373000000;15889000000;28406000000;3202000000;48292000000;79900000000;95789000000;8855000000;6172000000;19595000000;19119000000;30042000000;49637000000;36248000000;-64011000000;72606000000;46152000000;95789000000
DIS;261356;USD;2018;Q4;2018-10-31;2018-11-21;1490000000;1499000000;4150000000;9334000000;1392000000;16825000000;29540000000;2899000000;49334000000;81773000000;98598000000;9479000000;3790000000;17860000000;17084000000;26783000000;44643000000;36779000000;-67588000000;82679000000;53955000000;98598000000
EMC;261451;USD;2015;Q4;2015-12-31;2016-02-25;1941000000;1957000000;9275000000;3977000000;1245000000;15063000000;3850000000;5508000000;22191000000;31549000000;46612000000;5376000000;1299000000;12885000000;5475000000;11008000000;23893000000;19000000;;21700000000;22719000000;46612000000
EMC;261451;USD;2014;Q4;2014-12-31;2015-02-27;2014000000;2039000000;8321000000;4413000000;1276000000;14663000000;3766000000;6334000000;20822000000;30922000000;45585000000;5689000000;0;11710000000;5469000000;10350000000;22060000000;20000000;;22242000000;23525000000;45585000000
IP;261549;USD;2017;Q4;2017-12-31;2018-02-22;412900000;421000000;1018000000;3287000000;2313000000;8277000000;13713000000;390000000;11523000000;25626000000;33903000000;3986000000;311000000;5102000000;17137000000;22260000000;27362000000;6655000000;-1680000000;6180000000;6541000000;33903000000
IP;261549;USD;2016;Q4;2016-12-31;2016-11-03;411200000;418400000;1033000000;2852000000;2233000000;6670000000;13459000000;360000000;12604000000;26423000000;33093000000;3669000000;239000000;4069000000;17359000000;24665000000;28734000000;6638000000;-1753000000;4818000000;4359000000;33093000000
IP;261549;USD;2015;Q4;2015-12-31;2015-11-05;413300000;419300000;1050000000;2675000000;2228000000;6477000000;12346000000;228000000;11480000000;24054000000;30531000000;3498000000;426000000;3924000000;15121000000;22698000000;26622000000;6692000000;-1749000000;4649000000;3909000000;30531000000
IP;261549;USD;2014;Q4;2014-12-31;2014-11-06;421000000;431700000;1881000000;3083000000;2424000000;7959000000;13235000000;248000000;7242000000;20725000000;28684000000;4167000000;742000000;4909000000;10681000000;18512000000;23421000000;6694000000;-1342000000;4409000000;5263000000;28684000000
IP;261549;USD;2013;Q4;2013-12-31;2013-11-06;434719000;441854600;1802000000;3756000000;2825000000;9025000000;14229000000;733000000;7541000000;22503000000;31528000000;4466000000;661000000;5127000000;10870000000;17954000000;23081000000;6910000000;-492000000;4446000000;8447000000;31528000000
IP;261549;USD;2012;Q4;2012-12-31;2012-11-07;418544000;425767600;1302000000;3562000000;2730000000;8905000000;14571000000;887000000;7790000000;23248000000;32153000000;4510000000;444000000;4998000000;11732000000;20519000000;25517000000;6482000000;0;3662000000;6636000000;32153000000
IP;261549;USD;2011;Q4;2011-12-31;2011-11-07;443827800;454779000;3994000000;3486000000;2320000000;10456000000;12477000000;657000000;3428000000;16562000000;27018000000;3976000000;719000000;4738000000;9189000000;15295000000;20033000000;6347000000;-52000000;3355000000;6985000000;27018000000
IP;261549;USD;2010;Q4;2010-12-31;2010-11-05;436729800;446971200;2073000000;3039000000;2347000000;8028000000;12749000000;1092000000;3499000000;17340000000;25368000000;4190000000;313000000;4503000000;8358000000;13781000000;18284000000;6268000000;-28000000;2416000000;7084000000;25368000000
IP;261549;USD;2009;Q4;2009-12-31;2010-02-25;432775200;440887200;1892000000;2695000000;2179000000;7551000000;13445000000;1077000000;3475000000;17997000000;25548000000;3708000000;304000000;4012000000;8729000000;15281000000;19293000000;6240000000;-89000000;1949000000;6255000000;25548000000
IP;261549;USD;2008;Q4;2008-12-31;2009-08-10;;417159600;1144000000;3288000000;2495000000;7360000000;14796000000;1274000000;3483000000;19553000000;26913000000;3927000000;828000000;4755000000;11246000000;17757000000;22512000000;6279000000;-218000000;1430000000;4401000000;26913000000
IP;261549;USD;2018;Q4;2018-12-31;2019-02-20;402300000;409500000;589000000;3521000000;2241000000;6996000000;13469000000;1648000000;11463000000;26580000000;33576000000;4055000000;639000000;4694000000;16313000000;21499000000;26193000000;6729000000;-2332000000;7465000000;7383000000;33576000000
HD;261673;USD;2017;Q4;2018-02-28;2017-03-23;1210000000;1215000000;3595000000;1952000000;12748000000;18933000000;22075000000;;3521000000;25596000000;44529000000;11628000000;2761000000;16194000000;24267000000;26881000000;43075000000;10281000000;-48196000000;39935000000;1454000000;44529000000
HD;261673;USD;2016;Q4;2017-02-28;2016-03-24;1259000000;1264000000;2538000000;2029000000;12549000000;17724000000;21914000000;;3328000000;25242000000;42966000000;11212000000;1252000000;14133000000;22349000000;24500000000;38633000000;9875000000;-40194000000;35519000000;4333000000;42966000000
HD;261673;USD;2015;Q4;2016-02-29;2015-05-27;1312000000;1321000000;1723000000;1484000000;11079000000;15302000000;22720000000;;1924000000;24644000000;39946000000;9473000000;328000000;11269000000;16869000000;19355000000;30624000000;8973000000;-26194000000;26995000000;9322000000;39946000000
HD;261673;USD;2014;Q4;2015-02-28;2015-03-26;;;1723000000;1484000000;11079000000;15302000000;22720000000;;1924000000;24644000000;39946000000;9473000000;328000000;11269000000;16869000000;19355000000;30624000000;8973000000;-26194000000;26995000000;9322000000;39946000000
HD;261673;USD;2013;Q4;2014-02-28;2014-03-27;;;1929000000;1398000000;11057000000;15279000000;23348000000;;1891000000;25239000000;40518000000;9379000000;33000000;10749000000;14691000000;17247000000;27996000000;8490000000;-19194000000;23180000000;12522000000;40518000000
HD;261673;USD;2012;Q4;2013-02-28;2012-03-22;1486000000;1503000000;2494000000;1395000000;10710000000;15372000000;24069000000;;1643000000;25712000000;41084000000;8871000000;1321000000;11462000000;9475000000;11845000000;23307000000;8036000000;-10694000000;20038000000;17777000000;41084000000
HD;261673;USD;2011;Q4;2012-02-29;2011-03-24;1541000000;1544000000;1987000000;1245000000;10325000000;14520000000;24448000000;;1550000000;25998000000;40518000000;8199000000;30000000;9376000000;10758000000;13244000000;22620000000;7053000000;-6694000000;17246000000;17898000000;40518000000
HD;261673;USD;2010;Q4;2011-02-28;2010-03-25;1544000000;1559000000;1421000000;964000000;10188000000;13900000000;25550000000;;1427000000;26977000000;40877000000;8185000000;1020000000;10363000000;8662000000;11121000000;21484000000;6390000000;-585000000;13226000000;19393000000;40877000000
HD;261673;USD;2009;Q4;2010-02-28;2009-09-03;1685000000;1686000000;525000000;972000000;10673000000;13362000000;26234000000;;1568000000;27802000000;41164000000;8221000000;1767000000;11153000000;9667000000;12234000000;23387000000;6133000000;-372000000;12093000000;17777000000;41164000000
HD;261673;USD;2018;Q4;2019-02-28;2019-03-28;1032000000;1038000000;1778000000;1936000000;13925000000;18529000000;22375000000;;3099000000;25474000000;44003000000;12539000000;2395000000;16716000000;26807000000;29165000000;45881000000;10667000000;-58196000000;46423000000;-1878000000;44003000000
PFE;262090;USD;2015;Q4;2015-12-31;2016-02-29;6174000000;6250000000;23290000000;8176000000;7513000000;43804000000;13766000000;15999000000;93812000000;123577000000;167381000000;8249000000;10159000000;29398000000;28740000000;72985000000;102383000000;81475000000;-79252000000;71993000000;64998000000;167381000000
PFE;262090;USD;2014;Q4;2014-12-31;2015-02-27;6297000000;6373000000;36122000000;8401000000;5663000000;55595000000;11762000000;17518000000;82692000000;111972000000;167567000000;7293000000;5141000000;21587000000;31541000000;74358000000;95945000000;79432000000;-73021000000;72176000000;71621000000;167566000000
PFE;262090;USD;2013;Q4;2013-12-31;2014-02-28;6442000000;6538000000;32408000000;9357000000;6166000000;56244000000;12397000000;16406000000;87054000000;115857000000;172101000000;7367000000;6027000000;23366000000;30462000000;72115000000;95481000000;77736000000;-67923000000;69732000000;76620000000;172101000000
PFE;262090;USD;2012;Q4;2012-12-31;2013-02-28;7319000000;7389000000;32399000000;10675000000;6076000000;64831000000;13213000000;14149000000;93605000000;120967000000;185798000000;7508000000;6424000000;29186000000;31036000000;74934000000;104120000000;73056000000;-40122000000;54240000000;81678000000;185798000000
PFE;262090;USD;2011;Q4;2011-12-31;2012-02-28;7641000000;7700000000;26452000000;13058000000;6610000000;60817000000;15921000000;9814000000;101450000000;127185000000;188002000000;8603000000;4016000000;28909000000;34926000000;76472000000;105381000000;71868000000;-31801000000;46210000000;82621000000;188002000000
PFE;262090;USD;2010;Q4;2010-12-31;2011-02-28;8010000000;8066000000;28012000000;13380000000;8275000000;61013000000;18645000000;9747000000;105609000000;134001000000;195014000000;8626000000;5603000000;28636000000;38410000000;78113000000;106749000000;71204000000;-22712000000;42716000000;88265000000;195014000000
PFE;262090;USD;2009;Q4;2009-12-31;2010-02-26;7847000000;7913000000;25969000000;14645000000;12403000000;61670000000;22780000000;13122000000;115377000000;151279000000;212949000000;18173000000;5469000000;37225000000;43193000000;85278000000;122503000000;70940000000;-21632000000;40426000000;90446000000;212949000000
PFE;262090;USD;2008;Q4;2008-12-31;2009-08-06;6718000000;6750000000;23731000000;8958000000;4381000000;43076000000;13287000000;11478000000;43307000000;68072000000;111148000000;6233000000;9320000000;27009000000;7963000000;26399000000;53408000000;70726000000;-57391000000;49142000000;57740000000;111148000000
PFE;262090;USD;2016;Q4;2016-12-31;2017-02-23;6072000000;6147000000;17850000000;8225000000;6783000000;38949000000;13318000000;7116000000;112232000000;132666000000;171615000000;9404000000;10688000000;31115000000;31398000000;80660000000;111775000000;83146000000;-84364000000;71774000000;59840000000;171615000000
PFE;262090;USD;2017;Q4;2017-12-31;2018-02-22;5965000000;6062000000;19992000000;8221000000;7578000000;41142000000;13865000000;7015000000;109775000000;130655000000;171797000000;9358000000;9953000000;30426000000;33538000000;69714000000;100140000000;84742000000;-89425000000;85291000000;71656000000;171796000000
PFE;262090;USD;2018;Q4;2018-12-31;2019-02-28;5790000000;5913000000;18833000000;8025000000;7508000000;49926000000;13385000000;2767000000;93345000000;109497000000;159423000000;10383000000;8831000000;31857000000;32909000000;63806000000;95663000000;86720000000;-101610000000;89554000000;63759000000;159422000000
MRK;262201;USD;2016;Q4;2016-12-31;2017-02-28;2757000000;2778000000;14341000000;7018000000;4866000000;30614000000;12026000000;11416000000;41321000000;64763000000;95377000000;6362000000;568000000;17204000000;24274000000;37865000000;55069000000;41727000000;-40546000000;44133000000;40308000000;95377000000
MRK;262201;USD;2015;Q4;2015-12-31;2016-02-26;2789000000;2813000000;13427000000;6484000000;4700000000;29751000000;12507000000;13039000000;46380000000;71926000000;101677000000;5402000000;2583000000;19201000000;23829000000;37709000000;56910000000;42010000000;-38534000000;45348000000;44767000000;101677000000
MRK;262201;USD;2014;Q4;2014-12-31;2015-02-27;2846000000;2881000000;15719000000;6626000000;5571000000;32605000000;13136000000;13515000000;38911000000;65562000000;98167000000;5170000000;2704000000;18397000000;18699000000;30979000000;49376000000;42211000000;-35262000000;46021000000;48791000000;98167000000
MRK;262201;USD;2013;Q4;2013-12-31;2014-02-27;2926000000;2961000000;17486000000;7184000000;6226000000;35685000000;14973000000;9770000000;45217000000;69960000000;105645000000;3846000000;4521000000;17868000000;20539000000;35451000000;53319000000;42296000000;-29591000000;39257000000;52326000000;105645000000
MRK;262201;USD;2012;Q4;2012-12-31;2013-02-28;3035000000;3079000000;16141000000;7672000000;6535000000;34857000000;16030000000;7305000000;47940000000;71275000000;106132000000;4296000000;4315000000;18348000000;16254000000;32321000000;50669000000;42434000000;-24717000000;39985000000;55463000000;106132000000
MRK;262201;USD;2011;Q4;2011-12-31;2012-02-28;3044000000;3071000000;14972000000;8261000000;6254000000;33181000000;16297000000;3458000000;52192000000;71947000000;105128000000;4085000000;1990000000;16245000000;15525000000;31940000000;48185000000;42451000000;-23792000000;38990000000;56943000000;105128000000
MRK;262201;USD;2010;Q4;2010-12-31;2011-02-28;-9296987620;-9367987520;12201000000;7344000000;5868000000;29064000000;17082000000;2175000000;57460000000;76717000000;105781000000;4727000000;2400000000;15641000000;15482000000;33335000000;48976000000;42489000000;-22433000000;37536000000;56805000000;105781000000
MRK;262201;USD;2009;Q4;2009-12-31;2010-03-01;2746500000;2760200000;9604000000;6603000000;8048000000;28432000000;18279000000;432000000;65171000000;83882000000;112314000000;4600000000;1379000000;15434000000;16095000000;35188000000;50622000000;41464000000;-21044000000;41405000000;61692000000;112314000000
MRK;262201;USD;2008;Q4;2008-12-31;2009-10-29;;;5486400000;2907700000;2091000000;19112600000;11999600000;6491300000;9592200000;28083100000;47195700000;2847500000;2297100000;14318700000;3943300000;11709900000;26028600000;8348900000;-30735500000;43698800000;21167100000;47195700000
MRK;262201;USD;2017;Q4;2017-12-31;2018-02-27;2714000000;2747000000;8498000000;6873000000;5096000000;24766000000;12439000000;12125000000;38542000000;63106000000;87872000000;5130000000;3057000000;18614000000;21353000000;34689000000;53303000000;41690000000;-43794000000;41350000000;34569000000;87872000000
MRK;262201;USD;2018;Q4;2018-12-31;2019-02-27;2616000000;2632000000;8864000000;7071000000;5440000000;25875000000;13291000000;6233000000;37238000000;56762000000;82637000000;6747000000;5308000000;22206000000;19806000000;33549000000;55755000000;40596000000;-50929000000;42579000000;26882000000;82637000000
CA;262416;USD;2016;Q4;2017-03-31;2016-05-12;412000000;412000000;2771000000;764000000;;3733000000;237000000;;8640000000;8877000000;12610000000;673000000;18000000;3006000000;2773000000;3915000000;6921000000;3761000000;-4512000000;6923000000;5689000000;12610000000
CA;262416;USD;2015;Q4;2016-03-31;2016-05-12;436000000;441000000;2812000000;625000000;;3561000000;242000000;;7401000000;7643000000;11204000000;634000000;6000000;2894000000;1947000000;2932000000;5826000000;3723000000;-4504000000;6575000000;5378000000;11204000000
CA;262416;USD;2014;Q4;2015-03-31;2015-05-08;440000000;443000000;2804000000;652000000;;3986000000;252000000;;6735000000;6987000000;10973000000;752000000;10000000;2938000000;1247000000;2410000000;5348000000;3690000000;-3868000000;6221000000;5625000000;10973000000
CA;262416;USD;2013;Q4;2014-03-31;2014-05-19;449000000;449000000;3252000000;800000000;;4559000000;295000000;;7162000000;7457000000;12016000000;914000000;514000000;3922000000;1252000000;2524000000;6446000000;3669000000;-3746000000;5818000000;5570000000;12016000000
CA;262416;USD;2012;Q4;2013-03-31;2013-05-09;468000000;469000000;2776000000;856000000;;4126000000;311000000;;7378000000;7689000000;11815000000;820000000;16000000;3541000000;1274000000;2824000000;6365000000;3652000000;-3404000000;5357000000;5450000000;11815000000
CA;262416;USD;2011;Q4;2012-03-31;2012-05-11;502000000;503000000;2679000000;902000000;;3965000000;386000000;;7646000000;8032000000;11997000000;889000000;14000000;3751000000;1287000000;2849000000;6600000000;3550000000;-2910000000;4865000000;5397000000;11997000000
CA;262416;USD;2010;Q4;2011-03-31;2011-05-16;511000000;515000000;3124000000;849000000;;4369000000;437000000;104000000;7501000000;8042000000;12411000000;788000000;269000000;3921000000;1282000000;2870000000;6791000000;3674000000;-2095000000;4106000000;5620000000;12411000000
CA;262416;USD;2009;Q4;2010-03-31;2010-05-14;508000000;532000000;2583000000;931000000;;3990000000;452000000;46000000;7400000000;7898000000;11888000000;898000000;15000000;3581000000;1530000000;3320000000;6901000000;3716000000;-1964000000;3361000000;4987000000;11888000000
CA;262416;USD;2008;Q4;2009-03-31;2009-10-23;517000000;449000000;2712000000;839000000;;4149000000;442000000;128000000;6522000000;7092000000;11241000000;766000000;621000000;4002000000;1287000000;2877000000;6879000000;3745000000;-1873000000;2673000000;4362000000;11241000000
CA;262416;USD;2017;Q4;2018-03-31;2018-05-09;415000000;416000000;3405000000;793000000;;4408000000;237000000;;8415000000;8652000000;13060000000;667000000;269000000;3321000000;2514000000;3844000000;7165000000;3803000000;-4589000000;6971000000;5895000000;13060000000
AHPI;262963;USD;2016;Q4;2016-06-30;2016-09-23;2006787;2006787;1703663;4094462;8875270;14941661;6747570;;1506450;8254020;23195681;4205806;;4923226;;0;4923226;48535038;-20980788;;18272455;23195681
AHPI;262963;USD;2015;Q4;2015-06-30;2015-09-25;2006787;2006787;2039946;3574674;9190911;15146774;7821206;;2021487;9842693;24989467;3528363;;4296270;;0;4296270;48650949;-20980788;;20693197;24989467
AHPI;262963;USD;2014;Q4;2014-06-30;2014-09-26;2006787;2006787;1366762;3713105;9406098;14913229;8935601;;2183597;11119198;26032427;2692408;;3523354;;0;3523354;48689515;-20980788;;22509073;26032427
AHPI;262963;USD;2013;Q4;2013-06-30;2013-09-27;2007131;2007131;3687919;4221970;9338343;17705976;9722344;;1910411;11632755;29338731;3178443;;4023982;;0;4023982;48689278;-20980788;;25314749;29338731
AHPI;262963;USD;2012;Q4;2012-06-30;2012-09-28;2031097;2030985;5284543;4973593;10001226;20706081;9603556;;1167432;10770988;31477069;3782723;;4700384;;0;4700384;48645081;-20731428;;26776685;31477069
AHPI;262963;USD;2011;Q4;2011-06-30;2011-11-08;2031081;2034176;6512887;5366860;10553289;22742359;8660507;;362480;9022987;31765346;3290462;;4491234;;114700;4605934;48603382;-20731428;;27159412;31765346
AHPI;262963;USD;2017;Q4;2017-06-30;2017-09-28;4013537;4013537;995704;3362438;8511954;13198329;5734041;;704279;6438320;19636649;3450369;;3450369;;0;3450369;48537529;-20980788;;16186280;19636649
AHPI;262963;USD;2018;Q4;2018-06-30;2018-09-28;4013537;4013537;136112;3747993;7830541;11977429;4823149;;520663;5343812;17321241;3324301;;3324301;;0;3324301;48540359;-20980788;;13996940;17321241
TBTC;263057;USD;2015;Q4;2015-12-31;2016-03-30;4519363;4519363;289105;2494930;656137;3596453;54534;1569285;1622424;3246243;6842696;413235;7096;1284585;26215;2916682;4201267;1811060;-123542;953911;2641429;6842696
TBTC;263057;USD;2014;Q4;2014-12-31;2015-03-30;4771354;4771354;1208201;2224576;893743;4441737;2138;675683;366819;1044640;5486377;327319;0;1193967;0;1090746;2284713;1849904;-1422;1353182;3201664;5486377
TBTC;263057;USD;2013;Q4;2013-12-31;2014-03-26;4768576;4768576;1038288;3240412;474778;4985762;10953;904410;457626;1372989;6358751;567051;8180;1613227;;1536862;3150089;1890192;-1422;1319892;3208662;6358751
TBTC;263057;USD;2012;Q4;2012-12-31;2013-03-28;4748009;4748009;609690;2946468;194652;3966490;27744;732376;419483;1179603;5146093;359018;10907;1062396;8180;1465973;2528369;1879617;-1422;739529;2617724;5146093
TBTC;263057;USD;2011;Q4;2011-12-31;2012-03-29;4706125;4706125;834665;1982237;150593;3122018;54606;1062709;344402;1461717;4583735;135456;10907;799269;19087;1247716;2046985;1823317;-1422;714855;2536750;4583735
TBTC;263057;USD;2010;Q4;2010-12-31;2011-08-15;4495585;4495585;935301;1699201;151254;3189590;41641;260430;89735;391806;3581396;93648;0;758189;0;0;758189;1686817;-1422;1137812;2823207;3581396
TBTC;263057;USD;2016;Q4;2016-12-31;2017-03-29;4506335;4506335;102689;2807323;843233;4080246;33426;1421330;1445792;2900548;6980794;473336;7096;1453192;18096;2763177;4216369;1814023;-146360;1096762;2764425;6980794
TBTC;263057;USD;2017;Q4;2017-12-31;2018-03-30;4511965;4511965;1322743;3053280;466207;5306615;71786;1515120;967092;2553998;7860613;635112;;1199365;;3313772;4513137;1814023;-146360;1679813;3347476;7860613
TBTC;263057;USD;2018;Q4;2018-12-31;2019-03-28;4470573;4486453;1290797;2866474;762165;5211273;86656;1030354;528401;1645411;6856684;440895;2221;1367288;;1690660;3057948;1800484;-196526;2194778;3798736;6856684
HGEN;263238;USD;2016;Q4;2016-12-31;2017-03-09;14940313;14940313;2906000;;;4549000;68000;;101000;169000;4718000;4808000;;7824000;1273000;1273000;9097000;236231000;;-240610000;-4379000;4718000
HGEN;263238;USD;2015;Q4;2015-12-31;2016-09-01;4127729;4127729;8431000;;;10394000;288000;;464000;752000;11146000;0;;0;0;5414000;5414000;219323000;;-213591000;5732000;11146000
HGEN;263238;USD;2014;Q4;2014-12-31;2014-11-06;3628733;3628733;40713000;;;42245000;414000;;318000;732000;42977000;7020000;10928000;18053000;;311000;18364000;202834000;;-178213000;24613000;42977000
HGEN;263238;USD;2013;Q4;2013-12-31;2013-11-12;4292689;4292689;76731000;;;77722000;276000;;706000;982000;78704000;8040000;3182000;11382000;6786000;6786000;18168000;200748000;;-140215000;60536000;78704000
HGEN;263238;USD;2012;Q4;2012-12-31;2012-11-09;282530;282530;20298000;;;21256000;230000;;3053000;3283000;24539000;7116000;;7217000;9826000;112266000;119483000;3319000;;-98267000;-94944000;24539000
HGEN;263238;USD;2011;Q4;2011-12-31;2012-10-11;-1663689;-1663689;17847000;;;18604000;427000;;316000;743000;19347000;2425000;;8108000;;83584000;91692000;2414000;;-74758000;-72345000;19347000
MTN;264322;USD;2016;Q4;2016-07-31;2016-09-26;36170000;38253000;67897000;147113000;74589000;322865000;1363814000;;795339000;2159153000;2482018000;493127000;13354000;506481000;686909000;1087071000;1593552000;636402000;-246979000;486667000;888466000;2482018000
MTN;264322;USD;2015;Q4;2015-07-31;2015-09-28;36436000;38555000;35459000;113990000;73485000;288143000;1386275000;;812874000;2199149000;2487292000;388493000;10154000;398647000;804347000;1208059000;1606706000;623925000;-193192000;440748000;880586000;2487292000
MTN;264322;USD;2014;Q4;2014-07-31;2014-09-24;36193000;38028000;44406000;95977000;67183000;275046000;1147990000;;750813000;1898803000;2173849000;323184000;1022000;324206000;625600000;1014843000;1339049000;612734000;-193192000;401500000;834800000;2173849000
MTN;264322;USD;2013;Q4;2013-07-31;2013-09-27;35930000;37795000;138604000;79037000;68318000;343469000;1169288000;;795540000;1964828000;2308297000;312341000;994000;313335000;795928000;1157093000;1470428000;599084000;-193192000;418043000;837869000;2308297000
MTN;264322;USD;2012;Q4;2012-07-31;2012-09-25;35913000;37271000;46053000;65743000;65873000;232370000;1049207000;;646037000;1695244000;1927614000;248259000;990000;249249000;489775000;862037000;1111286000;587096000;-193192000;408662000;816328000;1927614000
MTN;264322;USD;2011;Q4;2011-07-31;2011-09-22;36069000;37411000;70143000;58529000;54007000;245624000;1021736000;;678876000;1700612000;1946236000;242137000;1045000;243182000;490698000;859335000;1102517000;576092000;-162827000;416458000;843719000;1946236000
MTN;264322;USD;2010;Q4;2010-07-31;2010-12-07;;;14745000;53622000;48295000;170745000;1027390000;;724674000;1752064000;1922809000;288055000;1869000;289924000;524842000;830498000;1120422000;564217000;-162827000;387380000;802387000;1922809000
MTN;264322;USD;2017;Q4;2017-07-31;2017-09-28;40052000;42342000;117389000;186913000;84814000;433070000;1714154000;;1963494000;3677648000;4110718000;566160000;38397000;604557000;1234024000;1707203000;2311760000;1222964000;-247189000;550985000;1798958000;4110718000
MTN;264322;USD;2018;Q4;2018-07-31;2018-09-28;40464000;43122000;178145000;230829000;85588000;538736000;1627219000;;1899029000;3526248000;4064984000;555165000;38455000;593620000;1234277000;1659702000;2253322000;1137927000;-272989000;726722000;1811662000;4064984000
MTN;264322;USD;2019;Q4;2019-07-31;2019-09-26;40308000;41981000;108850000;270896000;96539000;527940000;1842500000;;2055637000;3898137000;4426077000;670617000;48516000;719133000;1527744000;1980105000;2699238000;1130544000;-357989000;759801000;1726839000;4426077000
MAMS;265007;USD;2016;Q4;2016-06-30;2016-09-26;11528479;11693910;491000;4627000;221000;7369000;581000;;14495000;15076000;22445000;5368000;1925000;8232000;7853000;9194000;17426000;16163000;-2374000;-5785000;5019000;22445000
MAMS;265007;USD;2015;Q4;2015-06-30;2015-09-24;13125607;13178640;6793000;4243000;185000;12943000;732000;;12246000;12978000;25921000;6555000;0;7274000;0;250000;7524000;31188000;-2213000;-9337000;18397000;25921000
MAMS;265007;USD;2014;Q4;2014-06-30;2014-09-23;13567303;13590965;7008000;3857000;211000;12581000;692000;;11472000;12164000;24745000;6149000;;6982000;;488000;7470000;31428000;-1746000;-12342000;17275000;24745000
MAMS;265007;USD;2013;Q4;2013-06-30;2013-09-25;12644464;12570181;4061000;3511000;199000;9747000;689000;;10905000;11594000;21341000;5191000;312000;6245000;;474000;6719000;31550000;-1746000;-14014000;14622000;21341000
MAMS;265007;USD;2012;Q4;2012-06-30;2012-09-14;13510814;13821450;3628000;3507000;358000;8450000;664000;;11670000;12334000;20784000;5194000;759000;6776000;283000;867000;7643000;33455000;-2357000;-17027000;13141000;20784000
MAMS;265007;USD;2011;Q4;2011-06-30;2011-11-14;14093977;14428003;2770000;3340000;293000;7135000;776000;;12859000;13635000;20770000;5564000;1086000;7760000;776000;1537000;9297000;33157000;0;-21123000;11473000;20770000
MAMS;265007;USD;2017;Q4;2017-06-30;2017-09-28;11774000;11706000;1260000;4644000;154000;7715000;511000;;18426000;18937000;26652000;5343000;1734000;8554000;6386000;8423000;16977000;14181000;-16000;-1207000;9675000;26652000
MAMS;265007;USD;2018;Q4;2018-06-30;2018-09-14;11920000;11762000;4171000;5010000;170000;10621000;480000;;19533000;20013000;30634000;6244000;1811000;9940000;4581000;7174000;17114000;14769000;-16000;2003000;13520000;30634000
KANP;275886;USD;2017;Q4;2017-12-31;2018-03-29;1845000;1845000;30565000;;;31157000;64283000;;17468000;81751000;112908000;528000;;15413000;;11007000;26420000;5471000;;81754000;86488000;112908000
KANP;275886;USD;2016;Q4;2016-12-31;2017-03-31;1845000;1845000;21049000;;;21598000;71170000;;16419000;87589000;109187000;382000;;15593000;;17558000;33151000;5471000;;71094000;76036000;109187000
KANP;275886;USD;2015;Q4;2015-12-31;2016-08-08;1845000;1845000;22112000;;;22561000;75214000;;21602000;96816000;119377000;566000;;16549000;;19402000;35951000;5471000;;87817000;83426000;119377000
KANP;275886;USD;2014;Q4;2014-12-31;2016-04-11;1845000;1845000;23608000;;;24300000;77977000;;23846000;101823000;126123000;382000;;17671000;;19643000;37314000;5471000;;91430000;88809000;126123000
KANP;275886;USD;2013;Q4;2013-12-31;2015-12-29;1845000;1845000;13140000;;;14012000;90792000;;26815000;117607000;131619000;399000;;17067000;;21612000;38679000;5471000;;93191000;92940000;131619000
KANP;275886;USD;2012;Q4;2012-12-31;2013-03-27;;;14270000;;;14270000;95535000;;17084000;112619000;126889000;557000;;17779000;;18933000;36712000;5471000;;95795000;90177000;126889000
KANP;275886;USD;2011;Q4;2011-12-31;2012-03-29;;;19415;;;19415;96442;;16925;113367;132782;1406;;23970;;18275;42245;5471;;96213;90537;132782
KANP;275886;USD;2010;Q4;2010-12-31;2011-08-12;;;21733;112;;21845;98029;;24823;122852;144697;913;;23201;;19383;42584;5471;;103016;102113;144697
KANP;275886;USD;2018;Q4;2018-12-31;2019-03-28;1845000;1845000;28745000;;;29408000;61758000;;17740000;79498000;108906000;565000;;15190000;;10162000;25352000;5471000;;78792000;83554000;108906000
LCUT;276271;USD;2015;Q4;2015-12-31;2016-03-14;13905000;15174000;7131000;90576000;136890000;243380000;24877000;;130695000;155572000;398952000;71463000;252000;91715000;80617000;107769000;199484000;165920000;;47733000;199468000;398952000
LCUT;276271;USD;2014;Q4;2014-12-31;2015-03-16;13700000;15520000;5068000;107211000;137924000;258117000;26801000;;136484000;163285000;421402000;70811000;765000;83869000;127655000;149300000;233169000;160452000;;37703000;188233000;421402000
LCUT;276271;USD;2013;Q4;2013-12-31;2014-03-17;12752000;13557000;4947000;87217000;112791000;210736000;27698000;;98305000;126003000;336739000;65557000;;69494000;65919000;86340000;155834000;146401000;;38224000;180905000;336739000
LCUT;276271;USD;2012;Q4;2012-12-31;2013-03-15;12597000;12898000;1871000;97369000;104584000;209217000;31646000;;107934000;139580000;348797000;55524000;7000000;66899000;84593000;109668000;176567000;142617000;;33849000;172230000;348797000
LCUT;276271;USD;2011;Q4;2011-12-31;2012-03-09;12287000;12625000;2972000;77749000;110337000;196322000;34324000;;88099000;122423000;318745000;54962000;15000000;69962000;82625000;102608000;172570000;137591000;;14465000;146175000;318745000
LCUT;276271;USD;2010;Q4;2010-12-31;2011-08-08;;;3351000;72795000;99935000;181129000;36093000;;60364000;96457000;277586000;56412000;4100000;60512000;73557000;89468000;149980000;131471000;;1312000;127606000;277586000
LCUT;276271;USD;2016;Q4;2016-12-31;2017-03-16;14312000;15447000;7883000;104556000;135212000;256447000;21131000;;122276000;143407000;399854000;81830000;113000;91286000;86201000;110840000;202126000;173746000;;60981000;197728000;399854000
LCUT;276271;USD;2017;Q4;2017-12-31;2018-03-16;14596000;15925000;7600000;108033000;132436000;258423000;23065000;;120033000;143098000;401521000;71446000;69000;71515000;94744000;119727000;191242000;179058000;;60546000;210279000;401521000
LCUT;276271;USD;2018;Q4;2018-12-31;2019-03-14;20523000;20399000;7647000;125292000;173601000;318804000;25762000;;364006000;389768000;708572000;83623000;;84876000;304774000;344203000;429079000;258845000;;55264000;279493000;708572000
FEYE;276492;USD;2015;Q4;2015-12-31;2016-02-26;156185000;156185000;1169877000;172752000;13747000;1387259000;78368000;;975846000;1054214000;2441473000;152764000;;457933000;706198000;939168000;1397101000;2403104000;-150000000;-1206507000;1044372000;2441473000
FEYE;276492;USD;2014;Q4;2014-12-31;2015-03-02;147910000;147910000;402208000;193182000;7952000;657137000;82298000;;1019446000;1101744000;1758881000;123204000;;327081000;0;180972000;508053000;1918561000;0;-667292000;1250828000;1758881000
FEYE;276492;USD;2013;Q4;2013-12-31;2014-03-03;115610000;115610000;173918000;95772000;5663000;315167000;64765000;;996381000;1061146000;1376313000;93430000;;203965000;;124246000;328211000;1271604000;;-223502000;1048102000;1376313000
FEYE;276492;USD;2012;Q4;2012-12-31;2013-11-14;13803000;13803000;60200000;30133000;2340000;104241000;13536000;;7496000;21032000;125273000;25098000;1231000;72080000;10916000;47803000;119883000;109254000;;-102867000;5390000;125273000
FEYE;276492;USD;2016;Q4;2016-12-31;2017-02-24;167290000;167290000;935725000;121150000;5955000;1087911000;61852000;;1233202000;1295054000;2382965000;139270000;;536388000;741980000;1005465000;1541853000;2682926000;-150000000;-1690072000;841112000;2382965000
FEYE;276492;USD;2017;Q4;2017-12-31;2018-02-23;182415000;182415000;896802000;146317000;5746000;1142664000;71357000;;1244816000;1316173000;2458837000;114841000;;661456000;779578000;1165165000;1826621000;2891460000;-150000000;-2106363000;632216000;2458837000
FEYE;276492;USD;2018;Q4;2018-12-31;2019-02-25;194701000;194701000;1116520000;157817000;6548000;1381180000;89163000;;1225735000;1314898000;2696078000;120549000;;677364000;962577000;1368320000;2045684000;3152179000;-150000000;-2349486000;650394000;2696078000
EGLT;286194;USD;2017;Q4;2017-12-31;2018-03-16;43563130;43563130;91043000;4120000;3225000;101953000;9911000;;7994000;17905000;119858000;26264000;1081000;42967000;98890000;116266000;159233000;254917000;;-295300000;-39375000;119858000
EGLT;286194;USD;2016;Q4;2016-12-31;2016-11-08;24618032;24618032;86826000;1108000;1700000;93172000;12709000;;8977000;21686000;114858000;20539000;381000;24895000;83711000;84637000;109532000;230404000;;-225178000;5326000;114858000
EGLT;286194;USD;2015;Q4;2015-12-31;2015-11-06;24463548;24463548;145707000;295000;1837000;150238000;7801000;;14377000;22178000;172416000;15216000;3320000;28664000;52442000;54530000;83194000;223809000;;-134546000;89222000;172416000
EGLT;286194;USD;2014;Q4;2014-12-31;2014-11-14;16495415;16495415;52738000;;;55126000;4417000;;1027000;5444000;60570000;6763000;;7429000;;8880000;16309000;121045000;;-76613000;44261000;60570000
EGLT;286194;USD;2013;Q4;2013-12-31;2014-06-11;1292307;1292307;15700000;;;17743000;2378000;;242000;2620000;20363000;2801000;;20622000;;24571000;45193000;7444000;;-33399000;-24830000;20363000
EGLT;286194;USD;2018;Q4;2018-12-31;2019-03-29;55301864;55301864;40311000;8006000;2639000;54517000;1059000;;6357000;7416000;61933000;33145000;;33145000;;140148000;173293000;276624000;;-388853000;-111360000;61933000
DYNT;286288;USD;2018;Q4;2018-06-30;2018-09-27;8044329;8044069;1696116;7810846;10987855;21421791;5850899;;14781244;20632143;42053934;6172668;1920690;14585245;5680441;6091907;20677152;20225107;;-10490141;21376782;42053934
DYNT;286288;USD;2017;Q4;2017-06-30;2017-09-27;3864660;3864660;254705;5281348;7397682;13470923;4973477;;7619477;12592954;26063877;4472613;790818;7637366;5979536;6102121;13739487;11838022;;-8014927;12324390;26063877
DYNT;286288;USD;2016;Q4;2016-06-30;2016-09-28;2780993;2780993;966183;3523731;4997254;9754849;4777565;;740284;5517849;15272698;3310712;471033;3934350;5665187;5750338;9684688;7545880;;-5666022;5588010;15272698
DYNT;286288;USD;2015;Q4;2015-06-30;2015-09-29;2521725;2518642;3925967;3346770;5421787;13313009;5025076;;814145;5839221;19152230;3062966;445689;5571759;6096865;6274143;11845902;6969700;;-3391470;7306328;19152230
DYNT;286288;USD;2014;Q4;2014-06-30;2014-09-29;2520373;2518035;332800;3165396;6157848;10378927;2980677;;935540;3916217;14295144;3050096;302274;7031332;1255133;1255133;8286465;7149812;;-1141133;6008679;14295144
DYNT;286288;USD;2013;Q4;2013-06-30;2013-09-30;2519317;2518797;302050;3246712;6407553;10879449;3324947;;900191;4225138;15104587;3336750;322573;7333861;1561776;1561776;8895637;7078941;;-869991;6208950;15104587
DYNT;286288;USD;2012;Q4;2012-06-30;2012-09-28;2538359;2530434;278263;3667086;6098597;10654158;3677898;;938874;4616772;15270930;3014648;395055;7088300;1916315;1916315;9004615;7091935;;-825620;6266315;15270930
DYNT;286288;USD;2011;Q4;2011-06-30;2011-11-14;2603654;2620921;384904;3672128;5647815;10432811;3722749;;663621;4386370;14819181;2742763;368135;5880080;2238417;2323942;8204022;7417244;;-802085;6615159;14819181
FKWL;286530;USD;2017;Q4;2017-06-30;2017-09-28;10519714;10373481;14285001;10993191;3379065;28910753;219942;;3181318;3401260;32312013;13150906;;13202903;;0;13202903;7389244;-4513479;15846022;19109110;32312013
FKWL;286530;USD;2016;Q4;2016-06-30;2016-09-28;10199603;10624685;13156754;12341419;2285254;27876383;317764;;3554982;3872746;31749129;13523427;;13525328;;0;13525328;7309424;-4513479;14972062;18223801;31749129
FKWL;286530;USD;2015;Q4;2015-06-30;2015-09-28;10533869;10587174;11822620;5464182;2281667;21097203;314492;;3305772;3620264;24717467;7600694;148295;8442306;;0;8442306;7319573;-4279479;13361091;16275161;24717467
FKWL;286530;USD;2014;Q4;2014-06-30;2014-09-29;10417001;10206935;8240595;5622644;1967390;17290358;498465;;4487835;4986300;22276658;6226074;148295;6694257;;0;6694257;7259089;-4279479;12601083;15582401;22276658
FKWL;286530;USD;2013;Q4;2013-06-30;2013-09-30;10374039;11018419;10431474;5321803;262567;17596331;631225;;4932011;5563236;23159567;6432601;139134;6647104;;0;6647104;7003598;-4279479;13573119;16512463;23159567
FKWL;286530;USD;2012;Q4;2012-06-30;2012-11-05;11882438;11463935;9419441;13072597;1746877;26048035;427988;;5395328;5823316;31871351;12651908;139134;12792103;;185980;12978083;6694994;-1873065;13398461;18893268;31871351
FKWL;286530;USD;2011;Q4;2011-06-30;2011-12-14;11786810;12003299;11357878;6916020;934636;19583120;440120;;4148019;4588139;24171259;4856234;139134;5010875;;188104;5198979;6434218;-1873065;13527435;18972280;24171259
FKWL;286530;USD;2018;Q4;2018-06-30;2018-09-28;10543831;10543831;11975944;7907117;1615332;21749507;124072;;3263059;3387131;25136638;7872683;;8101281;;0;8101281;7456244;-4513479;13753565;17035357;25136638
CPRT;287342;USD;2017;Q4;2017-07-31;2017-09-28;1104000;2007000;210100000;311846000;10163000;587261000;944056000;;451184000;1395240000;1982501000;214887000;82155000;302153000;550883000;581748000;883901000;453372000;;745370000;1098600000;1982501000
CPRT;287342;USD;2016;Q4;2016-07-31;2016-09-28;438752000;494880000;155849000;266270000;10388000;499306000;816791000;;333723000;1150514000;1649820000;198004000;76151000;278783000;564341000;596581000;875364000;392456000;;491194000;774456000;1649820000
CPRT;287342;USD;2015;Q4;2015-07-31;2015-09-25;498896000;520748000;456012000;215696000;8613000;734582000;700402000;;363676000;1064078000;1798660000;155731000;53671000;213126000;590843000;621070000;834196000;407820000;;625437000;964464000;1798660000
CPRT;287342;USD;2014;Q4;2014-07-31;2014-09-29;1005154160;1048809176;158668000;196985000;7259000;412291000;692383000;;402130000;1094513000;1506804000;160440000;79674000;244284000;223227000;259021000;503305000;404555000;;619004000;1003499000;1506804000
CPRT;287342;USD;2013;Q4;2013-07-31;2013-09-30;1002046920;1044001880;63631000;182714000;10736000;306452000;677517000;;350512000;1028029000;1334481000;157680000;76047000;238559000;296410000;333521000;572080000;368782000;;440780000;762401000;1334481000
CPRT;287342;USD;2012;Q4;2012-07-31;2012-10-01;-1543286080;-1581269152;140112000;137900000;8494000;321227000;587163000;;245610000;832773000;1154000000;105759000;75170000;186319000;368950000;406564000;592883000;326199000;;272961000;561117000;1154000000
CPRT;287342;USD;2011;Q4;2011-07-31;2011-10-28;542436000;554484000;74009000;122859000;8016000;241868000;600388000;;242180000;842568000;1084436000;105251000;50370000;166626000;325386000;362638000;529264000;313940000;;264457000;555172000;1084436000
CPRT;287342;USD;2010;Q4;2010-07-31;2010-12-03;674264000;680680000;268188000;109061000;4976000;437415000;573514000;;217883000;791397000;1228812000;95054000;374000;107224000;601000;34354000;141578000;365507000;;754468000;1087234000;1228812000
CPRT;287342;USD;2018;Q4;2018-07-31;2018-10-01;232990000;244397000;274520000;351601000;16734000;709116000;1163425000;;435157000;1598582000;2307698000;271617000;1151000;277256000;398747000;449343000;726599000;526881000;;1162146000;1581099000;2307698000
BWLA;287640;USD;2017;Q4;2017-06-30;2017-10-03;5160971;5160971;3555986;;534741;4654576;18860778;5272318;838641;24971737;29626313;2643362;;2985686;;2054234;5039920;8370205;;13734200;24586393;29626313
BWLA;287640;USD;2016;Q4;2016-06-30;2016-09-29;5160971;5160971;1470751;;561217;2696347;19523856;8824456;806476;29154788;31851135;2939379;;3293211;;2408582;5701793;8370205;;14792550;26149342;31851135
BWLA;287640;USD;2015;Q4;2015-06-30;2015-10-08;5160971;5160971;912096;;552889;2004506;20417454;8866392;774057;30057903;32062409;2588572;;2888518;;2199812;5088330;8370205;;16150986;26974079;32062409
BWLA;287640;USD;2014;Q4;2014-06-30;2014-09-25;5160971;5160971;2295440;;520355;3739067;20887127;8979499;758087;30624713;34363780;2649972;;2982745;;2402304;5385049;8365911;;18020217;28978731;34363780
BWLA;287640;USD;2013;Q4;2013-06-30;2013-09-26;5152723;5152723;4387595;;519179;5535152;21979489;8477227;733182;31189898;36725050;2742887;;3054171;;2639078;5693249;8365911;;20081870;31031801;36725050
BWLA;287640;USD;2012;Q4;2012-06-30;2012-09-27;5151471;5151471;6195743;;535412;7658564;22718526;8286680;704404;31709610;39368174;2550836;;2912366;;2770654;5683020;8242411;;22903925;33685154;39368174
BWLA;287640;USD;2011;Q4;2011-06-30;2011-11-15;;5147555;8659668;;480318;10117544;22581314;7538332;680572;30800218;40917762;2715256;;3070961;;2545410;5616371;8242411;;24776026;35301391;40917762
BWLA;287640;USD;2018;Q4;2018-06-30;2018-09-27;5160971;5160971;3166308;;490456;4609623;18698651;4816804;784048;24299503;28909126;2791078;;3096314;;1329137;4425451;8370205;;14010725;24483675;28909126
SNA;288357;USD;2016;Q4;2016-12-31;2017-02-09;58200000;59400000;77600000;598800000;530500000;1884000000;425200000;;2414000000;2839200000;4723200000;313500000;301400000;989500000;708800000;1098500000;2088000000;384700000;-653900000;3384900000;2635200000;4723200000
SNA;288357;USD;2015;Q4;2015-12-31;2016-02-11;58068139;59104543;92800000;562500000;497800000;1788800000;413500000;;2128800000;2542300000;4331100000;291400000;18400000;670200000;861700000;1230200000;1900400000;363700000;-573700000;2986900000;2430700000;4331100000
SNA;288357;USD;2014;Q4;2014-12-31;2015-02-12;57954963;59311217;132900000;550800000;475500000;1858600000;404500000;;2047000000;2451500000;4310100000;298000000;56600000;718700000;862700000;1366100000;2084800000;322100000;-503300000;2637200000;2225300000;4310100000
SNA;288357;USD;2013;Q4;2013-12-31;2014-02-14;58136858;59190045;217600000;531600000;434400000;1796200000;392500000;;1921300000;2313800000;4110000000;299200000;113100000;715400000;858900000;1264200000;1979600000;292500000;-458600000;2324100000;2130400000;4110000000
SNA;288357;USD;2012;Q4;2012-12-31;2013-02-14;58214514;59156091;214500000;497900000;404200000;1669000000;375200000;;1858100000;2233300000;3902300000;281400000;5200000;589200000;970400000;1494100000;2083300000;272000000;-412700000;2067000000;1819000000;3902300000
SNA;288357;USD;2011;Q4;2011-12-31;2012-02-16;64267215;58608934;185600000;463500000;386400000;1530700000;352900000;;1789300000;2142200000;3672900000;264400000;16200000;583800000;967900000;1541800000;2125600000;248700000;-386900000;1843700000;1547300000;3672900000
SNA;288357;USD;2010;Q4;2010-12-31;2011-02-17;58050309;58598886;572200000;443300000;329400000;1765500000;344000000;;1619900000;1963900000;3729400000;277800000;216000000;881100000;954800000;1443900000;2325000000;236500000;-387300000;1644100000;1404400000;3729400000
SNA;288357;USD;2009;Q4;2009-12-31;2010-07-28;58000000;58200000;699400000;414400000;274700000;1676100000;347800000;;1423500000;1771300000;3447400000;233300000;164700000;739900000;902100000;1401900000;2141800000;221700000;-392200000;1528900000;1305600000;3447400000
SNA;288357;USD;2017;Q4;2017-12-31;2018-02-15;56700000;57800000;92000000;675600000;638800000;2119300000;484400000;;2645400000;3129800000;5249100000;305500000;433200000;1193300000;753600000;1083500000;2276800000;410600000;-900000000;3772300000;2972300000;5249100000
SNA;288357;USD;2018;Q4;2018-12-31;2019-02-14;55800000;56834771;140900000;692600000;673800000;2216900000;495100000;;2661100000;3156200000;5373100000;324600000;186300000;952000000;946000000;1302500000;2254500000;426800000;-1123400000;4257600000;3118600000;5373100000
CCL;288836;USD;2016;Q4;2016-11-30;2017-01-30;726000000;727000000;603000000;298000000;322000000;1689000000;32429000000;;4818000000;37247000000;38936000000;2453000000;1097000000;7072000000;8357000000;9267000000;16339000000;8997000000;-5789000000;21843000000;22597000000;38936000000
CCL;288836;USD;2015;Q4;2015-11-30;2016-01-29;775000000;776000000;1395000000;303000000;330000000;2451000000;31818000000;;4968000000;36786000000;39237000000;2310000000;1374000000;6956000000;7413000000;8510000000;15466000000;8927000000;-3475000000;20060000000;23771000000;39237000000
CCL;288836;USD;2014;Q4;2014-11-30;2015-01-29;776000000;780000000;331000000;332000000;349000000;1488000000;32819000000;;5141000000;37960000000;39448000000;2164000000;1725000000;6921000000;7363000000;8323000000;15244000000;8749000000;-3087000000;19158000000;24204000000;39448000000
CCL;288836;USD;2013;Q4;2013-11-30;2014-01-29;774000000;776000000;462000000;405000000;374000000;1937000000;32905000000;;5262000000;38167000000;40104000000;1765000000;1468000000;6720000000;8092000000;8828000000;15548000000;8690000000;-3077000000;18782000000;24556000000;40104000000
CCL;288836;USD;2012;Q4;2012-11-30;2013-01-29;777000000;780000000;465000000;270000000;390000000;1821000000;32137000000;;5203000000;37340000000;39161000000;1977000000;1734000000;7340000000;7168000000;7892000000;15232000000;8615000000;-2958000000;18479000000;23929000000;39161000000
CCL;288836;USD;2011;Q4;2011-11-30;2012-01-30;777000000;777000000;450000000;263000000;374000000;1312000000;32054000000;;5271000000;37325000000;38637000000;1602000000;1300000000;6105000000;8053000000;8700000000;14805000000;8543000000;-2851000000;18349000000;23832000000;38637000000
CCL;288836;USD;2010;Q4;2010-11-30;2011-01-31;788000000;803000000;429000000;248000000;320000000;1244000000;30967000000;;5279000000;36246000000;37490000000;1597000000;1353000000;5755000000;8011000000;8704000000;14459000000;8455000000;-2394000000;17224000000;23031000000;37490000000
CCL;288836;USD;2009;Q4;2009-11-30;2010-01-29;787000000;789000000;538000000;362000000;320000000;1518000000;29870000000;;5447000000;35317000000;36835000000;1442000000;950000000;4967000000;9097000000;9829000000;14796000000;8280000000;-2264000000;15561000000;22039000000;36835000000
CCL;288836;USD;2008;Q4;2008-11-30;2009-10-01;;;650000000;418000000;315000000;1650000000;26457000000;;5293000000;31750000000;33400000000;1654000000;1608000000;5781000000;7735000000;8521000000;14302000000;8037000000;-2296000000;13980000000;19098000000;33400000000
CCL;288836;USD;2017;Q4;2017-11-30;2018-01-29;716000000;719000000;395000000;312000000;387000000;1596000000;34430000000;;4752000000;39182000000;40778000000;2639000000;2202000000;8799000000;6993000000;7762000000;16561000000;9055000000;-6349000000;23292000000;24216000000;40777000000
CCL;288836;USD;2018;Q4;2018-11-30;2019-01-28;699000000;699000000;982000000;358000000;450000000;2226000000;35336000000;;4839000000;40175000000;42401000000;2384000000;2426000000;9205000000;7897000000;8753000000;17958000000;9121000000;-7795000000;25066000000;24443000000;42401000000
EXEL;289286;USD;2018;Q4;2019-01-31;2019-02-22;299395000;312934000;693334000;162771000;9838000;897016000;50897000;157187000;317186000;525270000;1422286000;90518000;;105472000;12178000;29361000;134833000;2168517000;;-880363000;1287453000;1422286000
EXEL;289286;USD;2017;Q4;2018-01-31;2018-02-26;296025000;314318000;387771000;77300000;6657000;484874000;25743000;64255000;80422000;170420000;655294000;75621000;;115170000;14938000;255163000;370333000;2114480000;;-1829172000;284961000;655294000
EXEL;289286;USD;2016;Q4;2017-01-31;2015-11-10;288191000;288191000;419803000;40444000;3338000;469001000;2071000;55601000;69066000;126738000;595739000;56579000;189122000;268786000;;237635000;506421000;2072881000;;-1983147000;89318000;595739000
EXEL;289286;USD;2015;Q4;2016-01-31;2014-11-04;227216000;227216000;167060000;5183000;2616000;178665000;1434000;83600000;68643000;153677000;332342000;52251000;0;52251000;417937000;420897000;473148000;1772351000;;-1912925000;-140806000;332342000
EXEL;289286;USD;2014;Q4;2015-01-31;2014-05-01;195442000;195442000;242453000;3941000;2890000;266609000;4910000;144299000;87469000;236678000;503287000;70216000;11762000;87853000;344522000;349196000;437049000;1564854000;;-1498762000;66238000;503287000
EXEL;289286;USD;2013;Q4;2014-01-31;2013-10-30;184376000;184376000;242453000;3941000;2890000;266609000;4910000;144299000;87469000;236678000;503287000;70216000;11762000;87853000;344522000;349196000;437049000;1564854000;;-1498762000;66238000;503287000
EXEL;289286;USD;2012;Q4;2013-01-31;2012-11-07;183604000;183604000;411440000;2751000;0;432541000;6059000;182311000;100186000;288556000;721097000;47128000;13170000;81704000;336703000;342959000;424663000;1550528000;;-1254002000;296434000;721097000
EXEL;289286;USD;2011;Q4;2012-01-31;2011-10-27;133794000;133626000;194262000;30190000;;228824000;8506000;85260000;70672000;164438000;393262000;41052000;4870000;92325000;186140000;210305000;302630000;1197127000;;-1106357000;90632000;393262000
EXEL;289286;USD;2010;Q4;2011-01-31;2011-08-04;433762881;433762881;162664000;5896000;;183486000;15811000;87314000;74179000;177304000;360790000;54602000;37748000;199941000;177697000;389174000;589115000;953717000;;-1182054000;-228325000;360790000
ALNY;325251;USD;2015;Q4;2015-12-31;2016-02-12;84908000;84908000;1080531000;8298000;;1105388000;27812000;251839000;1471000;281122000;1386510000;45585000;;62099000;;59697000;121796000;2507048000;;-1246703000;1264714000;1386510000
ALNY;325251;USD;2014;Q4;2014-12-31;2015-02-13;77083000;77083000;696691000;39937000;;746367000;21740000;279821000;31667000;333228000;1079595000;38791000;;95334000;;47994000;143328000;1844134000;;-956630000;936267000;1079595000
ALNY;325251;USD;2013;Q4;2013-12-31;2014-02-20;62954000;62954000;291322000;4248000;;299480000;16448000;104602000;;121050000;420530000;20056000;;53864000;;96319000;150183000;846865000;;-596235000;270347000;420530000
ALNY;325251;USD;2012;Q4;2012-12-31;2013-02-19;52112000;52112000;161560000;104000;;164305000;19799000;103416000;;123215000;287520000;15978000;;48345000;;105122000;153467000;625401000;;-507010000;134053000;287520000
ALNY;325251;USD;2011;Q4;2011-12-31;2012-02-13;42262000;42262000;146402000;1468000;;152028000;14643000;114407000;839000;129889000;281917000;18140000;;80990000;;82930000;163920000;519158000;;-400996000;117997000;281917000
ALNY;325251;USD;2010;Q4;2010-12-31;2011-02-18;;;233131000;3450000;;254139000;18289000;116773000;4064000;139126000;393265000;20428000;;102046000;;132986000;235032000;500866000;;-343347000;158233000;393265000
ALNY;325251;USD;2009;Q4;2009-12-31;2010-08-05;;;281402000;6044000;;293534000;18324000;153914000;15613000;187851000;481385000;27966000;;110733000;;192687000;303420000;477081000;;-299832000;177965000;481385000
ALNY;325251;USD;2016;Q4;2016-12-31;2017-02-15;85846000;85846000;626799000;23334000;;671877000;114572000;324799000;151562000;590933000;1262810000;96583000;;131699000;150000000;210890000;342589000;2610473000;;-1656811000;920221000;1262810000
ALNY;325251;USD;2017;Q4;2017-12-31;2018-02-15;96263000;96263000;1690618000;34002000;;1764740000;181900000;13919000;34171000;229990000;1994730000;100558000;;144251000;30000000;84048000;228299000;3948549000;;-2147685000;1766431000;1994730000
ALNY;325251;USD;2018;Q4;2018-12-31;2019-02-14;101079000;101079000;1084155000;18760000;24068000;1200696000;320658000;;53448000;374106000;1574802000;172427000;;179494000;30000000;93343000;272837000;4176150000;;-2840972000;1301965000;1574802000
CAG;326285;USD;2017;Q4;2017-05-31;2017-07-21;419200000;423600000;251400000;563400000;934200000;2013200000;1655000000;;6428100000;8083100000;10096300000;1493300000;227200000;1720500000;2769200000;4298000000;6018500000;4011600000;-4054900000;4247000000;4077800000;10096300000
CAG;326285;USD;2016;Q4;2016-05-31;2016-07-15;314650500;316625500;798100000;650100000;1044100000;3576700000;1697800000;;8116100000;9813900000;13390600000;1495200000;573300000;2532400000;4881400000;7063400000;9595800000;3976000000;-3136200000;3218300000;3794800000;13390600000
CAG;326285;USD;2015;Q4;2015-05-31;2015-07-17;63840500;64466000;164700000;739000000;1642600000;3563300000;2644600000;;11229900000;13874500000;17437800000;1933400000;1015700000;3310100000;6888800000;9517700000;12827800000;3889100000;-3364700000;4331100000;4610000000;17437800000
CAG;326285;USD;2014;Q4;2014-05-31;2014-07-16;542013000;549337500;141300000;1058400000;2077000000;4230800000;3636000000;;11452700000;15088700000;19319500000;2251700000;225900000;2642400000;8720500000;11321900000;13964300000;3876600000;-3494400000;5010600000;5355200000;19319500000
CAG;326285;USD;2013;Q4;2013-05-31;2013-07-19;539057500;551136500;183900000;1279400000;2340900000;4379800000;3757600000;;12267900000;16025500000;20405300000;2693600000;702900000;3401300000;8886900000;11641000000;15042300000;3845900000;-3514900000;5129500000;5363000000;20405300000
CAG;326285;USD;2012;Q4;2012-05-31;2012-07-20;528135000;535202500;103000000;924800000;1869600000;3218800000;2741900000;;5481200000;8223100000;11441900000;2147100000;78100000;2225200000;2858600000;4680700000;6905900000;3741200000;-3767700000;4765100000;4536000000;11441900000
CAG;326285;USD;2011;Q4;2011-05-31;2011-07-19;528263500;535588000;972400000;849400000;1803400000;3899300000;2670100000;;4839300000;7509400000;11408700000;1762100000;363500000;2125600000;2870300000;4606400000;6732000000;3738800000;-3668200000;4690300000;4676700000;11408700000
CAG;326285;USD;2010;Q4;2010-05-31;2010-07-22;570540000;576065500;953200000;849600000;1597900000;3960100000;2602400000;;5175500000;7777900000;11738000000;1762000000;260800000;2036200000;3226400000;4772900000;6809100000;3737200000;-2945100000;4417100000;4928900000;11738000000
CAG;326285;USD;2009;Q4;2009-05-31;2009-10-07;;;243200000;755300000;1821700000;3336600000;2559200000;;5177500000;7736700000;11073300000;1526300000;27600000;1574100000;3455400000;4778300000;6352400000;3720300000;-2938200000;4042500000;4720900000;11073300000
CAG;326285;USD;2018;Q4;2018-05-31;2018-07-20;394900000;397500000;128000000;582600000;997100000;1938900000;1620100000;;6830500000;8450600000;10389500000;1751900000;584300000;2336200000;3231500000;4296700000;6632900000;4019700000;-4977900000;4744900000;3756600000;10389500000
CAG;326285;USD;2019;Q4;2019-05-31;2019-07-19;478200000;479100000;236600000;818200000;1563300000;2733800000;2356300000;;17123700000;19480000000;22213800000;2116400000;21600000;2142600000;10655700000;12607500000;14750100000;5207200000;-2760200000;5047900000;7463700000;22213800000
BGS;327019;USD;2017;Q4;2017-12-31;2018-03-01;66497298;66686601;206506000;141392000;501849000;889717000;272192000;;2399129000;2671321000;3561038000;201486000;;201486000;2217574000;2478733000;2680219000;267454000;;634121000;880819000;3561038000
BGS;327019;USD;2016;Q4;2016-12-31;2015-10-30;68780796;69086348;28833000;119265000;356590000;549776000;245344000;;2248385000;2493729000;3043505000;195180000;10515000;205695000;1715268000;2052153000;2257848000;388363000;;416658000;785657000;3043505000
BGS;327019;USD;2015;Q4;2015-12-31;2014-10-23;114547508;114710300;5246000;69712000;312880000;463161000;163642000;;1916817000;2080459000;2543620000;101118000;33750000;134868000;1697771000;1951067000;2085935000;163148000;;307233000;457685000;2543620000
BGS;327019;USD;2014;Q4;2014-12-31;2014-04-24;160861096;161217418;4107000;62763000;101251000;181737000;110374000;;1192232000;1302606000;1484343000;79464000;26250000;105714000;844635000;1000266000;1105980000;183647000;;197187000;378363000;1484343000
BGS;327019;USD;2013;Q4;2013-12-31;2013-10-25;53541587;53803731;4107000;62763000;101251000;181737000;110374000;;1192232000;1302606000;1484343000;79464000;26250000;105714000;844635000;1000266000;1105980000;183647000;;197187000;378363000;1484343000
BGS;327019;USD;2012;Q4;2012-12-31;2012-10-25;52153274;52423305;19219000;43357000;89757000;164096000;104746000;;923126000;1027872000;1191968000;63903000;40375000;104278000;597314000;726515000;830793000;227426000;;144844000;361175000;1191968000
BGS;327019;USD;2011;Q4;2011-12-31;2011-10-25;47712245;48360430;16738000;39476000;82666000;150224000;61930000;;920769000;982699000;1132923000;62117000;9750000;71867000;710357000;825509000;897376000;160393000;;85584000;235547000;1132923000
BGS;327019;USD;2018;Q4;2018-12-31;2019-02-26;65821618;65928442;11648000;151707000;401355000;591036000;282553000;;2181210000;2463763000;3054799000;258462000;;258462000;1635881000;1896288000;2154750000;116995000;;806556000;900049000;3054799000
GNTX;327200;USD;2016;Q4;2016-12-31;2017-02-22;287984784;291055203;723498272;211591745;189311437;1154989029;465822467;49894363;638913974;1154630804;2309619833;79963630;;149857979;178125000;249337620;399195599;700710714;;1210984825;1910424234;2309619833
GNTX;327200;USD;2015;Q4;2015-12-31;2016-02-23;290805293;293517873;556104882;195969400;174695411;984008792;412720270;95156539;656787327;1164664136;2148672928;100585976;7500000;131006546;225625000;295149621;426156167;614262976;;1109384621;1722516761;2148672928
GNTX;327200;USD;2014;Q4;2014-12-31;2015-02-23;292571986;297885484;497429804;168008704;141757884;856637694;373390992;114642567;677868776;1165902335;2022540029;104829571;7500000;133431163;258125000;317696421;451127584;571551360;;988548070;1571412445;2022540029
GNTX;327200;USD;2013;Q4;2013-12-31;2014-02-26;288734648;290983388;309591724;143046590;120074164;601186242;357021225;107005522;698875445;1162902192;1764088434;97978214;7500000;119980414;265625000;316504337;436484751;487600459;;818027861;1327603683;1764088434
GNTX;327200;USD;2012;Q4;2012-12-31;2013-02-20;284274652;285116782;450481520;109579693;159930266;744663040;349938172;141834034;29256089;521028295;1265691335;70570590;0;87957442;0;56773337;144730779;427350591;;676039254;1120960556;1265691335
GNTX;327200;USD;2011;Q4;2011-12-31;2012-02-22;286297842;289218748;418795011;110389715;188753312;752292984;282541588;128168165;13024265;423734018;1176027002;89317559;;100694500;;48213981;148908481;403874065;;610702253;1027118521;1176027002
GNTX;327200;USD;2010;Q4;2010-12-31;2011-02-22;281011656;284887286;434797369;95647612;100728730;655269274;205107756;129091167;13222442;347421365;1002690639;61672416;;72088629;;37071184;109159813;356371746;;514842177;893530826;1002690639
GNTX;327200;USD;2009;Q4;2009-12-31;2010-08-03;;;353232093;71159512;53608996;505413495;197530249;109155248;10504497;317189994;822603489;51115526;;58637778;;28036968;86674746;278652159;;438937242;735928743;822603489
GNTX;327200;USD;2017;Q4;2017-12-31;2018-02-21;284666686;284560666;722272550;231121788;216765583;1184563823;492479330;57782418;617228341;1167490089;2352053912;136788822;78000000;243647007;0;58888644;302535651;740327551;;1301997327;2049518261;2352053912
GNTX;327200;USD;2018;Q4;2018-12-31;2019-02-22;260078156;261308890;386438277;213537799;225281599;850930254;498473766;137979082;598050966;1234503814;2085434068;141490144;0;169160919;;54521489;223682408;760883861;;1102468137;1861751660;2085434068
PNW;327292;USD;2015;Q4;2015-12-31;2016-02-19;111166000;111755000;39488000;271566000;279931000;890516000;11684969000;799820000;1652953000;14137742000;15028258000;561748000;357580000;1442317000;3462391000;8866484000;10308801000;2541668000;-5806000;2092803000;4719457000;15028258000
PNW;327292;USD;2014;Q4;2014-12-31;2015-02-20;110996000;111719000;7604000;294646000;255986000;973435000;11074575000;785533000;1455347000;13315455000;14288890000;554217000;530970000;1559143000;3006573000;8210645000;9769788000;2512970000;-3401000;1926065000;4519102000;14288890000
PNW;327292;USD;2013;Q4;2013-12-31;2014-02-21;110133000;110404000;9526000;296701000;259710000;1043609000;10731296000;726697000;1007084000;12465077000;13508686000;526393000;693549000;1618644000;2796465000;7549582000;9168226000;2491558000;-4308000;1785273000;4340460000;13508686000
PNW;327292;USD;2012;Q4;2012-12-31;2013-02-22;109695000;111795000;26202000;273885000;249430000;1005726000;10234243000;669210000;1470436000;12373889000;13379615000;455420000;215003000;1083542000;3199088000;8193784000;9277326000;2466923000;-4211000;1624102000;4102289000;13379615000
PNW;327292;USD;2011;Q4;2011-12-31;2012-02-24;109208000;111045000;33583000;280435000;226387000;956470000;9791687000;627643000;1735218000;12154548000;13111018000;502148000;477435000;1342705000;3019054000;7837727000;9180432000;2439530000;;1534483000;3930586000;13111018000
PNW;327292;USD;2010;Q4;2010-12-31;2011-02-18;108831000;110219140;110188000;316226000;202989000;1024511000;9393867000;625134000;1349486000;11368487000;12392998000;395896000;648479000;1449704000;3045794000;7168068000;8617772000;2419133000;;1423961000;3775226000;12392998000
PNW;327292;USD;2009;Q4;2009-12-31;2010-08-03;101323000;101504000;145378000;295762000;215265000;928737000;9240158000;673511000;1143918000;11057587000;11986324000;399244000;457191000;1196234000;3496524000;7362086000;8558320000;2149483000;;1298213000;3428004000;11986324000
PNW;327292;USD;2016;Q4;2016-12-31;2017-02-24;111556000;112233000;8881000;247454000;282587000;822219000;12624254000;848650000;1709130000;15182034000;16004253000;529356000;302200000;1292946000;4021785000;9775395000;11068341000;2596030000;-4133000;2255547000;4935912000;16004253000
PNW;327292;USD;2017;Q4;2017-12-31;2018-02-23;111996000;112527000;13892000;302634000;289270000;1016288000;13188077000;955582000;1859135000;16002794000;17019082000;539452000;177400000;1197852000;4789713000;10685500000;11883352000;2614805000;-5624000;2442511000;5135730000;17019082000
PNW;327292;USD;2018;Q4;2018-12-31;2019-02-22;112236000;112703000;5766000;263818000;294094000;923878000;13766668000;852247000;2121409000;16740324000;17664202000;575937000;576400000;1648964000;4638232000;10666533000;12315497000;2634265000;-4825000;2641183000;5348705000;17664202000
MAYS;327434;USD;2018;Q4;2018-07-31;2018-10-04;2015780;;5255073;252304;;7568090;50792984;3141828;5059571;58994383;66562473;2186804;168501;2456594;6506667;11012667;13469261;5524542;-1287852;48369386;53093212;66562473
MAYS;327434;USD;2017;Q4;2017-07-31;2017-10-05;2015780;;5381195;164716;;7243726;49485089;2815727;5304397;57605213;64848939;2602854;162569;2781328;6430200;12067200;14848528;5524542;-1287852;45395245;50000411;64848939
MAYS;327434;USD;2016;Q4;2016-07-31;2016-06-02;2015780;;5228826;293317;;7092364;49064737;2062205;5325948;56452890;63545254;2241156;156846;4418835;6538482;11155482;15574317;5524542;-1287852;43469706;47970937;63545254
MAYS;327434;USD;2015;Q4;2015-07-31;2015-06-04;2015780;;4085704;638643;;6980620;48191392;1491504;6138636;55821532;62802152;2642835;127891;4020405;8542078;12397078;16417483;5524542;-1287852;41951946;46384669;62802152
MAYS;327434;USD;2014;Q4;2014-07-31;2014-06-05;2015780;;1892760;311006;;6597766;47458998;1414213;5705588;54578799;61176565;2325094;240000;3742261;9104938;13324938;17067199;5524542;-1287852;39743264;44109366;61176565
MAYS;327434;USD;2013;Q4;2013-07-31;2013-06-06;2015780;;715044;309517;;3604878;45634465;2499273;4955321;53089059;56693937;2096709;170262;2524946;7060727;10744727;13269673;5524542;-1287852;39003941;43424264;56693937
MAYS;327434;USD;2012;Q4;2012-07-31;2012-06-07;2015780;;1566600;276585;;3879540;44259379;2335209;4910617;51505205;55384745;1652676;158662;2028360;7363948;10645948;12674308;5524542;-1287852;38340270;42710437;55384745
MAYS;327434;USD;2011;Q4;2011-07-31;2011-12-08;2015780;;3275450;264857;;5513162;44690891;1482460;4654738;50828089;56341251;1657194;3346267;5145165;7672064;9763064;14908229;5524542;-1287852;37069917;41433022;56341251
APOG;327543;USD;2017;Q4;2018-03-31;2018-04-30;27699000;28629000;19359000;211852000;80908000;336278000;304063000;;381979000;686042000;1022320000;115995000;;208152000;232167000;303735000;511887000;161227000;;373259000;510433000;1022320000
APOG;327543;USD;2016;Q4;2017-03-31;2017-04-28;28703000;28825000;20011000;185740000;73409000;297461000;246748000;9041000;231408000;487197000;784658000;123001000;;186058000;74231000;128898000;314956000;158796000;;341996000;469702000;784658000
APOG;327543;USD;2015;Q4;2016-03-31;2016-04-25;28820000;29063000;90643000;172832000;63386000;336793000;202462000;12519000;105666000;320647000;657440000;116152000;;177381000;27537000;74701000;252082000;154252000;;282477000;405358000;657440000
APOG;327543;USD;2014;Q4;2015-03-31;2015-04-29;28776000;29447000;52512000;171623000;61408000;298975000;193540000;10655000;108887000;313082000;612057000;101194000;;149028000;26772000;81354000;230382000;147457000;;256538000;381675000;612057000
APOG;327543;USD;2013;Q4;2014-03-31;2014-04-30;28614000;29572000;28669000;154914000;53435000;247430000;193946000;11273000;117346000;322565000;569995000;79140000;49000;136834000;28636000;77848000;214682000;139432000;;228841000;355313000;569995000
APOG;327543;USD;2012;Q4;2013-03-31;2013-05-16;28077000;29073000;63774000;121170000;36052000;251841000;168948000;12807000;86545000;268300000;520141000;67112000;10057000;122167000;28786000;65417000;187584000;128503000;;211135000;332557000;520141000
APOG;327543;USD;2011;Q4;2012-03-31;2012-04-30;27643000;28710000;65691000;108424000;34045000;229439000;159547000;7936000;96182000;263665000;493104000;63297000;108000;105771000;30521000;66880000;172651000;121655000;;203558000;320453000;493104000
APOG;327543;USD;2010;Q4;2011-03-31;2011-10-06;27700000;27700000;35465000;100967000;32608000;213923000;179201000;15709000;102265000;297175000;511098000;61413000;987000;113946000;30712000;70226000;184172000;117608000;;210203000;326926000;511098000
APOG;327543;USD;2018;Q4;2019-03-31;2019-04-26;27055000;27356000;17087000;192767000;78344000;371898000;315823000;;380447000;696270000;1068168000;113338000;0;227512000;267157000;345094000;572606000;160092000;;367597000;495562000;1068168000
KMX;327637;USD;2016;Q4;2017-02-28;2017-04-21;187102000;189166000;38416000;152388000;2260563000;2873630000;2518393000;;10887333000;13405726000;16279356000;762521000;343266000;1105787000;11826438000;12064989000;13170776000;1281852000;;1883283000;3108580000;16279356000
KMX;327637;USD;2015;Q4;2016-02-29;2016-04-22;195862000;197477000;37394000;132171000;1932029000;2471781000;2161698000;;9826432000;11988130000;14459911000;689684000;315509000;1005193000;10320658000;10549932000;11555125000;1228178000;;1746804000;2904786000;14459911000
KMX;327637;USD;2014;Q4;2015-02-28;2015-04-24;209792000;213037000;27606000;137690000;2086874000;2590938000;1862538000;;8744725000;10607263000;13198201000;706671000;290502000;997173000;8818750000;9044243000;10041416000;1227955000;;1994221000;3156785000;13198201000
KMX;327637;USD;2013;Q4;2014-02-28;2014-04-25;222869000;226733000;627901000;79923000;1641424000;2643224000;1652977000;;7410956000;9063933000;11707157000;632518000;242979000;875497000;7340431000;7514663000;8390160000;1149052000;;2214216000;3316997000;11707157000
KMX;327637;USD;2012;Q4;2013-02-28;2013-04-26;227337000;231138000;449364000;91961000;1517813000;2310131000;1428970000;;6149501000;7578471000;9888602000;484764000;199409000;684173000;6009627000;6185262000;6869435000;1085203000;;1993772000;3019167000;9888602000
KMX;327637;USD;2011;Q4;2012-02-29;2012-04-25;226812000;231293000;442658000;86434000;1092592000;1853448000;1278722000;;5199373000;6478095000;8331543000;456925000;189388000;646313000;4863318000;5012118000;5658431000;991052000;;1744519000;2673112000;8331543000
KMX;327637;USD;2010;Q4;2011-02-28;2011-04-28;446763779;455574821;41121000;119597000;1049477000;1410098000;1175317000;;4540134000;5715451000;7125549000;376533000;146138000;522671000;4248759000;4363629000;4886300000;933582000;;1330724000;2239249000;7125549000
KMX;327637;USD;2009;Q4;2010-02-28;2010-10-12;221168000;224898000;18278000;99434000;843133000;1556412000;893453000;;106326000;999779000;2556191000;354151000;123200000;477351000;27371000;145258000;622609000;857667000;;1095461000;1933582000;2556191000
KMX;327637;USD;2017;Q4;2018-02-28;2018-04-24;180684000;182292000;44525000;133321000;2390694000;3061444000;2667061000;;11757767000;14424828000;17486272000;808504000;365554000;1174058000;12752812000;12995365000;14169423000;1323921000;;2047240000;3316849000;17486272000
KMX;327637;USD;2018;Q4;2019-02-28;2019-04-19;169613000;170594000;46938000;139850000;2519455000;3214013000;2828058000;;12675796000;15503854000;18717867000;915159000;396350000;1311509000;13776534000;14049330000;15360839000;1320892000;;2104146000;3357028000;18717867000
RECN;328011;USD;2018;Q4;2018-05-31;2018-07-23;31542000;32136000;56470000;130452000;;194881000;22413000;;215380000;237793000;432674000;81698000;;94524000;63000000;69325000;163849000;430191000;-486722000;335741000;268825000;432674000
RECN;328011;USD;2017;Q4;2017-05-31;2017-07-24;29655000;30235000;62329000;98222000;;166845000;23354000;;173929000;197283000;364128000;63343000;;71771000;48000000;54215000;125986000;399418000;-481904000;332024000;238142000;364128000
RECN;328011;USD;2016;Q4;2016-05-31;2016-04-07;36589000;37102000;116046000;97807000;;218588000;21274000;;177393000;198667000;417255000;63761000;;70884000;;3722000;74606000;389345000;-363856000;327954000;342649000;417255000
RECN;328011;USD;2015;Q4;2015-05-31;2015-04-09;37486000;38091000;112238000;96574000;;221706000;22001000;;173274000;195275000;416981000;61947000;;68946000;;7583000;76529000;374860000;-336759000;313268000;340452000;416981000
RECN;328011;USD;2014;Q4;2014-05-31;2014-04-03;38530000;38671000;114277000;90334000;;217462000;23158000;;179458000;202616000;420078000;59598000;;67175000;;7142000;74317000;361012000;-311508000;298830000;345761000;420078000
RECN;328011;USD;2013;Q4;2013-05-31;2013-04-03;40481000;40493000;119012000;84194000;;217177000;21087000;;179376000;200463000;417640000;55002000;;61333000;;3980000;65313000;348351000;-282615000;290549000;352327000;417640000
RECN;328011;USD;2012;Q4;2012-05-31;2012-04-05;42288000;42373000;128115000;84192000;;228235000;22651000;;179833000;202484000;430719000;55213000;;61651000;;3200000;64851000;336346000;-249238000;280650000;365868000;430719000
RECN;328011;USD;2011;Q4;2011-05-31;2011-04-07;45959000;46324000;144873000;87162000;;249874000;26389000;;200134000;226523000;476397000;60507000;;67199000;;36472000;103671000;325042000;-204741000;248983000;372726000;476397000
RECN;328011;USD;2010;Q4;2010-05-31;2010-10-07;46340000;46340000;140905000;73936000;;231221000;29354000;;212625000;241979000;473200000;52555000;;57749000;;62210000;119959000;306956000;-181165000;232034000;353241000;473200000
RECN;328011;USD;2019;Q4;2019-05-31;2019-07-19;31031000;31544000;49026000;133304000;;191657000;26632000;;210081000;236713000;428370000;80262000;;91416000;43000000;54558000;145974000;460857000;-516103000;350230000;282396000;428370000
RPM;328948;USD;2017;Q4;2017-05-31;2017-07-24;130676000;144047000;350497000;995330000;788197000;2397436000;742686000;;1950327000;2693013000;5090449000;981749000;253645000;1235394000;1836437000;2416355000;3651749000;955827000;-218222000;1172442000;1438700000;5090449000
RPM;328948;USD;2016;Q4;2016-05-31;2016-07-28;129021000;143755000;265152000;963092000;685818000;2135348000;629453000;;2000168000;2629621000;4764969000;997478000;4713000;1002191000;1635260000;2388030000;3390221000;923285000;-196274000;1147371000;1374748000;4764969000
RPM;328948;USD;2015;Q4;2015-05-31;2015-07-27;129815000;139779000;174711000;956211000;674205000;2069954000;589646000;;2034640000;2624286000;4694240000;901198000;2038000;903236000;1654037000;2497539000;3400775000;873459000;-124928000;936996000;1293465000;4694240000
RPM;328948;USD;2014;Q4;2014-05-31;2014-08-14;129529000;138987000;332868000;873946000;613644000;2040014000;532805000;;1805546000;2338351000;4378365000;931424000;5662000;937086000;1345965000;1862685000;2799771000;791435000;-85400000;833691000;1578594000;4378365000
RPM;328948;USD;2013;Q4;2013-05-31;2013-07-24;129121000;130921000;343554000;787517000;548680000;1849707000;492363000;;1778777000;2271140000;4120847000;923509000;4521000;928030000;1369176000;1837884000;2765914000;764831000;-72494000;667774000;1354933000;4120847000
RPM;328948;USD;2012;Q4;2012-05-31;2012-07-26;128319000;127433000;315968000;745541000;489978000;1718567000;418832000;;1424414000;1843246000;3561813000;722556000;2584000;725140000;1112952000;1522690000;2247830000;744211000;-69480000;686818000;1313983000;3561813000
RPM;328948;USD;2011;Q4;2011-05-31;2011-07-27;127647000;126898000;435011000;712863000;463120000;1850206000;390027000;;1274796000;1664823000;3515029000;732740000;2549000;735289000;1106304000;1392372000;2127661000;736551000;-62495000;583035000;1387368000;3515029000
RPM;328948;USD;2010;Q4;2010-05-31;2010-10-06;;127162000;215355000;633910000;386982000;1430373000;382527000;;1191124000;1573651000;3004024000;627187000;4307000;631494000;924308000;1211289000;1842783000;725388000;-40686000;502562000;1161241000;3004024000
RPM;328948;USD;2018;Q4;2018-05-31;2018-07-23;131139000;146194000;244422000;1113818000;834461000;2470931000;780306000;;2020585000;2800891000;5271822000;1003225000;3501000;1006726000;2170643000;2631558000;3638284000;983403000;-236318000;1342736000;1633538000;5271822000
RPM;328948;USD;2019;Q4;2019-05-31;2019-07-24;129184000;137346000;223168000;1232350000;841873000;2518092000;819211000;;2104052000;2923263000;5441355000;986959000;552446000;1539405000;1973462000;2493345000;4032750000;995818000;-437290000;1425052000;1408605000;5441355000
AXN;329205;USD;2016;Q4;2016-06-30;2016-10-05;76160399;83090798;6912100;11200418;2841690;26866763;25603734;;3761094;29364828;56231591;26716199;11070966;37815530;;340089;38155619;73705960;;-56293745;18075972;56231591
AXN;329205;USD;2015;Q4;2015-06-30;2015-10-13;74076946;74218820;5371545;5854055;3240026;21096033;28651717;;3292942;31944659;53040692;28749513;12484356;41239662;;1738108;42977770;66527089;;-58354968;10062922;53040692
RT;330525;USD;2017;Q4;2017-06-30;2017-08-21;60334000;60334000;41714000;;17178000;99037000;583097000;;41508000;624605000;723642000;28598000;368000;99074000;213341000;317505000;416579000;80138000;;235210000;307063000;723642000
RT;330525;USD;2016;Q4;2016-06-30;2016-08-15;59767000;59767000;66964000;;21595000;120916000;671250000;;45751000;717001000;837917000;32910000;9934000;97706000;213803000;332952000;430658000;76539000;;341350000;407259000;837917000
RT;330525;USD;2015;Q4;2015-06-30;2015-08-17;60724000;60090000;75331000;;20411000;118880000;752174000;;54398000;806572000;925452000;35141000;10078000;110381000;231017000;350169000;460550000;84491000;;392032000;464902000;925452000
RT;330525;USD;2014;Q4;2014-06-30;2014-08-06;60351000;60351000;51326000;;21174000;96393000;794846000;;65188000;860034000;956427000;37422000;4816000;113823000;253875000;382017000;495840000;76883000;;395226000;460587000;956427000
RT;330525;USD;2013;Q4;2013-06-30;2013-08-05;59564000;58887000;52907000;;30872000;113868000;859830000;;69485000;929315000;1043183000;26275000;8487000;105632000;290515000;421810000;527442000;68208000;;459572000;515741000;1043183000
RT;330525;USD;2012;Q4;2012-06-30;2012-08-06;125203402;126440402;48184000;;29030000;101134000;966605000;;105798000;1072403000;1173537000;49423000;12454000;132224000;314209000;466097000;598321000;91496000;;498985000;575216000;1173537000
RT;330525;USD;2011;Q4;2011-06-30;2011-11-07;64247000;65245000;9722000;;34470000;68937000;1031151000;;86938000;1118089000;1187026000;43502000;15090000;119324000;329184000;477545000;596869000;105592000;;499173000;590157000;1187026000
INFO;330628;USD;2017;Q4;2017-11-30;2018-01-23;397700000;412800000;133800000;693500000;;1015000000;531300000;;13008100000;13539400000;14554400000;539300000;576000000;1906100000;3617300000;4624800000;6530900000;7616800000;-1745000000;2217600000;8023500000;14554400000
INFO;330628;USD;2016;Q4;2016-11-30;2017-01-27;416700000;442000000;138900000;635600000;;933500000;416200000;;12586900000;13003100000;13936600000;537600000;104600000;1412400000;3279300000;4382100000;5794500000;7215400000;-499100000;1806900000;8142100000;13936600000
INFO;330628;USD;2015;Q4;2015-11-30;2016-10-07;241300000;247600000;291600000;355900000;;950500000;314400000;;4312600000;4627000000;5577500000;339700000;36000000;960300000;2071500000;2416300000;3376600000;1053800000;-317000000;1655300000;2200900000;5577500000
INFO;330628;USD;2018;Q4;2018-11-30;2019-01-18;394800000;406800000;120000000;792900000;;1099400000;579600000;;14383300000;14962900000;16062300000;643600000;789900000;2320300000;4889200000;5715600000;8035900000;7685100000;-2108800000;2743100000;8026400000;16062300000
VFC;330907;USD;2016;Q4;2017-03-31;2017-03-01;438831144;418406760;1227862000;1161393000;1471300000;4293098000;926010000;;4520179000;5446189000;9739287000;1470477000;279718000;1785400000;2039180000;3012966000;4798366000;3436926000;;2545458000;4940921000;9739287000
VFC;330907;USD;2015;Q4;2016-03-31;2016-03-02;452220840;430498692;944423000;1289962000;1555360000;4163136000;945491000;;4530915000;5476406000;9639542000;1462754000;452941000;1941713000;1401820000;2312991000;4254704000;3299329000;;3128731000;5384838000;9639542000
VFC;330907;USD;2014;Q4;2015-03-31;2015-03-03;458333712;434846520;971895000;1276224000;1482804000;4031569000;942181000;;4871550000;5813731000;9845300000;1588268000;25797000;1614065000;1413847000;2600353000;4214418000;3101401000;;3231753000;5630882000;9845300000
VFC;330907;USD;2013;Q4;2014-03-31;2014-02-26;466302960;475567848;776403000;1360443000;1399062000;3882982000;932792000;;5499669000;6432461000;10315443000;1544024000;23977000;1568001000;1426829000;2670404000;4238405000;2856668000;;3432090000;6077038000;10315443000
VFC;330907;USD;2012;Q4;2013-03-31;2013-02-27;467246016;476413200;597461000;1222345000;1354158000;3449583000;828218000;;5355220000;6183438000;9633021000;1316780000;415432000;1732212000;1429166000;2775184000;4507396000;2638073000;;2941447000;5125625000;9633021000
VFC;330907;USD;2011;Q4;2012-03-31;2012-02-29;468146592;478494720;341228000;1120246000;1453645000;3187944000;737451000;;5387731000;6125182000;9313126000;1381602000;284430000;1666032000;1831781000;3121919000;4787951000;2426664000;;2520804000;4525175000;9313126000
VFC;330907;USD;2010;Q4;2011-03-31;2011-03-02;458609832;467339472;792239000;773083000;1070694000;2826060000;602908000;;3028588000;3631496000;6457556000;1070162000;39313000;1109475000;935882000;1486762000;2596237000;2189305000;;1940508000;3861319000;6457556000
VFC;330907;USD;2009;Q4;2010-03-31;2010-03-03;469149120;475801488;731549000;776140000;958639000;2632562000;614178000;;3227123000;3841301000;6473863000;847157000;248632000;1095789000;938494000;1564789000;2660578000;1974784000;;2050109000;3813285000;6473863000
VFC;330907;USD;2008;Q4;2009-03-31;2009-08-11;466218000;471030984;381844000;851282000;1151895000;2653010000;642727000;;3138131000;3780858000;6433868000;955280000;56902000;1012182000;1141546000;1864441000;2876623000;1859312000;;1972874000;3557245000;6433868000
VFC;330907;USD;2017;Q4;2018-03-31;2018-02-28;419042898;406784232;680762000;1408587000;1861441000;4683323000;1011617000;;4616370000;5627987000;10311310000;1521431000;1531371000;3138829000;2212555000;3484385000;6623214000;3706002000;;846124000;3688096000;10311310000
VFC;330907;USD;2018;Q4;2019-03-31;2019-05-24;321913238;326252252;445119000;1465855000;1432660000;4673457000;915177000;;4768151000;5683328000;10356785000;1735799000;664323000;2661604000;2115884000;3396665000;6058269000;4020990000;;1179601000;4298516000;10356785000
RL;331016;USD;2017;Q4;2018-03-31;2017-05-18;85800000;84300000;2004000000;421400000;761300000;3548400000;1186300000;;1408600000;2594900000;6143300000;195600000;308200000;1587200000;288000000;1098700000;2685900000;2384700000;-4581000000;5752200000;3457400000;6143300000
RL;331016;USD;2016;Q4;2017-03-31;2016-05-19;92200000;93800000;1353000000;450200000;791500000;2954500000;1316000000;;1381500000;2697500000;5652000000;177200000;0;1159900000;588200000;1192500000;2352400000;2310000000;-4563900000;5751900000;3299600000;5652000000
RL;331016;USD;2015;Q4;2016-03-31;2015-08-06;95800000;97400000;1144000000;655000000;1042000000;3324000000;1436000000;;1346000000;2782000000;6106000000;237000000;234000000;1186000000;298000000;1029000000;2215000000;2118000000;-3849000000;5787000000;3891000000;6106000000
RL;331016;USD;2014;Q4;2015-03-31;2015-05-15;97400000;99600000;1144000000;655000000;1042000000;3324000000;1436000000;;1346000000;2782000000;6106000000;237000000;234000000;1186000000;298000000;1029000000;2215000000;2118000000;-3849000000;5787000000;3891000000;6106000000
RL;331016;USD;2013;Q4;2014-03-31;2014-05-15;;;1285000000;588000000;1020000000;3329000000;1322000000;;1437000000;2759000000;6088000000;280000000;0;970000000;298000000;1084000000;2054000000;1980000000;-3317000000;5257000000;4034000000;6088000000
RL;331016;USD;2012;Q4;2013-03-31;2013-05-23;90600000;93000000;1299000000;458000000;896000000;2963000000;932000000;81000000;1442000000;2455000000;5418000000;190000000;267000000;1121000000;0;512000000;1633000000;1753000000;-2709000000;4647000000;3785000000;5418000000
RL;331016;USD;2011;Q4;2012-03-31;2011-05-26;92500000;95400000;1187300000;547200000;841600000;2899900000;884100000;99900000;1532500000;2516500000;5416400000;252500000;0;946200000;274400000;817700000;1763900000;1625200000;-2211700000;4042400000;3652500000;5416400000
RL;331016;USD;2010;Q4;2011-03-31;2010-08-10;95800000;98800000;1046900000;442800000;702100000;2478000000;788800000;83600000;1630700000;2503100000;4981100000;150200000;;832000000;291900000;844400000;1676400000;1445900000;-1792300000;3435300000;3304700000;4981100000
RL;331016;USD;2018;Q4;2019-03-31;2019-05-16;79000000;80000000;1987500000;398100000;817800000;3594800000;1039200000;;1308800000;2348000000;5942800000;231700000;0;1200100000;689100000;1455500000;2655600000;2495100000;-5083600000;5979100000;3287200000;5942800000
COH;331230;USD;2018;Q4;2018-06-30;2018-08-16;287700000;291200000;1250000000;314100000;673800000;2432600000;885400000;0;3360300000;4245700000;6678300000;937500000;700000;938200000;1599900000;2495500000;3433700000;3208400000;;119000000;3244600000;6678300000
COH;331230;USD;2017;Q4;2017-06-30;2017-05-10;281600000;284600000;3083600000;268000000;469700000;3953300000;691400000;75100000;1111800000;1878300000;5831600000;753800000;0;753800000;1579500000;2075900000;2829700000;2981100000;;107700000;3001900000;5831600000
COH;331230;USD;2016;Q4;2016-06-30;2016-05-04;277900000;281000000;1319400000;245200000;459200000;2172900000;919500000;558600000;1241700000;2719800000;4892700000;811700000;15000000;826700000;861200000;1383100000;2209800000;2859900000;;-104100000;2682900000;4892700000
COH;331230;USD;2015;Q4;2015-06-30;2015-05-06;276300000;278500000;1525800000;219500000;485100000;2506500000;732600000;406000000;1021800000;2160400000;4666900000;823400000;11300000;834700000;879100000;1342300000;2177000000;2757200000;;-189600000;2489900000;4666900000
COH;331230;USD;2014;Q4;2014-06-30;2014-05-06;274600000;276800000;868600000;198600000;526200000;1855200000;713900000;484500000;609500000;1807900000;3663100000;672600000;140500000;813100000;0;429400000;1242500000;2648800000;;-219500000;2420600000;3663100000
COH;331230;USD;2013;Q4;2013-06-30;2013-05-07;281920000;285856000;1134891000;175477000;524706000;2070947000;694771000;197340000;568839000;1460950000;3531897000;722010000;500000;722510000;485000;400229000;1122739000;2523288000;;-101884000;2409158000;3531897000
COH;331230;USD;2012;Q4;2012-06-30;2012-05-09;285977000;291443000;917215000;174462000;504490000;1804528000;644449000;6000000;649344000;1299793000;3104321000;695785000;22375000;718160000;985000;393230000;1111390000;2329906000;;-387450000;1992931000;3104321000
COH;331230;USD;2011;Q4;2011-06-30;2011-05-11;291149000;298708000;702038000;142898000;421831000;1452388000;582348000;;600380000;1182728000;2635116000;592222000;795000;593017000;23360000;429530000;1022547000;2003312000;;-445654000;1612569000;2635116000
COH;331230;USD;2010;Q4;2010-06-30;2010-05-05;300659000;306936000;696398000;109068000;363285000;1302641000;548474000;;616000000;1164474000;2467115000;528294000;742000;529036000;24159000;432786000;961822000;1505951000;;-30053000;1505293000;2467115000
COH;331230;USD;2009;Q4;2009-06-30;2009-11-04;319173000;321934000;800362000;108707000;326148000;1396409000;592982000;6000000;568945000;1167927000;2564336000;451648000;508000;459652000;25072000;408642000;868294000;1192240000;;499951000;1696042000;2564336000
HBI;331419;USD;2016;Q4;2016-12-31;2017-02-03;381929000;384152000;460245000;836924000;1840565000;3321166000;692464000;;2916850000;3609314000;6930480000;761647000;234760000;1625668000;3507685000;4080898000;5706566000;263789000;;1396116000;1223914000;6930480000
HBI;331419;USD;2015;Q4;2015-12-31;2016-02-05;392592000;395887000;319169000;680417000;1814602000;2917867000;650462000;;2029261000;2679723000;5597590000;672972000;370604000;1503909000;2232712000;2817790000;4321699000;281486000;;1389338000;1275891000;5597590000
HBI;331419;USD;2014;Q4;2014-12-31;2015-02-06;403324000;407548000;239855000;672048000;1537200000;2550167000;674379000;;1983647000;2658026000;5208193000;621220000;369755000;1482414000;1613997000;2339007000;3821421000;294934000;;1464427000;1386772000;5208193000
HBI;331419;USD;2013;Q4;2013-12-31;2014-02-06;400584000;407328000;115863000;578558000;1283331000;2243666000;579883000;;1266499000;1846382000;4090048000;466270000;217982000;999278000;1467000000;1860147000;2859425000;286222000;;1181418000;1230623000;4090048000
HBI;331419;USD;2012;Q4;2012-12-31;2013-02-06;396096000;408020000;42796000;506278000;1253136000;2027525000;596158000;;1008017000;1604175000;3631700000;403644000;200052000;875668000;1317500000;1869166000;2744834000;293012000;;911467000;886866000;3631700000
HBI;331419;USD;2011;Q4;2011-12-31;2012-02-17;392736000;398624000;35345000;470713000;1607555000;2330791000;635406000;;1068472000;1703878000;4034669000;451525000;230008000;933719000;1807777000;2419889000;3353608000;;;;681061000;4034669000
HBI;331419;USD;2010;Q4;2010-12-31;2011-02-16;387032000;391296000;43671000;503243000;1322719000;2147671000;631254000;;1011077000;1642331000;3790002000;412369000;140678000;829350000;1990735000;2397978000;3227328000;295791000;;480098000;562674000;3790002000
HBI;331419;USD;2009;Q4;2009-12-31;2010-07-28;383968000;385060000;38943000;450541000;1049204000;1822557000;602826000;;901181000;1504007000;3326564000;351971000;231369000;878975000;1727547000;2112870000;2991845000;288909000;;268805000;334719000;3326564000
HBI;331419;USD;2017;Q4;2017-12-31;2018-02-09;365508000;366301000;421566000;903318000;1874990000;3386370000;623991000;;2884414000;3508405000;6894775000;867649000;261462000;1778745000;3702054000;4429828000;6208573000;275063000;;850345000;686202000;6894775000
HBI;331419;USD;2018;Q4;2018-12-31;2019-02-11;366649000;366837000;433022000;870878000;2054458000;3517589000;607688000;;3130681000;3738369000;7255958000;1029933000;446408000;2030242000;3534183000;4255433000;6285675000;288490000;;1184735000;970283000;7255958000
SSNI;331528;USD;2016;Q4;2016-12-31;2017-03-10;52049000;50507000;118259000;44770000;8040000;378374000;28986000;;39768000;68754000;447128000;70931000;;363191000;;115473000;478664000;618651000;;-648074000;-31536000;447128000
SSNI;331528;USD;2015;Q4;2015-12-31;2016-03-09;50496000;55147000;124445000;47813000;4545000;384506000;14106000;;59113000;73219000;457725000;73374000;;378845000;;112745000;491590000;594352000;;-626445000;-33865000;457725000
SSNI;331528;USD;2014;Q4;2014-12-31;2015-03-02;48949000;48949000;120796000;54740000;6722000;222267000;12860000;;313067000;325927000;548194000;51951000;;143888000;;538125000;682013000;573391000;;-706431000;-133819000;548194000
SSNI;331528;USD;2013;Q4;2013-12-31;2014-02-27;47711000;45315000;145852000;69724000;4350000;262144000;12364000;;241843000;254207000;516351000;52599000;1615000;166683000;;427786000;594469000;539013000;;-617261000;-78118000;516351000
SSNI;331528;USD;2012;Q4;2012-12-31;2013-05-09;3688000;;72646000;56528000;7731000;185659000;12701000;;219384000;232085000;417744000;42935000;1647000;142317000;56319000;492949000;635266000;51082000;;-550454000;-217522000;417744000
MA;331628;USD;2017;Q4;2017-12-31;2018-02-14;1057000000;1063000000;7782000000;1969000000;;13797000000;829000000;;6703000000;7532000000;21329000000;5573000000;0;8793000000;5424000000;6968000000;15761000000;4365000000;-20764000000;22364000000;5568000000;21329000000
MA;331628;USD;2016;Q4;2016-12-31;2017-02-15;1089000000;1092000000;8335000000;1416000000;;13228000000;733000000;;4714000000;5447000000;18675000000;4649000000;;7206000000;5180000000;5785000000;12991000000;4183000000;-17021000000;19418000000;5684000000;18675000000
MA;331628;USD;2015;Q4;2015-12-31;2016-02-12;1120000000;1122000000;6738000000;1079000000;;10984000000;675000000;;4591000000;5266000000;16250000000;3944000000;;6269000000;3268000000;3919000000;10188000000;4004000000;-13522000000;16222000000;6062000000;16250000000
MA;331628;USD;2014;Q4;2014-12-31;2015-02-13;1153000000;1158000000;6375000000;1109000000;;10997000000;615000000;;3717000000;4332000000;15329000000;3629000000;;6222000000;1494000000;2283000000;8505000000;3876000000;-9995000000;13169000000;6824000000;15329000000
MA;331628;USD;2013;Q4;2013-12-31;2014-02-14;1199000000;1204000000;6295000000;966000000;;10950000000;526000000;;2766000000;3292000000;14242000000;3325000000;;6032000000;0;715000000;6747000000;3762000000;-6577000000;10121000000;7495000000;14242000000
MA;331628;USD;2012;Q4;2012-12-31;2013-02-14;1240000000;1247000000;5003000000;925000000;;9357000000;472000000;;2633000000;3105000000;12462000000;2831000000;;4906000000;;627000000;5533000000;3641000000;-4139000000;7354000000;6929000000;12462000000
MA;331628;USD;2011;Q4;2011-12-31;2012-02-16;4732000000;4750000000;4949000000;808000000;;7741000000;449000000;;2503000000;2952000000;10693000000;2740000000;;4217000000;;599000000;4816000000;3519000000;-2394000000;4745000000;5877000000;10693000000
MA;331628;USD;2010;Q4;2010-12-31;2011-02-24;132000000;131000000;4198000000;650000000;;6454000000;439000000;142000000;1802000000;2383000000;8837000000;1587000000;;3143000000;;478000000;3621000000;3445000000;-1250000000;2915000000;5216000000;8837000000
MA;331628;USD;2009;Q4;2009-12-31;2010-02-18;130000000;130000000;2879000000;536000000;;5003000000;449000000;518000000;1500000000;2467000000;7470000000;2122000000;;3167000000;22000000;791000000;3958000000;3412000000;-1250000000;1148000000;3512000000;7470000000
MA;331628;USD;2008;Q4;2008-12-31;2009-07-31;128974000;128974000;2247255000;639482000;;4311507000;306798000;229210000;1628334000;2164342000;6475849000;1998372000;149380000;2990451000;19387000;1553423000;4543874000;3304618000;-1250000000;-236100000;1931975000;6475849000
MA;331628;USD;2018;Q4;2018-12-31;2019-02-13;1033000000;1039000000;8378000000;2276000000;;16171000000;921000000;;7768000000;8689000000;24860000000;6875000000;500000000;11593000000;5834000000;7778000000;19371000000;4580000000;-25750000000;27283000000;5489000000;24860000000
SCND;331831;USD;2018;Q4;2018-06-30;2018-09-28;1494112;1494112;1367800;1444100;2267900;5391500;199500;245400;1489100;1934000;7325500;1091500;;1273300;;350000;1623300;2621600;-52400;3131800;5702200;7325500
SCND;331831;USD;2017;Q4;2017-06-30;2017-09-28;1494110;1494072;1320600;1179000;1961200;4541100;199300;245400;1841900;2286600;6827700;636900;;812600;5800;187100;999700;2591600;-52400;3292300;5828000;6827700
SCND;331831;USD;2016;Q4;2016-06-30;2016-05-12;1489112;1490212;1535100;1231900;2412100;5366900;251100;;1931300;2182400;7549300;1198500;;1335000;12500;282300;1617300;2573900;-52400;3409600;5932000;7549300
SCND;331831;USD;2015;Q4;2015-06-30;2015-05-14;1485168;1492192;763800;1081700;2213700;4542000;235200;;2364200;2599400;7141400;947500;;1130700;0;260300;1391000;2562100;-52400;3244000;5750400;7141400
SCND;331831;USD;2014;Q4;2014-06-30;2014-05-15;1469457;1455722;909100;756700;2309200;4184100;252100;;2675600;2927700;7111800;843200;;1041700;;391000;1432700;2495100;-52400;3235300;5679100;7111800
SCND;331831;USD;2013;Q4;2013-06-30;2013-05-14;1337642;1349832;1835700;815900;1705600;4502800;156500;;1493700;1650200;6153000;642800;;677700;26700;78300;756000;2045000;-52400;3418000;5397000;6153000
SCND;331831;USD;2012;Q4;2012-06-30;2012-05-15;1334570;1361530;1487600;623500;1613700;3962800;180500;;1628900;1809400;5772200;428100;;545600;105000;193400;739000;2036500;-52400;3061700;5033200;5772200
SCND;331831;USD;2011;Q4;2011-06-30;2011-10-27;;;1601200;620000;1639800;4136400;175100;;701700;876800;5013200;412400;;412400;0;0;412400;1619300;-52400;3055400;4600800;5013200
CTAS;331923;USD;2017;Q4;2017-05-31;2017-07-31;105323000;108479000;191485000;736008000;278218000;1954478000;1323501000;164788000;3401290000;4889579000;6844057000;756495000;362900000;1130852000;2770624000;3410412000;4541264000;708992000;-3574000000;5170830000;2302793000;6844057000
CTAS;331923;USD;2016;Q4;2016-05-31;2016-07-29;106143000;108019000;209762000;546488000;249362000;1590579000;993692000;124952000;1389592000;2508236000;4098815000;555597000;250000000;815555000;1044422000;1440601000;2256156000;614942000;-3553276000;4805867000;1842659000;4098815000
CTAS;331923;USD;2015;Q4;2015-05-31;2015-07-30;113648000;115620000;433154000;496130000;226211000;1735807000;871421000;329692000;1255540000;2456653000;4192460000;507965000;0;508669000;1300000000;1751336000;2260005000;486431000;-2773125000;4227620000;1932455000;4192460000
CTAS;331923;USD;2014;Q4;2014-05-31;2014-07-30;119558000;121338000;513288000;508427000;251239000;1805681000;855702000;458357000;1342712000;2656771000;4462452000;540783000;503000;630131000;1300477000;1639463000;2269594000;386692000;-2221155000;3998893000;2192858000;4462452000
CTAS;331923;USD;2013;Q4;2013-05-31;2013-07-30;122409000;123300000;357953000;496049000;240440000;1624826000;986703000;101525000;1632578000;2720806000;4345632000;470900000;8187000;556256000;1300979000;1587884000;2144140000;296154000;-1850556000;3717771000;2201492000;4345632000
CTAS;331923;USD;2012;Q4;2012-05-31;2012-07-30;128793000;129109000;339825000;450861000;251205000;1538086000;952587000;;1675033000;2627620000;4165706000;447496000;225636000;675691000;1059166000;1350880000;2026571000;255274000;-1634875000;3482073000;2139135000;4165706000
CTAS;331923;USD;2011;Q4;2011-05-31;2011-07-29;143366000;143366000;525326000;429131000;249658000;1700777000;946218000;;1704945000;2651163000;4351940000;432804000;1335000;434139000;1284790000;1615152000;2049291000;231133000;-1242547000;3255256000;2302649000;4351940000
CTAS;331923;USD;2010;Q4;2010-05-31;2010-10-08;;;566087000;362219000;169484000;1520862000;894522000;;1554352000;2448874000;3969736000;383073000;609000;383682000;785444000;1052025000;1435707000;216674000;-798857000;3080079000;2534029000;3969736000
CTAS;331923;USD;2018;Q4;2018-05-31;2018-07-27;107734000;110710000;138724000;804583000;280347000;1977932000;1382730000;175581000;3421971000;4980282000;6958214000;775857000;;775857000;2535309000;3165831000;3941688000;863675000;-3701319000;5837827000;3016526000;6958214000
CTAS;331923;USD;2019;Q4;2019-05-31;2019-07-26;105930000;109296000;96645000;910120000;334589000;2236280000;1430685000;192346000;3577351000;5200382000;7436662000;815469000;312264000;1127733000;2537507000;3306208000;4433941000;1068256000;-4717619000;6691236000;3002721000;7436662000
WOR;332221;USD;2017;Q4;2017-05-31;2017-07-24;62789000;65457000;278081000;486730000;353934000;1190969000;570489000;208591000;355295000;1134375000;2325344000;513969000;6814000;520783000;571796000;730632000;1251415000;;;;1073929000;2325344000
WOR;332221;USD;2016;Q4;2016-05-31;2016-08-01;61460000;64421000;84188000;439688000;319335000;915115000;582838000;191826000;371485000;1146149000;2061264000;426565000;3513000;430078000;577491000;711340000;1141418000;298984000;;522952000;919846000;2061264000
WOR;332221;USD;2015;Q4;2015-05-31;2015-07-30;64205000;74518000;31067000;474292000;374975000;992193000;513190000;196776000;382983000;1092949000;2085142000;433001000;91391000;524392000;579352000;720701000;1245093000;289078000;;510738000;840049000;2085142000
WOR;332221;USD;2014;Q4;2014-05-31;2014-07-30;68963000;79843000;190079000;493127000;410002000;1198922000;498861000;179113000;419485000;1097459000;2296381000;478128000;111535000;589663000;554790000;761836000;1351499000;262610000;;591783000;944882000;2296381000
WOR;332221;USD;2013;Q4;2013-05-31;2013-07-30;69297000;73360000;51385000;394327000;356768000;866883000;459430000;246125000;378419000;1083974000;1950857000;334094000;114820000;448914000;406236000;629706000;1078620000;244864000;;597994000;872237000;1950857000
WOR;332221;USD;2012;Q4;2012-05-31;2012-07-30;68764000;69725000;41028000;400869000;401940000;914239000;443077000;240882000;279599000;963558000;1877797000;382011000;276252000;658263000;257462000;472097000;1130360000;192338000;;525223000;747437000;1877797000
WOR;332221;USD;2011;Q4;2011-05-31;2011-08-01;73321000;74878000;56167000;388550000;370830000;891635000;405334000;232149000;138131000;775614000;1667249000;392046000;132956000;525002000;250254000;401544000;926546000;181525000;;504410000;740703000;1667249000
WOR;332221;USD;2010;Q4;2010-05-31;2010-10-12;79201000;79236000;59016000;301455000;364331000;782285000;506163000;113001000;118898000;738062000;1520347000;379802000;;379802000;250238000;390511000;770313000;189918000;;532126000;750034000;1520347000
WOR;332221;USD;2018;Q4;2018-05-31;2018-07-30;59362000;61765000;121967000;572689000;454027000;1241122000;584970000;216010000;579685000;1380665000;2621787000;645421000;1474000;646895000;748894000;938517000;1585412000;295592000;;637757000;1036375000;2621787000
WOR;332221;USD;2019;Q4;2019-05-31;2019-07-30;55859000;57359000;92363000;501944000;484280000;1165913000;578664000;214930000;551289000;1344883000;2510796000;547077000;150943000;698020000;598356000;864382000;1562402000;;;;948394000;2510796000
SMIT;332324;USD;2018;Q4;2018-05-31;2018-08-21;3993026;4051533;2053181;2047032;5710888;10018377;770915;;496768;1267683;11286060;1770404;;1770404;;;1770404;13085652;;-3033689;9515656;11286060
SMIT;332324;USD;2017;Q4;2017-05-31;2017-08-15;2995910;2995910;867607;2344373;4204723;7539769;865224;;601351;1466575;9006344;2028957;;2028957;;0;2028957;10649287;;-3244328;6977387;9006344
SMIT;332324;USD;2016;Q4;2016-05-31;2016-04-13;2995910;2995910;988686;2099082;4727977;7956407;965452;;712881;1678333;9634740;1630700;;1630700;;0;1630700;10569522;;-2170964;8004040;9634740
SMIT;332324;USD;2015;Q4;2015-05-31;2015-04-09;2995910;2992648;1795654;2660426;4557567;9168646;1110878;;824411;1935289;11103935;1615331;;1615331;;0;1615331;10511324;;-655775;9488604;11103935
SMIT;332324;USD;2014;Q4;2014-05-31;2014-04-11;3010910;3010910;1510565;2235194;4789822;8689157;1191591;;943643;2135234;10824391;1211084;;1211084;;0;1211084;10438750;;-562106;9613307;10824391
SMIT;332324;USD;2013;Q4;2013-05-31;2013-04-09;2990910;2976529;1909071;1980685;5054087;9211430;1334890;;1078278;2413168;11624598;1609480;;1609480;;0;1609480;10369524;;-22482;10015118;11624598
SMIT;332324;USD;2012;Q4;2012-05-31;2012-04-10;2989892;2947720;2776817;2493889;3975600;9440575;1372136;;1213204;2585340;12025915;1534674;;1534674;;7500;1542174;10279636;;517400;10483741;12025915
SMIT;332324;USD;2011;Q4;2011-05-31;2011-10-11;2895642;2842342;2760506;1831811;4146408;8905504;1334175;;1349583;2683758;11589262;1431954;;1431954;;;1431954;9943910;;439979;10157308;11589262
SMIT;332324;USD;2019;Q4;2019-05-31;2019-08-21;4033100;4033100;1411732;1996240;5019044;8633694;839374;;392185;1231559;9865253;1154713;20828;1363777;;28543;1392320;13245439;;-4244679;8472933;9865253
VLGEA;333215;USD;2018;Q4;2018-07-31;2018-10-11;14027000;18331000;96108000;;39413000;190898000;214566000;;76126000;290692000;481590000;100933000;764000;101697000;48186000;76748000;178445000;62377000;-9151000;258104000;303145000;481590000
VLGEA;333215;USD;2017;Q4;2017-07-31;2017-10-12;14053000;18362000;87435000;;41852000;181472000;204440000;;69313000;273753000;455225000;95541000;652000;96193000;42646000;72212000;168405000;58551000;-8633000;244308000;286820000;455225000
VLGEA;333215;USD;2016;Q4;2016-07-31;2016-10-12;13890000;18204000;88379000;;42011000;159834000;201470000;;88950000;290420000;450254000;98782000;514000;99296000;43561000;79223000;178519000;55897000;-4998000;234175000;271735000;450254000
VLGEA;333215;USD;2015;Q4;2015-07-31;2015-10-07;13898000;18268000;59040000;;45772000;135911000;206594000;;89384000;295978000;431889000;93682000;469000;94151000;44425000;84971000;179122000;52319000;-4443000;221765000;252767000;431889000
VLGEA;333215;USD;2014;Q4;2014-07-31;2014-10-08;13771000;22678000;77352000;;44694000;162786000;206720000;;87906000;294626000;457412000;145773000;231000;146004000;45242000;78272000;224276000;47764000;-5885000;203722000;233136000;457412000
VLGEA;333215;USD;2013;Q4;2013-07-31;2013-10-08;13533000;18430000;109571000;;41515000;205364000;176981000;;45067000;222048000;427412000;111055000;10000;111065000;42738000;71787000;182852000;41918000;;211109000;244560000;427412000
VLGEA;333215;USD;2012;Q4;2012-07-31;2012-11-05;13424000;19839000;103103000;;40599000;171578000;172420000;;65540000;237960000;409538000;99906000;;99906000;43149000;79321000;179227000;36412000;;209373000;230311000;409538000
VLGEA;333215;USD;2011;Q4;2011-07-31;2011-12-08;;;91362000;;38547000;152334000;174530000;;59326000;233856000;386190000;107886000;0;107886000;43147000;70147000;178033000;31613000;;187686000;208157000;386190000
VLGEA;333215;USD;2019;Q4;2019-07-31;2019-10-10;14059000;18324000;101121000;;38503000;218989000;224890000;;58410000;283300000;502289000;111452000;1022000;112474000;47725000;71143000;183617000;65811000;-9550000;270753000;318672000;502289000
TSRI;333363;USD;2017;Q4;2017-05-31;2017-08-15;1962062;1962062;6744864;7342746;;14464840;20650;;49653;70303;14535143;5444954;;6775668;;0;6775668;5134010;-13514003;16118011;7759475;14535143
TSRI;333363;USD;2016;Q4;2016-05-31;2016-07-28;1962062;1962062;6067429;7714533;;14009031;27998;;52653;80651;14089682;3372625;;4618188;;0;4618188;5134010;-13514003;17811884;9471494;14089682
TSRI;333363;USD;2015;Q4;2015-05-31;2015-07-30;1962062;1962062;4941358;8757242;;13934696;38931;;77653;116584;14051280;3516824;;4948346;;0;4948346;5134010;-13514003;17412658;9102934;14051280
TSRI;333363;USD;2014;Q4;2014-05-31;2014-08-04;1962062;1962062;4356823;8799668;;13348838;34095;;179653;213748;13562586;3150562;;4642508;;0;4642508;5134010;-13514003;17219947;8920078;13562586
TSRI;333363;USD;2013;Q4;2013-05-31;2013-08-08;1962062;1962062;3889585;9151299;;13406389;16784;;195653;212437;13618826;3241234;;4689489;;0;4689489;5134010;-13514003;17305883;8929337;13618826
TSRI;333363;USD;2012;Q4;2012-05-31;2012-08-06;1984310;1984310;8035421;8731411;;17047092;20819;;96653;117472;17164564;3162620;;4645272;;0;4645272;5134010;-13432092;20796104;12519292;17164564
TSRI;333363;USD;2011;Q4;2011-05-31;2011-10-05;;;7662396;8926842;;17024318;16249;;100653;116902;17141220;2878587;;4386026;;0;4386026;5134010;-13279263;20858282;12755194;17141220
TSRI;333363;USD;2018;Q4;2018-05-31;2018-08-21;1962062;1962062;5860597;7229917;;13217072;27726;;127653;155379;13372451;3892441;;5103673;;0;5103673;5134010;-13514003;16604219;8268778;13372451
TSRI;333363;USD;2019;Q4;2019-05-31;2019-08-29;1962062;1962062;4222221;7448902;;11841990;6502;;685653;692155;12534145;4427108;;5617122;;0;5617122;5134010;-13514003;15268224;6917023;12534145
MHK;333439;USD;2015;Q4;2015-12-31;2016-02-29;73897000;74448000;81692000;1257505000;1607256000;3249972000;3147118000;;3537310000;6684428000;9934400000;1256025000;2003003000;3259028000;1188964000;1792557000;5051585000;1760829000;-215795000;4102707000;4882815000;9934400000
MHK;333439;USD;2014;Q4;2014-12-31;2015-02-27;72910000;73497000;97877000;1081963000;1543313000;2980486000;2703210000;;2601848000;5305058000;8285544000;1095419000;851305000;1946724000;1402135000;1916007000;3862731000;1599698000;-239450000;3487079000;4422813000;8285544000
MHK;333439;USD;2013;Q4;2013-12-31;2014-02-28;72736000;73353000;54066000;1062875000;1572325000;3085718000;2701743000;;2706716000;5408459000;8494177000;1193593000;127218000;1320811000;2132790000;2703060000;4023871000;1567793000;-239234000;2953809000;4470306000;8494177000
MHK;333439;USD;2012;Q4;2012-12-31;2013-02-27;69096000;69487000;477672000;679473000;1133736000;2550046000;1692852000;;2060786000;3753638000;6303684000;773436000;55213000;828649000;1327729000;1755418000;2584067000;1278323000;-323462000;2605023000;3719617000;6303684000
MHK;333439;USD;2011;Q4;2011-12-31;2012-02-29;68767000;69017000;311945000;686165000;1113630000;2398164000;1712154000;;2095910000;3808064000;6206228000;715091000;386255000;1101346000;1200184000;1655374000;2756720000;1248929000;-323548000;2354765000;3449508000;6206228000
MHK;333439;USD;2010;Q4;2010-12-31;2011-03-01;68611000;68844000;354217000;614473000;1007503000;2248613000;1687124000;;2163189000;3850313000;6098926000;698326000;350588000;1048914000;1302994000;1743015000;2791929000;1236242000;-323626000;2180843000;3306997000;6098926000
MHK;333439;USD;2009;Q4;2009-12-31;2010-08-06;68470000;68470000;531458000;673931000;892981000;2359000000;1791412000;;2241034000;4032446000;6391446000;831115000;52907000;884022000;1801572000;2273142000;3157164000;1228651000;-323361000;1998616000;3234282000;6391446000
MHK;333439;USD;2016;Q4;2016-12-31;2017-02-27;74163000;74595000;121665000;1376151000;1675751000;3471512000;3370348000;;3388736000;6759084000;10230596000;1335582000;1382738000;2718320000;1128747000;1705093000;4423413000;1792355000;-215791000;5032914000;5807183000;10230596000
MHK;333439;USD;2017;Q4;2017-12-31;2018-02-28;74551000;74960000;84884000;1558159000;1948663000;4072967000;4270790000;;3751096000;8021886000;12094853000;1451672000;1203683000;2655355000;1559895000;2343026000;4998381000;1828949000;-215766000;6004506000;7096472000;12094853000
MHK;333439;USD;2018;Q4;2018-12-31;2019-02-28;73999000;74281000;119050000;1606159000;2287615000;4509296000;4699902000;;3889925000;8589827000;13099123000;1523866000;1742373000;3266239000;1515601000;2392825000;5659064000;1852970000;-215745000;6588197000;7440059000;13099123000
MCHP;333440;USD;2017;Q4;2018-03-31;2018-05-18;267625000;313189000;2196600000;563700000;476200000;3356300000;767900000;;4133000000;4900900000;8257200000;373700000;1309900000;2017400000;1758400000;2960000000;4977400000;2562700000;-662600000;1397300000;3279800000;8257200000
MCHP;333440;USD;2016;Q4;2017-03-31;2016-02-05;203735000;217711000;1302800000;478400000;417200000;2305000000;683300000;107500000;4591100000;5381900000;7686900000;361700000;50000000;704500000;2900500000;3711700000;4416200000;2537600000;-731900000;1479400000;3270700000;7686900000
MCHP;333440;USD;2015;Q4;2016-03-31;2015-02-03;201729000;220946000;2446035000;290183000;306815000;3096713000;609396000;118549000;1713225000;2441170000;5537883000;198577000;0;382009000;2453405000;3004955000;3386964000;1391757000;-820066000;1582585000;2150919000;5537883000
MCHP;333440;USD;2014;Q4;2015-03-31;2014-02-07;199630000;222690000;1344785000;242405000;262725000;1969399000;531967000;798712000;767552000;2098231000;4067630000;170781000;17500000;336079000;1003258000;1596090000;1932169000;1244783000;-577382000;1467009000;2135461000;4067630000
MCHP;333440;USD;2013;Q4;2014-03-31;2013-02-11;195910000;220939000;1578597000;229955000;242334000;2236370000;514544000;257450000;843041000;1615035000;3851405000;202659000;0;341611000;983385000;1576324000;1917935000;1255823000;-682220000;1352932000;1933470000;3851405000
MCHP;333440;USD;2012;Q4;2013-03-31;2012-02-06;192571000;206019000;1459009000;170201000;217278000;2015861000;516611000;328586000;222718000;1067915000;3083776000;139164000;;247873000;355050000;845230000;1093103000;1269100000;-780893000;1499365000;1990673000;3083776000
MCHP;333440;USD;2011;Q4;2012-03-31;2011-02-08;188933000;201829000;1243496000;181202000;180800000;1774983000;540513000;464838000;187724000;1193075000;2968058000;200272000;;340316000;347334000;815304000;1155620000;1268318000;-888075000;1428838000;1812438000;2968058000
MCHP;333440;USD;2010;Q4;2011-03-31;2010-06-02;734018097;748795690;1214323000;137806000;116579000;1610969000;493039000;317215000;95090000;905344000;2516313000;104449000;;203390000;340672000;779543000;982933000;1277007000;-1013358000;1266699000;1533380000;2516313000
MCHP;333440;USD;2009;Q4;2010-03-31;2009-08-10;364596144;368995474;1389945000;88525000;131510000;1742789000;531687000;50826000;80409000;662922000;2405711000;71714000;;155645000;334184000;759755000;915400000;1282119000;-1095370000;1299250000;1490311000;2405711000
MCHP;333440;USD;2018;Q4;2019-03-31;2019-05-30;237100000;251000000;430900000;880600000;711700000;2214800000;996700000;;15138500000;16135200000;18350000000;1013700000;1360800000;2374500000;8946200000;10688000000;13062500000;2679800000;-582200000;3210600000;5287500000;18350000000
MNST;333441;USD;2015;Q4;2015-12-31;2016-02-29;610071000;621165000;2920027000;352955000;156121000;3582602000;97354000;15348000;1979885000;2092587000;5675189000;481918000;;514189000;;351590000;865779000;3992892000;-556467000;1394863000;4809410000;5675189000
MNST;333441;USD;2014;Q4;2014-12-31;2014-05-12;503013000;525495000;1151457000;280755000;174573000;1653154000;90156000;42940000;152625000;285721000;1938875000;305790000;;355716000;;68009000;423725000;427180000;-1231087000;2330510000;1515150000;1938875000
MNST;333441;USD;2013;Q4;2013-12-31;2014-03-03;501861000;521073000;613596000;296180000;221449000;1183043000;88143000;9792000;139531000;237466000;1420509000;302182000;;316014000;;112216000;428230000;369099000;-1222912000;1847325000;992279000;1420509000
MNST;333441;USD;2012;Q4;2012-12-31;2013-03-01;506412000;530661000;319556000;236710000;203106000;835068000;69137000;21393000;117727000;208257000;1043325000;275850000;;288545000;;110383000;398928000;288972000;-1155313000;1508664000;644397000;1043325000
MNST;333441;USD;2011;Q4;2011-12-31;2012-02-29;522264000;556800000;770613000;218741000;155613000;1182677000;45151000;23194000;111377000;179722000;1362399000;254507000;;266090000;;117151000;383241000;230295000;-418234000;1168644000;979158000;1362399000
MNST;333441;USD;2010;Q4;2010-12-31;2011-03-01;532518000;559314000;599491000;166454000;153241000;962972000;34551000;44189000;105238000;183978000;1146950000;183513000;;193653000;;124899000;318552000;187534000;-241842000;882425000;828398000;1146950000
MNST;333441;USD;2009;Q4;2009-12-31;2010-08-09;532368000;560352000;346836000;108905000;108143000;585504000;33314000;80836000;100416000;214566000;800070000;74398000;206000;83729000;;131388000;215117000;137526000;-218302000;670396000;584953000;800070000
MNST;333441;USD;2016;Q4;2016-12-31;2017-03-01;568584000;580355000;598136000;448051000;161971000;1432270000;173343000;2394000;2545464000;2721201000;4153471000;428917000;;470589000;;353173000;823762000;4054361000;-2808951000;2107548000;3329709000;4153471000
MNST;333441;USD;2017;Q4;2017-12-31;2018-03-01;559762000;570144000;1201555000;449476000;255745000;2086377000;230276000;2366000;2471993000;2704635000;4791012000;517115000;;560351000;;335449000;895800000;4153774000;-3170129000;2928226000;3895212000;4791012000
MNST;333441;USD;2018;Q4;2018-12-31;2019-02-28;550103000;556580000;958163000;484562000;277705000;1804170000;243051000;;2479670000;2722721000;4526891000;557100000;;601145000;;314845000;915990000;4241325000;-4512205000;3914645000;3610901000;4526891000
MYL;333504;USD;2015;Q4;2015-12-31;2016-02-16;490200000;509900000;1236000000;2689100000;1951000000;6472700000;1983900000;;13811100000;15795000000;22267700000;1202000000;1078300000;4122200000;6295600000;8379700000;12501900000;7134100000;-67500000;4462100000;9765800000;22267700000
MYL;333504;USD;2014;Q4;2014-12-31;2015-05-08;374600000;400600000;225500000;2268500000;1651400000;6441200000;1785700000;;7593600000;9379300000;15820500000;1066300000;2803600000;5304000000;5699900000;7240500000;12544500000;4486100000;-3857700000;3614500000;3276000000;15820500000
MYL;333504;USD;2016;Q4;2016-12-31;2017-03-01;534200000;539100000;998800000;3310900000;2456400000;7522500000;2322200000;;24881500000;27203700000;34726200000;1445800000;336400000;5040700000;15202900000;18567900000;23608600000;8505300000;-67500000;4942100000;11117600000;34726200000
MYL;333504;USD;2017;Q4;2017-12-31;2018-03-01;533300000;535900000;292100000;3612400000;2542700000;7213300000;2339100000;;26253900000;28593000000;35806300000;1565400000;1855400000;6385300000;12865300000;16113400000;22498700000;8592000000;-567700000;5644500000;13307600000;35806300000
MYL;333504;USD;2018;Q4;2018-12-31;2019-02-27;514700000;516400000;388100000;2881000000;2580200000;6367700000;2170200000;;24197000000;26367200000;32734900000;1738500000;701700000;4587800000;13161200000;15980000000;20567800000;8597400000;-999700000;6010700000;12167100000;32734900000
MUR;333627;USD;2016;Q4;2016-12-31;2017-02-24;172181772;171578859;984339000;357099000;127071000;1559183000;8316188000;;420489000;8736677000;10295860000;929839000;569817000;1502432000;2422750000;3876749000;5379181000;1111855000;-1296560000;5729596000;4916679000;10295860000
MUR;333627;USD;2015;Q4;2015-12-31;2016-02-26;172976474;172469017;456471000;522672000;166788000;1397233000;9818365000;;278214000;10096579000;11493812000;1648451000;18881000;1674629000;3040594000;4512455000;6187084000;1105130000;-1306061000;6212201000;5306728000;11493812000
MUR;333627;USD;2014;Q4;2014-12-31;2015-02-27;178008260;178806268;1654621000;873277000;242733000;3279149000;13331047000;;113542000;13444589000;16723738000;2530951000;465388000;3147887000;2517669000;5002417000;8150304000;1101781000;-1086124000;8728032000;8573434000;16723738000
MUR;333627;USD;2013;Q4;2013-12-31;2014-02-28;184933573;187037893;1124997000;999872000;294195000;3508643000;13481055000;;519786000;14000841000;17509484000;2558642000;26249000;3224031000;2936563000;5689723000;8913754000;1097553000;-732734000;8058792000;8595730000;17509484000
MUR;333627;USD;2012;Q4;2012-12-31;2013-02-28;131863301;132308573;1062919000;1853364000;752310000;4108583000;13011606000;;402454000;13414060000;17522643000;3358953000;46000;3409081000;2245201000;5171527000;8580608000;1068550000;-252805000;7717389000;8942035000;17522643000
MUR;333627;USD;2011;Q4;2011-12-31;2012-02-28;101892070;101864831;1045966000;1554184000;666638000;3447671000;10475149000;;215318000;10690467000;14138138000;2452351000;350005000;2824928000;249553000;2534813000;5359741000;1011883000;-4848000;7460942000;8778397000;14138138000
MUR;333627;USD;2010;Q4;2010-12-31;2011-02-28;222998786;223603350;1152383000;1467311000;762213000;3550693000;10367847000;;314703000;10682550000;14233243000;2913553000;41000;2930910000;939350000;3102783000;6033693000;961056000;-11926000;6800992000;8199550000;14233243000
MUR;333627;USD;2009;Q4;2009-12-31;2010-02-26;221137229;222995590;1080169000;1463297000;733982000;3375695000;9065088000;;315576000;9380664000;12756359000;2181570000;38000;2181608000;1353183000;3228725000;5410333000;872307000;-17784000;6204316000;7346026000;12756359000
MUR;333627;USD;2008;Q4;2008-12-31;2009-08-07;219946366;222192244;1086450000;1033996000;604173000;2846964000;7727718000;;574416000;8302134000;11149098000;1885574000;2572000;1888146000;1026222000;2982007000;4870153000;823108000;-13949000;5557483000;6278945000;11149098000
MUR;333627;USD;2017;Q4;2017-12-31;2018-02-26;172542944;171876702;964988000;243472000;105127000;1583146000;8220031000;;57765000;8277796000;9860942000;820775000;9902000;834207000;2906520000;4406544000;5240751000;1112721000;-1275529000;5245242000;4620191000;9860942000
MUR;333627;USD;2018;Q4;2018-12-31;2019-02-28;173003027;174057649;359923000;231686000;80024000;1026011000;8432133000;;1594443000;10026576000;11052587000;558932000;668000;846058000;3109318000;5008887000;5854945000;1174719000;-1249162000;5513529000;5197642000;11052587000
NLSN;333689;USD;2015;Q4;2015-12-31;2016-02-19;362954208;366390287;357000000;1235000000;;1908000000;490000000;;12905000000;13395000000;15303000000;1055000000;310000000;1687000000;7028000000;8989000000;10676000000;5151000000;;341000000;4627000000;15303000000
NLSN;333689;USD;2014;Q4;2014-12-31;2015-02-20;377678995;381498005;273000000;1241000000;;2011000000;533000000;;12782000000;13315000000;15326000000;1097000000;393000000;1794000000;6419000000;8399000000;10193000000;6376000000;-415000000;-128000000;5133000000;15326000000
NLSN;333689;USD;2013;Q4;2013-12-31;2014-02-21;378436651;384293436;564000000;1196000000;;2134000000;560000000;;12836000000;13396000000;15530000000;1081000000;148000000;1535000000;6492000000;8188000000;9723000000;6628000000;;-512000000;5807000000;15530000000
NLSN;333689;USD;2012;Q4;2012-12-31;2013-02-22;362724731;367425639;288000000;1110000000;;1676000000;560000000;;12349000000;12909000000;14585000000;1023000000;355000000;1751000000;6229000000;7856000000;9607000000;6515000000;;-1252000000;4978000000;14585000000
NLSN;333689;USD;2011;Q4;2011-12-31;2012-02-22;360454762;370083967;319000000;1080000000;;1665000000;609000000;;12230000000;12839000000;14504000000;1105000000;144000000;1692000000;6619000000;8171000000;9863000000;6457000000;;-1525000000;4641000000;14504000000
NLSN;333689;USD;2010;Q4;2010-12-31;2011-07-28;276545786;280379828;421000000;1014000000;;1654000000;599000000;;12176000000;12775000000;14429000000;1061000000;94000000;1607000000;8464000000;9926000000;11533000000;4592000000;;-1609000000;2896000000;14429000000
NLSN;333689;USD;2016;Q4;2016-12-31;2017-02-17;357386687;359675693;754000000;1171000000;;2222000000;471000000;;13037000000;13508000000;15730000000;1109000000;188000000;1594000000;7738000000;9843000000;11437000000;4857000000;;456000000;4293000000;15730000000
NLSN;333689;USD;2017;Q4;2017-12-31;2018-02-08;356203354;357377582;656000000;1280000000;;2282000000;482000000;;14102000000;14584000000;16866000000;1252000000;84000000;1697000000;8357000000;10726000000;12423000000;4774000000;;411000000;4443000000;16866000000
NLSN;333689;USD;2018;Q4;2018-12-31;2019-02-28;355178890;353194577;524000000;1118000000;;2003000000;468000000;;12708000000;13176000000;15179000000;1195000000;107000000;1657000000;8280000000;10479000000;12136000000;4752000000;;-795000000;3043000000;15179000000
NOC;333824;USD;2016;Q4;2016-12-31;2017-01-30;176100000;177500000;2541000000;3299000000;816000000;6856000000;3588000000;;15170000000;18758000000;25614000000;4367000000;;5630000000;7058000000;14725000000;20355000000;175000000;;10630000000;5259000000;25614000000
NOC;333824;USD;2015;Q4;2015-12-31;2016-02-01;182300000;184300000;2319000000;2841000000;807000000;6334000000;3064000000;;15026000000;18090000000;24424000000;4014000000;;5457000000;6386000000;13445000000;18902000000;181000000;;10661000000;5522000000;24424000000
NOC;333824;USD;2014;Q4;2014-12-31;2015-02-02;200300000;203600000;3863000000;2806000000;742000000;7780000000;2991000000;;15801000000;18792000000;26572000000;4459000000;;5892000000;5925000000;13445000000;19337000000;199000000;;12392000000;7235000000;26572000000
NOC;333824;USD;2013;Q4;2013-12-31;2014-02-03;219800000;224500000;5150000000;2685000000;698000000;9488000000;2806000000;;14087000000;16893000000;26381000000;4397000000;;5815000000;5928000000;9946000000;15761000000;1066000000;;12538000000;10620000000;26381000000
NOC;333824;USD;2012;Q4;2012-12-31;2013-02-05;243300000;248800000;3862000000;2858000000;798000000;8392000000;2887000000;;15264000000;18151000000;26543000000;4324000000;;6056000000;3930000000;10973000000;17029000000;3163000000;;11138000000;9514000000;26543000000
NOC;333824;USD;2011;Q4;2011-12-31;2012-02-08;257900000;263000000;3002000000;2964000000;873000000;7746000000;3047000000;;14618000000;17665000000;25411000000;4454000000;;6135000000;3935000000;8940000000;15075000000;4127000000;;9699000000;10336000000;25411000000
NOC;333824;USD;2010;Q4;2010-12-31;2011-02-09;292000000;296900000;3701000000;3329000000;896000000;13774000000;3045000000;;14591000000;17636000000;31410000000;4688000000;784000000;10027000000;3940000000;7947000000;17974000000;8069000000;;8124000000;13436000000;31410000000
NOC;333824;USD;2009;Q4;2009-12-31;2010-02-09;207631200;210196200;3275000000;3394000000;1170000000;8635000000;4868000000;;16749000000;21617000000;30252000000;5156000000;103000000;6985000000;4191000000;10580000000;17565000000;8964000000;;6737000000;12687000000;30252000000
NOC;333824;USD;2008;Q4;2008-12-31;2009-10-21;361591560;337020600;1504000000;3701000000;1003000000;8243000000;4785000000;;17169000000;21954000000;30197000000;5146000000;501000000;7449000000;3443000000;10828000000;18277000000;9972000000;;5590000000;11920000000;30197000000
NOC;333824;USD;2017;Q4;2017-12-31;2018-01-29;174100000;175500000;11225000000;1054000000;398000000;16587000000;4225000000;;14316000000;18541000000;35128000000;4804000000;;7092000000;14399000000;20904000000;27996000000;218000000;;11632000000;7132000000;35128000000
NOC;333824;USD;2018;Q4;2018-12-31;2019-01-31;171900000;172700000;1579000000;1448000000;654000000;9680000000;6372000000;;21601000000;27973000000;37653000000;5775000000;;8274000000;13883000000;21192000000;29466000000;171000000;;8068000000;8187000000;37653000000
MSI;333970;USD;2017;Q4;2017-12-31;2018-02-16;162000000;143700000;1205000000;1523000000;327000000;3950000000;856000000;247000000;3155000000;4258000000;8208000000;2879000000;52000000;2931000000;4419000000;7004000000;9935000000;353000000;;467000000;-1727000000;8208000000
MSI;333970;USD;2016;Q4;2016-12-31;2017-02-21;165700000;171000000;967000000;1410000000;273000000;3468000000;789000000;238000000;3968000000;4995000000;8463000000;2664000000;4000000;2668000000;4392000000;6747000000;9415000000;205000000;;1148000000;-952000000;8463000000
MSI;333970;USD;2015;Q4;2015-12-31;2016-02-23;175900000;178600000;1980000000;1362000000;296000000;4619000000;487000000;231000000;3009000000;3727000000;8346000000;2189000000;4000000;2193000000;4345000000;6249000000;8442000000;44000000;;1716000000;-96000000;8346000000
MSI;333970;USD;2014;Q4;2014-12-31;2015-02-13;228300000;219700000;3954000000;1409000000;345000000;6879000000;549000000;316000000;2679000000;3544000000;10423000000;2246000000;4000000;2250000000;3396000000;5407000000;7657000000;1180000000;;3410000000;2766000000;10423000000
MSI;333970;USD;2013;Q4;2013-12-31;2014-02-13;257800000;261300000;3225000000;1369000000;347000000;7020000000;610000000;232000000;3989000000;4831000000;11851000000;2346000000;4000000;3220000000;2457000000;4942000000;8162000000;3521000000;;2425000000;3689000000;11851000000
MSI;333970;USD;2012;Q4;2012-12-31;2013-02-12;283400000;288400000;3603000000;1881000000;513000000;7401000000;839000000;240000000;4199000000;5278000000;12679000000;3331000000;4000000;3335000000;1859000000;6054000000;9389000000;4940000000;;1625000000;3290000000;12679000000
MSI;333970;USD;2011;Q4;2011-12-31;2012-02-15;321200000;326600000;5091000000;1866000000;512000000;8768000000;896000000;166000000;4099000000;5161000000;13929000000;3410000000;405000000;3815000000;1130000000;4840000000;8655000000;7074000000;;1016000000;5274000000;13929000000
MSI;333970;USD;2010;Q4;2010-12-31;2011-02-18;335600000;345900000;8863000000;1547000000;521000000;17154000000;922000000;242000000;7259000000;8423000000;25577000000;3305000000;605000000;8710000000;2098000000;5880000000;14590000000;8647000000;;4460000000;10987000000;25577000000
MSI;333970;USD;2009;Q4;2009-12-31;2010-02-16;-389027600;-389043360;7963000000;2845000000;1097000000;16032000000;1819000000;522000000;7230000000;9571000000;25603000000;6139000000;536000000;8261000000;3365000000;7459000000;15720000000;8234000000;;3827000000;9883000000;25603000000
MSI;333970;USD;2008;Q4;2008-12-31;2009-08-26;-384530620;-384530620;6979000000;3493000000;2659000000;17363000000;2442000000;983000000;7081000000;10506000000;27869000000;10528000000;92000000;10620000000;4092000000;7654000000;18274000000;7834000000;;3878000000;9595000000;27869000000
MSI;333970;USD;2018;Q4;2018-12-31;2019-02-15;163400000;173100000;1246000000;1293000000;356000000;4272000000;895000000;169000000;4073000000;5137000000;9409000000;1802000000;31000000;3096000000;5289000000;7589000000;10685000000;421000000;;1051000000;-1276000000;9409000000
OKE;334076;USD;2015;Q4;2015-12-31;2016-02-23;210458000;210696000;97619000;593979000;204780000;975210000;12373989000;948221000;1148691000;14470901000;15446111000;745025000;656990000;1638266000;8323582000;10041509000;11679775000;1380902000;-917862000;0;3766336000;15446111000
OKE;334076;USD;2014;Q4;2014-12-31;2015-02-25;209542000;210267000;172812000;745494000;189967000;1307244000;11662437000;1132653000;1159439000;13954529000;15261773000;996290000;1065946000;2392345000;7150142000;8863545000;11255890000;1544041000;-953701000;138128000;4005883000;15261773000
OKE;334076;USD;2013;Q4;2013-12-31;2014-02-25;206319000;210555000;145565000;1109510000;188286000;2404724000;9231954000;1229838000;4874965000;15336757000;17741481000;1273102000;575112000;2730330000;7753657000;10165971000;12896301000;1436058000;-997035000;2020815000;4845180000;17741481000
OKE;334076;USD;2012;Q4;2012-12-31;2013-02-26;116494229;119146649;583618000;1349371000;517014000;2764660000;10114340000;1221405000;1754870000;13090615000;15855275000;1333489000;828025000;2812994000;6515372000;8809831000;11622825000;1327156000;-1039773000;2059024000;4232450000;15855275000
OKE;334076;USD;2011;Q4;2011-12-31;2012-02-21;600905518;615417940;65953000;1339933000;549915000;2318812000;8444333000;1223398000;1710092000;11377823000;13696635000;1341718000;1206373000;3246175000;4529551000;6650728000;9896903000;1419643000;-935323000;1960374000;3799732000;13696635000
OKE;334076;USD;2010;Q4;2010-12-31;2011-02-22;971219671;984158586;30341000;1283891000;706912000;2379735000;7312948000;1188124000;1618368000;10119440000;12499175000;1212323000;1200091000;3151431000;3686542000;5426903000;8578334000;1393899000;-663274000;1826800000;3920841000;12499175000
OKE;334076;USD;2009;Q4;2009-12-31;2010-02-23;-720718039;-725858323;29399000;1437994000;583127000;2588464000;7793658000;765163000;1680398000;10239219000;12827683000;1240207000;1150085000;3338912000;4334204000;6043309000;9382221000;1323564000;-683467000;1685710000;3445462000;12827683000
OKE;334076;USD;2008;Q4;2008-12-31;2009-08-06;-713965289;-724396855;510058000;1265300000;858966000;3377602000;7263769000;755492000;1729199000;9748460000;13126062000;1122761000;2388195000;4193764000;4112581000;5764759000;9958523000;1302369000;-696616000;1553033000;3167539000;13126062000
OKE;334076;USD;2016;Q4;2016-12-31;2017-02-28;211347000;212973000;248875000;872430000;200946000;1429684000;12571403000;958807000;1178857000;14709067000;16138751000;987245000;1520927000;2836701000;7919996000;9873135000;12709836000;1236772000;-893677000;0;3428915000;16138751000
OKE;334076;USD;2017;Q4;2017-12-31;2018-02-27;385597000;388087000;37193000;1202951000;432594000;1764458000;12698126000;1003156000;1380197000;15081479000;16845937000;1275880000;1047323000;2667335000;8091629000;8493250000;11160585000;6593110000;-876713000;0;5685352000;16845937000
OKE;334076;USD;2018;Q4;2018-12-31;2019-02-26;412201000;415119000;11975000;818958000;437841000;1398632000;14766651000;969150000;1097238000;16833039000;18231671000;1277714000;507650000;2108436000;8873334000;9543692000;11652128000;7619588000;-851806000;0;6579543000;18231671000
OXY;334205;USD;2017;Q4;2017-12-31;2018-02-23;765600000;766100000;1672000000;4145000000;1246000000;8270000000;31174000000;1515000000;1067000000;33756000000;42026000000;6900000000;500000000;7400000000;9328000000;14054000000;21454000000;8063000000;-9168000000;21935000000;20572000000;42026000000
OXY;334205;USD;2016;Q4;2016-12-31;2016-11-01;764200000;764200000;2233000000;3989000000;866000000;8428000000;32337000000;1401000000;943000000;34681000000;43109000000;6362000000;;6362000000;9819000000;15250000000;21612000000;7925000000;-9143000000;22981000000;21497000000;43109000000
OXY;334205;USD;2015;Q4;2015-12-31;2015-10-30;761802390;761602390;3201000000;2970000000;986000000;9402000000;31639000000;1434000000;934000000;34007000000;43409000000;5282000000;1450000000;6842000000;6855000000;12217000000;19059000000;7818000000;-9121000000;25960000000;24350000000;43409000000
OXY;334205;USD;2014;Q4;2014-12-31;2014-10-31;769102790;768101090;3789000000;4206000000;1052000000;13873000000;39730000000;1565000000;1091000000;42386000000;56259000000;8244000000;;8244000000;6838000000;13056000000;21300000000;7777000000;-8528000000;36067000000;34959000000;56259000000
OXY;334205;USD;2013;Q4;2013-12-31;2013-10-30;696005200;696335166;3393000000;5674000000;1200000000;11323000000;55821000000;1459000000;840000000;58120000000;69443000000;8434000000;;8434000000;6939000000;17637000000;26071000000;7693000000;-6095000000;41831000000;43372000000;69443000000
OXY;334205;USD;2012;Q4;2012-12-31;2012-11-02;705816852;706325315;1592000000;4916000000;1344000000;9492000000;52064000000;1894000000;760000000;54718000000;64210000000;6690000000;600000000;7290000000;7023000000;16872000000;24162000000;7619000000;-5091000000;37990000000;40048000000;64210000000
OXY;334205;USD;2011;Q4;2011-12-31;2011-11-03;846289851;847229245;3781000000;5395000000;1069000000;11542000000;45684000000;2072000000;746000000;48502000000;60044000000;7947000000;;7947000000;5871000000;14477000000;22424000000;7463000000;-4502000000;35142000000;37620000000;60044000000
OXY;334205;USD;2010;Q4;2010-12-31;2010-11-04;848168640;849629920;2578000000;5932000000;1041000000;13059000000;36536000000;2039000000;798000000;39373000000;52432000000;7213000000;;7825000000;5111000000;12123000000;19948000000;7368000000;-4228000000;29868000000;32484000000;52432000000
OXY;334205;USD;2009;Q4;2009-12-31;2009-11-02;847438000;849108034;1224000000;5167000000;998000000;10607000000;31137000000;1732000000;753000000;33622000000;44229000000;5597000000;239000000;6491000000;2557000000;8579000000;15070000000;7304000000;-4161000000;26534000000;29159000000;44229000000
OXY;334205;USD;2008;Q4;2008-12-31;2009-08-06;;;1777000000;4129000000;958000000;7172000000;32266000000;1263000000;836000000;34365000000;41537000000;5325000000;698000000;6134000000;2049000000;8078000000;14212000000;7289000000;-4121000000;24684000000;27325000000;41537000000
OXY;334205;USD;2018;Q4;2018-12-31;2019-02-21;753800000;755500000;3033000000;4893000000;1260000000;9932000000;31437000000;1680000000;805000000;33922000000;43854000000;7296000000;116000000;7412000000;10201000000;15112000000;22524000000;8225000000;-10473000000;23750000000;21330000000;43854000000
PNR;334445;USD;2017;Q4;2017-12-31;2018-02-27;270402400;273231500;86300000;483100000;356900000;1748800000;279800000;;6605100000;6884900000;8633700000;321500000;;1199400000;1440700000;2396500000;3595900000;2799500000;;2481700000;5037800000;8633700000
PNR;334445;USD;2016;Q4;2016-12-31;2017-02-21;271295800;273082600;238500000;764000000;524200000;2672000000;538600000;;8324200000;8862800000;11534800000;436600000;800000;1471200000;4278400000;5809200000;7280400000;2922600000;;2068100000;4254400000;11534800000
PNR;334445;USD;2015;Q4;2015-12-31;2016-02-26;269657900;272189200;126300000;773200000;564700000;2777600000;539800000;;8516100000;9055900000;11833500000;403800000;0;1486500000;4685800000;6338200000;7824700000;2862100000;;1791700000;4008800000;11833500000
PNR;334445;USD;2014;Q4;2014-12-31;2015-02-24;272338100;276358400;110400000;1205900000;1130400000;2894100000;950000000;;6811100000;7761100000;10655200000;583100000;6700000;1639500000;2997400000;4351900000;5991400000;4252000000;-1251900000;2044000000;4663800000;10655200000
PNR;334445;USD;2013;Q4;2013-12-31;2014-02-25;295119800;300629100;256000000;1285000000;1195100000;3232100000;1044300000;;7466900000;8511200000;11743300000;576900000;2500000;1610200000;2547900000;3915400000;5525600000;5184900000;-875100000;1829100000;6217700000;11743300000
PNR;334445;USD;2012;Q4;2012-12-31;2013-02-26;315072400;305393900;261300000;1274600000;1333900000;3204300000;1188200000;;7490200000;8678400000;11882700000;567000000;3100000;1645100000;2454300000;3750100000;5395200000;5405900000;-315500000;1292300000;6487500000;11882700000
PNR;334445;USD;2011;Q4;2011-12-31;2012-02-21;145768633;138868607;50077000;569204000;449863000;1237835000;387525000;;2960953000;3348478000;4586313000;294858000;4862000;641841000;1304225000;1897080000;2538921000;505280000;;1465780000;2047392000;4586313000
PNR;334445;USD;2010;Q4;2010-12-31;2011-02-23;145344268;146600984;46056000;516905000;405356000;1069297000;329435000;;2574801000;2904236000;3973533000;344175000;4951000;546796000;702521000;1221705000;1768501000;490890000;;1624605000;2205032000;3973533000
PNR;334445;USD;2009;Q4;2009-12-31;2011-02-23;144693575;147561389;33396000;455090000;360627000;946298000;333688000;;2631348000;2965036000;3911334000;275162000;2286000;446279000;803351000;1338715000;1784994000;489249000;;1502242000;2126340000;3911334000
PNR;334445;USD;2018;Q4;2018-12-31;2019-02-19;85171200;84646500;74300000;488200000;387500000;1039400000;272600000;;2494500000;2767100000;3806500000;378600000;;818700000;787600000;1151700000;1970400000;1895500000;;169200000;1836100000;3806500000
PRGO;334568;USD;2013;Q4;2013-06-30;2013-08-15;94097000;94750000;779900000;651900000;703900000;2236900000;681400000;;2432500000;3113900000;5350800000;620900000;46200000;749400000;1927800000;2268800000;3018200000;538500000;;1715900000;2332600000;5350800000
PRGO;334568;USD;2012;Q4;2012-06-30;2012-08-16;93400000;94300000;602500000;572600000;547500000;1795900000;578400000;;1649800000;2228200000;4024100000;522700000;40100000;652700000;1329200000;1518600000;2171300000;504700000;;1306900000;1852600000;4023900000
PRGO;334568;USD;2011;Q4;2011-06-30;2011-08-16;92685000;93819000;310104000;477851000;505576000;1377293000;507308000;;1304620000;1811928000;3189221000;502717000;17770000;606035000;875000000;1052199000;1658234000;467661000;;934333000;1530987000;3189221000
PRGO;334568;USD;2010;Q4;2010-06-30;2010-11-02;90739000;92396000;110324000;359809000;452980000;1402701000;448583000;;1257719000;1706302000;3109003000;428920000;409000000;922509000;935000000;1092554000;2015063000;428457000;;620439000;1093940000;3109003000
ORLY;334679;USD;2015;Q4;2015-12-31;2016-02-26;98431000;99920000;116301000;233687000;2631015000;3010026000;2861556000;;805102000;3666658000;6676684000;2680972000;;3046398000;1390018000;1668972000;4715370000;1282474000;;678840000;1961314000;6676684000
ORLY;334679;USD;2014;Q4;2014-12-31;2015-02-27;101587000;103316000;250560000;213211000;2554789000;3065380000;2658560000;;808143000;3466703000;6532083000;2482049000;25000;2813298000;1388397000;1700367000;4513665000;1195945000;;822473000;2018418000;6532083000
ORLY;334679;USD;2013;Q4;2013-12-31;2014-02-28;106834000;108736000;231318000;198123000;2375047000;2835201000;2425103000;;806904000;3232007000;6067208000;2114221000;67000;2423010000;1396141000;1677877000;4100887000;1119988000;;846333000;1966321000;6067208000
ORLY;334679;USD;2012;Q4;2012-12-31;2013-02-28;114342000;116202000;248128000;181174000;2276331000;2732948000;2211590000;;804649000;3016239000;5749187000;1983302000;222000;2272865000;1095734000;1368015000;3640880000;1085040000;;1023267000;2108307000;5749187000
ORLY;334679;USD;2011;Q4;2011-12-31;2012-02-28;127913000;130317000;361552000;203753000;1985748000;2607610000;2093767000;;799124000;2892891000;5500501000;1332449000;662000;1580010000;796912000;1075640000;2655650000;1111377000;;1733474000;2844851000;5500501000
ORLY;334679;USD;2010;Q4;2010-12-31;2011-02-28;139972000;145533000;29721000;183652000;2023488000;2301252000;1930095000;;816480000;2746575000;5047827000;946928000;1431000;1228958000;357273000;609184000;1838142000;1143159000;;2069496000;3209685000;5047827000
ORLY;334679;USD;2009;Q4;2009-12-31;2010-05-07;137330000;139042000;26935000;170997000;1913218000;2226719000;1726379000;;828373000;2554752000;4781471000;873501000;106708000;1219143000;684040000;876463000;2095606000;1043704000;;1650123000;2685865000;4781471000
ORLY;334679;USD;2016;Q4;2016-12-31;2017-02-28;93790000;94941000;146598000;279379000;2778976000;3257975000;3123431000;;822783000;3946214000;7204189000;3004577000;;3400649000;1887019000;2176404000;5577053000;1337636000;;289500000;1627136000;7204189000
ORLY;334679;USD;2017;Q4;2017-12-31;2018-02-28;84726000;85189000;46348000;292487000;3009800000;3397672000;3343806000;;830407000;4174213000;7571885000;3261724000;;3647366000;2978390000;3271473000;6918839000;1265886000;;-612840000;653046000;7571885000
ORLY;334679;USD;2018;Q4;2018-12-31;2019-02-27;79768000;80651000;31315000;270181000;3193344000;3543102000;3587002000;;850685000;4437687000;7980789000;3453415000;;3894020000;3417122000;3733102000;7627122000;1262853000;;-909186000;353667000;7980789000
NUE;334772;USD;2016;Q4;2016-12-31;2017-02-28;319915000;320383000;2195961000;1631676000;2479958000;6506393000;5078650000;;3638475000;8717125000;15223518000;838109000;617959000;2389966000;3739141000;4578844000;6968810000;2126406000;-1559614000;7630916000;8254708000;15223518000
NUE;334772;USD;2015;Q4;2015-12-31;2016-02-26;320620000;320625000;2039469000;1383823000;2245469000;5854405000;4891153000;;3581411000;8472564000;14326969000;566527000;51315000;1385173000;4337145000;5091919000;6477092000;2070396000;-1558128000;7316910000;7849877000;14326969000
NUE;334772;USD;2014;Q4;2014-12-31;2015-02-27;320131000;320422000;1124144000;2068298000;2745032000;6441888000;5287639000;;3886400000;9174039000;15615927000;993872000;223811000;2097776000;4360600000;5443033000;7540809000;2034593000;-1494629000;7378214000;8075118000;15615927000
NUE;334772;USD;2013;Q4;2013-12-31;2014-02-28;319378000;319673000;1511443000;1810987000;2605609000;6410046000;4917024000;;3876213000;8793237000;15203283000;1117078000;32502000;1960216000;4376900000;5332789000;7293005000;1994363000;-1498114000;7140440000;7910278000;15203283000
NUE;334772;USD;2012;Q4;2012-12-31;2013-02-28;318561000;318621000;1157029000;1707317000;2323641000;5661364000;4283056000;275163000;3932476000;8490695000;14152059000;1046713000;279912000;2029568000;3380200000;4237117000;6266685000;1962264000;-1501977000;7124523000;7885374000;14152059000
NUE;334772;USD;2011;Q4;2011-12-31;2012-02-28;317388000;317461000;2563286000;1710773000;1987257000;6708081000;3755604000;585833000;3520832000;7862269000;14570350000;958645000;651826000;2396059000;3630200000;4467711000;6863770000;1907030000;-1505534000;7111566000;7706580000;14570350000
NUE;334772;USD;2010;Q4;2010-12-31;2011-02-28;316315000;316584000;2479029000;1439828000;1557574000;5861175000;3852118000;598482000;3610135000;8060735000;13921910000;896703000;13328000;1504438000;4280200000;5086778000;6591216000;1861699000;-1509841000;6795988000;7330694000;13921910000
NUE;334772;USD;2009;Q4;2009-12-31;2010-02-25;315248000;315248000;2241981000;1116035000;1312903000;5182248000;4013836000;;3375820000;7389656000;12571904000;707038000;7748000;1227057000;3080200000;3760558000;4987615000;1825654000;-1514290000;7120218000;7584289000;12571904000
NUE;334772;USD;2008;Q4;2008-12-31;2009-08-11;314632000;314732000;2355130000;1228807000;2408157000;6397486000;4131861000;;3345096000;7476957000;13874443000;534161000;189022000;1854192000;3086200000;3763570000;5617762000;1779609000;-1520772000;7860629000;8256681000;13874443000
NUE;334772;USD;2017;Q4;2017-12-31;2018-02-28;319201000;319957000;999104000;2028545000;3461686000;6824420000;5093147000;;3923691000;9016838000;15841258000;1181346000;552833000;2824764000;3242242000;3931706000;6756470000;2173299000;-1643291000;8463709000;9084788000;15841258000
NUE;334772;USD;2018;Q4;2018-12-31;2019-02-28;309631000;310269000;1398886000;2505568000;4553500000;8636265000;5334748000;;3949575000;9284323000;17920588000;1428191000;57870000;2806300000;4233276000;4912320000;7718620000;2225776000;-2467010000;10337445000;10201968000;17920588000
MTD;334921;USD;2016;Q4;2016-12-31;2017-02-02;26133296;26642507;158674000;454988000;222047000;896784000;563707000;;706286000;1269993000;2166777000;468211000;18974000;587515000;875056000;1144319000;1731834000;731004000;-3006771000;3065708000;434943000;2166777000
MTD;334921;USD;2015;Q4;2015-12-31;2016-02-04;27216813;27741902;98887000;411420000;214383000;795332000;517229000;;646774000;1164003000;1959335000;454895000;14488000;558212000;575138000;820666000;1378878000;698018000;-2543229000;2692317000;580457000;1959335000
MTD;334921;USD;2014;Q4;2014-12-31;2015-02-06;28386005;29037558;85263000;435648000;204531000;849430000;511462000;;648218000;1159680000;2009110000;461830000;116164000;678890000;335790000;610625000;1289515000;670866000;-2095656000;2357334000;719595000;2009110000
MTD;334921;USD;2013;Q4;2013-12-31;2014-02-07;29546140;30382061;111874000;466703000;210414000;913987000;514438000;;724394000;1238832000;2152819000;447819000;17067000;564188000;395960000;653579000;1217767000;653698000;-1721030000;2037420000;935052000;2152819000
MTD;334921;USD;2012;Q4;2012-12-31;2013-02-08;30532491;31271375;101702000;437390000;198939000;864237000;469421000;;688630000;1158051000;2022288000;433611000;41600000;561994000;347131000;633075000;1195069000;639153000;-1463924000;1749451000;827219000;2022288000
MTD;334921;USD;2011;Q4;2011-12-31;2012-02-13;33945479;35332527;235601000;425147000;241421000;1018863000;410007000;;774604000;1184611000;2203474000;463508000;28300000;609844000;476715000;812493000;1422337000;616650000;-1225125000;1476550000;781137000;2203474000
MTD;334921;USD;2010;Q4;2010-12-31;2011-02-16;37073137;37590387;447577000;368936000;217104000;1144895000;364472000;;773696000;1138168000;2283063000;426833000;10902000;542186000;670301000;969293000;1511479000;597643000;-1057390000;1223130000;771584000;2283063000
MTD;334921;USD;2009;Q4;2009-12-31;2010-07-23;33815083;34560582;85031000;312998000;168042000;646107000;316334000;;756346000;1072680000;1718787000;330112000;89968000;494675000;203590000;512974000;1007649000;574482000;-857130000;1009995000;711138000;1718787000
MTD;334921;USD;2017;Q4;2017-12-31;2018-02-09;25557381;26246013;98949000;483919000;278318000;927372000;696890000;;887645000;1584535000;2511907000;491295000;14883000;636882000;978715000;1314278000;1951160000;751940000;-3481032000;3526355000;560747000;2511907000
HLF;335043;USD;2016;Q4;2016-12-31;2017-02-23;166200000;178800000;844000000;70300000;371300000;1462500000;378000000;;724900000;1102900000;2565400000;327200000;9500000;791500000;1438400000;1577600000;2369100000;467700000;;-66300000;196300000;2565400000
HLF;335043;USD;2015;Q4;2015-12-31;2016-02-25;165800000;171400000;889800000;69900000;332000000;1566300000;339200000;;572400000;911600000;2477900000;731100000;229500000;1024400000;1392500000;1507000000;2531400000;438300000;;-326300000;-53500000;2477900000
HLF;335043;USD;2014;Q4;2014-12-31;2015-02-26;163600000;170000000;645400000;83600000;377700000;1393400000;366700000;;594900000;961600000;2355000000;704800000;100000000;874800000;1691800000;1814600000;2689400000;409200000;;-665400000;-334400000;2355000000
HLF;335043;USD;2013;Q4;2013-12-31;2014-02-18;202172000;213344000;973000000;100300000;351200000;1643100000;318900000;;511700000;830600000;2473700000;772900000;81300000;922300000;850000000;1000000000;1922300000;324000000;;247200000;551400000;2473700000
HLF;335043;USD;2012;Q4;2012-12-31;2013-12-16;216072000;228198000;333534000;116139000;339411000;984047000;242886000;;497210000;740096000;1724143000;656628000;56302000;762362000;431305000;566298000;1328660000;304082000;;123096000;395483000;1724143000
HLF;335043;USD;2011;Q4;2011-12-31;2012-04-11;231944000;249352000;258775000;89660000;247696000;785685000;193703000;;483687000;677390000;1463075000;546313000;1542000;579557000;202079000;335374000;914931000;292066000;;293887000;548144000;1463075000
HLF;335043;USD;2010;Q4;2010-12-31;2011-02-22;236400000;258676000;190550000;85612000;182467000;595586000;177427000;;459207000;636634000;1232220000;432551000;3120000;470816000;175046000;274192000;745008000;248811000;;265686000;487212000;1232220000
HLF;335043;USD;2009;Q4;2009-12-31;2010-08-02;241932000;252964000;150801000;76958000;145962000;513502000;178009000;;454539000;632548000;1146050000;395303000;12402000;429966000;237931000;356773000;786739000;223002000;;159705000;359311000;1146050000
HLF;335043;USD;2017;Q4;2017-12-31;2018-02-22;145400000;153200000;1278800000;93300000;341200000;1860300000;377500000;;657300000;1034800000;2895100000;345500000;102400000;906800000;2165700000;2323000000;3229800000;407400000;-328600000;-248100000;-334700000;2895100000
HLF;335043;USD;2018;Q4;2018-12-31;2019-02-19;136900000;147900000;1198900000;70500000;381800000;1805000000;360000000;;624800000;984800000;2789800000;362500000;678900000;1588800000;1774900000;1924400000;3513200000;341600000;-328900000;-526300000;-723400000;2789800000
AVP;335142;USD;2016;Q4;2016-12-31;2017-02-22;437800000;437800000;654400000;458900000;586400000;1992300000;711300000;;715300000;1426600000;3418900000;1456900000;18100000;1485700000;2000300000;2324700000;3810400000;2462700000;-4599700000;2322200000;-391500000;3418900000
AVP;335142;USD;2015;Q4;2015-12-31;2016-02-23;435300000;435300000;686900000;443000000;624000000;2341100000;766900000;;762400000;1529300000;3870400000;1550200000;55200000;2195100000;2150500000;2731700000;4926800000;2441900000;-4594100000;2448100000;-1056400000;3870400000
AVP;335142;USD;2014;Q4;2014-12-31;2015-02-24;434700000;434700000;936400000;515600000;707700000;3064500000;1036800000;;1495500000;2532300000;5596800000;1717900000;121700000;2147200000;2428700000;3144300000;5291500000;2395500000;-4591000000;3702900000;305300000;5596800000
AVP;335142;USD;2013;Q4;2013-12-31;2014-02-26;434100000;436200000;1107900000;676300000;967700000;3441200000;1393300000;;1657800000;3051100000;6492300000;2052500000;188000000;2240500000;2532700000;3124300000;5364800000;2365000000;-4581200000;4196700000;1127500000;6492300000
AVP;335142;USD;2012;Q4;2012-12-31;2013-03-05;432200000;432600000;1206900000;752100000;1101100000;3928900000;1526000000;;1927600000;3453600000;7382500000;2108500000;572000000;2704600000;2623800000;3444600000;6149200000;2307900000;-4571900000;4357800000;1233300000;7382500000
AVP;335142;USD;2011;Q4;2011-12-31;2012-02-29;431000000;431600000;1245100000;761500000;1161300000;4098800000;1571500000;;2064700000;3636200000;7735000000;2041700000;849300000;2891000000;2459100000;3258800000;6149800000;2265000000;-4566300000;4726100000;1585200000;7735000000
AVP;335142;USD;2010;Q4;2010-12-31;2011-02-24;1287479143;1294539136;1179900000;826300000;1152900000;4184300000;1627400000;;2062000000;3689400000;7873700000;2228700000;727600000;2956300000;2408600000;3244800000;6201100000;2210800000;-4559300000;4610800000;1672600000;7873700000
AVP;335142;USD;2009;Q4;2009-12-31;2010-02-25;427320000;430210000;1298100000;765700000;1049800000;4206200000;1469000000;;1148200000;2617200000;6823400000;2116500000;137800000;2291700000;2307200000;3219100000;5510800000;2127100000;-4545800000;4383900000;1312600000;6823400000
AVP;335142;USD;2008;Q4;2008-12-31;2009-07-30;;;1104700000;687800000;1007900000;3556900000;1343900000;;1173200000;2517100000;6074000000;1880800000;1031400000;2912200000;1456200000;2449500000;5361700000;2059700000;-4537800000;4118900000;712300000;6074000000
AVP;335142;USD;2017;Q4;2017-12-31;2018-02-22;440300000;440300000;881500000;457200000;598200000;2233300000;702700000;;761900000;1464600000;3697900000;1533900000;25700000;1559600000;2065300000;2385200000;3944800000;2480900000;-4600000000;2320300000;-246900000;3697900000
AVP;335142;USD;2018;Q4;2018-12-31;2019-02-21;442200000;442200000;532700000;349700000;542000000;1762000000;557600000;;690400000;1248000000;3010000000;1473100000;12000000;1496500000;1581600000;1918200000;3414700000;2493900000;-4602300000;2234300000;-404700000;3010000000
DOV;336327;USD;2016;Q4;2016-12-31;2017-02-10;192360440;194353620;349146000;1265201000;870487000;2589191000;945670000;;6581130000;7526800000;10115991000;1193173000;414550000;1940318000;3206637000;4375927000;6316245000;;;;3799746000;10115991000
DOV;336327;USD;2015;Q4;2015-12-31;2016-02-12;191748868;193631866;362185000;1120490000;802895000;2419010000;854269000;;5332797000;6187066000;8606076000;980089000;151122000;1367182000;2603655000;3594319000;4961501000;1184522000;-4972016000;7686642000;3644575000;8606076000
DOV;336327;USD;2014;Q4;2014-12-31;2015-02-13;203679474;205699890;681581000;1186746000;863737000;3161140000;837069000;;5032082000;5869151000;9030291000;994616000;777956000;2089567000;2253041000;3239999000;5329566000;1156726000;-4371852000;7074782000;3700725000;9030291000
DOV;336327;USD;2013;Q4;2013-12-31;2014-02-14;210436478;213914020;803882000;1076641000;715311000;5497035000;787849000;;4570297000;5358146000;10855181000;893361000;229278000;1877869000;2599201000;3599916000;5477785000;1126895000;-3771758000;7954536000;5377396000;10855181000
DOV;336327;USD;2012;Q4;2012-12-31;2013-02-15;80056793;81074528;800076000;1225898000;872841000;3425389000;1167052000;;5851502000;7018554000;10443943000;1120230000;610766000;2195586000;2189350000;3329127000;5524713000;1088796000;-3313887000;7199227000;4919230000;10443943000
DOV;336327;USD;2011;Q4;2011-12-31;2012-02-10;553645548;562728414;1206755000;1118848000;733807000;3735038000;970703000;;4794811000;5765514000;9500552000;920025000;1022000;1415908000;2186230000;3154089000;4569997000;913881000;-2564932000;6629116000;4930555000;9500552000
DOV;336327;USD;2010;Q4;2010-12-31;2011-02-11;278891632;285691211;1310813000;1023099000;657962000;3758718000;785624000;;4014401000;4800025000;8558743000;900454000;16590000;1374575000;1790886000;2657606000;4032181000;845818000;-2322444000;5953027000;4526562000;8558743000
DOV;336327;USD;2009;Q4;2009-12-31;2010-02-19;-831649737;-832454707;938174000;878754000;570858000;2639408000;828922000;;4414073000;5242995000;7882403000;714257000;35624000;1108054000;1825260000;2690741000;3798795000;744633000;-2198889000;5453022000;4083608000;7882403000
DOV;336327;USD;2008;Q4;2008-12-31;2009-10-23;277392383;276701685;826869000;1013174000;636121000;2699225000;872134000;;4311879000;5184013000;7883238000;818951000;224944000;1332637000;1860729000;2757735000;4090372000;701843000;-2206251000;5286458000;3792866000;7883238000
DOV;336327;USD;2017;Q4;2017-12-31;2018-02-16;192806120;196234142;753964000;1385567000;878635000;3207120000;999772000;;6450761000;7450533000;10657653000;1360992000;581102000;2298193000;2986702000;3976280000;6274473000;1199477000;-5077039000;8455501000;4383180000;10657653000
DOV;336327;USD;2018;Q4;2018-12-31;2019-02-15;109112240;110659580;396221000;1231859000;748796000;2503754000;806497000;;5055520000;5862017000;8365771000;1293651000;220318000;1827421000;2943660000;3769684000;5597105000;1143838000;-5947562000;7815486000;2768666000;8365771000
RAI;336424;USD;2016;Q4;2016-12-31;2017-02-09;1425810000;1428744000;2051000000;189000000;1645000000;4238000000;1348000000;;45509000000;46857000000;51095000000;877000000;501000000;4985000000;12664000000;24399000000;29384000000;18285000000;;3740000000;21711000000;51095000000
RAI;336424;USD;2015;Q4;2015-12-31;2016-02-11;1428220000;1432062000;2716000000;141000000;1734000000;5155000000;1255000000;;45690000000;46945000000;52100000000;693000000;506000000;5291000000;16849000000;28557000000;33848000000;18402000000;;188000000;18252000000;52100000000
RAI;336424;USD;2014;Q4;2014-12-31;2015-02-10;1062564000;1066630000;966000000;169000000;1281000000;3323000000;1203000000;;10670000000;11873000000;15196000000;498000000;450000000;3544000000;4633000000;7130000000;10674000000;6200000000;;-1314000000;4522000000;15196000000
RAI;336424;USD;2013;Q4;2013-12-31;2014-02-11;1078788000;1083392000;1500000000;178000000;1127000000;3655000000;1074000000;;10673000000;11747000000;15402000000;185000000;;3076000000;5099000000;7159000000;10235000000;6571000000;;-1348000000;5167000000;15402000000
RAI;336424;USD;2012;Q4;2012-12-31;2013-02-12;1112586000;1117256000;2502000000;164000000;984000000;4812000000;1037000000;;10708000000;11745000000;16557000000;187000000;60000000;3769000000;5035000000;7531000000;11300000000;7275000000;;-1707000000;5257000000;16557000000
RAI;336424;USD;2011;Q4;2011-12-31;2012-02-15;1160926000;1167858000;1956000000;181000000;967000000;4307000000;1070000000;;10877000000;11947000000;16254000000;113000000;457000000;4276000000;3206000000;5727000000;10003000000;8293000000;;-1660000000;6251000000;16254000000
RAI;336424;USD;2010;Q4;2010-12-31;2011-02-23;-3493198032;-3503151168;2195000000;210000000;1055000000;4802000000;1002000000;;11274000000;12276000000;17078000000;179000000;400000000;4372000000;3701000000;6196000000;10568000000;8535000000;;-1807000000;6510000000;17078000000
RAI;336424;USD;2009;Q4;2009-12-31;2010-02-19;1165528000;1168324000;2723000000;220000000;1219000000;5495000000;1025000000;;11489000000;12514000000;18009000000;196000000;300000000;4340000000;4136000000;7171000000;11511000000;8498000000;;-579000000;6498000000;18009000000
RAI;336424;USD;2008;Q4;2008-12-31;2009-10-27;;;2601000000;212000000;1170000000;5019000000;1031000000;;12104000000;13135000000;18154000000;206000000;200000000;3923000000;4486000000;7994000000;11917000000;8463000000;;-531000000;6237000000;18154000000
INCR;336622;USD;2018;Q4;2018-12-31;2019-03-18;103296000;107338000;155932000;;;1491962000;183486000;;5579461000;5762947000;7254909000;662151000;63906000;1503198000;2763778000;2895567000;4398765000;3403672000;;-459333000;2856144000;7254909000
INCR;336622;USD;2017;Q4;2017-12-31;2018-02-28;104362000;102070000;321976000;;;1422179000;180412000;;5683276000;5863688000;7285867000;558878000;41414000;1159562000;2966310000;3103726000;4263288000;3415433000;;-370469000;3022579000;7285867000
INCR;336622;USD;2016;Q4;2016-12-31;2017-02-28;53685000;54933000;102471000;;;522629000;58306000;;707572000;765878000;1288507000;177252000;11875000;466727000;485849000;520307000;987034000;573714000;;-229991000;301473000;1288507000
INCR;336622;USD;2015;Q4;2015-12-31;2015-10-29;55752000;58253000;85011000;;;422046000;44813000;;744360000;789173000;1211219000;133759000;29804000;474592000;472035000;519193000;993785000;560449000;;-301472000;217434000;1211219000
DPZ;338660;USD;2016;Q4;2016-12-31;2017-02-28;47634465;48762896;42815000;150369000;40181000;495873000;138534000;;81888000;220422000;716295000;229692000;38887000;403698000;2148990000;2195740000;2599438000;1487000;;-1881520000;-1883143000;716295000
DPZ;338660;USD;2015;Q4;2015-12-31;2016-02-25;50810623;52374361;133449000;131582000;36861000;602637000;131890000;6054000;59264000;197208000;799845000;199894000;59333000;375983000;2181460000;2224113000;2600096000;7440000;;-1804143000;-1800251000;799845000
DPZ;338660;USD;2014;Q4;2014-12-31;2015-02-24;54826114;56617368;30855000;118395000;37944000;428361000;114046000;4586000;49340000;167972000;596333000;178523000;565000;265608000;1500599000;1550190000;1815798000;30117000;;-1246921000;-1219465000;596333000
DPZ;338660;USD;2013;Q4;2013-12-31;2014-02-25;55101005;57353675;14383000;105779000;30321000;351540000;97584000;3269000;72862000;173715000;525255000;167516000;29103000;254611000;1512299000;1560846000;1815457000;1227000;;-1289445000;-1290202000;525255000
DPZ;338660;USD;2012;Q4;2012-12-31;2013-02-28;55913435;58359920;54813000;94103000;31061000;306267000;91445000;2097000;78388000;171930000;478197000;149243000;29374000;229498000;1536443000;1584222000;1813720000;2227000;;-1335364000;-1335523000;478197000
DPZ;338660;USD;2011;Q4;2011-12-31;2012-02-28;56660501;59214217;50292000;87200000;30702000;326843000;92400000;1538000;59762000;153700000;480543000;136898000;10973000;197175000;1450369000;1493107000;1690282000;577000;;-1207915000;-1209739000;480543000
DPZ;338660;USD;2010;Q4;2010-12-31;2011-05-05;59207896;61895766;47945000;80410000;26998000;305038000;97384000;1193000;57222000;155799000;460837000;128742000;7483000;186126000;1451321000;1485362000;1671488000;46133000;;-1254044000;-1210651000;460837000
DPZ;338660;USD;2017;Q4;2017-12-31;2018-02-20;41971456;43512704;35768000;173677000;39961000;579780000;169586000;;87387000;256973000;836753000;224984000;32324000;398285000;3121490000;3173852000;3572137000;6083000;;-2739437000;-2735384000;836753000
DPZ;338660;USD;2018;Q4;2018-12-31;2019-02-21;40971988;42297416;25438000;190091000;45975000;566951000;234939000;;105495000;340434000;907385000;214490000;35893000;379743000;3495691000;3567563000;3947306000;979000;;-3036471000;-3039921000;907385000
TAYD;338837;USD;2017;Q4;2017-05-31;2017-08-29;3478557;3770885;4347260;2545773;11488610;26106629;9994716;;1059358;11054074;37160703;2176262;;4304311;;;4304311;9170041;-2829359;26515710;32856392;37160703
TAYD;338837;USD;2016;Q4;2016-05-31;2016-08-29;3461391;3791423;7086080;3992214;9604956;26938417;8994504;;872393;9866897;36805314;5184464;;6648085;;;6648085;8628280;-2656184;24185133;30157229;36805314
TAYD;338837;USD;2015;Q4;2015-05-31;2015-08-27;3370002;3578706;4895898;4754757;8662056;24731673;7873511;;1059924;8933435;33665108;4861869;;7585341;;628785;8214126;8072932;-2598858;19976908;25450982;33665108
TAYD;338837;USD;2014;Q4;2014-05-31;2014-08-29;3396769;3520089;2793642;2894344;8978302;18561911;7867728;;1001137;8868865;27430776;2939789;;3790320;;558485;4348805;7778994;-2498983;17801960;23081971;27430776
TAYD;338837;USD;2013;Q4;2013-05-31;2013-08-29;3312409;3498655;2793642;2894344;8978302;18561911;7867728;;1001137;8868865;27430776;1596001;;3790320;;558485;4348805;7778994;-2498983;17801960;23081971;27430776
TAYD;338837;USD;2012;Q4;2012-05-31;2012-08-29;3378215;;73952;5610328;8372535;20981560;4481953;;998384;5480337;26461897;6250695;3657;7181252;;283985;7465237;7372689;-2498983;14122954;18996660;26461897
TAYD;338837;USD;2011;Q4;2011-05-31;2011-10-13;;;2193534;2136848;5352424;15470435;3413446;;994147;4407593;19878028;3054791;5485;3212781;3657;282142;3494923;6720784;-2261702;11924023;16383105;19878028
TAYD;338837;USD;2018;Q4;2018-05-31;2018-08-29;3493926;3617430;3897405;6265864;11317775;28504284;9935625;;1071381;11007006;39511290;2443435;;5898939;;;5898939;9482630;-2829359;26959080;33612351;39511290
TAYD;338837;USD;2019;Q4;2019-05-31;2019-08-02;3481745;3549917;6127413;5279302;11239331;30956828;9317442;;922626;10240068;41196896;2712050;;4878024;;;4878024;9639627;-2829359;29508604;36318872;41196896
PVHO;340334;USD;2016;Q4;2016-06-30;2016-10-13;86992847;86992847;2175543;0;3521739;6293051;26736;;172725;199461;6492512;5718492;699905;10042936;5805566;5755566;15798502;25190106;;-34758262;-9305990;6492512
PVHO;340334;USD;2015;Q4;2015-06-30;2015-10-13;74978974;74978974;128968;76305;1477267;1685540;0;;157121;157121;1842661;5011750;1107385;9171482;2113558;2063558;11235040;19163067;;-28555446;-9392379;1842661
PVHO;340334;USD;2014;Q4;2014-06-30;2015-05-01;69439517;69439517;739479;3444;0;745923;107;;204783;204890;950813;4510861;3986820;10270246;45633;-4367;10265879;18396610;;-27711676;-9315066;950813
PVHO;340334;USD;2013;Q4;2013-06-30;2015-05-01;;;35076;;;38076;749;;330149;330898;368974;3840461;3962263;9018142;26965;-23035;8995107;18322860;;-26948993;-8626133;368974
PVHO;340334;USD;2012;Q4;2012-06-30;2015-05-01;;;127004;;;133910;1391;;455038;456429;590339;3243562;3851666;7937471;271656;221656;8159127;17798628;;-25367416;-7568788;590339
PVHO;340334;USD;2011;Q4;2011-06-30;2015-05-01;;;13746;;;142347;2665;;584308;586973;729320;2308652;1844046;4872613;1535093;1485093;6357706;17294042;;-22922428;-5628386;729320
PVHO;340334;USD;2017;Q4;2017-06-30;2017-10-13;124799781;124799781;310749;0;2201759;2711748;17569;;170229;187798;2899546;5974719;7436211;15876823;0;-50000;15826823;29121863;;-42083390;-12927277;2899546
IMSCQ;340525;USD;2016;Q4;2016-06-30;2016-10-14;79265621;79265622;1338000;7123000;4681000;13973000;874000;;98000;972000;14945000;61613000;38680000;100699000;35000;514000;101213000;114334000;-73000;-200084000;-86268000;14945000
IMSCQ;340525;USD;2015;Q4;2015-06-30;2015-10-05;;74719789;1985000;872000;5244000;9414000;880000;;98000;978000;10392000;47119000;37707000;88280000;20000;289000;88569000;112688000;-73000;-189429000;-78177000;10392000
IMSCQ;340525;USD;2014;Q4;2014-06-30;2014-09-29;;63599296;391000;545000;2868000;4431000;619000;;429000;1048000;5479000;41953000;24040000;66476000;66000;208000;66684000;107119000;-73000;-167886000;-61205000;5479000
IMSCQ;340525;USD;2013;Q4;2013-06-30;2013-09-30;;;80000;1216000;2145000;4269000;395000;;434000;829000;5098000;35983000;13465000;49557000;89000;89000;49646000;103995000;-73000;-146876000;-44548000;5098000
IMSCQ;340525;USD;2012;Q4;2012-06-30;2012-11-14;;;84000;182000;3193000;5542000;220000;;474000;694000;6236000;10268000;27255000;38604000;33000;33000;38637000;87352000;-73000;-119522000;-32401000;6236000
PRLB;341185;USD;2015;Q4;2015-12-31;2016-02-26;26168642;26408116;80854000;36125000;9771000;138002000;125475000;64789000;32770000;223034000;361036000;26262000;;26262000;;7129000;33391000;198861000;;133996000;327645000;361036000
PRLB;341185;USD;2014;Q4;2014-12-31;2015-02-27;25819347;25962622;74035000;24226000;6194000;107861000;91626000;54318000;33226000;179170000;287031000;18620000;139000;18759000;10000;2733000;21492000;180986000;;87482000;265539000;287031000
PRLB;341185;USD;2013;Q4;2013-12-31;2014-02-28;25135445;25940733;79378000;18320000;5166000;109795000;56101000;64023000;256000;120380000;230175000;13459000;204000;13663000;159000;4869000;18532000;166887000;;45847000;211643000;230175000
PRLB;341185;USD;2012;Q4;2012-12-31;2013-03-22;24577129;24954826;61896000;15791000;4619000;90156000;45316000;36965000;285000;82566000;172722000;11266000;273000;11539000;356000;4484000;16023000;147057000;;10570000;156699000;172722000
PRLB;341185;USD;2011;Q4;2011-12-31;2012-05-04;12922994;15963024;8385000;11533000;3797000;28077000;34249000;;;34249000;62326000;9549000;390000;9939000;613000;5736000;15675000;9058000;;-27744000;46651000;62326000
PRLB;341185;USD;2016;Q4;2016-12-31;2017-02-22;26454502;26645173;108272000;34060000;9310000;157784000;139474000;84479000;32504000;256457000;414241000;23427000;;23427000;;10981000;34408000;213883000;;176703000;379833000;414241000
PRLB;341185;USD;2017;Q4;2017-12-31;2018-02-23;26964382;27329898;94131000;51503000;11271000;165004000;166440000;37034000;150260000;353734000;518738000;38755000;5000000;43755000;;13768000;57523000;241752000;;224697000;461215000;518738000
PRLB;341185;USD;2018;Q4;2018-12-31;2019-02-22;27039493;27305397;131796000;59155000;10087000;215362000;228001000;23579000;152043000;403623000;618985000;52734000;0;52734000;;24754000;77488000;258529000;;291460000;541497000;618985000
SEIC;341472;USD;2017;Q4;2017-12-31;2018-02-22;;163477000;744247000;282706000;;1139808000;146428000;94017000;473116000;713561000;1853369000;270326000;;275049000;30000000;101481000;376530000;1029280000;;467467000;1476839000;1853369000
SEIC;341472;USD;2016;Q4;2016-12-31;2017-02-22;;162566000;695701000;227957000;;1037833000;146190000;88891000;363909000;598990000;1636823000;246491000;;249371000;0;84338000;333709000;957051000;;384018000;1303114000;1636823000
SEIC;341472;USD;2015;Q4;2015-12-31;2016-02-22;;168461000;679661000;223023000;;1003724000;143977000;85333000;355594000;584904000;1588628000;222098000;;224483000;;74425000;298908000;912150000;;402860000;1289720000;1588628000
SEIC;341472;USD;2014;Q4;2014-12-31;2015-02-23;;171223000;667446000;194419000;;955427000;125535000;82132000;379781000;587448000;1542875000;218017000;;219766000;;75496000;295262000;836282000;;420226000;1247613000;1542875000
SEIC;341472;USD;2013;Q4;2013-12-31;2014-02-27;;174766000;578273000;186664000;;847100000;118995000;88172000;384902000;592069000;1439169000;204358000;;207988000;;75179000;283167000;722911000;;431604000;1156002000;1439169000
SEIC;341472;USD;2012;Q4;2012-12-31;2013-02-22;;174538000;452247000;171734000;;699392000;127581000;81778000;401073000;610432000;1309824000;149553000;;152005000;;100490000;252495000;626027000;;405914000;1057329000;1309824000
SEIC;341472;USD;2011;Q4;2011-12-31;2012-02-27;;366719505;420986000;142109000;;633801000;129548000;139333000;391877000;660758000;1294559000;149043000;;151073000;;102027000;253100000;579714000;;443702000;1041459000;1294559000
SEIC;341472;USD;2010;Q4;2010-12-31;2011-02-24;;760711918;496292000;136490000;;682332000;140568000;179364000;374959000;694891000;1377223000;125992000;;127600000;95000000;192898000;320498000;567254000;;471159000;1056725000;1377223000
SEIC;341472;USD;2009;Q4;2009-12-31;2010-08-05;;;590877000;184317000;;839120000;146053000;181897000;366738000;694688000;1533808000;155795000;6400000;163055000;247152000;339135000;502190000;523982000;;384483000;1031618000;1533808000
SEIC;341472;USD;2018;Q4;2018-12-31;2019-02-25;;158768000;754525000;315336000;;1190812000;145863000;116788000;518205000;780856000;1971668000;290554000;;295708000;0;82813000;378521000;1108177000;;517970000;1593147000;1971668000
DGX;341807;USD;2015;Q4;2015-12-31;2016-02-26;144000000;144000000;133000000;901000000;84000000;1501000000;925000000;473000000;7063000000;8461000000;9962000000;1014000000;159000000;1173000000;3492000000;4006000000;5179000000;2483000000;-3960000000;6199000000;4783000000;9962000000
DGX;341807;USD;2014;Q4;2014-12-31;2015-02-24;147000000;145000000;192000000;932000000;110000000;1603000000;933000000;46000000;7275000000;8254000000;9857000000;1191000000;518000000;1709000000;3224000000;3818000000;5527000000;2420000000;-3815000000;5723000000;4330000000;9857000000
DGX;341807;USD;2013;Q4;2013-12-31;2014-02-18;147000000;148000000;187000000;852000000;91000000;1383000000;805000000;;6760000000;7565000000;8948000000;920000000;212000000;1132000000;3120000000;3843000000;4975000000;2381000000;-3783000000;5358000000;3973000000;8948000000
DGX;341807;USD;2012;Q4;2012-12-31;2013-02-27;160447000;159808000;296000000;867000000;93000000;1561000000;756000000;;6967000000;7723000000;9284000000;1016000000;10000000;1048000000;3354000000;4050000000;5098000000;2373000000;-2914000000;4690000000;4186000000;9284000000
DGX;341807;USD;2011;Q4;2011-12-31;2012-02-16;159088000;160157000;164886000;906455000;89132000;1401260000;799771000;;7112348000;7912119000;9313379000;906764000;654395000;1561159000;3370522000;4037221000;5598380000;2349664000;-2912324000;4263599000;3714999000;9313379000
DGX;341807;USD;2010;Q4;2010-12-31;2011-02-16;170368000;171822000;449301000;845299000;76572000;1605417000;834376000;;6087837000;6922213000;8527630000;865272000;348996000;1214268000;2641160000;3259237000;4473505000;2313563000;-2158129000;3867420000;4054125000;8527630000
DGX;341807;USD;2009;Q4;2009-12-31;2010-02-17;373212630;376834302;534256000;827343000;91386000;1679425000;825946000;;6058272000;6884218000;8563643000;888705000;170507000;1059212000;2936792000;3492967000;4552179000;2304509000;-1510548000;3216639000;4011464000;8563643000
DGX;341807;USD;2008;Q4;2008-12-31;2009-07-28;193491000;194744000;253946000;832873000;102125000;1496819000;879687000;;6027324000;6907011000;8403830000;1219619000;5142000;1224761000;3078089000;3553935000;4778696000;2264206000;-1152921000;2561679000;3625134000;8403830000
DGX;341807;USD;2016;Q4;2016-12-31;2017-02-22;138000000;140000000;359000000;926000000;82000000;1531000000;1029000000;443000000;7097000000;8569000000;10100000000;975000000;6000000;981000000;3728000000;4382000000;5363000000;2547000000;-4460000000;6613000000;4737000000;10100000000
DGX;341807;USD;2017;Q4;2017-12-31;2018-02-23;137000000;139000000;137000000;924000000;95000000;1306000000;1145000000;462000000;7590000000;9197000000;10503000000;1021000000;36000000;1057000000;3748000000;4411000000;5468000000;2614000000;-4783000000;7138000000;5035000000;10503000000
DGX;341807;USD;2018;Q4;2018-12-31;2019-02-21;136000000;139000000;135000000;1012000000;99000000;1390000000;1288000000;436000000;7889000000;9613000000;11003000000;1021000000;464000000;1485000000;3429000000;4174000000;5659000000;2669000000;-4996000000;7602000000;5344000000;11003000000
RSYS;342891;USD;2015;Q4;2015-12-31;2016-03-02;36936000;36936000;20764000;60942000;16812000;126729000;6134000;;34206000;40340000;167069000;60105000;15000000;98167000;;2985000;101152000;338165000;;-271349000;65917000;167069000
RSYS;342891;USD;2014;Q4;2014-12-31;2015-02-27;36504000;36504000;31242000;43845000;18475000;103338000;9786000;;47772000;57558000;160896000;45940000;28000000;80320000;;2800000;83120000;334024000;;-256671000;77776000;160896000
RSYS;342891;USD;2013;Q4;2013-12-31;2014-03-14;29150000;29150000;25482000;41359000;25409000;100693000;14854000;;60638000;75492000;176185000;50606000;15000000;73773000;18000000;21276000;95049000;309370000;;-229090000;81136000;176185000
RSYS;342891;USD;2012;Q4;2012-12-31;2013-03-07;27747000;26250000;33182000;51881000;28907000;125988000;17713000;;88693000;106406000;232394000;57960000;16919000;84101000;18000000;22851000;106952000;303724000;;-179686000;125442000;232394000
RSYS;342891;USD;2011;Q4;2011-12-31;2012-03-01;26539000;21173000;47770000;49212000;35454000;147059000;15366000;;134848000;150214000;297273000;64249000;0;75851000;45000000;54689000;130540000;301225000;;-136212000;166733000;297273000
RSYS;342891;USD;2010;Q4;2010-12-31;2011-08-05;24312000;23646000;129078000;42855000;21372000;200133000;9487000;;31308000;40795000;240928000;48660000;;53084000;50000000;50450000;103534000;266945000;;-134683000;137394000;240928000
RSYS;342891;USD;2016;Q4;2016-12-31;2017-03-01;38466000;38466000;33087000;38378000;20021000;98637000;6713000;;22835000;29548000;128185000;34948000;25000000;65663000;;5966000;71629000;339715000;;-281600000;56556000;128185000
RSYS;342891;USD;2017;Q4;2017-12-31;2018-02-28;39208000;39208000;8124000;32820000;4265000;51816000;4728000;;9485000;14213000;66029000;32413000;16000000;52613000;;6866000;59479000;342219000;;-336182000;6550000;66029000
SONC;343236;USD;2017;Q4;2017-08-31;2017-10-27;41308000;41986000;22340000;33758000;;89184000;312380000;;160180000;472560000;561744000;54059000;3464000;58616000;644283000;704886000;763502000;238078000;-1373853000;934017000;-201758000;561744000
SONC;343236;USD;2016;Q4;2016-08-31;2016-10-31;47237000;48037000;72092000;35437000;3321000;137657000;392380000;;118624000;511004000;648661000;68853000;5090000;74663000;583578000;649641000;724304000;236139000;-1206224000;894442000;-75643000;648661000
SONC;343236;USD;2015;Q4;2015-08-31;2015-10-23;51735000;52934000;27191000;31577000;3824000;85438000;421406000;;113180000;534586000;620024000;73484000;13467000;87821000;449001000;514770000;602591000;233733000;-1068015000;851715000;17433000;620024000
SONC;343236;USD;2014;Q4;2014-08-31;2014-10-24;54024000;55418000;35694000;32833000;3349000;95712000;441969000;;113291000;555260000;650972000;63349000;13484000;79511000;450577000;508786000;588297000;226187000;-964714000;801202000;62675000;650972000
SONC;343236;USD;2013;Q4;2013-08-31;2013-10-25;56061000;57411000;77896000;29142000;3678000;140722000;399661000;;120411000;520072000;660794000;54562000;14320000;72930000;459838000;510400000;583330000;225951000;-906625000;758138000;77464000;660794000
SONC;343236;USD;2012;Q4;2012-08-31;2012-10-26;58104000;58388000;52647000;27073000;3289000;107151000;443008000;;130601000;573609000;680760000;57981000;19480000;80516000;493990000;540997000;621513000;231726000;-895093000;722614000;59247000;680760000
SONC;343236;USD;2011;Q4;2011-08-31;2011-10-28;61956000;62154000;29509000;24558000;3503000;93457000;464875000;;121410000;586285000;679742000;49442000;18940000;71279000;512137000;556767000;628046000;230582000;-866317000;687431000;51696000;679742000
SONC;343236;USD;2010;Q4;2010-08-31;2011-01-07;;;86036000;25463000;3674000;133928000;489264000;;114128000;603392000;737320000;50176000;65133000;118608000;562744000;596146000;714754000;225636000;-872937000;670488000;22566000;737320000
SONC;343236;USD;2018;Q4;2018-08-31;2018-10-23;35937000;36446000;39835000;34967000;1774000;104429000;298222000;;128483000;426705000;531134000;54652000;6704000;62079000;714481000;757901000;819980000;239552000;-1509649000;981251000;-288846000;531134000
INT;344219;USD;2015;Q4;2015-12-31;2016-02-16;69400000;69900000;582500000;1812600000;359100000;3246000000;225600000;;1053700000;1279300000;4525300000;1604800000;25500000;1754200000;746700000;865200000;2619400000;436000000;;1569400000;1905900000;4525300000
INT;344219;USD;2014;Q4;2014-12-31;2015-02-12;70900000;71100000;302300000;2306400000;437600000;3673400000;203400000;;1004200000;1207600000;4881000000;2082600000;17900000;2239300000;672000000;776800000;3016100000;497100000;;1418500000;1864900000;4881000000
INT;344219;USD;2013;Q4;2013-12-31;2014-02-14;70625000;71306000;292061000;2538642000;655046000;3815501000;129685000;;794091000;923776000;4739277000;2388800000;14647000;2514515000;449064000;545868000;3060383000;495918000;;1207299000;1678894000;4739277000
INT;344219;USD;2012;Q4;2012-12-31;2013-02-21;71229000;71911000;172740000;2193866000;572313000;3281377000;112525000;;713849000;826374000;4107751000;2123233000;26065000;2149298000;354253000;416829000;2566127000;518310000;;1014882000;1541624000;4107751000
INT;344219;USD;2011;Q4;2011-12-31;2012-02-23;70983000;71913000;205415000;2160561000;472584000;3122227000;90710000;;484309000;575019000;3697246000;1902788000;17800000;2026142000;269348000;324386000;2350528000;503263000;;836222000;1346718000;3697246000
INT;344219;USD;2010;Q4;2010-12-31;2011-02-24;69434000;70815000;272893000;1386700000;211526000;2067867000;64106000;;434477000;498583000;2566450000;1275928000;17076000;1358484000;24566000;81402000;1439886000;469659000;;652796000;1126564000;2566450000
INT;344219;USD;2009;Q4;2009-12-31;2010-08-03;59414000;61008000;306943000;951398000;126793000;1467947000;38777000;;241271000;280048000;1747995000;870444000;6684000;951711000;9925000;63035000;1014746000;214008000;;515218000;733249000;1747995000
INT;344219;USD;2016;Q4;2016-12-31;2017-02-21;69100000;69700000;698600000;2344000000;458000000;3836600000;311200000;;1264900000;1576100000;5412700000;2076400000;15400000;2182600000;1170800000;1289900000;3472500000;400600000;;1679300000;1940100000;5412600000
INT;344219;USD;2017;Q4;2017-12-31;2018-02-28;67400000;66300000;372300000;2705600000;505000000;3940300000;329800000;;1317600000;1647400000;5587700000;2584600000;25600000;2718500000;884600000;1131200000;3849700000;355600000;;1492800000;1737900000;5587600000
INT;344219;USD;2018;Q4;2018-12-31;2019-03-01;66900000;67200000;211700000;2739600000;523100000;3974800000;350300000;;1351700000;1702000000;5676800000;2776600000;41100000;2935900000;659900000;909400000;3845300000;341100000;;1606100000;1831600000;5676900000
OSIS;344473;USD;2018;Q4;2018-06-30;2018-08-28;18050000;16660000;84814000;210744000;313552000;650697000;115524000;;489470000;604994000;1255691000;147063000;115262000;443322000;248980000;322933000;766255000;169475000;;334745000;489436000;1255691000
OSIS;344473;USD;2017;Q4;2017-06-30;2017-09-07;18684000;19997000;169650000;206526000;248510000;653000000;141539000;;435548000;577087000;1230087000;110742000;105396000;346134000;241750000;314740000;660874000;222529000;;363872000;569213000;1230087000
OSIS;344473;USD;2016;Q4;2016-06-30;2016-04-28;18898000;19503000;104370000;141716000;273288000;598793000;183114000;;209816000;392930000;991723000;98693000;127759000;367835000;6054000;83042000;450877000;219114000;;338988000;540846000;991723000
OSIS;344473;USD;2015;Q4;2015-06-30;2015-04-28;19764000;20559000;47593000;178519000;230421000;496634000;225703000;;214952000;440655000;937289000;95101000;2801000;241643000;8556000;113867000;355510000;279212000;;312831000;581779000;937289000
OSIS;344473;USD;2014;Q4;2014-06-30;2014-05-02;19940000;20591000;38831000;185773000;234138000;566121000;260479000;;184477000;444956000;1011077000;128013000;26819000;302607000;10436000;176257000;478864000;287434000;;247680000;532213000;1011077000
OSIS;344473;USD;2013;Q4;2013-06-30;2013-05-09;19932000;20537000;34697000;206817000;206213000;543124000;249029000;;160586000;409615000;952739000;145212000;60797000;298239000;10673000;176049000;474288000;285001000;;199786000;478451000;952739000
OSIS;344473;USD;2012;Q4;2012-06-30;2012-04-25;19852000;20561000;91452000;156867000;195178000;483113000;111664000;;155119000;266783000;749896000;98733000;215000;160649000;2467000;155128000;315777000;282756000;;155651000;434119000;749896000
OSIS;344473;USD;2011;Q4;2011-06-30;2011-10-26;19209000;19952000;55619000;136716000;169634000;405286000;55017000;;124613000;179630000;584916000;105409000;;160981000;2756000;39135000;200116000;272552000;;110103000;384800000;584916000
OSIS;344473;USD;2019;Q4;2019-06-30;2019-08-27;18134000;18849000;96316000;238440000;273711000;640899000;127385000;;496580000;623965000;1264864000;137021000;88804000;382008000;257752000;331129000;713137000;168913000;;399541000;551727000;1264864000
ALJ;344561;USD;2015;Q4;2015-12-31;2016-02-26;70026000;66687000;234127000;119171000;105515000;504615000;1380202000;42811000;248510000;1671523000;2176138000;409501000;16420000;425921000;539542000;1086057000;1511978000;526745000;;141201000;664160000;2176138000
ALJ;344561;USD;2014;Q4;2014-12-31;2015-03-13;69319000;70018000;214961000;153859000;122803000;538362000;1372344000;25376000;255562000;1653282000;2191644000;396608000;15089000;411697000;539368000;1106169000;1517866000;517823000;;126851000;673778000;2191644000
ALJ;344561;USD;2013;Q4;2013-12-31;2014-03-14;66680000;60820000;224499000;200398000;128770000;601394000;1429342000;26251000;188153000;1643746000;2245140000;457357000;83174000;540531000;529074000;1079205000;1619736000;509856000;;124936000;625404000;2245140000
ALJ;344561;USD;2012;Q4;2012-12-31;2013-03-14;61039000;69945000;116296000;183632000;183919000;508898000;1492493000;21582000;200601000;1714676000;2223574000;412152000;9504000;421656000;577513000;1180732000;1602388000;444635000;;128319000;621186000;2223574000
ALJ;344561;USD;2011;Q4;2011-12-31;2012-03-13;55887000;61913000;157066000;244194000;147272000;609338000;1504870000;20342000;195832000;1721044000;2330382000;390012000;119874000;509886000;930322000;1424712000;1934598000;319220000;;63273000;395784000;2330382000
ALJ;344561;USD;2010;Q4;2010-12-31;2011-08-08;54213000;54213000;71687000;115541000;141050000;393847000;1488532000;18664000;187478000;1694674000;2088521000;381345000;11512000;392857000;904793000;1353897000;1746754000;291352000;;33052000;341767000;2088521000
ALJ;344561;USD;2016;Q4;2016-12-31;2017-02-27;71231000;71231000;136302000;134744000;130502000;471293000;1366895000;33431000;223682000;1624008000;2095301000;429090000;16414000;445504000;511552000;1067384000;1512888000;531341000;;15878000;582413000;2095301000
TYPE;344785;USD;2015;Q4;2015-12-31;2016-02-26;38934396;39381947;87520000;15179000;;109103000;15204000;;267480000;282684000;391787000;25202000;;35288000;;49317000;84605000;256257000;-50455000;108908000;307182000;391787000
TYPE;344785;USD;2014;Q4;2014-12-31;2015-02-27;38403584;39005769;90325000;9279000;;109456000;10578000;;254424000;265002000;374458000;26366000;;33473000;;45872000;79345000;232561000;-31946000;98672000;295113000;374458000
TYPE;344785;USD;2013;Q4;2013-12-31;2014-03-11;38230789;39970955;78411000;8317000;;97013000;3568000;;255778000;259346000;356359000;21551000;;28318000;;41166000;69484000;209415000;-2279000;78741000;286875000;356359000
TYPE;344785;USD;2012;Q4;2012-12-31;2013-03-01;36594631;37596964;39340000;6996000;;53217000;2587000;;264262000;266849000;320066000;20548000;10000000;39273000;;45687000;84960000;178718000;-86000;56980000;235106000;320066000
TYPE;344785;USD;2011;Q4;2011-12-31;2012-03-01;35632200;37264647;53850000;6588000;;64905000;2404000;;216513000;218917000;283822000;14638000;10000000;32380000;;53081000;85461000;167484000;-86000;30986000;198361000;283822000
TYPE;344785;USD;2010;Q4;2010-12-31;2011-08-02;34920458;36229176;42786000;4720000;;50676000;1589000;;226540000;228129000;278805000;14969000;8355000;31830000;;81993000;113823000;155826000;-86000;8317000;164982000;278805000
TYPE;344785;USD;2016;Q4;2016-12-31;2017-02-28;39145086;39395921;91434000;26549000;;125581000;14166000;;385273000;399439000;525020000;32405000;;48486000;;162556000;211042000;274989000;-56232000;105718000;313978000;525020000
TYPE;344785;USD;2017;Q4;2017-12-31;2018-02-27;39748892;40500703;82822000;34461000;;136188000;16763000;;373099000;389862000;526050000;45085000;;60187000;;136495000;196682000;298157000;-64083000;97815000;329368000;526050000
TYPE;344785;USD;2018;Q4;2018-12-31;2019-02-25;40113934;40394300;60106000;55943000;;133644000;14105000;;359907000;374012000;507656000;46069000;;56406000;;121544000;177950000;319532000;-83518000;99605000;329706000;507656000
WMB;344928;USD;2016;Q4;2016-12-31;2017-02-22;750957000;749853000;170000000;938000000;138000000;1462000000;28428000000;6701000000;10244000000;45373000000;46835000000;2071000000;878000000;2949000000;22624000000;29840000000;32789000000;15672000000;-1041000000;-9649000000;14046000000;46835000000
WMB;344928;USD;2015;Q4;2015-12-31;2016-02-26;749928000;742457000;100000000;1041000000;127000000;1527000000;29579000000;7336000000;10578000000;47493000000;49020000000;1822000000;675000000;2497000000;23812000000;30298000000;32795000000;15591000000;-1041000000;-7960000000;16225000000;49020000000
WMB;344928;USD;2014;Q4;2014-12-31;2015-02-25;748562000;752900000;240000000;972000000;231000000;1890000000;28081000000;8400000000;12084000000;48565000000;50455000000;1765000000;802000000;2567000000;20780000000;27716000000;30283000000;15707000000;-1041000000;-5548000000;20172000000;50455000000
WMB;344928;USD;2013;Q4;2013-12-31;2014-02-26;683573000;687367000;681000000;600000000;194000000;1683000000;18210000000;4360000000;2889000000;25459000000;27142000000;1757000000;226000000;1983000000;11353000000;16238000000;18221000000;12317000000;-1041000000;-6248000000;8921000000;27142000000
WMB;344928;USD;2012;Q4;2012-12-31;2013-02-27;637645000;642785000;839000000;620000000;175000000;1924000000;15467000000;3987000000;2949000000;22403000000;24327000000;1548000000;1000000;1549000000;10735000000;15351000000;16900000000;11850000000;-1041000000;-5695000000;7427000000;24327000000
WMB;344928;USD;2011;Q4;2011-12-31;2012-05-01;589975000;600950000;889000000;637000000;169000000;1894000000;12580000000;1391000000;637000000;14608000000;16502000000;1322000000;353000000;1675000000;8369000000;12241000000;13916000000;8546000000;-1041000000;-5820000000;2586000000;16502000000
WMB;344928;USD;2010;Q4;2010-12-31;2011-02-25;187696177;202367534;758000000;497000000;225000000;2530000000;11754000000;1240000000;9448000000;22442000000;24972000000;1170000000;508000000;2574000000;8600000000;14264000000;16838000000;8404000000;-1041000000;-478000000;8134000000;24972000000
WMB;344928;USD;2009;Q4;2009-12-31;2010-02-26;188160449;183355960;1867000000;816000000;222000000;3793000000;18644000000;886000000;1957000000;21487000000;25280000000;1882000000;17000000;2477000000;8259000000;13784000000;16261000000;8753000000;-1041000000;903000000;9019000000;25280000000
WMB;344928;USD;2008;Q4;2008-12-31;2009-08-27;710324315;720055726;1438000000;884000000;260000000;4411000000;17741000000;971000000;2883000000;21595000000;26006000000;2191000000;18000000;3519000000;7683000000;13433000000;16952000000;8687000000;-1041000000;874000000;9054000000;26006000000
WMB;344928;USD;2017;Q4;2017-12-31;2018-02-22;826955000;829653000;899000000;976000000;113000000;2179000000;28211000000;6552000000;9410000000;44173000000;46352000000;2145000000;501000000;2646000000;20434000000;27531000000;30177000000;19369000000;-1041000000;-8434000000;16175000000;46352000000
WMB;344928;USD;2018;Q4;2018-12-31;2019-02-21;1215540000;1207696000;168000000;992000000;130000000;1464000000;27504000000;7821000000;8513000000;43838000000;45302000000;1764000000;47000000;1811000000;22367000000;27494000000;29305000000;25938000000;-1041000000;-10002000000;15997000000;45302000000
MIC;345220;USD;2017;Q4;2017-12-31;2018-02-21;84604318;111789307;47121000;158152000;36955000;307645000;4659614000;9526000;3032166000;7701306000;8008951000;150081000;50835000;255965000;3530311000;4402283000;4658248000;1840118000;;1343567000;3350703000;8008951000
MIC;345220;USD;2016;Q4;2016-12-31;2016-10-31;81867189;80629772;44767000;124846000;31461000;244668000;4346536000;8835000;2959214000;7314585000;7559253000;153300000;40016000;251009000;3039966000;4160710000;4411719000;2089489000;;892365000;3147534000;7559253000
MIC;345220;USD;2015;Q4;2015-12-31;2015-11-02;79969688;79251795;22394000;95597000;29489000;216569000;4116163000;8274000;2967798000;7092235000;7308804000;135215000;40099000;308790000;2746525000;3797572000;4106362000;2317501000;;735984000;3202442000;7308804000
MIC;345220;USD;2014;Q4;2014-12-31;2014-10-29;71026858;75230039;48014000;96885000;28080000;256890000;3362585000;9773000;2995940000;6368298000;6625188000;126981000;27655000;224332000;2364866000;3430688000;3655020000;1964192000;0;844521000;2970168000;6625188000
MIC;345220;USD;2013;Q4;2013-12-31;2013-10-28;54007145;54036211;233373000;60823000;25834000;406550000;854169000;83703000;1156443000;2094315000;2500865000;71563000;164945000;271452000;832245000;1076145000;1347597000;1248180000;;-197507000;1153268000;2500865000
MIC;345220;USD;2012;Q4;2012-12-31;2012-10-31;46967010;47003380;141376000;56553000;20617000;253910000;708031000;75205000;1186548000;1969784000;2223694000;61998000;108247000;245330000;1054887000;1280799000;1526129000;904590000;;-228761000;697565000;2223694000
MIC;345220;USD;2011;Q4;2011-12-31;2011-11-02;46259991;46310478;22786000;56458000;23106000;143313000;561022000;230401000;1233897000;2025320000;2168633000;53026000;36487000;148902000;1088079000;1325871000;1474773000;973176000;;-242082000;693860000;2168633000
MIC;345220;USD;2010;Q4;2010-12-31;2011-08-03;45717266;45748709;24563000;47845000;17063000;125427000;563451000;223792000;1284072000;2071315000;2196742000;59083000;50400000;171286000;1089979000;1338761000;1510047000;986386000;;-269425000;686695000;2196742000
MIC;345220;USD;2018;Q4;2018-12-31;2019-02-20;85654206;77715097;589000000;95000000;29000000;772000000;3141000000;8000000;3523000000;6672000000;7444000000;124000000;361000000;521000000;2653000000;3806000000;4327000000;1510000000;;1485000000;3117000000;7444000000
BGSF;346052;USD;2016;Q4;2016-12-31;2017-03-06;8672901;8871412;;33328900;;34434269;1910858;;44869007;46779865;81214134;11668835;0;15249396;23618194;25476284;40725680;36229373;;4259081;40488454;81214134
BGSF;346052;USD;2015;Q4;2015-12-31;2016-03-07;7381645;7375184;;32324284;;33319600;1489061;;49590896;51079957;84399557;14987744;;23303703;30648926;35167430;58471133;20520828;;5407596;25928424;84399557
BGSF;346052;USD;2014;Q4;2014-12-31;2015-03-02;5787941;5567528;;22030342;;22902480;667597;;29705883;30373480;53275960;10851323;2198352;14598533;19392540;22314135;36912668;10800420;;5562872;16363292;53275960
BGSF;346052;USD;2013;Q4;2013-12-31;2014-03-31;5439554;5598407;;23347449;;25249986;523360;;32849155;33372515;58622501;11973001;2378333;16858932;15378333;33660895;50519827;1121216;;6981458;8102674;58622501
BGSF;346052;USD;2012;Q4;2012-12-31;2014-01-21;;;;12626792;;13390493;286911;;23465164;23752075;37142568;7069389;2378333;11917660;10656667;25224908;37142568;0;;0;0;37142568
BGSF;346052;USD;2017;Q4;2017-12-31;2018-03-08;8761333;9100586;;36707885;;37990002;2039935;;64602952;66642887;104632889;14373169;2923699;21670104;41199322;43828106;65498210;37762923;;1371756;39134679;104632889
BGSF;346052;USD;2018;Q4;2018-12-31;2019-03-12;10203556;10264200;;37606721;;38613673;2556992;;59098138;61655130;100268803;11452999;4242580;18059091;15846157;16507699;34566790;57702625;;7999388;65702013;100268803
INFN;346530;USD;2015;Q4;2015-12-31;2016-02-23;140013000;149438000;274662000;186243000;174699000;665115000;110861000;91007000;357198000;559066000;1224181000;194066000;;237043000;123327000;210077000;447120000;1300441000;;-539413000;777061000;1224181000
INFN;346530;USD;2014;Q4;2014-12-31;2015-02-18;125830000;137186000;326123000;154596000;146500000;651855000;81566000;73733000;10862000;166161000;818016000;139010000;;174331000;116894000;161778000;336109000;1077351000;;-590826000;481907000;818016000
INFN;346530;USD;2013;Q4;2013-12-31;2014-02-21;119741000;113802000;296990000;100643000;123685000;539070000;79668000;73419000;8769000;161856000;700926000;108547000;;140949000;109164000;142167000;283116000;1025781000;;-604485000;417810000;700926000
INFN;346530;USD;2012;Q4;2012-12-31;2013-03-05;112308000;112308000;180812000;107039000;127809000;429497000;80343000;11874000;6456000;98673000;528170000;117303000;;144047000;0;27987000;172034000;930730000;;-572366000;356136000;528170000
INFN;346530;USD;2011;Q4;2011-12-31;2012-03-06;106873000;106873000;195754000;80616000;88996000;383231000;76753000;63315000;8405000;148473000;531704000;95917000;;118698000;;25203000;143901000;877034000;;-487036000;387803000;531704000
INFN;346530;USD;2010;Q4;2010-12-31;2011-08-02;101579000;101579000;281662000;75931000;81893000;461595000;51740000;14453000;23737000;89930000;551525000;86242000;;108200000;;32576000;140776000;817302000;;-405292000;410749000;551525000
INFN;346530;USD;2016;Q4;2016-12-31;2017-02-23;144905000;135335000;304338000;150370000;232955000;730423000;124800000;47779000;295581000;468160000;1198583000;157633000;0;216533000;133586000;219722000;436255000;1354227000;;-563575000;762328000;1198583000
INFN;346530;USD;2017;Q4;2017-12-31;2018-02-28;149411000;149411000;263941000;126152000;214704000;647937000;135942000;36129000;297662000;469733000;1117670000;157327000;144928000;374676000;;77629000;452305000;1417192000;;-758081000;665365000;1117670000
HDSN;346795;USD;2016;Q4;2016-12-31;2017-03-10;36527248;38154842;33931000;4797000;68601000;108176000;7532000;;6762000;14294000;122470000;10102000;199000;10301000;152000;152000;10453000;114447000;;-2430000;112017000;122470000
HDSN;346795;USD;2015;Q4;2015-12-31;2016-03-11;32671816;33224874;1258000;4414000;61897000;69469000;7536000;;8006000;15542000;85011000;10387000;20573000;30960000;4293000;4626000;35586000;62491000;;-13066000;49425000;85011000
HDSN;346795;USD;2014;Q4;2014-12-31;2015-03-16;33101426;29761208;935000;3968000;37017000;43328000;7887000;;8720000;16607000;59935000;4894000;6320000;11214000;4389000;4722000;15936000;61828000;;-17829000;43999000;59935000
HDSN;346795;USD;2013;Q4;2013-12-31;2014-02-28;25007937;20623295;669000;3706000;33967000;41866000;4536000;;5966000;10502000;52368000;4244000;15367000;19611000;4671000;4671000;24282000;45195000;;-17109000;28086000;52368000
HDSN;346795;USD;2012;Q4;2012-12-31;2013-03-05;24071191;26822250;3991000;1956000;40167000;47024000;4765000;1138000;4305000;10208000;57232000;6880000;12736000;19616000;4920000;4920000;24536000;43963000;;-11267000;32696000;57232000
HDSN;346795;USD;2011;Q4;2011-12-31;2012-03-05;23781438;25273516;3958000;2453000;17734000;24756000;3441000;0;3254000;6695000;31451000;5930000;6361000;12291000;121000;121000;12412000;43107000;;-24068000;19039000;31451000
HDSN;346795;USD;2010;Q4;2010-12-31;2011-08-03;23780608;24803320;3926000;1767000;18211000;24280000;3008000;;3808000;6816000;31096000;7043000;5012000;12055000;1018000;1018000;13073000;43125000;;-25102000;18023000;31096000
HDSN;346795;USD;2017;Q4;2017-12-31;2018-03-16;42111603;40549275;5002000;14831000;172485000;208916000;30461000;;82067000;112528000;321444000;29158000;66202000;95360000;101158000;102631000;197991000;114726000;;8727000;123453000;321444000
HDSN;346795;USD;2018;Q4;2018-12-31;2019-03-15;42603243;42603243;2272000;14065000;101962000;123586000;27395000;;77360000;104755000;228341000;28740000;31672000;60412000;98273000;98716000;159128000;116145000;;-46932000;69213000;228341000
NTRI;346874;USD;2015;Q4;2015-12-31;2016-02-29;28930000;29422000;15508000;18385000;30530000;76882000;30849000;;22162000;53011000;129893000;52063000;;57681000;;2284000;59965000;41421000;-5672000;34191000;69928000;129893000
NTRI;346874;USD;2014;Q4;2014-12-31;2015-03-09;28745000;29378000;29247000;12206000;26899000;76498000;26851000;;6543000;33394000;109892000;47243000;;51667000;;2710000;54377000;30021000;-3062000;28552000;55515000;109892000
NTRI;346874;USD;2013;Q4;2013-12-31;2014-03-10;28415000;29127000;26323000;7738000;26088000;69281000;26029000;;7135000;33164000;102445000;43281000;;47509000;;2779000;50288000;24124000;-1586000;29611000;52157000;102445000
NTRI;346874;USD;2012;Q4;2012-12-31;2013-03-12;82379238;82140057;19391000;8487000;23637000;66175000;28003000;;4228000;32231000;98406000;31429000;;34772000;;3525000;38297000;18495000;-636000;42254000;60109000;98406000
NTRI;346874;USD;2011;Q4;2011-12-31;2012-03-13;81275935;82443369;57607000;11198000;31514000;116901000;29771000;;3682000;33453000;150354000;37746000;;40662000;30000000;34734000;75396000;10119000;0;64931000;74958000;150354000
NTRI;346874;USD;2010;Q4;2010-12-31;2011-08-05;-86391752;-87500256;41219000;9256000;28747000;113684000;34324000;;1945000;36269000;149953000;35176000;;39664000;30000000;35313000;74977000;3116000;;71988000;74976000;149953000
NTRI;346874;USD;2016;Q4;2016-12-31;2017-02-28;29317000;29735000;33496000;17560000;38504000;99644000;32643000;;21953000;54596000;154240000;50357000;;57839000;;1877000;59716000;54087000;-8329000;48799000;94524000;154240000
NTRI;346874;USD;2017;Q4;2017-12-31;2018-02-28;29771000;30274000;72222000;17871000;44266000;152558000;31549000;;17436000;48985000;201543000;56113000;;64104000;;1636000;65740000;69276000;-16359000;83035000;135803000;201543000
NTRI;346874;USD;2018;Q4;2018-12-31;2019-02-26;29179000;29602000;81324000;16640000;47755000;160841000;28129000;;15267000;43396000;204237000;46989000;;55396000;;2325000;57721000;81519000;-47583000;112611000;146516000;204237000
HST;346970;USD;2018;Q4;2018-12-31;2019-02-26;740400000;742100000;1542000000;;;1894000000;9973000000;;223000000;10196000000;12090000000;293000000;;559000000;3837000000;3837000000;4396000000;8163000000;;-610000000;7694000000;12090000000
HST;346970;USD;2017;Q4;2017-12-31;2018-02-27;739000000;740400000;913000000;;;1242000000;9887000000;;564000000;10451000000;11693000000;283000000;;570000000;3954000000;3954000000;4524000000;8104000000;;-1071000000;7169000000;11693000000
HST;346970;USD;2016;Q4;2016-12-31;2016-11-02;737800000;739700000;372000000;;;579000000;10318000000;;511000000;10829000000;11408000000;278000000;;561000000;3649000000;3649000000;4210000000;8084000000;;-1007000000;7198000000;11408000000
HST;346970;USD;2015;Q4;2015-12-31;2015-10-30;753300000;723000000;221000000;;;347000000;10724000000;;585000000;11309000000;11656000000;243000000;;542000000;3867000000;3867000000;4409000000;8310000000;;-1139000000;7247000000;11656000000
HST;346970;USD;2014;Q4;2014-12-31;2014-10-31;755700000;849800000;684000000;;;754000000;10704000000;;714000000;11418000000;12172000000;298000000;;622000000;3957000000;3957000000;4579000000;8484000000;;-1098000000;7593000000;12172000000
HST;346970;USD;2013;Q4;2013-12-31;2013-11-06;755200000;757400000;861000000;;;987000000;11168000000;;659000000;11827000000;12814000000;214000000;;603000000;4759000000;4759000000;5362000000;8500000000;;-1263000000;7452000000;12814000000
HST;346970;USD;2012;Q4;2012-12-31;2012-10-15;725900000;719000000;417000000;;;586000000;11742000000;;666000000;12408000000;12994000000;194000000;;566000000;5411000000;5411000000;5977000000;8047000000;;-1234000000;7017000000;12994000000
HST;346970;USD;2011;Q4;2011-12-31;2011-10-17;706900000;705500000;826000000;;;954000000;11549000000;;587000000;12136000000;13090000000;175000000;;466000000;5753000000;5753000000;6219000000;7757000000;;-1079000000;6871000000;13090000000
HST;346970;USD;2010;Q4;2010-12-31;2010-10-15;;1322199346;1113000000;;;1243000000;10666000000;;502000000;11168000000;12411000000;161000000;;411000000;5477000000;5477000000;5888000000;7243000000;;-965000000;6523000000;12411000000
HST;346970;USD;2009;Q4;2009-12-31;2009-10-16;;;1642000000;;;1781000000;10355000000;;419000000;10774000000;12555000000;174000000;;368000000;5837000000;5837000000;6205000000;6881000000;;-801000000;6350000000;12555000000
OMI;347188;USD;2017;Q4;2017-12-31;2018-02-23;60279000;60279000;104522000;758936000;990193000;2181905000;206490000;;987898000;1194388000;3376293000;977988000;;1309733000;900744000;1051081000;2360814000;349889000;;690674000;1015479000;3376293000
OMI;347188;USD;2016;Q4;2016-12-31;2017-02-17;60159000;60159000;185488000;606084000;916311000;1962039000;191718000;;563995000;755713000;2717752000;795801000;;1034638000;564583000;723076000;1757714000;342017000;;685504000;960038000;2717752000
OMI;347188;USD;2015;Q4;2015-12-31;2016-02-25;61976000;61978000;161020000;587935000;940775000;1974700000;208930000;;590146000;799076000;2773776000;756516000;;1063589000;568495000;717597000;1781186000;337549000;;706866000;992590000;2773776000
OMI;347188;USD;2014;Q4;2014-12-31;2015-02-23;62090000;62092000;56772000;626192000;872457000;1869900000;232979000;;632527000;865506000;2735406000;640353000;;966576000;608551000;777992000;1744568000;329074000;;685765000;990838000;2735406000
OMI;347188;USD;2013;Q4;2013-12-31;2014-02-25;62501000;62516000;101905000;572854000;771663000;1725932000;191961000;;406149000;598110000;2324042000;667168000;;990208000;212786000;308791000;1298999000;322798000;;691547000;1025043000;2324042000
OMI;347188;USD;2012;Q4;2012-12-31;2013-02-22;62680000;62739000;97888000;537335000;763756000;1630243000;191841000;;392314000;584155000;2214398000;628605000;;925636000;215383000;315106000;1240742000;313938000;;658994000;973656000;2214398000
OMI;347188;USD;2011;Q4;2011-12-31;2012-02-24;62574000;62690000;135938000;506758000;806366000;1525825000;108061000;;312929000;420990000;1946815000;596461000;;732365000;212681000;295233000;1027598000;305952000;;619629000;919217000;1946815000
OMI;347188;USD;2010;Q4;2010-12-31;2011-02-25;62426000;62638000;159213000;471661000;720116000;1403789000;101545000;;316705000;418250000;1822039000;552323000;;694481000;209096000;270040000;964521000;292314000;;570320000;857518000;1822039000
OMI;347188;USD;2009;Q4;2009-12-31;2010-07-30;;;96136000;498080000;689889000;1342067000;84965000;;320056000;405021000;1747088000;581874000;;700116000;208418000;277793000;977909000;277732000;;504480000;769179000;1747088000
OMI;347188;USD;2018;Q4;2018-12-31;2019-03-06;60571000;60571000;103367000;823418000;1290103000;2538578000;386723000;;848487000;1235210000;3773788000;1157792000;;1472011000;1650582000;1783358000;3255369000;363361000;;200670000;518419000;3773788000
MAN;348449;USD;2015;Q4;2015-12-31;2016-02-22;74100000;74900000;730500000;4243000000;;5092500000;147100000;;2277900000;2425000000;7517500000;3195400000;44200000;3451000000;810900000;1374000000;4825000000;3187900000;-2243200000;1966000000;2692500000;7517500000
MAN;348449;USD;2014;Q4;2014-12-31;2015-02-20;78600000;79100000;699200000;4134500000;;4981500000;149100000;;2050600000;2199700000;7181200000;3104100000;45200000;3353800000;422600000;884400000;4238200000;3085300000;-1654900000;1667800000;2943000000;7181200000
MAN;348449;USD;2013;Q4;2013-12-31;2014-02-21;79100000;81600000;737600000;4277900000;;5243000000;166000000;;1879300000;2045300000;7288300000;3243200000;36000000;3509600000;481900000;864500000;4374100000;3015100000;-1500600000;1317500000;2914200000;7288300000
MAN;348449;USD;2012;Q4;2012-12-31;2013-02-22;78200000;79100000;648100000;4179000000;;5060600000;184800000;;1767200000;1952000000;7012600000;3158500000;308000000;3677200000;462100000;834600000;4511800000;2874300000;-1509400000;1101500000;2500800000;7012600000
MAN;348449;USD;2011;Q4;2011-12-31;2012-02-23;80800000;81900000;580500000;4181300000;;4990500000;174500000;;1734700000;1909200000;6899700000;3106100000;434200000;3762200000;266000000;654100000;4416300000;2841000000;-1364600000;971700000;2483400000;6899700000
MAN;348449;USD;2010;Q4;2010-12-31;2011-02-24;82000000;78900000;772600000;3844100000;;4874000000;170300000;;1685400000;1855700000;6729700000;3021200000;28700000;3290100000;669300000;1042400000;4332500000;2782800000;-1257800000;785200000;2397200000;6729700000
MAN;348449;USD;2009;Q4;2009-12-31;2010-08-05;78300000;78300000;1014600000;3070800000;;4332400000;176400000;;1705000000;1881400000;6213800000;2373500000;41700000;2603000000;715600000;1074300000;3677300000;2545200000;-1225200000;1109600000;2536500000;6213800000
MAN;348449;USD;2016;Q4;2016-12-31;2017-02-21;67600000;68400000;598500000;4413100000;;5132900000;147300000;;2294000000;2441300000;7574200000;3410900000;39800000;3658800000;785600000;1469000000;5127800000;3228400000;-2731700000;2291300000;2446400000;7574200000
MAN;348449;USD;2017;Q4;2017-12-31;2018-02-23;66500000;67600000;689000000;5370500000;;6171200000;157700000;;2554700000;2712400000;8883600000;4110400000;469400000;4810400000;478100000;1215600000;6026000000;3303800000;-2953700000;2713000000;2857600000;8883600000
MAN;348449;USD;2018;Q4;2018-12-31;2019-02-22;61900000;62400000;591900000;5276100000;;5997100000;152600000;;2370100000;2522700000;8519800000;3916100000;50100000;4175900000;1025300000;1645400000;5821300000;3338700000;-3471700000;3157700000;2698500000;8519800000
PODD;349262;USD;2015;Q4;2015-12-31;2016-02-29;56939166;56939166;122672000;42530000;12024000;190761000;41793000;;42572000;84365000;275126000;51957000;5519000;65156000;171967000;175919000;241075000;686250000;;-651545000;34051000;275126000
PODD;349262;USD;2014;Q4;2014-12-31;2015-02-26;56179949;56179949;151193000;39882000;13099000;208196000;37069000;;51917000;88986000;297182000;39362000;3380000;44296000;166283000;169057000;213353000;661867000;;-578025000;83829000;297182000
PODD;349262;USD;2013;Q4;2013-12-31;2014-02-28;54698077;54698077;149727000;33067000;9464000;198198000;32356000;;57401000;89757000;287955000;38837000;2637000;42374000;119041000;120984000;163358000;651122000;;-526525000;124597000;287955000
PODD;349262;USD;2012;Q4;2012-12-31;2013-02-28;48224265;48224265;57293000;33294000;14867000;109936000;25422000;;62701000;88123000;198059000;28412000;14429000;48286000;103730000;105597000;153883000;525727000;;-481551000;44176000;198059000
PODD;349262;USD;2011;Q4;2011-12-31;2012-02-28;47432812;47432812;93955000;23190000;11838000;132635000;19422000;;69265000;88687000;221322000;24482000;;27995000;108540000;110592000;138587000;512419000;;-429684000;82735000;221322000
PODD;349262;USD;2010;Q4;2010-12-31;2011-08-09;;;113274000;16841000;11430000;142457000;12522000;;1254000;13776000;156233000;14703000;;18950000;69433000;71052000;90002000;450084000;;-383853000;66231000;156233000
PODD;349262;USD;2016;Q4;2016-12-31;2017-02-28;57438907;57438907;298570000;28803000;35514000;369960000;44753000;;41934000;86687000;456647000;54388000;;55697000;332768000;337800000;393497000;744300000;;-680424000;63150000;456647000
PODD;349262;USD;2017;Q4;2017-12-31;2018-02-22;58242806;58242806;440056000;53373000;33793000;537171000;107864000;125549000;46160000;279573000;816744000;83669000;;86025000;566173000;572203000;658228000;866264000;;-707255000;158516000;816744000
PODD;349262;USD;2018;Q4;2018-12-31;2019-02-26;59105647;65569844;288946000;63294000;71414000;461286000;258379000;140784000;68295000;467458000;928744000;114473000;;115657000;591978000;600988000;716645000;898618000;;-683614000;212099000;928744000
TSRO;349753;USD;2017;Q4;2017-12-31;2018-02-28;54412000;54412000;643095000;53416000;57939000;787961000;9652000;;64572000;74224000;862185000;158980000;;166206000;437105000;446893000;613099000;1724855000;;-1469887000;249086000;862185000
TSRO;349753;USD;2016;Q4;2016-12-31;2016-11-04;52683000;52683000;785877000;6195000;14700000;817287000;6640000;;18366000;25006000;842293000;73936000;;77009000;131775000;137166000;214175000;1604803000;;-973761000;628118000;842293000
TSRO;349753;USD;2015;Q4;2015-12-31;2015-10-30;40190000;40190000;230146000;679000;1106000;236491000;2779000;;16011000;18790000;255281000;44647000;;46681000;121325000;121726000;168407000;688792000;;-601918000;86874000;255281000
TSRO;349753;USD;2014;Q4;2014-12-31;2014-11-06;36089000;36089000;256861000;;;258596000;1022000;;767000;1789000;260385000;22839000;;24365000;111964000;111964000;136329000;474566000;;-350510000;124056000;260385000
TSRO;349753;USD;2013;Q4;2013-12-31;2013-11-08;32649000;32649000;130310000;;;134339000;440000;;799000;1239000;135578000;12410000;;12423000;;3000;12426000;302650000;;-179498000;123152000;135578000
TSRO;349753;USD;2012;Q4;2012-12-31;2012-10-26;27020000;27020000;125445000;;;126620000;219000;;541000;760000;127380000;11715000;;11718000;;0;11718000;202798000;;-87136000;115662000;127380000
TSRO;349753;USD;2011;Q4;2011-12-31;2012-07-27;591000;591000;39825000;;;42431000;118000;;330000;448000;42879000;3585000;;3596000;;3000;3599000;305000;;-25373000;39280000;42879000
DVA;349826;USD;2017;Q4;2017-12-31;2018-02-23;182153363;187243017;551750000;1714750000;181799000;8744358000;3149213000;37695000;7016927000;10203835000;18948193000;1125232000;178213000;3041177000;9158018000;10009590000;13050767000;1043081000;;3633713000;5897426000;18948193000
DVA;349826;USD;2016;Q4;2016-12-31;2016-11-02;193938420;196681906;981757000;1503950000;160419000;3994748000;2864121000;29997000;11866910000;14761028000;18755776000;1164577000;160262000;2710964000;8944676000;10221813000;12932777000;1027377000;;3710313000;5822999000;18755776000
DVA;349826;USD;2015;Q4;2015-12-31;2015-11-05;208717100;217322316;1907200000;1724228000;185575000;4503280000;2788740000;89122000;11133733000;14011595000;18514875000;1587978000;129037000;2399138000;9001308000;10167499000;12566637000;1118543000;-544772000;4356835000;5948238000;18514875000
DVA;349826;USD;2014;Q4;2014-12-31;2014-11-06;212955844;217634365;1302640000;1525849000;136084000;3636170000;2469099000;89389000;11422774000;13981262000;17617432000;1458274000;120154000;2088651000;8298624000;9338505000;11427156000;1108427000;;4087103000;6190276000;17617432000
DVA;349826;USD;2013;Q4;2013-12-31;2013-11-06;210596610;215176258;953050000;1485163000;88805000;3472278000;2189411000;79557000;11357631000;13626599000;17098877000;1722930000;274697000;2462049000;8141231000;9333987000;11796036000;1071135000;;3363989000;5302841000;17098877000
DVA;349826;USD;2012;Q4;2012-12-31;2012-10-31;202302446;207036810;540886000;1424303000;78126000;2887050000;1872370000;59341000;11195872000;13127583000;16014633000;1220018000;233042000;2016425000;8326534000;9500591000;11517016000;1208935000;-1162336000;3731835000;4497617000;16014633000
DVA;349826;USD;2011;Q4;2011-12-31;2011-11-04;186876474;189842532;411151000;1195163000;75731000;2293244000;1432651000;9890000;5168023000;6610564000;8903808000;748800000;87345000;1164752000;4417624000;4992715000;6157467000;596435000;-1631694000;3195818000;2746341000;8903808000
DVA;349826;USD;2010;Q4;2010-12-31;2010-11-05;194080312;197999122;883120000;1048976000;76008000;2622854000;1170808000;8848000;4311914000;5491570000;8114424000;506510000;74892000;924345000;4233850000;4769893000;5694238000;620681000;-1360579000;2717817000;2420186000;8114424000
DVA;349826;USD;2009;Q4;2009-12-31;2009-11-05;205408212;207457106;565934000;1105903000;70041000;2302521000;1104925000;7616000;4143174000;5255715000;7558236000;485842000;100007000;1046941000;3532217000;3985411000;5032352000;621820000;-793340000;2312134000;2525884000;7558236000
DVA;349826;USD;2008;Q4;2008-12-31;2009-08-07;207775758;208990696;446413000;1075457000;84174000;2128296000;1048075000;5656000;4104056000;5157787000;7286083000;595099000;72725000;1163063000;3622421000;4004724000;5167787000;584493000;-691857000;1889450000;2118296000;7286083000
DVA;349826;USD;2018;Q4;2018-12-31;2019-02-22;165798131;166255893;325973000;1858608000;107381000;8331777000;3393669000;35424000;7349382000;10778475000;19110252000;1122183000;1929369000;4891161000;8172847000;9186052000;14077213000;995172000;;2743194000;5033039000;19110252000
DPLO;349954;USD;2015;Q4;2015-12-31;2016-02-29;64606158;67318534;27600000;254682000;165950000;460970000;16538000;4959000;519112000;540609000;1001579000;296587000;6000000;371902000;106706000;114131000;486033000;480841000;;31130000;515546000;1001579000
DPLO;349954;USD;2014;Q4;2014-12-31;2015-03-03;49613461;52306296;17957000;155273000;110683000;291086000;13150000;3500000;82350000;99000000;390086000;202495000;;215428000;;5931000;221359000;158794000;;5354000;168727000;390086000
DPLO;349954;USD;2013;Q4;2013-12-31;2014-11-25;33140000;31031000;9109000;110294000;56454000;177781000;12378000;5577000;16041000;33996000;211777000;142353000;6693000;216667000;18849000;72892000;289559000;4190000;;-81972000;-77782000;211777000
DPLO;349954;USD;2016;Q4;2016-12-31;2017-03-08;66746156;67951952;7953000;275568000;215351000;511117000;20372000;;567765000;588137000;1099254000;320684000;7500000;385346000;100184000;100184000;485530000;537096000;;76306000;613724000;1099254000
DPLO;349954;USD;2017;Q4;2017-12-31;2018-03-01;69734842;70358278;84251000;332091000;206603000;634070000;38990000;;1267363000;1306353000;1940423000;413463000;11500000;651457000;521098000;539465000;1190922000;657685000;;91816000;749501000;1940423000
DPLO;349954;USD;2018;Q4;2018-12-31;2019-03-18;74436759;74081634;9485000;326602000;210573000;556256000;34525000;;885578000;920103000;1476359000;331348000;11500000;558585000;438369000;452690000;1011275000;679955000;;-210579000;465084000;1476359000
FOE;350054;USD;2016;Q4;2016-12-31;2017-03-01;83404000;86450000;45582000;259687000;229847000;582017000;262026000;;439726000;701752000;1283769000;163514000;17310000;246027000;557175000;782710000;1028737000;400002000;-160936000;114690000;255032000;1283769000
FOE;350054;USD;2015;Q4;2015-12-31;2016-02-24;85364000;88234000;58380000;231970000;184854000;553290000;260429000;;411632000;672061000;1225351000;148964000;7446000;218230000;466108000;682840000;901070000;408290000;-166020000;135507000;324281000;1225351000
FOE;350054;USD;2014;Q4;2014-12-31;2015-02-25;86987000;84396000;140500000;236749000;158368000;613783000;212642000;;265129000;477771000;1091554000;165287000;8382000;236818000;298285000;518720000;755538000;410840000;-136058000;71407000;336016000;1091554000
FOE;350054;USD;2013;Q4;2013-12-31;2014-02-24;86542000;89433000;28328000;238278000;144780000;555389000;225255000;;227548000;452803000;1008192000;162961000;44729000;313731000;267469000;420618000;734349000;411491000;-143802000;-14664000;273843000;1008192000
FOE;350054;USD;2012;Q4;2012-12-31;2013-03-05;86329000;85493000;29576000;306463000;200824000;593503000;309374000;;176226000;485600000;1079103000;213667000;85152000;376503000;261624000;495926000;872429000;415088000;-151605000;-86606000;206674000;1079103000
FOE;350054;USD;2011;Q4;2011-12-31;2012-02-29;86173000;86168000;22991000;306775000;228813000;630899000;379336000;;430416000;809752000;1440651000;245515000;11241000;324634000;298082000;533523000;858157000;414318000;-153617000;287662000;582494000;1440651000
FOE;350054;USD;2010;Q4;2010-12-31;2011-08-01;;;29035000;302448000;202067000;621754000;391496000;;421105000;812601000;1434355000;257360000;3580000;345675000;290971000;514500000;860175000;416451000;-164257000;362164000;574180000;1434355000
FOE;350054;USD;2017;Q4;2017-12-31;2018-02-28;83914000;85009000;63551000;354416000;324180000;825732000;321742000;;534728000;856470000;1682202000;259912000;25136000;355199000;726491000;970323000;1325522000;395594000;-147056000;171744000;356680000;1682202000
FOE;350054;USD;2018;Q4;2018-12-31;2019-02-27;83298000;84079000;104301000;306882000;356998000;883284000;381341000;;547835000;929176000;1812460000;296562000;10260000;384817000;811137000;1041794000;1426611000;391559000;-165545000;255978000;385849000;1812460000
CHEF;350160;USD;2017;Q4;2018-01-31;2018-03-09;26438739;29081688;41504000;142170000;102083000;296840000;68378000;;322531000;390909000;687749000;104446000;3827000;108273000;313995000;330875000;439148000;167281000;;82869000;248601000;687749000
CHEF;350160;USD;2016;Q4;2017-01-31;2017-03-10;25944351;26311229;32862000;128030000;87498000;264491000;62183000;;306864000;369047000;633538000;92579000;14795000;107374000;317725000;332404000;439778000;127443000;;68503000;193760000;633538000
CHEF;350160;USD;2015;Q4;2016-01-31;2016-03-04;25870642;27274693;2454000;124139000;92758000;228515000;54283000;;297005000;351288000;579803000;96878000;6266000;103144000;267349000;288695000;391839000;125433000;;65480000;187964000;579803000
CHEF;350160;USD;2014;Q4;2015-01-31;2015-03-11;24656684;24842572;3328000;96896000;75528000;189007000;47938000;;139248000;187186000;376193000;69324000;7736000;77060000;135800000;152339000;229399000;98216000;;49271000;146794000;376193000
CHEF;350160;USD;2013;Q4;2014-01-31;2014-03-12;24609345;24822489;20014000;76413000;64710000;180095000;27589000;;147074000;174663000;354758000;55724000;6867000;62591000;140847000;160102000;222693000;97223000;;35056000;132065000;354758000
CHEF;350160;USD;2012;Q4;2013-01-31;2013-03-13;20734085;20944393;118000;56694000;40402000;105505000;9365000;;95264000;104629000;210134000;42528000;5175000;47703000;119352000;123149000;170852000;21215000;;18067000;39282000;210134000
CHEF;350160;USD;2011;Q4;2012-01-31;2012-03-29;20724276;21430300;2033000;42876000;23873000;73594000;5379000;;28905000;34284000;107878000;37718000;6107000;43825000;39590000;40483000;84308000;20014000;;3556000;23570000;107878000
CHEF;350160;USD;2010;Q4;2011-01-31;2011-10-04;-67703993416;-70025339416;1978000;36200000;16441000;59878000;4228000;;18566000;22794000;82672000;30727000;16945000;47672000;82580000;83812000;131484000;;;;-48812000;82672000
CHEF;350160;USD;2018;Q4;2019-01-31;2019-03-01;29442533;31179331;42410000;161758000;112614000;328735000;85276000;;318387000;403663000;732398000;125481000;61000;125542000;278169000;298180000;423722000;207626000;;103271000;308676000;732398000
KTWO;350257;USD;2015;Q4;2015-12-31;2016-03-04;41300840;41300840;34646000;38773000;62002000;155241000;38318000;;180953000;219271000;374512000;47549000;284000;47833000;34140000;40017000;87850000;454194000;0;-169421000;286662000;374512000
KTWO;350257;USD;2014;Q4;2014-12-31;2015-03-18;37457437;37457437;11411000;33937000;52617000;101876000;4220000;;193095000;197315000;299191000;35583000;0;35583000;0;5154000;40737000;386832000;;-130205000;258454000;299191000
KTWO;350257;USD;2013;Q4;2013-12-31;2014-06-05;22369395;22369395;7419000;32824000;39223000;92274000;2978000;;201684000;204662000;296936000;36225000;;59725000;19650000;33945000;93670000;165673000;;-70568000;203266000;296936000
KTWO;350257;USD;2016;Q4;2016-12-31;2017-05-02;42000532;42000532;45511000;46430000;61897000;159985000;50714000;;172826000;223540000;383525000;43108000;973000;44081000;71827000;77876000;121957000;474554000;-134000;-211081000;261568000;383525000
KTWO;350257;USD;2017;Q4;2017-12-31;2018-03-01;43082766;43082766;23964000;50474000;71424000;153704000;49200000;;170223000;219423000;373127000;52942000;1122000;54064000;72988000;76664000;130728000;491055000;-311000;-249221000;242399000;373127000
IRG;350449;USD;2015;Q4;2015-12-31;2016-03-03;25768000;25759000;7817000;3385000;5272000;21151000;176307000;;7724000;184031000;205182000;49938000;1621000;51559000;123112000;147010000;198569000;92879000;;-86266000;6613000;205182000
IRG;350449;USD;2014;Q4;2014-12-31;2014-10-30;25674000;25535000;20564000;7992000;5848000;123483000;192942000;;11295000;204237000;327720000;44653000;1650000;94289000;161052000;182132000;276421000;91200000;;-39901000;51299000;327720000
IRG;350449;USD;2013;Q4;2013-12-31;2013-11-05;25636000;25658000;972000;14565000;9836000;41710000;248507000;;56867000;305374000;347084000;84497000;2998000;87495000;128984000;157982000;245477000;87959000;;13648000;101607000;347084000
IRG;350449;USD;2012;Q4;2012-12-31;2012-10-30;26374000;26374000;6929000;6285000;4841000;24295000;165746000;;11397000;177143000;201438000;37151000;;37151000;45000000;58070000;95221000;85984000;;20233000;106217000;201438000
IRG;350449;USD;2016;Q4;2016-12-31;2016-11-02;25879000;25879000;430000;5195000;3845000;13206000;129324000;;5886000;135210000;148416000;41338000;1180000;42518000;117806000;142338000;184856000;94187000;;-130627000;-36440000;148416000
BBRG;350647;USD;2015;Q4;2015-12-31;2016-02-29;15051000;15706000;447000;9617000;3163000;15372000;170463000;;62225000;232688000;248060000;45152000;0;67110000;43300000;126126000;193236000;200739000;-77558000;-68357000;54824000;248060000
BBRG;350647;USD;2014;Q4;2014-12-31;2015-03-06;18200000;18882000;427000;7079000;3132000;17889000;178877000;;54997000;233874000;251763000;39213000;;59690000;56000000;138289000;197979000;199718000;-72997000;-72937000;53784000;251763000
BBRG;350647;USD;2013;Q4;2013-12-31;2014-03-03;19446000;20324000;7640000;8181000;2941000;28207000;169127000;;57518000;226645000;254852000;32432000;2082000;54411000;13611000;96665000;151076000;197913000;-9378000;-84759000;103776000;254852000
BBRG;350647;USD;2012;Q4;2012-12-31;2013-03-05;19662000;20599000;13717000;7728000;3023000;30957000;175969000;;56412000;232381000;263338000;35419000;2704000;56763000;20382000;106292000;163055000;195512000;-2927000;-92302000;100283000;263338000
BBRG;350647;USD;2011;Q4;2011-12-31;2012-03-06;19430000;20565000;10093000;6403000;2767000;25177000;163208000;;59241000;222449000;247626000;33241000;1714000;51457000;30857000;111585000;163042000;193034000;;-108450000;84584000;247626000
BBRG;350647;USD;2010;Q4;2010-12-31;2011-08-09;15422000;15422000;2460000;4754000;2415000;12490000;147621000;;3342000;150963000;163453000;31070000;2050000;47824000;38950000;109226000;157050000;191297000;;-184894000;6403000;163453000
BBRG;350647;USD;2016;Q4;2016-12-31;2017-03-06;14775000;14125000;444000;9587000;3114000;17283000;145120000;;4359000;149479000;166762000;42865000;4000000;72817000;37500000;115475000;188292000;202561000;-81019000;-143072000;-21530000;166762000
BBRG;350647;USD;2017;Q4;2017-12-31;2018-03-15;15208000;15136000;393000;10397000;3077000;16043000;121251000;;4873000;126124000;142167000;38671000;38500000;104204000;0;68292000;172496000;203531000;-81019000;-152841000;-30329000;142167000
RIG;350729;USD;2017;Q4;2017-12-31;2018-02-21;392000000;392000000;2969000000;596000000;418000000;4606000000;17402000000;;402000000;17804000000;22410000000;280000000;250000000;1369000000;7146000000;8272000000;9641000000;11068000000;;1929000000;12769000000;22410000000
RIG;350729;USD;2016;Q4;2016-12-31;2016-11-02;374000000;374000000;3052000000;833000000;561000000;5098000000;21093000000;;698000000;21791000000;26889000000;301000000;724000000;1985000000;7740000000;9071000000;11056000000;11029000000;;5056000000;15833000000;26889000000
RIG;350729;USD;2015;Q4;2015-12-31;2015-11-04;362000000;362000000;2339000000;1343000000;627000000;4798000000;20809000000;;824000000;21633000000;26431000000;510000000;1093000000;2665000000;7397000000;8761000000;11426000000;10929000000;-240000000;4278000000;15005000000;26431000000
RIG;350729;USD;2014;Q4;2014-12-31;2014-11-10;363000000;363000000;2635000000;2084000000;818000000;5840000000;21538000000;;1193000000;22731000000;28571000000;915000000;1032000000;3769000000;9019000000;10809000000;14578000000;10966000000;-240000000;3349000000;13993000000;28571000000
RIG;350729;USD;2013;Q4;2013-12-31;2013-11-06;360000000;359000000;3243000000;2112000000;737000000;6772000000;21707000000;;4067000000;25774000000;32546000000;1159000000;323000000;3554000000;10379000000;12307000000;15861000000;11931000000;-240000000;5262000000;16685000000;32546000000
RIG;350729;USD;2012;Q4;2012-12-31;2012-11-05;362000000;362000000;5134000000;1940000000;610000000;8647000000;20880000000;;4728000000;25608000000;34255000000;1163000000;1339000000;5463000000;11092000000;13062000000;18525000000;12651000000;-240000000;3855000000;15730000000;34255000000
RIG;350729;USD;2011;Q4;2011-12-31;2011-11-03;329000000;328000000;4017000000;2049000000;529000000;7536000000;20788000000;;6708000000;27496000000;35032000000;966000000;1942000000;5528000000;11349000000;13761000000;19289000000;12193000000;-240000000;4180000000;15743000000;35032000000
RIG;350729;USD;2010;Q4;2010-12-31;2010-11-03;321000000;319000000;3354000000;1653000000;425000000;6209000000;19119000000;;11486000000;30605000000;36814000000;941000000;1917000000;3996000000;9061000000;11437000000;15433000000;11986000000;-240000000;9934000000;21381000000;36814000000
RIG;350729;USD;2009;Q4;2009-12-31;2009-11-04;320000000;321000000;1130000000;2330000000;462000000;4476000000;23018000000;;8942000000;31960000000;36436000000;1020000000;1568000000;3618000000;9849000000;12259000000;15877000000;11879000000;0;9008000000;20559000000;36436000000
RIG;350729;USD;2008;Q4;2008-12-31;2009-08-14;318000000;321000000;1296000000;2798000000;432000000;5349000000;20861000000;;8972000000;29833000000;35182000000;1231000000;664000000;2701000000;12893000000;15314000000;18015000000;11757000000;;5827000000;17167000000;35182000000
RIG;350729;USD;2018;Q4;2018-12-31;2019-02-19;509000000;509000000;2160000000;604000000;474000000;3948000000;20408000000;;1309000000;21717000000;25665000000;339000000;373000000;1458000000;9605000000;11093000000;12551000000;13453000000;;-67000000;13114000000;25665000000
CCS;350948;USD;2016;Q4;2016-12-31;2017-02-15;20766874;20953123;49494000;5729000;857885000;953565000;11412000;;42551000;53963000;1007528000;78022000;259088000;337110000;195000000;196782000;533892000;355783000;;117853000;473636000;1007528000
CCS;350948;USD;2015;Q4;2015-12-31;2016-02-19;20608615;20608615;41104000;5241000;810137000;883217000;8375000;;26149000;34524000;917741000;117744000;;117744000;390243000;390518000;508262000;341166000;;68313000;409479000;917741000
CCS;350948;USD;2014;Q4;2014-12-31;2015-03-06;21022440;21022440;33462000;13799000;556323000;627017000;12471000;;31128000;43599000;670616000;81164000;;81164000;224247000;224247000;305411000;336782000;;28423000;365205000;670616000
CCS;350948;USD;2013;Q4;2013-12-31;2014-08-13;17121172;17121172;109998000;4438000;184072000;306923000;3360000;;2356000;5716000;312639000;38671000;;38671000;1500000;2412000;41083000;263155000;;8401000;271556000;312639000
CCS;350948;USD;2017;Q4;2017-12-31;2018-03-01;28019519;28407282;126555000;12999000;1390354000;1643047000;27911000;;64064000;91975000;1735022000;175187000;776283000;999789000;0;0;999789000;567085000;;168148000;735233000;1735022000
CCS;350948;USD;2018;Q4;2018-12-31;2019-02-13;30689954;31006085;57246000;13464000;1848243000;2171744000;33258000;;49253000;82511000;2254255000;303064000;784777000;1192396000;202500000;202500000;1394896000;595339000;;264020000;859359000;2254255000
OGS;351460;USD;2015;Q4;2015-12-31;2016-02-18;52430000;53060000;2433000;216343000;33325000;482845000;3511911000;;640009000;4151920000;4634765000;195074000;12507000;304221000;1191660000;2488989000;2793210000;1765401000;-14491000;95046000;1841555000;4634765000
OGS;351460;USD;2014;Q4;2014-12-31;2015-02-19;52964000;53812000;11943000;326749000;27511000;667501000;3293720000;;687989000;3981709000;4649210000;248697000;42006000;392433000;1201311000;2462740000;2855173000;1759317000;0;39894000;1794037000;4649210000
OGS;351460;USD;2013;Q4;2013-12-31;2014-02-25;52319000;52319000;3171000;356988000;;602184000;3044858000;;199433000;3244291000;3846475000;206717000;444966000;769077000;1028949000;1838375000;2607452000;1239023000;;0;1239023000;3846475000
OGS;351460;USD;2016;Q4;2016-12-31;2017-02-23;52454000;52967000;14663000;290944000;34084000;568923000;3731620000;;642248000;4373868000;4942791000;216344000;145000000;443933000;1192446000;2610578000;3054511000;1750100000;-18126000;161021000;1888280000;4942791000
OGS;351460;USD;2017;Q4;2017-12-31;2018-02-22;52491000;52965000;14413000;298768000;39672000;588994000;4007585000;;610299000;4617884000;5206878000;233839000;357223000;673330000;1193257000;2573339000;3246669000;1738077000;-18496000;246121000;1960209000;5206878000
OGS;351460;USD;2018;Q4;2018-12-31;2019-02-20;52740000;53208000;21323000;295421000;44333000;543287000;4283712000;;641643000;4925355000;5468642000;271368000;299500000;698891000;1285483000;2727095000;3425986000;1728018000;-2145000;320869000;2042656000;5468642000
WR;351692;USD;2017;Q4;2017-12-31;2018-02-21;142479966;142432765;3400000;290700000;293600000;727000000;9730100000;;1167300000;10897400000;11624400000;418400000;304200000;823700000;3769000000;6940300000;7764000000;2734800000;;1173300000;3860400000;11624400000
WR;351692;USD;2016;Q4;2016-12-31;2017-02-22;142152838;142512216;3066000;288579000;300125000;768382000;9506263000;;1212429000;10718692000;11487074000;431655000;518542000;1047193000;3499879000;6606691000;7653884000;2727273000;;1078602000;3833190000;11487074000
WR;351692;USD;2015;Q4;2015-12-31;2016-02-24;141872669;142322931;3231000;258286000;301294000;717141000;8793141000;;1195384000;9988525000;10705666000;425997000;278609000;836935000;3302047000;6196768000;7033703000;2710891000;;945830000;3671963000;10705666000
WR;351692;USD;2014;Q4;2014-12-31;2015-02-25;131496077;135026811;4556000;267327000;247406000;669403000;8441481000;;1178022000;9619503000;10288906000;418385000;285533000;849631000;3353645000;6137968000;6987599000;2439557000;;855299000;3301307000;10288906000
WR;351692;USD;2013;Q4;2013-12-31;2014-02-26;127899319;129533641;4487000;250036000;239511000;706825000;7848542000;;1041771000;8890313000;9597138000;427181000;412079000;955426000;3163760000;5573181000;6528607000;2337998000;;724776000;3068531000;9597138000
WR;351692;USD;2012;Q4;2012-12-31;2013-02-28;126932086;126974840;5829000;224439000;249016000;643075000;7335740000;;1286416000;8622156000;9265231000;359083000;365142000;846141000;3042014000;5508835000;6354976000;2289491000;;606649000;2910255000;9265231000
WR;351692;USD;2011;Q4;2011-12-31;2012-02-23;121972100;122235574;3539000;226428000;229118000;633585000;6745416000;;1303850000;8049266000;8682851000;357779000;314414000;827287000;2740392000;5054823000;5882110000;2267995000;;501216000;2800741000;8682851000
PZZA;352171;USD;2010;Q4;2010-12-31;2011-02-22;51126000;51332000;46225000;29468000;17402000;117107000;186594000;1604000;110636000;298834000;415941000;76183000;;76183000;99017000;132558000;208741000;245741000;-291048000;243152000;207200000;415941000
PZZA;352171;USD;2009;Q4;2009-12-31;2010-02-23;55208000;55858000;25457000;21471000;15576000;84003000;187971000;1382000;120370000;309723000;393726000;87085000;;87085000;99050000;121604000;208689000;232078000;-245337000;191212000;185037000;393726000
PZZA;352171;USD;2008;Q4;2008-12-31;2009-05-05;55274000;54964000;10987000;22921000;16872000;75348000;189992000;530000;120598000;311120000;386468000;100128000;;100128000;123579000;148102000;248230000;216905000;-216860000;133759000;138238000;386468000
DXCM;352596;USD;2015;Q4;2015-12-31;2016-02-23;81300000;81600000;115200000;74100000;35200000;231300000;54700000;;6000000;60700000;292000000;63800000;2300000;66900000;;3900000;70800000;776900000;;-555400000;221200000;292000000
DXCM;352596;USD;2014;Q4;2014-12-31;2015-02-25;76700000;76100000;83600000;42400000;16000000;145900000;31200000;;7500000;38700000;184600000;37600000;2300000;40600000;2300000;3800000;44400000;638100000;;-497800000;140200000;184600000
DXCM;352596;USD;2013;Q4;2013-12-31;2014-02-20;72300000;72300000;54600000;26100000;9000000;93100000;20700000;;8700000;29400000;122500000;29200000;2200000;32100000;4600000;6300000;38400000;559600000;;-475400000;84100000;122500000
DXCM;352596;USD;2012;Q4;2012-12-31;2013-02-21;69300000;69300000;48700000;19500000;7400000;77600000;18900000;;9500000;28400000;106000000;17900000;200000;19500000;6800000;9500000;29000000;522700000;;-445600000;77000000;106000000
DXCM;352596;USD;2011;Q4;2011-12-31;2012-02-23;;;82000000;12500000;8200000;104500000;15000000;;1000000;16000000;120500000;13100000;0;14700000;0;1300000;16000000;495700000;;-391100000;104500000;120500000
DXCM;352596;USD;2010;Q4;2010-12-31;2011-08-03;;;47113000;6671000;8112000;65361000;10763000;;1040000;11803000;77164000;11080000;525000;15129000;;1042000;16171000;407437000;;-346378000;60993000;77164000
DXCM;352596;USD;2016;Q4;2016-12-31;2017-02-28;84600000;84500000;123700000;101700000;45400000;280000000;109400000;;13400000;122800000;402800000;101500000;;102400000;0;16600000;119000000;905800000;;-621000000;283800000;402800000
DXCM;352596;USD;2017;Q4;2017-12-31;2018-02-27;86900000;85900000;548600000;134300000;45200000;744700000;145600000;;13800000;159400000;904100000;135700000;;138900000;327600000;345800000;484700000;1093800000;;-671800000;419400000;904100000
DXCM;352596;USD;2018;Q4;2018-12-31;2019-02-21;88800000;85800000;1385600000;226700000;70700000;1699500000;183100000;;33400000;216500000;1916000000;219500000;0;222400000;1010300000;1030300000;1252700000;1560700000;-100000000;-798900000;663300000;1916000000
EFH;352819;USD;2014;Q4;2014-12-31;2015-03-31;;;3428000000;589000000;468000000;5083000000;12397000000;7100000000;4668000000;24165000000;29248000000;919000000;39000000;1795000000;128000000;47176000000;48971000000;7970000000;;-27563000000;-19723000000;29248000000
EFH;352819;USD;2013;Q4;2013-12-31;2014-04-30;;;1217000000;718000000;399000000;4362000000;17791000000;7688000000;6605000000;32084000000;36446000000;1271000000;40252000000;43506000000;0;6195000000;49701000000;7964000000;;-21157000000;-13255000000;36446000000
EFH;352819;USD;2012;Q4;2012-12-31;2013-02-19;;;1913000000;718000000;393000000;5513000000;18705000000;7442000000;9310000000;35457000000;40970000000;984000000;2239000000;5268000000;37815000000;46625000000;51893000000;7961000000;;-18939000000;-10923000000;40970000000
EFH;352819;USD;2011;Q4;2011-12-31;2012-02-21;;;826000000;767000000;418000000;5303000000;19427000000;7664000000;11683000000;38774000000;44077000000;1231000000;821000000;5614000000;35360000000;46220000000;51834000000;7949000000;;-15579000000;-7757000000;44077000000
EFH;352819;USD;2010;Q4;2010-12-31;2011-07-29;;;1534000000;999000000;395000000;5919000000;20366000000;7704000000;12399000000;40469000000;46388000000;1346000000;1890000000;6603000000;34226000000;45696000000;52299000000;7939000000;;-13666000000;-5911000000;46388000000
PSX;353084;USD;2017;Q4;2017-12-31;2018-02-23;508005000;513392000;3119000000;6424000000;3395000000;14390000000;21460000000;13941000000;4580000000;39981000000;54371000000;9029000000;41000000;10107000000;10069000000;16836000000;26943000000;19774000000;-10378000000;16306000000;27428000000;54371000000
PSX;353084;USD;2016;Q4;2016-12-31;2016-10-28;524147000;525697000;2711000000;5485000000;3150000000;12680000000;20855000000;13534000000;4584000000;38973000000;51653000000;7866000000;550000000;9463000000;9588000000;18465000000;27928000000;19565000000;-8788000000;12608000000;23725000000;51653000000
PSX;353084;USD;2015;Q4;2015-12-31;2015-10-30;536246000;541949000;3074000000;4411000000;3477000000;12256000000;19721000000;12143000000;4460000000;36324000000;48580000000;6533000000;44000000;7531000000;8843000000;17111000000;24642000000;19151000000;-7746000000;12348000000;23938000000;48580000000
PSX;353084;USD;2014;Q4;2014-12-31;2014-10-30;554264000;560198000;5207000000;6306000000;3397000000;16692000000;17346000000;10189000000;4465000000;32000000000;48692000000;8942000000;842000000;11094000000;7793000000;15561000000;26655000000;19046000000;-6234000000;9309000000;22037000000;48692000000
PSX;353084;USD;2013;Q4;2013-12-31;2013-10-31;598565000;605242000;5400000000;7900000000;3354000000;19237000000;15398000000;11220000000;3943000000;30561000000;49798000000;11962000000;24000000;12931000000;6131000000;14475000000;27406000000;18893000000;-2602000000;5622000000;22392000000;49798000000
PSX;353084;USD;2012;Q4;2012-12-31;2012-11-01;628530000;639341000;3474000000;8593000000;3430000000;17962000000;15407000000;10471000000;4233000000;30111000000;48073000000;11611000000;13000000;12482000000;6961000000;14785000000;27267000000;18732000000;-356000000;2713000000;20806000000;48073000000
PSX;353084;USD;2011;Q4;2011-12-31;2012-05-16;627628000;634645000;0;8354000000;3466000000;13948000000;14771000000;10306000000;4186000000;29263000000;43211000000;11879000000;30000000;12384000000;361000000;30676000000;43060000000;0;0;0;151000000;43211000000
PSX;353084;USD;2018;Q4;2018-12-31;2019-02-22;461327000;465442000;3019000000;5414000000;3543000000;13209000000;22018000000;14421000000;4654000000;41093000000;54302000000;7702000000;67000000;8935000000;11093000000;18214000000;27149000000;19879000000;-15023000000;20489000000;27153000000;54302000000
MPC;353184;USD;2015;Q4;2015-12-31;2016-02-26;531000000;537000000;1127000000;2927000000;5225000000;9471000000;25164000000;3622000000;4858000000;33644000000;43115000000;5890000000;29000000;6345000000;11896000000;17095000000;23440000000;11078000000;-7275000000;9752000000;19675000000;43115000000
MPC;353184;USD;2014;Q4;2014-12-31;2015-02-27;555000000;559000000;1494000000;4058000000;5642000000;11339000000;16261000000;865000000;1960000000;19086000000;30425000000;8198000000;27000000;8579000000;6575000000;10456000000;19035000000;9848000000;-6299000000;7515000000;11390000000;30425000000
MPC;353184;USD;2013;Q4;2013-12-31;2014-02-28;596000000;600000000;2292000000;5559000000;4689000000;12737000000;13921000000;463000000;1264000000;15648000000;28385000000;9526000000;23000000;9824000000;3373000000;7229000000;17053000000;9772000000;-4155000000;5507000000;11332000000;28385000000
MPC;353184;USD;2012;Q4;2012-12-31;2013-02-28;668000000;674000000;4860000000;4610000000;3449000000;13029000000;12643000000;321000000;1230000000;14194000000;27223000000;8072000000;19000000;8203000000;3342000000;6915000000;15118000000;9531000000;-1253000000;3880000000;12105000000;27223000000
MPC;353184;USD;2011;Q4;2011-12-31;2012-02-29;712000000;710000000;3079000000;5461000000;3320000000;12001000000;12228000000;302000000;1214000000;13744000000;25745000000;9396000000;15000000;9591000000;3292000000;6649000000;16240000000;9486000000;;898000000;9505000000;25745000000
MPC;353184;USD;2010;Q4;2010-12-31;2011-08-09;;;2522000000;4393000000;3071000000;10056000000;11724000000;312000000;1140000000;13176000000;23232000000;7529000000;666000000;8620000000;3231000000;6368000000;14988000000;8867000000;;;8244000000;23232000000
MPC;353184;USD;2016;Q4;2016-12-31;2017-02-24;528000000;528000000;887000000;3617000000;5656000000;10401000000;25765000000;3827000000;4420000000;34012000000;44413000000;6740000000;28000000;7146000000;10544000000;16064000000;23210000000;11067000000;-7482000000;10206000000;21203000000;44413000000
MPC;353184;USD;2017;Q4;2017-12-31;2018-02-28;486000000;493000000;3011000000;4695000000;5550000000;13401000000;26443000000;4787000000;4416000000;35646000000;49047000000;9558000000;624000000;10478000000;12322000000;16741000000;27219000000;11269000000;-9869000000;12864000000;21828000000;49047000000
MPC;353184;USD;2018;Q4;2018-12-31;2019-02-28;686000000;704000000;1687000000;5853000000;9837000000;18023000000;45058000000;5898000000;23961000000;74917000000;92940000000;11964000000;544000000;13216000000;26980000000;34671000000;47887000000;33739000000;-13175000000;14755000000;45053000000;92940000000
S;353395;USD;2017;Q4;2018-03-31;2018-05-24;4004000000;4177000000;8964000000;3711000000;1003000000;14253000000;19925000000;;51281000000;71206000000;85459000000;7371000000;3429000000;10800000000;37463000000;48240000000;59040000000;27924000000;;-1255000000;26419000000;85459000000
S;353395;USD;2016;Q4;2017-03-31;2017-05-26;3987000000;3987000000;8314000000;4138000000;1064000000;14117000000;19209000000;;51797000000;71006000000;85123000000;7422000000;5036000000;12458000000;35878000000;53857000000;66315000000;27796000000;;-8584000000;18808000000;85123000000
S;353395;USD;2015;Q4;2016-03-31;2016-05-17;3970000000;3970000000;2641000000;1099000000;1173000000;6833000000;20297000000;;51845000000;72142000000;78975000000;7273000000;4690000000;11963000000;29268000000;47229000000;59192000000;27603000000;-3000000;-7378000000;19783000000;78975000000
S;353395;USD;2014;Q4;2015-03-31;2015-08-07;3961000000;3904000000;4176000000;2290000000;1359000000;9777000000;19721000000;;53343000000;73064000000;82841000000;9640000000;1300000000;10940000000;32342000000;50191000000;61131000000;27508000000;-7000000;-5383000000;21710000000;82841000000
SLB;353500;USD;2017;Q4;2017-12-31;2018-01-24;1387000000;1371000000;5089000000;8084000000;4046000000;18497000000;;;53490000000;53490000000;71987000000;11958000000;3324000000;15282000000;14875000000;19444000000;34726000000;12975000000;-4049000000;32190000000;37261000000;71987000000
SLB;353500;USD;2016;Q4;2016-12-31;2016-10-26;1393000000;1379000000;9257000000;9387000000;4225000000;23927000000;;238000000;53791000000;54029000000;77956000000;11906000000;3153000000;15059000000;16463000000;21368000000;36427000000;12801000000;-3550000000;36470000000;41529000000;77956000000
SLB;353500;USD;2015;Q4;2015-12-31;2015-10-21;1258000000;1263000000;13034000000;8780000000;3756000000;26912000000;;418000000;40675000000;41093000000;68005000000;9564000000;4557000000;14121000000;14442000000;17979000000;32100000000;12693000000;-13372000000;40870000000;35905000000;68005000000
SLB;353500;USD;2014;Q4;2014-12-31;2014-10-22;1280000000;1289000000;7501000000;11171000000;4628000000;24694000000;;442000000;41768000000;42210000000;66904000000;11411000000;2765000000;14176000000;10565000000;14679000000;28855000000;12495000000;-11772000000;41333000000;38049000000;66904000000
SLB;353500;USD;2013;Q4;2013-12-31;2013-10-23;1313000000;1323000000;8370000000;11497000000;4603000000;26225000000;;363000000;40512000000;40875000000;67100000000;10742000000;2783000000;13525000000;10393000000;13940000000;27465000000;12192000000;-8135000000;37966000000;39635000000;67100000000
SLB;353500;USD;2012;Q4;2012-12-31;2012-10-24;1327000000;1337000000;6274000000;11351000000;4785000000;24156000000;;245000000;37146000000;37391000000;61547000000;10247000000;2121000000;12368000000;9509000000;14321000000;26689000000;11912000000;-6160000000;32887000000;34858000000;61547000000
SLB;353500;USD;2011;Q4;2011-12-31;2011-10-26;1339000000;1346000000;4827000000;9500000000;4700000000;20539000000;;256000000;34406000000;34662000000;55201000000;9161000000;1377000000;10538000000;8556000000;13271000000;23809000000;11639000000;-5679000000;28860000000;31392000000;55201000000
SLB;353500;USD;2010;Q4;2010-12-31;2010-10-29;1364000000;1371000000;4990000000;8278000000;3804000000;18098000000;;484000000;33185000000;33669000000;51767000000;8270000000;2595000000;10865000000;5517000000;9458000000;20323000000;11920000000;-3136000000;25210000000;31444000000;51767000000
SLB;353500;USD;2009;Q4;2009-12-31;2009-10-28;1199000000;1214000000;4616000000;6088000000;1866000000;13650000000;;738000000;19077000000;19815000000;33465000000;6134000000;1125000000;7259000000;4355000000;6977000000;14236000000;4777000000;-5002000000;22019000000;19229000000;33465000000
SLB;353500;USD;2008;Q4;2008-12-31;2009-07-29;1193000000;1209000000;3692000000;6258000000;1919000000;12986000000;;470000000;18638000000;19108000000;32094000000;6577000000;1598000000;8175000000;3693000000;6985000000;15160000000;4668000000;-4796000000;19891000000;16934000000;32094000000
SLB;353500;USD;2018;Q4;2018-12-31;2019-01-23;1386000000;1394000000;2777000000;7881000000;4010000000;15731000000;;;54776000000;54776000000;70507000000;12079000000;1407000000;13486000000;14644000000;20435000000;33921000000;13132000000;-4006000000;31658000000;36586000000;70507000000
SWKS;353611;USD;2016;Q4;2016-09-30;2016-11-22;185500000;188700000;1083800000;416600000;424000000;2002100000;806300000;;1047000000;1853300000;3855400000;152700000;;210200000;;103800000;314000000;2732200000;-1443500000;2263600000;3541400000;3855400000
SWKS;353611;USD;2015;Q4;2015-09-30;2015-11-24;189400000;194800000;1043600000;538000000;267900000;1914700000;826400000;;978300000;1804700000;3719400000;372600000;;463900000;;96300000;560200000;2542800000;-844600000;1469200000;3159200000;3719400000
SWKS;353611;USD;2014;Q4;2014-09-30;2014-11-25;187700000;193800000;805800000;317600000;270800000;1429200000;555900000;;988700000;1544600000;2973800000;271300000;;297600000;;143800000;441400000;2295500000;-553100000;794900000;2532400000;2973800000
SWKS;353611;USD;2013;Q4;2013-09-30;2013-11-18;185300000;190500000;511100000;292700000;229500000;1073300000;328600000;;931200000;1259800000;2333100000;167700000;;179700000;;52300000;232000000;2088400000;-365300000;378900000;2101100000;2333100000
SWKS;353611;USD;2012;Q4;2012-09-30;2012-11-21;187744000;194018000;307100000;297600000;232900000;883300000;279400000;;973900000;1253300000;2136600000;171900000;;182700000;;48400000;231100000;1968100000;-161800000;100800000;1905500000;2136600000
SWKS;353611;USD;2011;Q4;2011-09-30;2011-11-28;183673000;190918000;410087000;177940000;198183000;816334000;251365000;;822690000;1074055000;1890389000;150974000;26089000;247096000;;34198000;281294000;1842555000;-130854000;-101275000;1609095000;1890389000
SWKS;353611;USD;2010;Q4;2010-09-30;2010-11-29;177419000;184735000;453257000;175232000;125059000;789865000;204363000;;569824000;774187000;1564052000;147662000;50000000;204324000;24743000;43132000;247456000;1686472000;-40719000;-327860000;1316596000;1564052000
SWKS;353611;USD;2009;Q4;2009-09-30;2010-05-11;170275000;177112000;364221000;115034000;86097000;590127000;162299000;;600165000;762464000;1352591000;98547000;81865000;196243000;41483000;47569000;243812000;1611620000;-36307000;-465154000;1108779000;1352591000
SWKS;353611;USD;2017;Q4;2017-09-30;2017-11-13;183400000;185800000;1616800000;454700000;493500000;2633700000;882300000;;1057600000;1939900000;4573600000;326500000;;387900000;;120000000;507900000;2939600000;-1925000000;3059600000;4065700000;4573600000
SWKS;353611;USD;2018;Q4;2018-09-30;2018-11-15;178400000;180200000;1027400000;655800000;490200000;2262200000;1140900000;22800000;1403000000;2566700000;4828900000;315100000;;389700000;;342200000;731900000;3105400000;-2732500000;3732900000;4097000000;4828900000
ACT;353702;USD;2012;Q4;2012-12-31;2013-02-28;126100000;132100000;328000000;1330900000;1546500000;3838300000;1485000000;91200000;8700300000;10276500000;14114800000;2536000000;176200000;2749300000;6257100000;7509100000;10258400000;1957100000;-342800000;2182700000;3856400000;14114800000
ACT;353702;USD;2011;Q4;2011-12-31;2012-02-16;124900000;127000000;224200000;1165700000;889400000;2569700000;713700000;71300000;3343600000;4128600000;6698300000;1642100000;184500000;1839500000;848500000;1296300000;3135800000;1881400000;-326700000;2085400000;3562500000;6698300000
ACT;353702;USD;2010;Q4;2010-12-31;2011-02-22;123000000;125100000;293900000;560900000;631000000;1786700000;642300000;84500000;3173100000;3899900000;5686600000;781000000;0;808000000;1016100000;1596000000;2404000000;1772200000;-312500000;1824500000;3282600000;5686600000
ACT;353702;USD;2009;Q4;2009-12-31;2010-08-06;109800000;111300000;215000000;517400000;692300000;1769500000;694200000;114500000;3325300000;4134000000;5903500000;692700000;307600000;1047900000;1150200000;1832500000;2880400000;1687300000;-306200000;1640100000;3023100000;5903500000
LOGI;353811;USD;2016;Q4;2017-03-31;2017-05-26;161903000;166407000;547533000;185179000;253401000;1027845000;85408000;;385424000;470832000;1498677000;507078000;;507078000;;135488000;642566000;56744000;-174037000;1074110000;856111000;1498677000
LOGI;353811;USD;2015;Q4;2016-03-31;2016-05-23;162569000;165264000;519195000;142778000;228786000;926247000;92860000;;305040000;397900000;1324147000;414930000;;414930000;;149269000;564199000;36764000;-128407000;963576000;759948000;1324147000
LOGI;353811;USD;2014;Q4;2015-03-31;2015-06-05;164369000;166477000;533380000;167196000;255980000;1052020000;86478000;;288182000;374660000;1426680000;456141000;;494907000;;173639000;668546000;30148000;-88951000;930174000;758134000;1426680000
LOGI;353811;USD;2013;Q4;2014-03-31;2014-11-13;162338000;165252000;469412000;182029000;222402000;933000000;88391000;;429999000;518390000;1451390000;454787000;;454787000;;192475000;647262000;30148000;-116510000;976292000;804128000;1451390000
LOGI;353811;USD;2012;Q4;2013-03-31;2013-05-30;158697000;157501000;333824000;178959000;262644000;846764000;93721000;;441848000;535569000;1382333000;458489000;;461691000;;198689000;660380000;30148000;-179990000;966924000;721953000;1382333000
LOGI;353811;USD;2011;Q4;2012-03-31;2012-05-30;169380000;172100000;478370000;223104000;297072000;1066079000;94884000;;688135000;783019000;1849098000;497242000;;497242000;;229624000;726866000;33370000;-343829000;1528620000;1122232000;1849098000
LOGI;353811;USD;2010;Q4;2011-03-31;2011-02-07;178628000;180141000;477931000;258294000;280814000;1076386000;84160000;;701010000;785170000;1861556000;470720000;;470720000;;185835000;656555000;33370000;-264019000;1514168000;1205001000;1861556000
LOGI;353811;USD;2009;Q4;2010-03-31;2010-08-25;;;319944000;195247000;219593000;793661000;91229000;;714788000;806017000;1599678000;440291000;;440291000;;159672000;599963000;48250000;-382512000;1406618000;999715000;1599678000
LOGI;353811;USD;2017;Q4;2018-03-31;2018-05-21;164377000;169388000;641947000;214885000;259906000;1173100000;86304000;;483753000;570057000;1743157000;575720000;;575720000;;116880000;692600000;77382000;-165686000;1232316000;1050557000;1743157000
LOGI;353811;USD;2018;Q4;2019-03-31;2019-05-17;165782000;168963000;604516000;383309000;293495000;1350436000;78552000;;595136000;673688000;2024124000;717819000;;717819000;;129966000;847785000;86803000;-169802000;1365036000;1176339000;2024124000
ACIA;353923;USD;2016;Q4;2016-12-31;2017-02-23;37803000;44392000;310406000;108127000;31681000;462375000;25124000;0;29437000;54561000;516936000;79293000;;80668000;;1473000;82141000;295897000;;138914000;434795000;516936000
ACIA;353923;USD;2015;Q4;2015-12-31;2016-08-11;6645000;8806000;27610000;41260000;27920000;103445000;15925000;;11374000;27299000;130744000;40536000;;48298000;;71176000;119474000;1000;;8015000;11270000;130744000
ACIA;353923;USD;2017;Q4;2017-12-31;2018-02-22;39357000;41767000;279428000;86602000;62232000;447247000;28175000;85182000;50646000;164003000;611250000;85053000;;85626000;;23574000;109200000;324948000;0;177422000;502050000;611250000
ACIA;353923;USD;2018;Q4;2018-12-31;2019-02-21;40398000;45785000;325104000;90831000;25511000;454044000;26643000;74764000;46408000;147815000;601859000;78498000;;83599000;;15533000;99132000;360271000;-39712000;182540000;502727000;601859000
PH;354246;USD;2017;Q4;2017-06-30;2017-08-25;133278323;134497664;924204000;1930751000;1549494000;4779718000;1937292000;842475000;7930419000;10710186000;15489904000;2387395000;1008465000;3395860000;4861895000;6826698000;10222558000;634402000;-4378897000;10930348000;5267346000;15489904000
PH;354246;USD;2016;Q4;2016-06-30;2016-08-26;134385814;135453636;2103995000;1593920000;1173329000;5207787000;1568100000;827492000;4430763000;6826355000;12034142000;2004101000;361787000;2365888000;2652457000;5089576000;7455464000;718974000;-4218820000;10302866000;4578678000;12034142000
PH;354246;USD;2015;Q4;2015-06-30;2015-08-26;138674444;140002385;1914074000;1620194000;1300459000;5440945000;1664022000;811930000;4362385000;6838337000;12279282000;2125978000;223142000;2349120000;2723960000;4822593000;7171713000;713252000;-3712232000;9841885000;5107569000;12279282000
PH;354246;USD;2014;Q4;2014-06-30;2014-08-22;148967358;150025510;2187256000;1858176000;1371681000;5935387000;1824294000;1018781000;4495900000;7338975000;13274362000;2436174000;816622000;3252796000;1508142000;3358758000;6611554000;686021000;-2377284000;9174189000;6662808000;13274362000
PH;354246;USD;2013;Q4;2013-06-30;2013-08-29;149298278;149175698;1781412000;1840820000;1377405000;5404231000;1808240000;687458000;4640969000;7136667000;12540898000;2186377000;1333826000;3520203000;1495960000;3279214000;6799417000;699275000;-2274286000;8421270000;5741481000;12540898000
PH;354246;USD;2012;Q4;2012-06-30;2012-08-24;150470994;153567175;838317000;;1400732000;4368762000;1719968000;931126000;4150426000;6801520000;11170282000;2260424000;225589000;2486013000;1503946000;3778539000;6264552000;730772000;-2205532000;7787175000;4905730000;11170282000
PH;354246;USD;2011;Q4;2011-06-30;2011-08-26;159369295;162293782;657466000;;1412153000;4159409000;1797179000;597532000;4332685000;6727396000;10886805000;2315772000;75271000;2391043000;1691086000;3007426000;5398469000;758855000;-1815418000;6891407000;5488336000;10886805000
PH;354246;USD;2010;Q4;2010-06-30;2010-08-26;161310416;163188592;575526000;;1171655000;3458667000;1697881000;687320000;4066514000;6451715000;9910382000;1841619000;363272000;2204891000;1413634000;3246091000;5450982000;727965000;-1237984000;6086545000;4459400000;9910382000
PH;354246;USD;2009;Q4;2009-06-30;2009-11-03;;;187611000;;1254550000;3001801000;1880554000;674628000;4298919000;6854101000;9855902000;1524287000;481467000;2005754000;1839705000;3499708000;5505462000;678724000;-1289544000;5722038000;4350440000;9855902000
PH;354246;USD;2018;Q4;2018-06-30;2018-08-24;132696489;133949867;855132000;2145517000;1621304000;5085238000;1856237000;801049000;7577563000;10234849000;15320087000;2559017000;638466000;3197483000;4318559000;6257111000;9454594000;587115000;-4590138000;11625975000;5865493000;15320087000
ETR;354347;USD;2018;Q4;2018-12-31;2019-02-26;183130813;185485402;480975000;1114405000;870147000;2958064000;31974446000;7661811000;5680745000;45317002000;48275066000;1943491000;2592348000;5443544000;15518303000;33767815000;39211359000;5954047000;-5273719000;8721150000;9063707000;48275066000
ETR;354347;USD;2017;Q4;2017-12-31;2018-02-26;180252125;181423253;781273000;1212950000;905865000;3285331000;29664360000;7915033000;5842425000;43421818000;46707149000;1855155000;2339817000;5036207000;14337274000;33480624000;38516831000;5435981000;-5397637000;7977702000;8190318000;46707149000
ETR;354347;USD;2016;Q4;2016-12-31;2017-02-24;179189964;177100000;1187844000;1170167000;878123000;3684268000;27921407000;6427400000;7871359000;42220166000;45904434000;1653920000;782334000;3200096000;14492237000;34419344000;37619440000;5419793000;-5498584000;8195571000;8284994000;45904434000
ETR;354347;USD;2015;Q4;2015-12-31;2016-02-26;178373335;176953232;1350961000;1068900000;1091167000;4067412000;27824361000;6042997000;6712911000;40580269000;44647681000;1476440000;711431000;3089958000;13138557000;31982747000;35072705000;5406306000;-5552379000;9393913000;9574976000;44647681000
ETR;354347;USD;2014;Q4;2014-12-31;2015-02-26;180238001;181559025;1422026000;1103255000;1124018000;4389633000;28722946000;6026126000;7275750000;42024822000;46414455000;1500549000;1500290000;3848891000;12416420000;32253079000;36101970000;5377901000;-5497526000;10169657000;10312485000;46414455000
ETR;354347;USD;2013;Q4;2013-12-31;2014-02-27;178336561;178601720;739126000;1172186000;1123964000;3929691000;27881644000;5353485000;6241626000;39476755000;43406446000;1545403000;1506305000;4060572000;12171367000;29408648000;33469220000;5370679000;-5533942000;9825053000;9937226000;43406446000
ETR;354347;USD;2012;Q4;2012-12-31;2013-02-27;177749524;178021789;532569000;1001715000;1142361000;3683126000;27298545000;4929119000;7291712000;39519376000;43202502000;1735563000;1518398000;4106321000;11954859000;29618581000;33724902000;5360400000;-5574819000;9704591000;9477600000;43202502000
ETR;354347;USD;2011;Q4;2011-12-31;2012-02-28;176127131;176750750;694438000;1001868000;1096888000;3622703000;25609285000;4509766000;6959945000;37078996000;40701699000;1530843000;2304695000;4950699000;10082134000;26509219000;31459918000;5363230000;-5680468000;9446960000;9241781000;40701699000
ETR;354347;USD;2010;Q4;2010-12-31;2011-02-28;-188833380863;181478107;1294472000;1035582000;1074428000;4339083000;23848355000;4300206000;6197632000;34346193000;38685276000;1398784000;457071000;2776249000;11359235000;27101889000;29878138000;5370022000;-5524811000;8689401000;8807138000;38685276000
ETR;354347;USD;2009;Q4;2009-12-31;2010-02-26;188964621;191175860;1709551000;980827000;1022557000;4534161000;23389402000;3618700000;6019690000;33027792000;37561953000;1190511000;954484000;3193997000;11059971000;25443253000;28637250000;5372590000;-4727167000;8043122000;8924703000;37561953000
ETR;354347;USD;2008;Q4;2008-12-31;2009-09-04;189368619;212852465;1920491000;1198135000;992315000;5160389000;22429114000;3237544000;5789771000;31456429000;36616818000;1738265000;761887000;3765894000;11517382000;24573303000;28339197000;4871785000;-4175214000;7382719000;8277621000;36616818000
RTN;354596;USD;2017;Q4;2017-12-31;2018-02-14;289500000;289800000;3400000000;1324000000;594000000;11326000000;2439000000;;17095000000;19534000000;30860000000;2861000000;300000000;7348000000;4750000000;13037000000;20385000000;3000000;;17895000000;10475000000;30860000000
RTN;354596;USD;2016;Q4;2016-12-31;2016-10-27;294300000;294500000;3403000000;1163000000;608000000;10885000000;2166000000;;17187000000;19353000000;30238000000;2754000000;0;6539000000;5335000000;13093000000;19632000000;3000000;;17565000000;10606000000;30238000000
RTN;354596;USD;2015;Q4;2015-12-31;2015-10-22;301700000;302200000;3200000000;;635000000;9812000000;2005000000;;17464000000;19469000000;29281000000;2556000000;;6126000000;5330000000;12470000000;18596000000;401000000;;16903000000;10685000000;29281000000
RTN;354596;USD;2014;Q4;2014-12-31;2014-10-23;309200000;309700000;4719000000;;414000000;10279000000;1935000000;;15502000000;17437000000;27716000000;2309000000;;5752000000;5325000000;12243000000;17995000000;1312000000;;15671000000;9721000000;27716000000
RTN;354596;USD;2013;Q4;2013-12-31;2013-10-24;318800000;319700000;4297000000;;363000000;9816000000;1937000000;;14214000000;16151000000;25967000000;2246000000;;5810000000;4734000000;8960000000;14770000000;1975000000;;14173000000;11197000000;25967000000
RTN;354596;USD;2012;Q4;2012-12-31;2012-10-25;329900000;330700000;4044000000;;381000000;9246000000;1986000000;;15454000000;17440000000;26686000000;2362000000;;5902000000;4731000000;12594000000;18496000000;2931000000;;12883000000;8190000000;26686000000
RTN;354596;USD;2011;Q4;2011-12-31;2011-10-27;343900000;345100000;4000000000;;336000000;9309000000;2006000000;;14539000000;16545000000;25854000000;2448000000;;6130000000;4605000000;11384000000;17514000000;3526000000;;11656000000;8340000000;25854000000
RTN;354596;USD;2010;Q4;2010-12-31;2010-10-28;363000000;366000000;3638000000;;363000000;8822000000;2003000000;;13597000000;15600000000;24422000000;2439000000;;5960000000;3610000000;8572000000;14532000000;11410000000;-6900000000;10390000000;9890000000;24422000000
RTN;354596;USD;2009;Q4;2009-12-31;2009-10-22;382000000;388200000;2642000000;;344000000;7868000000;2001000000;;13738000000;15739000000;23607000000;2265000000;;5523000000;2329000000;8145000000;13668000000;10995000000;-5446000000;9102000000;9939000000;23607000000
RTN;354596;USD;2008;Q4;2008-12-31;2009-07-23;;;2259000000;105000000;325000000;7417000000;2024000000;;13693000000;15717000000;23134000000;2114000000;;5149000000;2309000000;8797000000;13946000000;10877000000;-4254000000;7646000000;9188000000;23134000000
RTN;354596;USD;2018;Q4;2018-12-31;2019-02-13;284500000;284800000;3608000000;1648000000;758000000;12136000000;2840000000;;16888000000;19728000000;31864000000;3473000000;300000000;8288000000;4755000000;11693000000;19981000000;3000000;;20087000000;11883000000;31864000000
SMG;355003;USD;2017;Q4;2017-09-30;2017-11-28;58500000;60100000;120500000;197700000;407500000;881700000;467700000;31100000;1366500000;1865300000;2747000000;153100000;143100000;544500000;1258000000;1540800000;2085300000;407600000;-667800000;978200000;661700000;2747000000
SMG;355003;USD;2016;Q4;2016-09-30;2016-11-28;60400000;62400000;28600000;127000000;394700000;1032900000;444900000;101000000;1177000000;1722900000;2755800000;131200000;185000000;707100000;1030900000;1314400000;2021500000;401700000;-451400000;881800000;734300000;2755800000
SMG;355003;USD;2015;Q4;2015-09-30;2015-11-24;61400000;63600000;71400000;157700000;395800000;1119200000;444100000;0;963900000;1408000000;2527200000;193100000;132600000;618600000;1025000000;1275500000;1894100000;400400000;-357100000;684200000;633100000;2527200000
SMG;355003;USD;2014;Q4;2014-09-30;2014-11-25;61100000;63400000;89300000;224000000;385100000;935000000;437000000;;686300000;1123300000;2058300000;193300000;91900000;544700000;692400000;946400000;1491100000;395300000;-392300000;636900000;567200000;2058300000
SMG;355003;USD;2013;Q4;2013-09-30;2013-11-20;62100000;64000000;129800000;206600000;324900000;881000000;422300000;;633900000;1056200000;1937200000;137700000;92400000;509800000;478100000;716900000;1226700000;397500000;-312600000;703400000;710500000;1937200000
SMG;355003;USD;2012;Q4;2012-09-30;2012-11-20;61100000;63300000;131900000;330900000;414900000;1000000000;427400000;;647000000;1074400000;2074400000;152300000;1500000;433600000;781100000;1038900000;1472500000;408600000;-349600000;630200000;601900000;2074400000
SMG;355003;USD;2011;Q4;2011-09-30;2011-11-23;62200000;64700000;130900000;323500000;387000000;992500000;394700000;;665000000;1059700000;2052200000;150000000;3200000;468600000;791800000;1023800000;1492400000;427100000;-388500000;599200000;559800000;2052200000
SMG;355003;USD;2010;Q4;2010-09-30;2010-11-24;66600000;69200000;88100000;350900000;352900000;1118100000;381300000;;664600000;1045900000;2164000000;141700000;195000000;736800000;436700000;662700000;1399500000;434000000;-92000000;499600000;764500000;2164000000
SMG;355003;USD;2009;Q4;2009-09-30;2010-08-12;65300000;67000000;71600000;384300000;458900000;1090900000;369700000;;759500000;1129200000;2220100000;190000000;160400000;756800000;649700000;878800000;1635600000;451500000;-131700000;337500000;584500000;2220100000
SMG;355003;USD;2018;Q4;2018-09-30;2018-11-29;55300000;57100000;33900000;226000000;481400000;885700000;530800000;36100000;1601900000;2168800000;3054500000;150500000;132600000;612700000;1883800000;2082200000;2694900000;420300000;-939600000;919900000;359600000;3054500000
ISIL;355428;USD;2016;Q4;2016-12-31;2017-02-17;137273000;140097000;306789000;54295000;65208000;437119000;49250000;;678972000;728222000;1165341000;77906000;;171082000;;10720000;181802000;1542393000;;-556800000;983539000;1165341000
ISIL;355428;USD;2015;Q4;2015-12-31;2016-02-12;132610000;137311000;247403000;42684000;65334000;370181000;71044000;;697393000;768437000;1138618000;75565000;;168035000;;15834000;183869000;1560661000;;-604937000;954749000;1138618000
ISIL;355428;USD;2014;Q4;2014-12-31;2015-02-13;130137000;136399000;211216000;55585000;73770000;371945000;72272000;;710043000;782315000;1154260000;87112000;;98743000;;73969000;172712000;1592734000;;-612123000;981548000;1154260000
ISIL;355428;USD;2013;Q4;2013-12-31;2014-02-18;127706000;130855000;194787000;49466000;62408000;339832000;81867000;;769697000;851564000;1191396000;117953000;;129889000;;103705000;233594000;1622009000;;-666935000;957802000;1191396000
ISIL;355428;USD;2012;Q4;2012-12-31;2013-02-22;126470000;126448000;163561000;54684000;74868000;327623000;85374000;;814789000;900163000;1227786000;90740000;;100312000;;132866000;233178000;1661158000;;-669790000;994608000;1227786000
ISIL;355428;USD;2011;Q4;2011-12-31;2012-02-24;126431000;127129000;410194000;64874000;97889000;629883000;91038000;4752000;843550000;939340000;1569223000;157500000;;166085000;200000000;322450000;488535000;1711970000;;-632141000;1080688000;1569223000
ISIL;355428;USD;2010;Q4;2010-12-31;2011-02-28;124455000;127279000;383016000;88723000;101967000;613568000;103495000;69295000;886111000;1058901000;1672469000;113741000;23508000;150254000;274992000;478018000;628272000;1743048000;;-699305000;1044197000;1672469000
ISIL;355428;USD;2009;Q4;2009-12-31;2010-08-09;122700000;122620000;361165000;73633000;81236000;552816000;102251000;63937000;446777000;612965000;1165781000;125008000;;134695000;;;134695000;1765274000;;-725697000;1031086000;1165781000
RNG;355550;USD;2015;Q4;2015-12-31;2016-02-29;71445000;71445000;137588000;19163000;2317000;171046000;28160000;;15607000;43767000;214813000;39898000;4019000;80574000;15021000;24107000;104681000;319799000;;-210194000;110132000;214813000
RNG;355550;USD;2014;Q4;2014-12-31;2015-02-27;68377000;68377000;141661000;7651000;1710000;159789000;25527000;;3021000;28548000;188337000;33417000;17273000;76276000;8348000;15556000;91832000;274851000;;-178095000;96505000;188337000
RNG;355550;USD;2013;Q4;2013-12-31;2014-02-26;62771000;62771000;116378000;3045000;2111000;126748000;16660000;;1777000;18437000;145185000;24973000;10218000;51743000;24603000;29927000;81670000;193580000;;-129755000;63515000;145185000
RNG;355550;USD;2012;Q4;2012-12-31;2013-11-13;22593000;22593000;37864000;2690000;833000;44795000;17008000;;1551000;18559000;63354000;26040000;7948000;45279000;13131000;18004000;63283000;9791000;;-83657000;69000;63352000
RNG;355550;USD;2016;Q4;2016-12-31;2017-02-28;73928000;73928000;160355000;30243000;;205911000;31994000;;14724000;46718000;252629000;56132000;14709000;116000000;312000;6588000;122588000;366807000;;-239503000;130041000;252629000
RNG;355550;USD;2017;Q4;2017-12-31;2018-02-26;77660000;77660000;181192000;46690000;;264818000;43298000;;51698000;94996000;359814000;62299000;;125216000;;6252000;131468000;434848000;;-209500000;228346000;359814000
RNG;355550;USD;2018;Q4;2018-12-31;2019-02-27;80667000;80667000;566329000;94375000;;707514000;70205000;;116607000;186812000;894326000;110832000;;199359000;366552000;377358000;576717000;551086000;;-235703000;317609000;894326000
CR;355869;USD;2016;Q4;2016-12-31;2017-02-28;59000000;59700000;509700000;396400000;342500000;1315700000;278900000;;1833400000;2112300000;3428000000;449800000;;520800000;745300000;1761500000;2282300000;349300000;-459300000;1719900000;1145700000;3428000000
CR;355869;USD;2015;Q4;2015-12-31;2016-02-23;58200000;58700000;363500000;397600000;376900000;1203500000;276000000;;1857400000;2133400000;3336900000;448200000;49600000;572800000;744600000;1613300000;2186100000;336000000;-494200000;1674300000;1150800000;3336900000
CR;355869;USD;2014;Q4;2014-12-31;2015-02-25;58400000;59200000;346300000;410900000;369700000;1195200000;290300000;;1965300000;2255600000;3450800000;460200000;100800000;640000000;749200000;1740200000;2380200000;321600000;-485100000;1522100000;1070600000;3450800000
CR;355869;USD;2013;Q4;2013-12-31;2014-02-25;58120000;58948000;270643000;437541000;368886000;1149092000;305055000;;2105460000;2410515000;3559607000;455038000;125826000;668902000;749170000;1676032000;2344934000;300963000;-451195000;1403202000;1214673000;3559607000
CR;355869;USD;2012;Q4;2012-12-31;2013-02-26;56998000;57805000;423947000;333330000;352725000;1180521000;268283000;;1441074000;1709357000;2889878000;419095000;1123000;511888000;399092000;1450614000;1962502000;276898000;-481410000;1250972000;927376000;2889878000
CR;355869;USD;2011;Q4;2011-12-31;2012-02-27;57929000;58858000;245089000;349250000;360689000;1032232000;284146000;;1527153000;1811299000;2843531000;431040000;1112000;533095000;398914000;1488380000;2021475000;261720000;-450608000;1095953000;822056000;2843531000
CR;355869;USD;2010;Q4;2010-12-31;2011-02-28;58237000;59259000;272941000;301918000;319077000;988661000;280746000;;1437290000;1718036000;2706697000;397570000;984000;498554000;398736000;1215113000;1713667000;246569000;-399773000;1126630000;993030000;2706697000
CR;355869;USD;2009;Q4;2009-12-31;2010-08-05;58506000;59139000;372714000;282463000;284552000;1046346000;285224000;;1381328000;1666552000;2712898000;365404000;1078000;466782000;398557000;1352414000;1819196000;233835000;-376041000;1022838000;893702000;2712898000
CR;355869;USD;2017;Q4;2017-12-31;2018-02-27;59300000;60400000;706200000;418400000;349300000;1518500000;282400000;;1792600000;2075000000;3593500000;503100000;249400000;837500000;494100000;1407500000;2245000000;364100000;-452100000;1813300000;1348500000;3593500000
CR;355869;USD;2018;Q4;2018-12-31;2019-02-26;59300000;60800000;343400000;515800000;411500000;1362900000;599100000;;2080700000;2679800000;4042700000;667300000;6900000;740200000;942300000;1775400000;2515600000;375900000;-476200000;2072100000;1527100000;4042700000
QCP;356195;USD;2017;Q4;2017-12-31;2018-03-08;374135196;374135196;325587000;;;325611000;3883626000;;182827000;4066453000;4392064000;974433000;808412000;1790874000;;;1790874000;3172398000;;-573635000;2601190000;4392064000
QCP;356195;USD;2016;Q4;2016-12-31;2017-03-31;374111210;374111210;126185000;;;142221000;4417829000;;229325000;4647154000;4789375000;990961000;755604000;1752152000;;;1752152000;3164890000;;-130094000;3037223000;4789375000
QCP;356195;USD;2015;Q4;2015-12-31;2016-11-21;;;6058000;;;138533000;4618262000;;336839000;4955101000;5093634000;1716000;;6140000;;;6140000;;;;5087494000;5093634000
AMTD;356477;USD;2018;Q4;2018-09-30;2018-11-16;566000000;567000000;3174000000;22616000000;;30960000000;792000000;;5768000000;6560000000;37520000000;26760000000;;26901000000;2439000000;2620000000;29521000000;3386000000;-2371000000;7011000000;7999000000;37520000000
AMTD;356477;USD;2017;Q4;2017-09-30;2017-11-17;533000000;534000000;2218000000;17151000000;;31963000000;752000000;;5912000000;6664000000;38627000000;28426000000;;28632000000;2555000000;2749000000;31381000000;3376000000;-2116000000;6011000000;7246000000;38627000000
AMTD;356477;USD;2016;Q4;2016-09-30;2016-11-18;525000000;530000000;2612000000;11941000000;;25069000000;526000000;;3223000000;3749000000;28818000000;21660000000;;21669000000;1817000000;2098000000;23767000000;1676000000;-2121000000;5518000000;5051000000;28818000000
AMTD;356477;USD;2015;Q4;2015-09-30;2015-11-20;540000000;546000000;1978000000;12770000000;;22577000000;521000000;;3277000000;3798000000;26375000000;19379000000;;19385000000;1800000000;2087000000;21472000000;1655000000;-1765000000;5038000000;4903000000;26375000000
AMTD;356477;USD;2014;Q4;2014-09-30;2014-11-21;547000000;550000000;1460000000;11639000000;;19901000000;543000000;;3385000000;3928000000;23829000000;17663000000;;17668000000;1099000000;1413000000;19081000000;1624000000;-1409000000;4551000000;4748000000;23829000000
AMTD;356477;USD;2013;Q4;2013-09-30;2013-11-22;551000000;557000000;1062000000;8984000000;;17865000000;497000000;;3474000000;3971000000;21836000000;15752000000;;15756000000;1052000000;1404000000;17160000000;1598000000;-1226000000;4304000000;4676000000;21836000000
AMTD;356477;USD;2012;Q4;2012-09-30;2012-11-26;545000000;554000000;1139000000;8647000000;;15472000000;444000000;;3597000000;4041000000;19513000000;13352000000;;13384000000;1350000000;1704000000;15088000000;1593000000;-1286000000;4100000000;4425000000;19513000000
AMTD;356477;USD;2011;Q4;2011-09-30;2011-11-18;560923000;566514000;1036000000;8059000000;;13103000000;341000000;;3682000000;4023000000;17126000000;11274000000;;11320000000;1348000000;1690000000;13010000000;1590000000;-1120000000;3646000000;4116000000;17126000000
AMTD;356477;USD;2010;Q4;2010-09-30;2010-11-19;575453000;582329000;741492000;7393855000;;10713781000;272211000;;3740926000;4013137000;14726918000;9221012000;;9287768000;1323068000;1667467000;10955235000;1396597000;-747271000;3122305000;3771683000;14726918000
AMTD;356477;USD;2009;Q4;2009-09-30;2010-08-09;586628000;595139000;843282000;5712261000;;14337446000;238256000;;3796108000;4034364000;18371810000;13107226000;;13183084000;1443465000;1637614000;14820698000;1580952000;-559883000;2530117000;3551112000;18371810000
DLB;357388;USD;2017;Q4;2017-09-30;2017-11-16;101961000;101163000;874774000;73750000;25051000;1011434000;485275000;314364000;722481000;1522120000;2533554000;222623000;;245773000;;143939000;389712000;61432000;;2083063000;2143842000;2533554000
DLB;357388;USD;2016;Q4;2016-09-30;2016-11-18;101145000;103533000;637741000;75688000;16354000;759730000;443656000;393904000;712816000;1550376000;2310106000;188903000;;213083000;;118288000;331371000;42133000;;1938320000;1978735000;2310106000
DLB;357388;USD;2015;Q4;2015-09-30;2015-11-24;101934000;103164000;670827000;101563000;13872000;821229000;403091000;321015000;587958000;1312064000;2133293000;190771000;;209681000;;107605000;317286000;17673000;;1800857000;1816007000;2133293000
DLB;357388;USD;2014;Q4;2014-09-30;2014-11-18;102213000;103460000;799680000;86168000;8536000;1005851000;289755000;296335000;392071000;978161000;1984012000;176874000;;189370000;;62994000;252364000;46518000;;1660485000;1731648000;1984012000
DLB;357388;USD;2013;Q4;2013-09-30;2013-11-15;101766000;101918000;594664000;97460000;10093000;818579000;242917000;306338000;370111000;919366000;1737945000;151884000;;172815000;;65104000;237919000;18914000;;1454382000;1500026000;1737945000
DLB;357388;USD;2012;Q4;2012-09-30;2012-11-15;104077000;104349000;795293000;43495000;16700000;970286000;254676000;361614000;374222000;990512000;1960798000;133347000;;156840000;;60725000;217565000;103000;;1709479000;1743233000;1960798000
DLB;357388;USD;2011;Q4;2011-09-30;2011-11-23;110107000;110808000;942793000;61815000;26244000;1158598000;117107000;272797000;335885000;725789000;1884387000;132684000;;159385000;;39652000;199037000;210791000;;1445189000;1685350000;1884387000
DLB;357388;USD;2010;Q4;2010-09-30;2010-11-22;112484000;114137000;848130000;54257000;28338000;1060413000;94097000;190837000;366425000;651359000;1711772000;156109000;;165756000;;51337000;217093000;330014000;;1135922000;1494679000;1711772000
DLB;357388;USD;2009;Q4;2009-09-30;2010-07-29;113683000;116009000;735486000;22981000;12975000;900838000;92178000;205938000;382361000;680477000;1581315000;117756000;1624000;156584000;5825000;61626000;218210000;479092000;;852475000;1363105000;1581315000
DLB;357388;USD;2018;Q4;2018-09-30;2018-11-15;103349000;111409000;1096201000;137151000;26206000;1301954000;514182000;187782000;655351000;1357315000;2659269000;248196000;;272127000;;191024000;463151000;66229000;;2139154000;2196118000;2659269000
GEOS;357500;USD;2016;Q4;2016-09-30;2016-11-17;13053309;13053309;37753000;15392000;104540000;174334000;75705000;;4733000;80438000;254772000;10094000;;10268000;;37000;10305000;78100000;;182308000;244467000;254772000
GEOS;357500;USD;2015;Q4;2015-09-30;2015-11-19;13004387;13004387;40426000;12693000;124800000;198587000;94745000;;10260000;105005000;303592000;13759000;;13924000;;44000;13968000;74291000;;228278000;289624000;303592000
GEOS;357500;USD;2014;Q4;2014-09-30;2014-11-21;12954376;12985733;53218000;24602000;145890000;244008000;103078000;;7900000;110978000;354986000;19576000;;23351000;;2377000;25728000;70835000;;260919000;329258000;354986000
GEOS;357500;USD;2013;Q4;2013-09-30;2013-11-22;12923858;12889942;2726000;49756000;149548000;233103000;85388000;;8734000;94122000;327225000;33534000;;34639000;931000;3528000;38167000;66114000;;224008000;289058000;327225000
GEOS;357500;USD;2012;Q4;2012-09-30;2012-12-12;12763084;12766632;70712000;16229000;83894000;187228000;62286000;;9508000;71794000;259022000;32440000;;41192000;;2843000;44035000;60761000;;154451000;214987000;259022000
GEOS;357500;USD;2011;Q4;2011-09-30;2011-12-09;12680668;12332332;36314000;19761000;72390000;142581000;46637000;;7583000;54220000;196801000;16825000;;17681000;;2107000;19788000;57510000;;119333000;177013000;196801000
GEOS;357500;USD;2010;Q4;2010-09-30;2011-08-05;12102974;12243206;33453000;19107000;47395000;109986000;41991000;;11519000;53510000;163496000;16658000;440000;18409000;7260000;8501000;26910000;47120000;;89622000;136586000;163496000
GEOS;357500;USD;2017;Q4;2017-09-30;2017-12-01;13148129;13148129;51229000;9435000;20752000;86367000;53861000;;65468000;119329000;205696000;8937000;;10505000;;37000;10542000;83867000;;125517000;195154000;205696000
GEOS;357500;USD;2018;Q4;2018-09-30;2018-11-16;13270058;13270058;37405000;14323000;18812000;76654000;73169000;;49257000;122426000;199080000;10983000;;14735000;;7758000;22493000;86252000;;105954000;176587000;199080000
SPB;357600;USD;2017;Q4;2017-09-30;2017-11-17;57600000;58600000;168200000;266000000;496300000;1004100000;503100000;;5912500000;6415600000;7419700000;470000000;19400000;612800000;3752300000;4960200000;5573000000;2145900000;-360700000;262300000;1846700000;7419700000
SPB;357600;USD;2016;Q4;2016-09-30;2016-08-03;59200000;60100000;275300000;482600000;740600000;1632900000;542100000;;4894100000;5436200000;7069100000;742300000;164000000;1095600000;3456200000;4129500000;5225100000;2074200000;-108300000;63600000;1844000000;7069100000
SPB;357600;USD;2015;Q4;2015-09-30;2015-08-06;59800000;60700000;247900000;498800000;780800000;1687500000;507100000;;4999200000;5506300000;7193800000;780400000;33800000;1026900000;3872100000;4560100000;5587000000;2034200000;-65500000;-205500000;1606800000;7193800000
SPB;357600;USD;2014;Q4;2014-09-30;2014-08-06;52600000;54500000;194600000;439000000;624500000;1434600000;428900000;;3649500000;4078400000;5513000000;643200000;96700000;915700000;2894100000;3510500000;4426200000;1433900000;-44300000;-283100000;1086800000;5513000000
SPB;357600;USD;2013;Q4;2013-09-30;2013-08-08;52024000;51459000;207257000;481313000;632923000;1482905000;412551000;;3731217000;4143768000;5626673000;676919000;102921000;952370000;3115942000;3734207000;4686577000;1411273000;-39820000;-435911000;940096000;5626673000
SPB;357600;USD;2012;Q4;2012-09-30;2012-08-07;52066000;58393000;157961000;335301000;452633000;1061427000;214017000;;2476205000;2690222000;3751649000;467887000;16414000;610631000;1652886000;2151923000;2762554000;1399789000;-36612000;-340647000;989095000;3751649000
SPB;357600;USD;2011;Q4;2011-09-30;2011-08-11;51872000;51872000;142414000;356605000;434630000;1048289000;206389000;;2372028000;2578417000;3626706000;456189000;16090000;606912000;1535522000;2001297000;2608209000;1374622000;-5616000;-336063000;1018497000;3626706000
SPB;357600;USD;2010;Q4;2010-09-30;2011-08-11;49956000;49956000;170614000;365002000;530342000;1199712000;201164000;;2472728000;2673892000;3873604000;494972000;20710000;662772000;1723057000;2164453000;2827225000;1316975000;-2207000;-260892000;1046379000;3873604000
HRC;357864;USD;2016;Q4;2016-09-30;2016-11-17;65378000;67176000;232200000;515100000;252000000;1082100000;350000000;;2830300000;3180300000;4262400000;303800000;210100000;662300000;1938400000;2364200000;3026500000;580300000;-773700000;1589700000;1235900000;4262400000
HRC;357864;USD;2015;Q4;2015-09-30;2015-11-19;58645000;60481000;192800000;494700000;267400000;1141000000;378400000;;2938200000;3316600000;4457600000;341800000;58000000;578800000;2175200000;2721900000;3300700000;566400000;-788600000;1509900000;1156900000;4457600000
HRC;357864;USD;2014;Q4;2014-09-30;2014-11-19;57414000;59487000;99300000;411000000;176200000;779300000;261500000;;710500000;972000000;1751300000;209000000;126900000;442300000;364100000;502500000;944800000;138500000;-757700000;1499800000;806500000;1751300000
HRC;357864;USD;2013;Q4;2013-09-30;2013-11-20;58747000;59119000;127400000;361800000;118300000;688000000;234300000;;664500000;898800000;1586800000;173200000;81200000;345400000;225800000;382700000;728100000;127100000;-706500000;1473800000;858700000;1586800000
HRC;357864;USD;2012;Q4;2012-09-30;2012-11-15;124122846;124474454;84300000;392600000;126900000;681800000;250100000;7300000;688400000;945800000;1627600000;154100000;115200000;378100000;237500000;436900000;815000000;121200000;-630900000;1400300000;812600000;1627600000
HRC;357864;USD;2011;Q4;2011-09-30;2011-11-16;63077000;63230000;224600000;386200000;95600000;791700000;222800000;11100000;273500000;507400000;1299100000;157500000;100300000;334000000;50800000;223400000;557400000;118500000;-607600000;1309800000;741700000;1299100000
HRC;357864;USD;2010;Q4;2010-09-30;2010-11-17;62965000;64264000;184500000;353100000;108500000;739200000;243700000;12100000;250600000;506400000;1245600000;169500000;53100000;288700000;98500000;241100000;529800000;123700000;-558000000;1203600000;715800000;1245600000
HRC;357864;USD;2009;Q4;2009-09-30;2010-07-29;62605000;62605000;197000000;346600000;92000000;695100000;272400000;17200000;247900000;537500000;1232600000;175200000;102200000;344300000;99700000;279000000;623300000;123400000;-559400000;1105200000;609300000;1232600000
HRC;357864;USD;2017;Q4;2017-09-30;2017-11-17;65635000;67220000;231800000;579300000;284500000;1166200000;355400000;;3007100000;3362500000;4528700000;334500000;188900000;658700000;2120400000;2504400000;3163100000;588800000;-796800000;1676200000;1365600000;4528700000
HRC;357864;USD;2018;Q4;2018-09-30;2018-11-19;66539000;67773000;183000000;580700000;291700000;1155600000;328300000;;2876100000;3204400000;4360000000;352300000;182500000;662400000;1790400000;2081400000;2743800000;607300000;-754300000;1876200000;1616200000;4360000000
NUTR;357986;USD;2016;Q4;2016-09-30;2016-11-17;9211477;9211477;6803000;17680000;63923000;93866000;83048000;;58941000;141989000;235855000;20165000;;20165000;43500000;43700000;63865000;144000;0;172276000;171990000;235855000
NUTR;357986;USD;2015;Q4;2015-09-30;2015-11-19;9519180;9520005;4615000;16798000;59440000;86215000;77645000;;48589000;126234000;212449000;20528000;;20528000;31500000;31674000;52202000;7056000;-48000;153618000;160247000;212449000
NUTR;357986;USD;2014;Q4;2014-09-30;2014-11-20;9689490;9697257;6232000;15118000;57914000;83850000;79244000;;51684000;130928000;214778000;21709000;;21709000;43000000;43456000;65165000;11209000;-22000;138347000;149613000;214778000
NUTR;357986;USD;2013;Q4;2013-09-30;2013-11-26;9834418;9847423;8235000;13697000;49329000;75048000;76214000;;41048000;117262000;192310000;21796000;;21796000;32500000;32638000;54434000;15224000;-7000;122458000;137876000;192310000
NUTR;357986;USD;2012;Q4;2012-09-30;2012-11-21;9832921;9856791;4824000;13590000;46073000;68268000;75454000;;42196000;117650000;185918000;20670000;;20670000;34000000;34192000;54862000;15498000;-15000;115235000;131056000;185918000
NUTR;357986;USD;2011;Q4;2011-09-30;2011-12-19;10236367;10288896;2441000;13671000;39853000;62069000;72094000;;37502000;109596000;171665000;19737000;;19737000;32000000;32253000;51990000;19895000;;99468000;119675000;171665000
NUTR;357986;USD;2010;Q4;2010-09-30;2011-07-28;10380589;10473513;3740000;10668000;40273000;58294000;61733000;;34920000;96653000;154947000;17673000;;45673000;;1739000;47412000;23512000;;83750000;107535000;154947000
HAYN;358061;USD;2016;Q4;2016-09-30;2016-11-17;12369960;12379018;59297000;61612000;236558000;366260000;199182000;;84159000;283341000;649601000;47900000;;55388000;;282914000;338302000;246637000;-1380000;180565000;311299000;649601000
HAYN;358061;USD;2015;Q4;2015-09-30;2015-11-19;12326570;12338153;49045000;75593000;247836000;385442000;185351000;;67398000;252749000;638191000;50927000;;53427000;;242775000;296202000;244500000;-1091000;186533000;341989000;638191000
HAYN;358061;USD;2014;Q4;2014-09-30;2014-11-20;12321200;12415570;45871000;72439000;254027000;384833000;174083000;;51855000;225938000;610771000;59742000;;62242000;;201799000;264041000;242399000;-840000;166999000;346730000;610771000
HAYN;358061;USD;2013;Q4;2013-09-30;2013-11-21;12235505;12274976;68326000;82562000;232157000;395904000;152764000;;49184000;201948000;597852000;46194000;;48694000;;193355000;242049000;238953000;-505000;174154000;355803000;597852000
HAYN;358061;USD;2012;Q4;2012-09-30;2012-11-15;12176547;12228191;46740000;100631000;263236000;426225000;124652000;;76049000;200701000;626926000;73693000;;76193000;;249635000;325828000;236763000;;163426000;301098000;626926000
HAYN;358061;USD;2011;Q4;2011-09-30;2011-11-17;12078295;11939836;60062000;87680000;250051000;411435000;110678000;;74456000;185134000;596569000;90174000;;92674000;;231042000;323716000;231854000;;124047000;272853000;596569000
HAYN;358061;USD;2010;Q4;2010-09-30;2011-08-04;12049779;12164992;63968000;62851000;231783000;371630000;107043000;;72870000;179913000;551543000;68822000;109000;71431000;;214263000;285694000;229209000;;102677000;265849000;551543000
HAYN;358061;USD;2017;Q4;2017-09-30;2017-11-16;12405145;12405145;46328000;61602000;244457000;355168000;192556000;;74095000;266651000;621819000;52200000;;54700000;;233347000;288047000;248746000;-1646000;159366000;333772000;621819000
HAYN;358061;USD;2018;Q4;2018-09-30;2018-11-15;12422390;12415246;9802000;73437000;273045000;366349000;179400000;;42945000;222345000;588694000;59698000;;62198000;;193276000;255474000;251066000;-1869000;126588000;333220000;588694000
GFF;358146;USD;2017;Q4;2017-09-30;2017-11-20;41724000;43248000;236456000;271966000;384467000;1062533000;291516000;;727251000;1018767000;2081300000;369493000;12917000;382410000;1078462000;1224872000;1607282000;;;;474018000;2081300000
GFF;358146;USD;2016;Q4;2016-09-30;2016-11-17;40344000;43881000;72553000;184339000;261317000;780957000;236905000;;764234000;1001139000;1782096000;232189000;13932000;316579000;896946000;1054570000;1371149000;549972000;-501866000;475760000;410947000;1782096000
GFF;358146;USD;2015;Q4;2015-09-30;2015-11-12;42748000;44971000;52001000;218755000;325809000;740954000;379972000;;591887000;971859000;1712813000;301015000;16593000;319837000;826976000;962451000;1282288000;538255000;-436559000;454548000;430525000;1712813000
GFF;358146;USD;2014;Q4;2014-09-30;2014-11-13;47354000;44009000;92405000;258436000;290135000;815099000;370565000;;623162000;993727000;1808826000;322260000;7886000;333428000;791301000;943371000;1276799000;525711000;-354216000;427913000;532027000;1808826000
GFF;358146;USD;2013;Q4;2013-09-30;2013-11-15;53949000;58438000;178130000;256215000;230120000;816510000;353593000;;607505000;961098000;1777608000;270353000;10768000;284409000;678487000;842735000;1127144000;513816000;-274602000;434363000;650464000;1777608000
GFF;358146;USD;2012;Q4;2012-09-30;2012-11-16;55560000;57359000;209654000;239857000;257868000;826215000;356879000;;623098000;979977000;1806192000;252041000;17703000;273383000;681907000;878657000;1152040000;501136000;-242081000;436421000;654152000;1806192000
GFF;358146;USD;2011;Q4;2011-09-30;2011-11-18;57516000;56597000;243029000;267471000;263809000;899255000;350050000;;615949000;965999000;1865254000;285921000;25164000;314879000;688247000;898467000;1213346000;490974000;-231699000;424153000;651908000;1865254000
GFF;358146;USD;2010;Q4;2010-09-30;2011-08-03;59064000;60281000;169802000;252852000;268801000;811471000;314760000;;627470000;942230000;1753701000;315171000;20901000;340361000;503935000;702625000;1042986000;479600000;-213560000;431584000;710715000;1753701000
MTSI;358330;USD;2017;Q4;2017-09-30;2017-11-15;64247000;64247000;214225000;136096000;136074000;562897000;131019000;0;943207000;1074226000;1637123000;107275000;7700000;117119000;661471000;742630000;859749000;1041708000;-330000;-266981000;777374000;1637123000
MTSI;358330;USD;2016;Q4;2016-09-30;2016-11-17;53697000;51925000;356753000;108331000;114935000;612944000;99167000;;476440000;575607000;1188551000;84947000;7203000;92150000;573882000;633617000;725767000;551563000;-330000;-97488000;462784000;1188551000
MTSI;358330;USD;2015;Q4;2015-09-30;2015-11-24;53287000;51211000;161869000;83950000;79943000;384219000;83759000;;392856000;476615000;860834000;67418000;4058000;71476000;335087000;364825000;436301000;526064000;-330000;-98922000;424533000;860834000
MTSI;358330;USD;2014;Q4;2014-09-30;2014-12-09;47431000;46187000;173895000;62258000;71481000;373349000;50052000;;258833000;308885000;682234000;56989000;3478000;85646000;343178000;368021000;453667000;377762000;-330000;-147511000;228567000;682234000
MTSI;358330;USD;2013;Q4;2013-09-30;2013-12-05;46298000;47289000;110488000;63526000;54908000;246447000;32735000;;37453000;70188000;316635000;42927000;;52158000;;17336000;69494000;379826000;-330000;-132188000;247141000;316635000
MTSI;358330;USD;2012;Q4;2012-09-30;2012-11-28;45296000;41186000;84528000;54184000;57459000;213034000;30209000;;24830000;55039000;268073000;41155000;;55727000;;12888000;68615000;348016000;-685000;-147736000;199458000;268073000
MTSI;358330;USD;2011;Q4;2011-09-30;2012-05-10;1724000;1724000;45668000;46212000;52480000;156535000;25364000;;29369000;54733000;211268000;38990000;;67109000;;106978000;174087000;2000;;-144658000;37181000;211268000
MTSI;358330;USD;2018;Q4;2018-09-30;2018-11-16;65170000;66083000;192897000;97375000;122837000;458861000;149923000;31094000;842617000;1023634000;1482495000;91896000;7352000;107005000;658372000;706815000;813820000;1074793000;-330000;-407976000;668675000;1482495000
ABCD;358762;USD;2015;Q4;2015-12-31;2016-03-03;45661000;42920000;8645000;14640000;4694000;39225000;22540000;;79620000;102160000;141385000;16217000;3850000;94174000;97872000;121380000;215554000;285358000;-12784000;-343975000;-74169000;141385000
ABCD;358762;USD;2014;Q4;2014-12-31;2015-03-17;45554000;45465000;34387000;14304000;5337000;63541000;20856000;;84820000;105676000;169217000;19044000;1076000;81908000;138317000;162364000;244272000;284295000;-12784000;-342650000;-75055000;169217000
ABCD;358762;USD;2013;Q4;2013-12-31;2014-03-06;45843000;45469000;67993000;15767000;9221000;101197000;20315000;;94698000;115013000;216210000;26580000;995000;81107000;176510000;198293000;279400000;283724000;-12147000;-332695000;-63190000;216210000
ABCD;358762;USD;2012;Q4;2012-12-31;2013-03-08;48408000;48408000;51904000;17813000;16620000;109230000;21021000;;100208000;121229000;230459000;23537000;1290000;78400000;177342000;198104000;276504000;282501000;-7528000;-318442000;-46045000;230459000
ABCD;358762;USD;2011;Q4;2011-12-31;2012-03-15;49862000;48654000;63191000;13485000;21561000;109921000;29910000;;229849000;259759000;369680000;24227000;826000;64037000;186459000;215573000;279610000;281291000;-4931000;-184659000;90069000;369679000
ABCD;358762;USD;2010;Q4;2010-12-31;2011-08-10;44322000;44322000;11831000;31627000;22015000;76177000;25106000;;281779000;306885000;383062000;29353000;1658000;66774000;163167000;192276000;259050000;259931000;0;-135218000;124011000;383061000
ABCD;358762;USD;2016;Q4;2016-12-31;2017-03-14;46072000;48728000;4930000;13378000;2864000;33395000;23507000;;75038000;98545000;131940000;13892000;7350000;104560000;67130000;88642000;193202000;286996000;-12784000;-333545000;-61262000;131940000
ABCD;358762;USD;2017;Q4;2017-12-31;2018-03-07;46718000;47832000;8493000;12937000;2382000;35966000;22086000;;100502000;122588000;158554000;14509000;5958000;107380000;41841000;65466000;172846000;289075000;-12784000;-288490000;-14292000;158554000
WAIR;359379;USD;2017;Q4;2017-09-30;2017-11-29;98904358;98094061;61625000;256301000;827870000;1163146000;50355000;;540606000;590961000;1754107000;222892000;77952000;300844000;790851000;803532000;1104376000;436621000;;297736000;649731000;1754107000
WAIR;359379;USD;2018;Q4;2018-09-30;2018-11-16;99214431;99645852;46222000;283775000;884212000;1231517000;44205000;;513754000;557959000;1789476000;225556000;76205000;301761000;774106000;795246000;1097007000;444630000;;330819000;692469000;1789476000
PVA;359467;USD;2015;Q4;2015-12-31;2016-03-15;77687000;46886000;11955000;47965000;;164980000;344395000;;8350000;352745000;517725000;103525000;1224383000;1327908000;0;104938000;1432846000;;;;-915121000;517725000
PVA;359467;USD;2014;Q4;2014-12-31;2015-02-25;71887000;19684000;6252000;189627000;;334974000;1825098000;;41738000;1866836000;2201810000;312227000;0;312227000;1085429000;1216977000;1529204000;1206834000;-3345000;-535176000;672606000;2201810000
WRK;359889;USD;2016;Q4;2016-09-30;2016-11-25;195475160;203801500;340900000;1592200000;1638200000;3912600000;9294300000;;9831300000;19125600000;23038200000;1460300000;292900000;2183000000;5496300000;11011500000;13194500000;10461100000;;-105900000;9843700000;23038200000
WRK;359889;USD;2015;Q4;2015-09-30;2015-11-27;229307110;233623550;207800000;1575400000;1761000000;4176000000;9159800000;;12036600000;21196400000;25372400000;1586300000;63700000;2178800000;5558200000;11395500000;13574300000;10770400000;;1661600000;11798100000;25372400000
WRK;359889;USD;2014;Q4;2014-09-30;2015-11-27;95589140;97197860;32600000;1118700000;1029200000;2432500000;5832600000;;2774600000;8607200000;11039700000;1037200000;132600000;1360500000;2852100000;5358100000;6718600000;2841200000;;1960900000;4321100000;11039700000
WRK;359889;USD;2017;Q4;2017-09-30;2017-11-20;254300000;257600000;298100000;1886800000;1797300000;4490900000;9118300000;;11479800000;20598100000;25089000000;1908800000;608700000;3009800000;5946100000;11688400000;14698200000;10627400000;;172400000;10390800000;25089000000
NWGI;360213;USD;2017;Q4;2017-12-31;2018-03-30;74074754;77251432;6469858;1280320;;7850413;280111;1;4093971;4374083;12224496;3161931;1796665;7214958;895488;895488;8110446;14261997;;-9897620;4114050;12224496
NWGI;360213;USD;2016;Q4;2016-12-31;2016-11-23;67161558;64910114;2230422;552327;;2883031;203660;6508;4427212;4637380;7520411;1532100;1285351;4285594;742189;742189;5027783;14172763;;-11263504;2492628;7520411
NWGI;360213;USD;2015;Q4;2015-12-31;2015-11-16;51738080;51738080;157363;178151;;682646;88705;6729;2868871;2964305;3646951;736667;407399;2275085;67532;67532;2342617;10474914;;-9294845;1304334;3646951
NWGI;360213;USD;2014;Q4;2014-12-31;2015-07-22;46696344;46683714;811812;371644;;1912305;17995;40594;2161676;2220265;4132570;499092;578142;1784276;52912;52912;1837188;9527684;;-7272182;2295382;4132570
NWGI;360213;USD;2018;Q4;2018-12-31;2019-03-08;80070645;46594002;6289903;1081048;;7551363;354799;275000;14406548;15036347;22587710;5660038;39237;11881242;393838;832836;12714078;23963864;;-13008894;9873632;22587710
JCI;360440;USD;2016;Q4;2016-09-30;2016-11-23;;;2232000000;6271000000;2810000000;13171000000;6649000000;;15180000000;21829000000;35000000000;7473000000;1290000000;13397000000;8193000000;18569000000;31966000000;251000000;0;2698000000;3034000000;35000000000
JCI;360440;USD;2015;Q4;2015-09-30;2015-11-18;620845500;625907000;597000000;5751000000;2377000000;10469000000;5870000000;;13283000000;19153000000;29622000000;6264000000;865000000;10446000000;5745000000;8466000000;18912000000;3747000000;-3152000000;10797000000;10710000000;29622000000
JCI;360440;USD;2014;Q4;2014-09-30;2014-11-19;635361500;642619500;409000000;5871000000;2477000000;13107000000;6314000000;;13383000000;19697000000;32804000000;6394000000;323000000;11694000000;6357000000;9354000000;21048000000;3376000000;-1784000000;9956000000;11756000000;32804000000
JCI;360440;USD;2013;Q4;2013-09-30;2013-11-21;653029000;659523000;1055000000;7206000000;2325000000;13698000000;6585000000;;11235000000;17820000000;31518000000;7533000000;938000000;12117000000;4560000000;6670000000;18787000000;3099000000;-531000000;9328000000;12731000000;31518000000
JCI;360440;USD;2012;Q4;2012-09-30;2012-11-19;652074000;655703000;265000000;7308000000;2343000000;12743000000;6440000000;;11771000000;18211000000;30954000000;7204000000;747000000;10855000000;5321000000;8073000000;18928000000;2735000000;-179000000;8611000000;12026000000;30954000000
JCI;360440;USD;2011;Q4;2011-09-30;2011-11-22;-1313665731;-1341411145;257000000;7151000000;2316000000;12015000000;5616000000;;12045000000;17661000000;29676000000;7474000000;613000000;10782000000;4533000000;7454000000;18236000000;2629000000;-74000000;7838000000;11440000000;29676000000
JCI;360440;USD;2010;Q4;2010-09-30;2010-11-23;-1304124602;-1325684272;560000000;6095000000;1786000000;10652000000;4096000000;;10995000000;15091000000;25743000000;6548000000;737000000;9910000000;2652000000;5460000000;15370000000;2457000000;-74000000;7765000000;10373000000;25743000000
JCI;360440;USD;2009;Q4;2009-09-30;2009-11-25;1151743513;1151743513;761000000;5528000000;1521000000;9826000000;3986000000;;10276000000;14262000000;24088000000;5306000000;798000000;8716000000;3168000000;6033000000;14749000000;2363000000;-70000000;6615000000;9339000000;24088000000
JCI;360440;USD;2008;Q4;2008-09-30;2009-11-25;;;384000000;6472000000;2099000000;10676000000;4389000000;;9922000000;14311000000;24987000000;6249000000;743000000;9810000000;3201000000;5517000000;15327000000;1555000000;-102000000;7300000000;9660000000;24987000000
HP;360878;USD;2016;Q4;2016-09-30;2016-11-23;108071000;107062000;949709000;375169000;124325000;1572686000;5144733000;84955000;29645000;5259333000;6832019000;330061000;;330120000;491847000;1940974000;2271094000;459592000;-188270000;4289807000;4560925000;6832019000
HP;360878;USD;2015;Q4;2015-09-30;2015-11-25;107745000;108598000;774927000;445948000;128541000;1439194000;5563170000;104354000;40524000;5708048000;7147242000;305726000;39094000;348197000;492443000;1903199000;2251396000;431240000;-182363000;4648346000;4895846000;7147242000
HP;360878;USD;2014;Q4;2014-09-30;2014-11-26;108222000;109621000;360909000;705214000;106241000;1277001000;5188544000;236644000;18809000;5443997000;6720998000;464309000;39635000;507161000;39502000;1322860000;1830021000;395023000;-112969000;4525797000;4890977000;6720998000
HP;360878;USD;2013;Q4;2013-09-30;2013-11-27;106521000;108492000;447868000;621420000;88866000;1258211000;4676103000;316154000;14359000;5006616000;6264827000;334063000;115000000;452273000;80000000;1368827000;1821100000;299632000;-91098000;4102663000;4443727000;6264827000
HP;360878;USD;2012;Q4;2012-09-30;2012-11-21;105689000;107253000;96095000;620489000;78777000;895228000;4351571000;451144000;23142000;4825857000;5721085000;336035000;40000000;381164000;195000000;1504923000;1886087000;247000000;-84104000;3505295000;3834998000;5721085000
HP;360878;USD;2011;Q4;2011-09-30;2011-11-23;107064000;109297000;364246000;460540000;54407000;956313000;3677070000;347924000;22584000;4047578000;5003891000;296750000;115000000;416729000;235000000;1317115000;1733844000;221633000;-4704000;2954210000;3270047000;5003891000
HP;360878;USD;2010;Q4;2010-09-30;2010-11-24;105815000;107450000;63020000;457659000;43402000;652804000;3275020000;320712000;16834000;3612566000;4265370000;224646000;;232638000;360000000;1225267000;1457905000;202606000;-27165000;2547917000;2807465000;4265370000
HP;360878;USD;2009;Q4;2009-09-30;2009-11-25;105465000;107096000;108642000;233949000;39544000;522932000;3194273000;356404000;87415000;3638092000;4161024000;179923000;105000000;301906000;420000000;1176109000;1478015000;186745000;-31129000;2414942000;2683009000;4161024000
HP;360878;USD;2008;Q4;2008-09-30;2009-08-05;105217000;107942000;121513000;462833000;33098000;690647000;2682251000;199266000;15881000;2897398000;3588045000;282224000;26733000;308957000;475000000;1013614000;1322571000;180203000;-35654000;2082518000;2265474000;3588045000
HP;360878;USD;2017;Q4;2017-09-30;2017-11-22;108587000;108587000;565866000;477074000;137204000;1235267000;5001051000;84026000;119644000;5204721000;6439988000;344311000;;344385000;492902000;1931012000;2275397000;498444000;-191839000;3855686000;4164591000;6439988000
HP;360878;USD;2018;Q4;2018-09-30;2018-11-16;108948000;110680000;325816000;565202000;158134000;1115550000;4857382000;98696000;143239000;5099317000;6214867000;377168000;;377168000;493968000;1454964000;1832132000;511594000;-173188000;4027779000;4382735000;6214867000
ARMK;361112;USD;2016;Q4;2016-09-30;2016-11-23;243891000;250112000;152580000;1476349000;587155000;2492571000;1023083000;;7066418000;8089501000;10582072000;2138223000;46522000;2184745000;5223514000;6226527000;8411272000;2924451000;-548884000;-33778000;2170800000;10582072000
ARMK;361112;USD;2015;Q4;2015-09-30;2015-12-01;239672000;248497000;122416000;1444574000;575263000;2379123000;959345000;;6857889000;7817234000;10196357000;2099561000;81427000;2180988000;5184597000;6121908000;8302896000;2787396000;-508828000;-228641000;1893461000;10196357000
ARMK;361112;USD;2014;Q4;2014-09-30;2014-12-03;234455000;247395000;111690000;1582431000;553815000;2464976000;997331000;;6993386000;7990717000;10455693000;2289068000;89805000;2378873000;5355789000;6348907000;8727780000;2577572000;-370775000;-382463000;1727913000;10455693000
ARMK;361112;USD;2013;Q4;2013-09-30;2014-02-05;202841000;218579000;110998000;1405843000;541972000;2287165000;977323000;;7002618000;7979941000;10267106000;2323412000;65841000;2389253000;5758229000;6805231000;9194484000;1695857000;-253692000;-479233000;1072622000;10267106000
ARMK;361112;USD;2017;Q4;2017-09-30;2017-11-22;243711000;250756000;238797000;1615993000;610732000;2653139000;1042031000;;7311059000;8353090000;11006229000;2289938000;78157000;2368095000;5190331000;6169275000;8537370000;3017317000;-681546000;247050000;2468859000;11006229000
ARMK;361112;USD;2018;Q4;2018-09-30;2018-11-21;246322000;256822000;215025000;1790433000;724802000;2901425000;1378094000;;9440583000;10818677000;13720102000;2459252000;30907000;2490159000;7213077000;8190292000;10680451000;3135214000;-724952000;710519000;3039651000;13720102000
VAR;361284;USD;2017;Q4;2017-09-30;2017-11-27;91800000;92500000;716200000;961500000;417700000;2296800000;255300000;;742300000;997600000;3294400000;537200000;350000000;1645100000;;127400000;1772500000;807800000;;778600000;1521900000;3294400000
VAR;361284;USD;2016;Q4;2016-09-30;2016-11-23;147376640;148513600;906700000;769600000;442400000;2615400000;258600000;;940800000;1199400000;3814800000;542800000;379000000;1613400000;286900000;446900000;2060300000;772300000;;1069000000;1754500000;3814800000
VAR;361284;USD;2015;Q4;2015-09-30;2015-11-25;112276942;113216631;845500000;770900000;612600000;2393000000;379200000;;806500000;1185700000;3578700000;550100000;158400000;1376700000;337500000;475700000;1852400000;780300000;;1017800000;1726300000;3578700000
VAR;361284;USD;2014;Q4;2014-09-30;2014-11-25;116569407;117958414;915451000;731929000;572261000;2368203000;337999000;;651088000;989087000;3357290000;559085000;50000000;1201654000;387500000;539216000;1740870000;743790000;;931241000;1616420000;3357290000
VAR;361284;USD;2013;Q4;2013-09-30;2013-11-26;122149384;123913583;1180561000;698254000;535223000;2582533000;315331000;;570610000;885941000;3468474000;515156000;56250000;1160579000;450000000;594048000;1754627000;743575000;;1010343000;1713847000;3468474000
VAR;361284;USD;2012;Q4;2012-09-30;2012-11-21;125230745;127936914;754279000;691806000;457869000;2054729000;296592000;;527405000;823997000;2878726000;517304000;155000000;1236531000;6250000;132419000;1368950000;673282000;;893115000;1509776000;2878726000
VAR;361284;USD;2011;Q4;2011-09-30;2011-11-23;129787784;130322631;583662000;635153000;409962000;1740652000;285894000;;472215000;758109000;2498761000;444955000;191276000;1125912000;6250000;128958000;1254870000;613266000;;677473000;1243891000;2498761000
VAR;361284;USD;2010;Q4;2010-09-30;2011-05-05;135210386;139346616;520221000;591677000;363933000;1563098000;267927000;;492927000;760854000;2323952000;406869000;25525000;903541000;17869000;145044000;1048585000;626373000;;686598000;1275367000;2323952000
VAR;361284;USD;2009;Q4;2009-09-30;2009-11-25;141750580;142920630;553529000;580918000;321861000;1528059000;264060000;;516129000;780189000;2308248000;420495000;13450000;842320000;23394000;154145000;996465000;641759000;;696409000;1311783000;2308248000
VAR;361284;USD;2008;Q4;2008-09-30;2009-08-11;142150860;145434072;397306000;486310000;282980000;1263413000;218183000;;493916000;712099000;1975512000;358196000;7987000;781677000;32399000;166650000;948327000;593974000;;451439000;1027185000;1975512000
VAR;361284;USD;2018;Q4;2018-09-30;2018-11-26;91400000;93300000;504800000;1009900000;438100000;2188400000;274600000;;789700000;1064300000;3252700000;610000000;0;1339700000;;324300000;1664000000;869300000;;780400000;1588700000;3252700000
HI;361523;USD;2016;Q4;2016-09-30;2016-11-16;63300000;63700000;52000000;;153100000;600300000;152500000;;1208100000;1360600000;1960900000;193000000;13800000;433700000;596300000;881000000;1314700000;348700000;-19900000;433300000;646200000;1960900000
HI;361523;USD;2015;Q4;2015-09-30;2015-11-18;63100000;63900000;48300000;;153600000;604100000;158300000;;1045700000;1204000000;1808100000;166600000;9400000;404200000;518700000;798100000;1202300000;350900000;-21000000;372100000;605800000;1808100000
HI;361523;USD;2014;Q4;2014-09-30;2014-11-19;63300000;63900000;58000000;;168500000;637800000;159500000;;1121200000;1280700000;1918500000;262200000;15000000;491100000;543500000;833600000;1324700000;342100000;-18300000;311700000;593800000;1918500000
HI;361523;USD;2013;Q4;2013-09-30;2013-11-25;62900000;63100000;42700000;;177500000;639400000;171900000;;1191900000;1363800000;2003200000;242800000;10000000;465500000;654300000;961400000;1426900000;321700000;-4200000;252200000;576300000;2003200000
HI;361523;USD;2012;Q4;2012-09-30;2012-11-26;62300000;62500000;20200000;;90000000;305300000;117900000;;664300000;782200000;1087500000;64600000;;151800000;271600000;429400000;581200000;321900000;-11500000;238300000;506300000;1087500000
HI;361523;USD;2011;Q4;2011-09-30;2011-11-28;61800000;61800000;115500000;;83700000;380100000;120600000;;680000000;800600000;1180700000;105300000;;136200000;431500000;601400000;737600000;317000000;-17100000;182700000;443100000;1180700000
HI;361523;USD;2010;Q4;2010-09-30;2010-11-23;61900000;61900000;98400000;;64900000;324400000;109600000;30100000;584800000;724500000;1048900000;89700000;;118000000;403400000;559000000;677000000;304900000;-14800000;124800000;371900000;1048900000
HI;361523;USD;2009;Q4;2009-09-30;2010-08-30;61400000;61400000;35200000;;42500000;267900000;85300000;170400000;37500000;293200000;561100000;57500000;60000000;134900000;0;122200000;257100000;297600000;-17500000;79300000;304000000;561100000
HI;361523;USD;2017;Q4;2017-09-30;2017-11-15;63400000;63600000;66000000;;151600000;593600000;150400000;;1212500000;1362900000;1956500000;224900000;18800000;511700000;446900000;678900000;1190600000;349900000;-24400000;507100000;765900000;1956500000
HI;361523;USD;2018;Q4;2018-09-30;2018-11-13;62700000;64300000;56000000;;172500000;610600000;142000000;;1112000000;1254000000;1864600000;268700000;0;531700000;344600000;588800000;1120500000;351400000;-67100000;531000000;744100000;1864600000
MSCC;361632;USD;2016;Q4;2016-10-31;2016-11-16;111200000;107300000;189500000;245200000;213100000;734900000;174900000;;3513200000;3688100000;4423000000;278900000;40700000;319600000;2138500000;2374500000;2694100000;1380500000;;350600000;1728900000;4423000000
MSCC;361632;USD;2015;Q4;2015-10-31;2015-11-12;94400000;96800000;256400000;186900000;227200000;710400000;152700000;;1568900000;1721600000;2432000000;169100000;32500000;201600000;953900000;1023200000;1224800000;827100000;;383200000;1207200000;2432000000
MSCC;361632;USD;2014;Q4;2014-10-31;2014-11-13;93598000;98573000;162200000;191200000;205000000;618600000;148700000;;1289100000;1437800000;2056400000;161200000;0;161200000;693400000;779600000;940800000;818200000;;298600000;1115600000;2056400000
MSCC;361632;USD;2013;Q4;2013-10-31;2013-11-14;90251000;94051000;256433000;162103000;161986000;622630000;125158000;;1164867000;1290025000;1912655000;133232000;;133232000;676000000;747365000;880597000;756664000;;275442000;1032058000;1912655000
MSCC;361632;USD;2012;Q4;2012-10-31;2012-11-21;86486000;84545000;204335000;153190000;159055000;561341000;116146000;;1257143000;1373289000;1934630000;155575000;903000;156478000;775975000;850166000;1006644000;696961000;;231768000;927986000;1934630000
MSCC;361632;USD;2011;Q4;2011-10-31;2011-11-23;84832000;90211000;266631000;110908000;140827000;577890000;89922000;;814661000;904583000;1482473000;149639000;4050000;153689000;357384000;436677000;590366000;629878000;;261443000;892107000;1482473000
MSCC;361632;USD;2010;Q4;2010-10-31;2010-11-23;78273000;79005000;199950000;78722000;126151000;432169000;75913000;;371804000;447717000;879886000;70879000;444000;71323000;;42120000;113443000;560276000;;205713000;766443000;879886000
MSCC;361632;USD;2009;Q4;2009-10-31;2010-08-05;80889000;79302000;263292000;62543000;95372000;454722000;68698000;;287710000;356408000;811130000;53788000;431000;100769000;;34010000;134779000;529144000;;146675000;676351000;811130000
MSCC;361632;USD;2017;Q4;2017-10-31;2017-11-14;115900000;117900000;144900000;267900000;239100000;726900000;197600000;;3398600000;3596200000;4323100000;318300000;61100000;379400000;1735600000;1949400000;2328800000;1467000000;;526900000;1994300000;4323100000
KLIC;362126;USD;2017;Q4;2017-10-31;2017-11-16;70743000;71736000;608410000;198480000;122023000;953382000;67762000;1502000;148461000;217725000;1171107000;200448000;;200448000;;57723000;258171000;506515000;-157604000;561986000;912936000;1171107000
KLIC;362126;USD;2016;Q4;2016-10-31;2016-11-17;70402000;71149000;547907000;130455000;87295000;780942000;50342000;0;151160000;201502000;982444000;118597000;;118597000;;57329000;175926000;498676000;-139407000;449975000;806518000;982444000
KLIC;362126;USD;2015;Q4;2015-10-31;2015-11-18;72527000;71743000;498614000;108596000;79096000;707369000;53234000;;143863000;197097000;904466000;73934000;;73934000;;61283000;135217000;492339000;-124856000;402863000;769249000;904466000
KLIC;362126;USD;2014;Q4;2014-10-31;2014-11-12;76672000;78630000;597086000;171530000;49694000;837691000;52755000;;54002000;106757000;944448000;81351000;;81351000;;73855000;155206000;479116000;-46984000;354866000;789242000;944448000
KLIC;362126;USD;2013;Q4;2013-10-31;2013-11-14;75279000;75525000;525040000;162714000;38135000;754388000;47541000;;61065000;108606000;862994000;77402000;;77402000;;68927000;146329000;467525000;-46356000;291878000;716665000;862994000
KLIC;362126;USD;2012;Q4;2012-10-31;2012-11-19;147582000;150386000;440244000;188986000;58994000;713316000;28441000;;73852000;102293000;815609000;123369000;;123369000;;48573000;171942000;455122000;-46356000;232520000;643667000;815609000
KLIC;362126;USD;2011;Q4;2011-10-31;2011-12-08;72688000;74408000;384552000;138649000;73092000;619841000;26501000;;82049000;108550000;728391000;94110000;105224000;214182000;;44332000;258514000;441749000;-46356000;71940000;469877000;728391000
KLIC;362126;USD;2010;Q4;2010-10-31;2011-08-10;70429000;70710000;181097000;196035000;73893000;472690000;30059000;;77420000;107479000;580169000;125130000;;125130000;98475000;132559000;257689000;423715000;-46356000;-55670000;322480000;580169000
KLIC;362126;USD;2018;Q4;2018-10-31;2018-11-20;67457000;69372000;613630000;243373000;115191000;987273000;76067000;1373000;121027000;198467000;1185740000;174076000;;174076000;;131457000;305533000;519244000;-248664000;613529000;880207000;1185740000
HOLX;362221;USD;2016;Q4;2016-09-30;2016-11-17;277549000;282494000;548400000;447000000;274700000;1326600000;460200000;;5530200000;5990400000;7317000000;444500000;296000000;901900000;3049400000;4272400000;5174300000;5563200000;-250000000;-3138200000;2142700000;7317000000
HOLX;362221;USD;2015;Q4;2015-09-30;2015-11-19;282071000;294780000;491300000;416100000;283100000;1265800000;457100000;;5919600000;6376700000;7642500000;389100000;391200000;943400000;3221000000;4619900000;5563300000;5562700000;0;-3469000000;2079200000;7642500000
HOLX;362221;USD;2014;Q4;2014-09-30;2014-11-20;277856000;286938000;736100000;396000000;330600000;1565800000;461900000;;6387000000;6848900000;8414700000;354200000;114500000;619600000;4153200000;5732100000;6351700000;5661000000;;-3600600000;2063000000;8414700000
HOLX;362221;USD;2013;Q4;2013-09-30;2013-11-26;270867000;267832000;822500000;409300000;289400000;1624200000;491500000;;6885100000;7376600000;9000800000;352500000;563800000;1088400000;4242100000;5970900000;7059300000;5539000000;-1500000;-3616400000;1941500000;9000800000
HOLX;362221;USD;2012;Q4;2012-09-30;2012-11-28;264938000;260012000;560430000;409333000;367191000;1563014000;507998000;;8406096000;8914094000;10477108000;459604000;64435000;661349000;4971179000;6854728000;7516077000;5399313000;-1518000;-2443554000;2961031000;10477108000
HOLX;362221;USD;2011;Q4;2011-09-30;2011-11-23;262163000;264877000;712332000;318712000;230544000;1342900000;238666000;;4427214000;4665880000;6008780000;388794000;;509450000;1488580000;2562435000;3071885000;5306338000;-1518000;-2369920000;2936895000;6008780000
HOLX;362221;USD;2010;Q4;2010-09-30;2010-11-24;259188000;250584000;515625000;283103000;192482000;1098881000;251698000;;4275255000;4526953000;5625834000;240534000;1362000;441912000;1447053000;2485373000;2927285000;5226994000;-1518000;-2527070000;2698549000;5625834000
HOLX;362221;USD;2009;Q4;2009-09-30;2009-11-24;257038000;252465000;293186000;263231000;179889000;818625000;278377000;;4587224000;4865601000;5684226000;183873000;38373000;329290000;1513878000;2628959000;2958249000;5184639000;-1433000;-2464257000;2725977000;5684226000
HOLX;362221;USD;2008;Q4;2008-09-30;2009-08-06;256060000;256060000;95661000;321299000;174667000;693578000;283975000;;7157079000;7441054000;8134632000;214336000;38480000;340875000;2162420000;3151488000;3492363000;4856401000;-1433000;-217644000;4642269000;8134632000
HOLX;362221;USD;2017;Q4;2017-09-30;2017-11-21;279542000;284740000;540600000;533500000;331600000;1478600000;491200000;;6009800000;6501000000;7979600000;541900000;1152400000;1865500000;2194800000;3329400000;5194900000;5633700000;-450100000;-2382700000;2784700000;7979600000
HOLX;362221;USD;2018;Q4;2018-09-30;2018-11-20;272721000;266935000;666700000;579200000;384100000;1723200000;478200000;;5029500000;5507700000;7230900000;628300000;601400000;1402600000;2725500000;3399500000;4802100000;5674200000;-725900000;-2494000000;2428800000;7230900000
SMID;362372;USD;2015;Q4;2015-12-31;2016-03-28;4903419;5009706;2777411;6795215;2494284;13507522;5073867;;268721;5342588;18850110;3168453;435717;4528113;2076675;2931675;7459788;5159593;-102300;6342386;11390322;18850110
SMID;362372;USD;2014;Q4;2014-12-31;2015-03-31;4881548;4790928;4585822;4092924;1726544;11935920;4106611;;255385;4361996;16297916;2134706;363821;2930801;2230364;2893364;5824165;5090253;-102300;5492427;10473751;16297916
SMID;362372;USD;2013;Q4;2013-12-31;2014-03-27;4860050;4888011;4051404;7296792;1939478;14035898;4322995;;297915;4620910;18656808;3151563;364204;4063556;2544809;3174809;7238365;5090253;-102300;6471504;11418443;18656808
SMID;362372;USD;2012;Q4;2012-12-31;2013-04-01;4826182;4934052;4367474;4752729;2104106;12478991;4049478;;289335;4338813;16817804;2062325;329529;2596845;2661228;3355228;5952073;5043540;-102300;5924491;10865731;16817804
SMID;362372;USD;2011;Q4;2011-12-31;2012-04-16;4834891;4587135;2130686;7191071;1939633;12700024;4615514;;212436;4827950;17527974;1639552;411561;2983306;2992996;3814996;6798302;5043540;-102300;5788432;10729672;17527974
SMID;362372;USD;2016;Q4;2016-12-31;2017-03-30;4974262;5415284;4572840;7187630;2578817;15231621;8007518;;173086;8180604;23412225;3316150;587523;5059595;3345511;4109511;9169106;5242162;-102300;9128170;14243119;23412225
SMID;362372;USD;2017;Q4;2017-12-31;2018-03-29;5060192;5070229;4488000;8967000;3515000;19032000;9867000;;326000;10193000;29225000;5134000;637000;7834000;2896000;4186000;12020000;5770000;-102000;11556000;17205000;29225000
SMID;362372;USD;2018;Q4;2018-12-31;2019-03-26;-10144794;-10187730;3053000;12281000;3560000;21596000;14102000;;5671000;19773000;41369000;6659000;711000;11860000;2792000;10662000;22522000;6024000;-102000;12962000;18847000;41369000
FLUG;362943;USD;2015;Q4;2015-12-31;2016-03-30;;;8915150;6086397;222195;15223742;66072;;6264;72336;15296078;9804981;;10077604;;599600;10677204;1290604;;3584960;4618874;15296078
FLUG;362943;USD;2014;Q4;2014-12-31;2015-03-31;;;4443148;3055270;8167484;15665902;78319;;6264;84583;15750485;11434057;;11737128;;1100000;12837128;1290604;;1482938;2913357;15750485
FLUG;362943;USD;2016;Q4;2016-12-31;2017-04-18;;;12592938;5394314;300825;18288077;117981;;6264;124245;18412322;11347810;;11379216;;1000000;12379216;929164;;5051215;6033106;18412322
TSSI;363007;USD;2015;Q4;2015-12-31;2016-03-30;15592000;12712000;1132000;6997000;66000;9514000;702000;;2778000;3480000;12994000;7608000;287000;12521000;1036000;1073000;13594000;68331000;-1531000;-67400000;-600000;12994000
TSSI;363007;USD;2014;Q4;2014-12-31;2015-04-22;16051000;;1378000;3951000;154000;6768000;670000;;2977000;3647000;10415000;5547000;149000;8876000;575000;593000;9469000;67653000;-1512000;-65195000;946000;10415000
TSSI;363007;USD;2013;Q4;2013-12-31;2014-04-15;14346449;14346609;3291000;8410000;217000;13411000;437000;;3177000;3614000;17025000;7590000;137000;13043000;723000;732000;13775000;67154000;-1512000;-62392000;3250000;17025000
TSSI;363007;USD;2012;Q4;2012-12-31;2013-03-21;14262648;14262648;5608322;7525340;0;14376099;273451;;1848219;2121670;16497769;5753347;500000;9281974;1957301;2009927;11291901;66307273;-1503496;-59597909;5205868;16497769
TSSI;363007;USD;2011;Q4;2011-12-31;2012-03-30;13889674;15221061;6731487;7147714;;17106337;305463;;3920836;4226299;21332636;6886094;375000;10080462;2457301;2533374;12613836;65806833;-1450455;-55637578;8718800;21332636
TSSI;363007;USD;2010;Q4;2010-12-31;2011-08-15;13308252;14256684;10980420;10134475;;22750083;375926;;3911337;4287263;27037346;9370446;200572;17463478;2750000;2887218;20350696;65248931;-1084809;-57477472;6686650;27037346
TSSI;363007;USD;2016;Q4;2016-12-31;2017-03-31;14644000;14601000;2152000;2389000;59000;5391000;544000;;2641000;3185000;8576000;5319000;246000;9120000;825000;887000;10007000;68524000;-1532000;-68423000;-1431000;8576000
TSSI;363007;USD;2017;Q4;2017-12-31;2018-03-23;15500000;18585000;2268000;990000;134000;3729000;418000;;2580000;2998000;6727000;2841000;;5335000;1656000;1697000;7032000;68888000;-1536000;-67657000;-305000;6727000
TSSI;363007;USD;2018;Q4;2018-12-31;2019-03-21;13594000;17113000;6178000;727000;108000;7433000;390000;;1287000;1677000;9110000;2390000;;4571000;1838000;2058000;6629000;69243000;-1542000;-65220000;2481000;9110000
JAZZ;364811;USD;2015;Q4;2015-12-31;2016-02-23;61500000;62936000;988785000;209685000;19451000;1257667000;85572000;;2000365000;2085937000;3343604000;187685000;37587000;226642000;1150857000;1518842000;1745484000;1562906000;;302686000;1598120000;3343604000
JAZZ;364811;USD;2014;Q4;2014-12-31;2015-02-24;60634000;66872000;684042000;186371000;30037000;1015845000;58363000;;2264747000;2323110000;3338955000;196805000;9428000;216801000;1333000000;1751472000;1968273000;1458011000;;34704000;1370682000;3338955000
JAZZ;364811;USD;2013;Q4;2013-12-31;2014-02-25;57880000;61678000;636504000;124805000;28669000;864617000;14246000;;1359358000;1373604000;2238221000;141059000;5572000;204028000;544404000;739185000;943213000;1220323000;;18532000;1295008000;2238221000
JAZZ;364811;USD;2012;Q4;2012-12-31;2013-02-26;57994000;61259000;387196000;75480000;26525000;551572000;7281000;;1407640000;1414921000;1966493000;160437000;29688000;191538000;427073000;654189000;845727000;1151016000;;-61296000;1120766000;1966493000
JAZZ;364811;USD;2011;Q4;2011-12-31;2012-02-28;42397000;47653000;157898000;34374000;3909000;199131000;1557000;;52885000;54442000;253573000;39912000;0;52870000;0;7915000;60785000;542701000;;-349882000;192788000;253573000
JAZZ;364811;USD;2010;Q4;2010-12-31;2011-08-03;39490000;42945000;44794000;22081000;5046000;74458000;690000;;60581000;61271000;135729000;26621000;16064000;59936000;24629000;45242000;105178000;505417000;;-474866000;30551000;135729000
JAZZ;364811;USD;2016;Q4;2016-12-31;2017-02-28;59922000;61529000;425963000;234244000;34051000;748069000;107490000;;3944668000;4052158000;4800227000;220189000;36094000;257406000;1993531000;2666009000;2923415000;1665238000;;528907000;1876812000;4800227000
JAZZ;364811;USD;2017;Q4;2017-12-31;2018-02-27;59984000;61191000;601035000;224129000;43245000;968277000;170080000;;3985315000;4155395000;5123672000;244724000;40605000;293947000;1540433000;2117155000;2411102000;1935492000;;917956000;2712570000;5123672000
JAZZ;364811;USD;2018;Q4;2018-12-31;2019-02-26;59323000;60411000;824622000;263838000;52956000;1234005000;200358000;;3769128000;3969486000;5203491000;306686000;33387000;345487000;1563025000;2101109000;2446596000;2113636000;;841050000;2756895000;5203491000
GEO;365061;USD;2016;Q4;2016-12-31;2017-02-27;111217000;111655000;68038000;356255000;;697669000;1897241000;;1154499000;3051740000;3749409000;265993000;238065000;504058000;2181738000;2270394000;2774452000;893118000;;112763000;974957000;3749409000
GEO;365061;USD;2015;Q4;2015-12-31;2016-02-26;110719500;111411000;59638000;314097000;;438346000;1916386000;;1107495000;3023881000;3462227000;261483000;17141000;278624000;2077601000;2176766000;2455390000;880346000;;158796000;1006837000;3462227000
GEO;365061;USD;2014;Q4;2014-12-31;2015-02-26;110253000;110493000;41337000;269038000;;377406000;1772166000;;852636000;2624802000;3002208000;237323000;16752000;254075000;1604643000;1702140000;1956215000;866798000;;206342000;1045993000;3002208000
GEO;365061;USD;2013;Q4;2013-12-31;2014-03-03;106995000;107619000;52125000;250530000;;384345000;1727798000;;777221000;2505019000;2889364000;200962000;22163000;223125000;1562613000;1642263000;1865388000;848884000;-53579000;232646000;1023976000;2889364000
GEO;365061;USD;2012;Q4;2012-12-31;2013-03-01;91834500;92644500;31755000;246635000;;337183000;1687159000;;814852000;2502011000;2839194000;205989000;53882000;259871000;1434291000;1532019000;1791890000;833090000;-53615000;264667000;1047304000;2839194000
GEO;365061;USD;2011;Q4;2011-12-31;2012-03-01;92421000;92724000;43378000;265250000;;459329000;1688356000;;902238000;2590594000;3049923000;228675000;53653000;288818000;1540664000;1722584000;2011402000;728149000;-214031000;507170000;1038521000;3049923000
GEO;365061;USD;2010;Q4;2010-12-31;2011-03-02;96345000;97206000;39664000;275778000;;422084000;1511292000;;478997000;1990289000;2412373000;225713000;41574000;267287000;1003416000;1105596000;1372883000;719334000;-139049000;428545000;1039490000;2412373000
GEO;365061;USD;2009;Q4;2009-12-31;2010-08-13;76674000;78220500;33856000;200756000;;279634000;998560000;;169624000;1168184000;1447818000;157824000;19624000;177448000;565070000;605272000;782720000;352066000;-58888000;365927000;665098000;1447818000
GEO;365061;USD;2017;Q4;2017-12-31;2018-02-26;122405000;122996000;81377000;389916000;;579709000;2078123000;;1569076000;3647199000;4226908000;340643000;28920000;369563000;2552967000;2658426000;3027989000;1192146000;;31541000;1198919000;4226908000
GEO;365061;USD;2018;Q4;2018-12-31;2019-02-25;119241000;119723000;31255000;445526000;;601762000;2158610000;;1497746000;3656356000;4258118000;373211000;332027000;705238000;2412244000;2512976000;3218214000;1212164000;-95175000;-52868000;1039904000;4258118000
USFD;365184;USD;2016;Q4;2017-01-31;2017-02-28;220711718;229467710;131090000;1226032000;1223037000;2789171000;1767611000;;4387668000;6155279000;8944450000;1750611000;75962000;1969285000;3705751000;4437515000;6406800000;2793473000;;-136460000;2537650000;8944450000
USFD;365184;USD;2015;Q4;2016-01-31;2016-08-09;169492996;171597477;517802000;1233978000;1112967000;3060433000;1768885000;;4410041000;6178926000;9239359000;1548870000;62639000;1802823000;4682149000;5563359000;7366182000;2293809000;;-346254000;1873177000;9239359000
USFD;365184;USD;2017;Q4;2018-01-31;2018-02-27;221606589;223678007;118849000;1301631000;1207830000;2819381000;1801215000;;4416562000;6217777000;9037158000;1740091000;109226000;2002882000;3648055000;4282913000;6285795000;2723604000;;123514000;2751363000;9037158000
USFD;365184;USD;2018;Q4;2019-01-31;2019-02-14;216916869;218212581;104000000;1347000000;1279000000;2979000000;1842000000;;4365000000;6207000000;9186000000;1813000000;263000000;2076000000;3351000000;3881000000;5957000000;2782000000;;531000000;3229000000;9186000000
AGCO;365265;USD;2016;Q4;2016-12-31;2017-02-28;79900000;80800000;429700000;890400000;1514800000;3165700000;1361300000;;2641400000;4002700000;7168400000;1883400000;85400000;2144900000;1610000000;2186300000;4331200000;104100000;;4113600000;2837200000;7168400000
AGCO;365265;USD;2015;Q4;2015-12-31;2016-02-26;85000000;85000000;426700000;836800000;1423400000;2898300000;1347100000;;2252300000;3599400000;6497700000;1732500000;89000000;2185400000;925200000;1429000000;3614400000;302500000;;3996000000;2883300000;6497700000
AGCO;365265;USD;2014;Q4;2014-12-31;2015-02-27;90900000;91300000;363700000;963800000;1750700000;3310700000;1530400000;;2527700000;4058100000;7368800000;1914300000;94300000;2216900000;997600000;1655000000;3871900000;583400000;;3771600000;3496900000;7368800000
AGCO;365265;USD;2013;Q4;2013-12-31;2014-02-28;97500000;99700000;1047200000;940600000;2016100000;4517100000;1602300000;;2319400000;3921700000;8438800000;2349500000;110500000;2812000000;938500000;1582000000;4394000000;1118900000;;3402000000;4044800000;8438800000
AGCO;365265;USD;2012;Q4;2012-12-31;2013-02-27;97100000;98500000;781300000;924600000;1703100000;3954700000;1406100000;;2361000000;3767100000;7721800000;2114800000;59100000;2464800000;1035600000;1775500000;4240300000;1083900000;;2843700000;3481500000;7721800000
AGCO;365265;USD;2011;Q4;2011-12-31;2012-02-27;97200000;98600000;724400000;970500000;1559600000;3662800000;1222600000;;2371800000;3594400000;7257200000;2017600000;60100000;2205500000;1409700000;2020500000;4226000000;1074200000;;2321600000;3031200000;7257200000
AGCO;365265;USD;2010;Q4;2010-12-31;2011-02-25;93000000;97700000;719900000;908500000;1233500000;3121000000;924800000;;1391100000;2315900000;5436900000;1565700000;100000;1912900000;443000000;864800000;2777700000;1052200000;;1738300000;2659200000;5436900000
AGCO;365265;USD;2009;Q4;2009-12-31;2010-08-06;92200000;95900000;651400000;725200000;1156700000;2748500000;910000000;;1340400000;2250400000;4998900000;1430300000;100000;1668900000;454000000;935600000;2604500000;1062800000;;1517800000;2394400000;4998900000
AGCO;365265;USD;2017;Q4;2017-12-31;2018-02-28;79500000;81000000;367700000;1019400000;1872900000;3627700000;1485300000;;2858700000;4344000000;7971700000;2325400000;95400000;2650600000;1618100000;2225800000;4876400000;137400000;;4253800000;3095300000;7971700000
AGCO;365265;USD;2018;Q4;2018-12-31;2019-03-01;77600000;78400000;326100000;880300000;1908700000;3537400000;1373100000;;2715900000;4089000000;7626400000;2388300000;210600000;2766700000;1275300000;1866200000;4632900000;11000000;;4477300000;2993500000;7626400000
HALO;365463;USD;2017;Q4;2017-12-31;2018-02-20;141858000;150408000;469214000;22133000;5146000;510372000;3520000;;6053000;9573000;519945000;47549000;77211000;131328000;125140000;180251000;311579000;731187000;;-522371000;208366000;519945000
HALO;365463;USD;2016;Q4;2016-12-31;2016-11-07;128129000;131678000;204981000;15680000;14623000;256532000;4264000;;719000;4983000;261515000;32399000;17393000;54585000;199228000;239411000;293996000;552867000;;-585342000;-32481000;261515000
HALO;365463;USD;2015;Q4;2015-12-31;2015-11-09;128452000;120089000;108339000;32410000;9489000;171772000;3943000;;6074000;10017000;181789000;31291000;21862000;62457000;27971000;76333000;138790000;525756000;;-482658000;42999000;181789000
HALO;365463;USD;2014;Q4;2014-12-31;2014-11-10;124066000;124066000;135623000;9149000;6406000;161321000;2951000;;1705000;4656000;165977000;16964000;0;24331000;49860000;100294000;124625000;491820000;;-450427000;41352000;165977000
HALO;365463;USD;2013;Q4;2013-12-31;2013-11-08;113552000;113552000;71503000;9097000;6170000;95195000;3422000;;3176000;6598000;101793000;17504000;;24902000;49772000;96881000;121783000;362045000;;-382052000;-19990000;101793000
HALO;365463;USD;2012;Q4;2012-12-31;2012-11-08;112349819;112349819;99501264;15703087;2670696;130627935;3700462;;400000;4100462;134728397;10055136;;18946153;31111680;66928525;85874678;347427367;;-298573648;48853719;134728397
HALO;365463;USD;2011;Q4;2011-12-31;2011-11-08;103442192;99933930;52825527;2262465;567263;63987497;1771048;;;1771048;65758545;13172433;;17301840;0;37556589;54858429;255921762;;-245021646;10900116;65758545
HALO;365463;USD;2010;Q4;2010-12-31;2011-08-05;;;83255848;2328268;193422;89498434;1846899;;;1846899;91345333;12425937;;15343066;;55650811;70993877;245603251;;-225251795;20351456;91345333
HALO;365463;USD;2018;Q4;2018-12-31;2019-02-21;144223000;144223000;354526000;30005000;22625000;427849000;7465000;;4934000;12399000;440248000;53608000;91506000;149361000;34874000;42000000;191361000;780602000;;-531438000;248887000;440248000
JMBA;365536;USD;2017;Q4;2017-12-31;2018-05-11;15588206;15192799;10030000;;465000;25690000;10928000;;4030000;14958000;40648000;39661000;;47713000;;7509000;55222000;409536000;-40009000;-384101000;-14574000;40648000
JMBA;365536;USD;2016;Q4;2016-12-31;2018-02-12;-15053581639;-15053581639;7133000;;534000;23704000;12512000;;5404000;17916000;41620000;38118000;;46457000;;8940000;55397000;407291000;-40009000;-381059000;-13777000;41620000
JMBA;365536;USD;2015;Q4;2015-12-31;2016-03-14;14897992;15752860;19730000;;818000;47157000;15600000;;6859000;22459000;69616000;46886000;;55635000;;8990000;64625000;403623000;-40009000;-358623000;4991000;69616000
JMBA;365536;USD;2014;Q4;2014-12-31;2015-03-30;17134544;16724235;17750000;;2300000;68955000;17988000;;5546000;23534000;92489000;48435000;;66200000;;9544000;75744000;396646000;-11991000;-368041000;16745000;92489000
JMBA;365536;USD;2013;Q4;2013-12-31;2013-08-06;17152867;17724475;32386000;;2670000;66402000;27961000;;3553000;31514000;97916000;60827000;;61873000;;9201000;71074000;391251000;0;-364409000;26842000;97916000
JMBA;365536;USD;2012;Q4;2012-12-31;2013-03-07;15489083;11485658;31486000;;3143000;51577000;38442000;;3594000;42036000;93613000;60547000;;61634000;;10467000;72101000;380085000;;-366489000;21512000;93613000
JMBA;365536;USD;2011;Q4;2011-12-31;2012-03-09;13403786;5877969;19607000;;2228000;41071000;44760000;;2462000;47222000;88293000;53938000;;55030000;;13079000;68109000;369095000;;-366791000;20184000;88293000
JMBA;365536;USD;2010;Q4;2010-12-31;2011-08-17;12548405;12548405;29024000;;2486000;46035000;49215000;;4804000;54019000;100054000;55390000;;56530000;166000;15582000;72112000;365881000;;-358493000;27942000;100054000
COHR;365654;USD;2017;Q4;2017-09-30;2017-11-28;24568000;24884000;475576000;305668000;414807000;1311664000;278850000;;747286000;1026136000;2337800000;179066000;5078000;419145000;589001000;755391000;1174536000;171648000;;971710000;1163264000;2337800000
COHR;365654;USD;2016;Q4;2016-09-30;2016-11-29;24243000;24595000;399953000;165715000;212898000;815639000;127443000;;218066000;345509000;1161148000;65052000;20000000;201494000;0;48826000;250320000;151540000;;764588000;910828000;1161148000
COHR;365654;USD;2015;Q4;2015-09-30;2015-12-01;24634000;24908000;325515000;142260000;156614000;652683000;102445000;;213819000;316264000;968947000;37658000;0;122590000;;49939000;172529000;128845000;;677086000;796418000;968947000
COHR;365654;USD;2014;Q4;2014-09-30;2014-11-25;24879000;25230000;318275000;137324000;170483000;681055000;107424000;;210896000;318320000;999375000;34813000;;117319000;;62407000;179726000;184290000;;600677000;819649000;999375000
COHR;365654;USD;2013;Q4;2013-09-30;2013-11-27;24387000;24833000;250110000;136759000;168067000;629226000;114333000;;222919000;337252000;966478000;61260000;2000;145828000;;62132000;207960000;162497000;;541571000;758518000;966478000
COHR;365654;USD;2012;Q4;2012-09-30;2012-11-28;23628000;24093000;224929000;144345000;160113000;614485000;115096000;;151191000;266287000;880772000;63032000;17000;153788000;2000;55328000;209116000;131945000;;499256000;671656000;880772000
COHR;365654;USD;2011;Q4;2011-09-30;2011-12-21;24696000;25169000;220203000;141037000;152385000;580646000;104504000;;158116000;262620000;843266000;63770000;15000;162405000;19000;62860000;225265000;130486000;;436294000;618001000;843266000
COHR;365654;USD;2010;Q4;2010-09-30;2011-08-10;24676000;25253000;262771000;110211000;113858000;542517000;90339000;;170248000;260587000;803104000;44004000;18000;131920000;33000;79721000;211641000;186323000;;343056000;591463000;803104000
COHR;365654;USD;2018;Q4;2018-09-30;2018-11-27;24234000;24492000;310615000;355208000;486741000;1238502000;311793000;;709674000;1021467000;2259969000;184437000;5072000;372838000;420711000;572667000;945505000;78942000;;1232689000;1314464000;2259969000
MNK;365935;USD;2017;Q4;2017-09-30;2018-02-27;92300000;92300000;1260900000;275400000;128700000;2285200000;413200000;;12642600000;13055800000;15341000000;228200000;313700000;1050400000;6420900000;7768600000;8819000000;5511000000;-1564700000;2588600000;6522000000;15341000000
MNK;365935;USD;2016;Q4;2016-09-30;2016-08-02;107300000;108300000;342000000;431000000;350700000;1566500000;881500000;;12758300000;13639800000;15206300000;358600000;271200000;1307200000;5880800000;8914800000;10222000000;5447600000;-919800000;529000000;4984300000;15206300000
MNK;365935;USD;2015;Q4;2015-09-30;2015-08-04;116500000;117500000;365900000;489600000;262100000;1846100000;793000000;;13765000000;14558000000;16404100000;292000000;22000000;929400000;6474300000;10163500000;11092900000;5381100000;-109700000;38900000;5311200000;16404100000
MNK;365935;USD;2014;Q4;2014-09-30;2014-08-07;85100000;83600000;707800000;476600000;306400000;2071000000;886800000;;9829500000;10716300000;12787300000;294700000;21200000;904800000;3874000000;6924500000;7829300000;5195600000;-17500000;-285800000;4958000000;12787300000
MNK;365935;USD;2013;Q4;2013-09-30;2013-08-12;57700000;58100000;275500000;400800000;403100000;1384900000;997400000;;1174300000;2171700000;3556600000;235200000;1500000;600200000;918300000;1700800000;2301000000;1113600000;0;33500000;1255600000;3556600000
MNK;365935;USD;2012;Q4;2012-09-30;2013-08-12;57700000;57700000;0;315400000;435300000;901600000;945200000;;1052100000;1997300000;2898900000;197100000;1300000;420100000;8900000;2393900000;2814000000;0;0;0;84900000;2898900000
MNK;365935;USD;2018;Q4;2018-09-30;2019-02-26;83500000;81700000;348900000;623300000;322300000;1427200000;982000000;;8468100000;9450100000;10877300000;374100000;22400000;943700000;6069200000;7046300000;7990000000;5546700000;-1617400000;-1017700000;2887300000;10877300000
CSGS;366036;USD;2017;Q4;2017-12-31;2018-02-23;32511000;32969000;261360000;219531000;;554266000;44651000;;305617000;350268000;904534000;102620000;22500000;222593000;309236000;339195000;561788000;427780000;-814732000;749438000;342746000;904534000
CSGS;366036;USD;2016;Q4;2016-12-31;2016-11-03;31105000;32934000;276498000;208930000;;558573000;33116000;;300190000;333306000;891879000;101281000;49426000;252029000;366834000;388490000;640519000;391881000;-826002000;714846000;251360000;891879000
CSGS;366036;USD;2015;Q4;2015-12-31;2015-11-05;30944000;34030000;240936000;178854000;;500091000;35992000;;326648000;362640000;862731000;111961000;148868000;359410000;130262000;157476000;516886000;503926000;-814437000;675431000;345845000;862731000
CSGS;366036;USD;2014;Q4;2014-12-31;2014-11-07;32254000;33370000;201800000;184369000;;474370000;38326000;;341936000;380262000;854632000;91165000;22500000;212835000;233331000;283164000;495999000;487081000;-757478000;635716000;358633000;854632000
CSGS;366036;USD;2013;Q4;2013-12-31;2013-11-07;32126000;33862000;210837000;178511000;;475375000;35061000;;358544000;393605000;868980000;94624000;15000000;206806000;250050000;296070000;502876000;473848000;-738372000;629011000;366104000;868980000
CSGS;366036;USD;2012;Q4;2012-12-31;2012-11-06;32070000;32636000;169321000;191943000;;440355000;39429000;;367157000;406586000;846941000;93672000;15000000;211732000;259698000;308570000;520302000;462150000;-728243000;592874000;326639000;846941000
CSGS;366036;USD;2011;Q4;2011-12-31;2011-11-08;32255000;32521000;158830000;179804000;;409960000;41154000;;363783000;404937000;814897000;71537000;27000000;197385000;282744000;342798000;540183000;450021000;-714893000;543995000;274714000;814897000
CSGS;366036;USD;2010;Q4;2010-12-31;2011-08-09;32429000;32786000;215550000;155005000;;441494000;52257000;;385947000;438204000;879698000;80781000;69528000;270409000;305159000;372211000;642620000;440353000;-704963000;501713000;237078000;879698000
CSGS;366036;USD;2018;Q4;2018-12-31;2019-02-22;32328000;32604000;162880000;235827000;;599567000;81813000;;432982000;514795000;1114362000;106711000;7500000;350391000;352326000;402947000;753338000;442110000;-842360000;795127000;361024000;1114362000
SRDX;366154;USD;2018;Q4;2018-09-30;2018-11-30;13259000;12896000;64670000;8877000;4016000;81527000;30143000;;52465000;82608000;164135000;8811000;;35133000;;20392000;55525000;8277000;;97615000;108610000;164135000
SRDX;366154;USD;2017;Q4;2017-09-30;2017-12-01;13037000;13297000;48336000;7211000;3516000;60883000;22942000;;52768000;75710000;136593000;4169000;;9803000;;15233000;25036000;6068000;;102072000;111557000;136593000
SRDX;366154;USD;2016;Q4;2016-09-30;2016-07-29;13062000;13216000;46941000;6869000;3579000;58558000;19601000;;54735000;74336000;132894000;3792000;;10135000;;15926000;26061000;7414000;;98146000;106833000;132894000
SRDX;366154;USD;2015;Q4;2015-09-30;2015-08-06;12945000;13247000;55588000;7478000;2979000;67789000;12968000;;17953000;30921000;98710000;1575000;;4700000;;2137000;6837000;3707000;;88161000;91873000;98710000
SRDX;366154;USD;2014;Q4;2014-09-30;2014-08-01;13649000;13858000;46551000;4751000;2817000;55280000;13133000;16823000;19653000;49609000;104889000;1909000;;4067000;;2071000;6138000;3342000;;93881000;98751000;104889000
SRDX;366154;USD;2013;Q4;2013-09-30;2013-08-02;14166000;14408000;25707000;5332000;3328000;35779000;12845000;32397000;20902000;66144000;101923000;2103000;;5976000;;2130000;8106000;2723000;;91036000;93817000;101923000
SRDX;366154;USD;2012;Q4;2012-09-30;2012-08-09;16749000;16917000;29657000;5069000;3524000;39955000;13610000;28433000;22321000;64364000;104319000;2723000;;6899000;;2432000;9331000;19079000;;75869000;94988000;104319000
SRDX;366154;USD;2011;Q4;2011-09-30;2011-08-08;17449000;17451000;38443000;4385000;3181000;54587000;14586000;29754000;57855000;102195000;156782000;2813000;;11040000;;6134000;17174000;75367000;;64394000;139608000;156782000
SRDX;366154;USD;2010;Q4;2010-09-30;2011-08-08;17369000;17365000;20496000;8987000;3047000;37478000;65395000;36290000;31116000;132801000;170279000;5094000;;7647000;;8273000;15920000;70573000;;82900000;154359000;170279000
HNNA;366890;USD;2017;Q4;2017-09-30;2017-12-04;7702635;7843977;15708000;4325000;;22231000;254000;;74773000;75027000;97258000;8029000;4228000;12459000;21728000;33269000;45728000;14943000;;36587000;51530000;97258000
HNNA;366890;USD;2016;Q4;2016-09-30;2016-12-01;11413631;11647429;3543000;4230000;;10135000;296000;;74508000;74804000;84939000;6961000;4228000;11221000;25956000;36387000;47608000;13279000;;24052000;37331000;84939000
HNNA;366890;USD;2015;Q4;2015-09-30;2015-11-30;13997673;14141572;3093000;4052000;;9412000;319000;;63402000;63721000;73133000;5796000;4375000;10265000;30625000;39773000;50038000;11654000;;11441000;23095000;73133000
HNNA;366890;USD;2014;Q4;2014-09-30;2014-12-02;13971526;13865873;7652000;3142000;;12181000;240000;;62894000;63134000;75315000;3538000;3750000;7430000;22972000;30471000;37901000;10852000;;26562000;37414000;75315000
HNNA;366890;USD;2013;Q4;2013-09-30;2013-12-04;13734927;13726031;8413000;2402000;;11682000;258000;;62794000;63052000;74734000;3129000;9308000;12469000;26653000;32478000;44947000;9948000;;19839000;29787000;74734000
HNNA;366890;USD;2012;Q4;2012-09-30;2012-12-06;13231037;13263091;8736000;643000;;9749000;148000;404000;22601000;23153000;32902000;1135000;625000;1847000;1302000;5831000;7678000;9584000;;15748000;25224000;32902000
HNNA;366890;USD;2011;Q4;2011-09-30;2011-12-09;13096559;13172825;8368000;548000;;9334000;136000;323000;22344000;22803000;32137000;873000;625000;1522000;1927000;5775000;7297000;9567000;;15462000;24840000;32137000
HNNA;366890;USD;2010;Q4;2010-09-30;2011-05-06;12800378;12849633;8059000;619000;;9004000;180000;364000;22351000;22895000;31899000;1023000;573000;1646000;2552000;5753000;7399000;9456000;;15192000;24500000;31899000
HNNA;366890;USD;2018;Q4;2018-09-30;2018-11-28;7819423;7909435;25404000;4259000;;30744000;382000;;78354000;78736000;109480000;7641000;4228000;12035000;17500000;26465000;38500000;16783000;;54197000;70980000;109480000
AA;367153;USD;2016;Q4;2016-12-31;2017-03-15;184586415;186000000;853000000;668000000;1160000000;3181000000;9325000000;1358000000;2877000000;13560000000;16741000000;2058000000;21000000;2821000000;1424000000;6223000000;9044000000;9533000000;;-104000000;7697000000;16741000000
AA;367153;USD;2015;Q4;2015-12-31;2016-12-01;;;557000000;380000000;1172000000;2566000000;9390000000;1472000000;2985000000;13847000000;16413000000;1828000000;18000000;2404000000;207000000;2496000000;4900000000;;;;11513000000;16413000000
AA;367153;USD;2017;Q4;2017-12-31;2018-02-26;183000000;189000000;1358000000;811000000;1453000000;4238000000;9138000000;1410000000;2661000000;13209000000;17447000000;2639000000;16000000;3252000000;1388000000;7397000000;10649000000;9592000000;;113000000;6798000000;17447000000
AA;367153;USD;2018;Q4;2018-12-31;2019-02-26;186000000;193000000;1113000000;830000000;1644000000;4134000000;8327000000;1360000000;2117000000;11804000000;15938000000;2489000000;1000000;2919000000;1801000000;5625000000;8544000000;9613000000;;341000000;7394000000;15938000000
UNH;367714;USD;2016;Q4;2016-12-31;2017-02-08;952000000;969000000;13275000000;8152000000;;33879000000;5901000000;23868000000;59162000000;88931000000;122810000000;13361000000;7193000000;49252000000;25777000000;33369000000;82621000000;10000000;;40945000000;40189000000;122810000000
UNH;367714;USD;2015;Q4;2015-12-31;2016-02-09;953000000;966000000;12911000000;6523000000;;31639000000;4861000000;18792000000;55962000000;79615000000;111254000000;11994000000;6634000000;42898000000;25331000000;32895000000;75793000000;39000000;;37125000000;35461000000;111254000000
UNH;367714;USD;2014;Q4;2014-12-31;2015-02-10;957000000;975000000;9236000000;4252000000;;23556000000;4418000000;18827000000;39581000000;62826000000;86382000000;9247000000;1399000000;30623000000;16007000000;21917000000;52540000000;10000000;;33836000000;33842000000;86382000000
UNH;367714;USD;2013;Q4;2013-12-31;2014-02-12;995000000;1013000000;9213000000;3052000000;;20380000000;4010000000;19605000000;37887000000;61502000000;81882000000;7458000000;1969000000;27881000000;14891000000;20677000000;48558000000;10000000;;33047000000;33324000000;81882000000
UNH;367714;USD;2012;Q4;2012-12-31;2013-02-07;1019000000;1036000000;11437000000;2709000000;;21052000000;3939000000;17711000000;38183000000;59833000000;80885000000;6984000000;2713000000;27116000000;14041000000;20470000000;47586000000;76000000;;30664000000;33299000000;80885000000
UNH;367714;USD;2011;Q4;2011-12-31;2012-02-09;1054000000;1072000000;12006000000;2294000000;;20350000000;2515000000;16166000000;28858000000;47539000000;67889000000;6853000000;982000000;23922000000;10656000000;15675000000;39597000000;10000000;;27821000000;28292000000;67889000000
UNH;367714;USD;2010;Q4;2010-12-31;2011-02-10;1093000000;1109000000;11195000000;2061000000;;18393000000;2200000000;14707000000;27763000000;44670000000;63063000000;6488000000;2480000000;23700000000;8662000000;13538000000;37238000000;11000000;;25562000000;25825000000;63063000000
UNH;367714;USD;2009;Q4;2009-12-31;2010-02-10;1151000000;1162000000;11039000000;1954000000;;18200000000;2140000000;13311000000;25394000000;40845000000;59045000000;6283000000;2164000000;22163000000;9009000000;13276000000;35439000000;11000000;;23342000000;23606000000;59045000000
UNH;367714;USD;2008;Q4;2008-12-31;2009-08-06;1196000000;1214000000;8209000000;1929000000;;14990000000;2181000000;13366000000;25278000000;40825000000;55815000000;5685000000;1456000000;19761000000;11338000000;15274000000;35035000000;50000000;;20782000000;20780000000;55815000000
UNH;367714;USD;2017;Q4;2017-12-31;2018-02-13;970000000;991000000;15490000000;9568000000;;37084000000;7013000000;28341000000;66620000000;101974000000;139058000000;15180000000;2857000000;50463000000;28835000000;36573000000;87036000000;1713000000;;48730000000;52022000000;139058000000
UNH;367714;USD;2018;Q4;2018-12-31;2019-02-12;963000000;980000000;14324000000;11388000000;;38692000000;8458000000;32510000000;72561000000;113529000000;152221000000;16705000000;1973000000;53209000000;34581000000;42785000000;95994000000;10000000;;55846000000;56227000000;152221000000
FLIR;367930;USD;2018;Q4;2018-12-31;2019-02-28;550845557;560414530;512144000;323746000;352107000;1292647000;247407000;14210000;1226978000;1488595000;2781242000;247434000;0;316014000;421948000;588442000;904456000;1355000;;2024523000;1876786000;2781242000
FLIR;367930;USD;2017;Q4;2017-12-31;2018-02-23;549412927;558167893;519090000;346687000;372183000;1387219000;263996000;;1158811000;1422807000;2810026000;293948000;;394933000;420684000;580535000;975468000;91162000;;1856756000;1834558000;2810026000
FLIR;367930;USD;2016;Q4;2016-12-31;2017-02-24;411313643;415772228;361349000;352020000;371371000;1164657000;271785000;;1183264000;1455049000;2619706000;269614000;15000000;361712000;501921000;579668000;941380000;12139000;;1832138000;1678326000;2619706000
FLIR;367930;USD;2015;Q4;2015-12-31;2016-02-26;137985000;139608000;472785000;326098000;393092000;1287514000;272629000;;846257000;1118886000;2406400000;248883000;264694000;585345000;93750000;171540000;756885000;1374000;;1773267000;1649515000;2406400000
FLIR;367930;USD;2014;Q4;2014-12-31;2015-02-27;140633000;142915000;531374000;354658000;320605000;1300328000;247094000;;801889000;1048983000;2349311000;230172000;15000000;309557000;357986000;429981000;739538000;1396000;;1671786000;1609773000;2349311000
FLIR;367930;USD;2013;Q4;2013-12-31;2014-03-03;141207000;144084000;542476000;286573000;344719000;1309731000;234041000;;799587000;1033628000;2343359000;202443000;15000000;276515000;372528000;453464000;729979000;42955000;;1544425000;1613380000;2343359000
FLIR;367930;USD;2012;Q4;2012-12-31;2013-03-01;148001000;150044000;321739000;335163000;379080000;1165246000;211615000;;813794000;1025409000;2190655000;193546000;0;241567000;248319000;349187000;590754000;171546000;;1418814000;1599901000;2190655000
FLIR;367930;USD;2011;Q4;2011-12-31;2012-02-29;155431000;157746000;440846000;329581000;336051000;1236080000;186269000;;726765000;913034000;2149114000;190379000;;235741000;247861000;334344000;570085000;352157000;;1238866000;1579029000;2149114000
FLIR;367930;USD;2010;Q4;2010-12-31;2011-03-01;158955000;162348000;193137000;339723000;303156000;954807000;189119000;;713426000;902545000;1857352000;201282000;;249951000;0;84853000;334804000;465467000;;1055429000;1522548000;1857352000
FLIR;367930;USD;2009;Q4;2009-12-31;2010-02-26;152195000;161845000;422047000;234974000;216500000;980028000;139112000;;375404000;514516000;1494544000;144011000;;186886000;57991000;103909000;290795000;389316000;;807303000;1203749000;1494544000
FLIR;367930;USD;2008;Q4;2008-12-31;2009-08-10;;;289442000;239183000;207487000;812502000;122304000;;306271000;428575000;1241077000;120964000;;172275000;182825000;224077000;396352000;282849000;;577090000;844725000;1241077000
ATKR;368117;USD;2016;Q4;2016-09-30;2016-11-29;62496000;63832000;200279000;192090000;161465000;582921000;202692000;;378955000;581647000;1164568000;203555000;1267000;204822000;629046000;702500000;907322000;398918000;-2580000;-113142000;257246000;1164568000
ATKR;368117;USD;2015;Q4;2015-09-30;2016-08-02;62524000;62524000;80598000;216992000;161924000;481492000;224284000;;408023000;632307000;1113799000;207634000;2864000;210498000;649344000;747024000;957522000;353131000;-2580000;-173241000;156277000;1113799000
ATKR;368117;USD;2017;Q4;2017-09-30;2017-11-29;63969000;66593000;45718000;224427000;200003000;505759000;208619000;;500714000;709333000;1215092000;207622000;4215000;211837000;571863000;642384000;854221000;423866000;-2580000;-42433000;360871000;1215092000
ATKR;368117;USD;2018;Q4;2018-09-30;2018-11-28;46219000;47952000;126662000;265147000;221753000;647138000;213108000;;463814000;676922000;1324060000;246186000;26561000;272747000;877686000;929254000;1202001000;458450000;-2580000;-317373000;122059000;1324060000
KTEC;368599;USD;2016;Q4;2016-09-30;2016-12-09;6401000;6401000;10491000;14024000;30687000;62421000;13789000;1127000;18647000;33563000;95984000;15466000;587000;26316000;4565000;6674000;32990000;34237000;;;62994000;95984000
KTEC;368599;USD;2015;Q4;2015-09-30;2015-12-11;6358000;6337000;7726000;14836000;31297000;61939000;14799000;1127000;19681000;35607000;97546000;20185000;705000;27108000;5149000;8366000;35474000;32676000;;;62072000;97546000
KTEC;368599;USD;2014;Q4;2014-09-30;2014-12-12;6305000;6305000;9741000;12557000;26673000;59993000;16652000;1127000;20573000;38352000;98345000;15761000;804000;21790000;4733000;9052000;30842000;31414000;;;67503000;98345000
KTEC;368599;USD;2013;Q4;2013-09-30;2013-12-13;6177000;6205000;17601000;17725000;27921000;72573000;17259000;1148000;23644000;42051000;114624000;21585000;871000;30235000;5612000;11929000;42164000;30086000;;;72460000;114624000
KTEC;368599;USD;2012;Q4;2012-09-30;2012-12-10;5344000;5373000;23755000;11426000;23166000;64193000;18370000;1153000;2639000;22162000;86355000;13524000;364000;20057000;4833000;6868000;26925000;21806000;;;59430000;86355000
KTEC;368599;USD;2011;Q4;2011-09-30;2011-12-09;10613714;10667696;28754000;8776000;24269000;69349000;19433000;1178000;4445000;25056000;94405000;15190000;345000;26865000;5197000;8766000;35631000;21138000;;;58774000;94405000
KTEC;368599;USD;2010;Q4;2010-09-30;2011-08-09;5313000;5326000;29096000;13250000;21191000;69520000;16821000;1178000;3748000;21747000;91267000;18506000;333000;28045000;5542000;6884000;34929000;20006000;;;56338000;91267000
KTEC;368599;USD;2017;Q4;2017-09-30;2017-12-08;6485000;6485000;9337000;20177000;38588000;77311000;12911000;1127000;16489000;30527000;107838000;23760000;4566000;37450000;0;1736000;39186000;34959000;;;68652000;107838000
MITK;369106;USD;2016;Q4;2016-09-30;2016-12-09;32102760;36513703;33873000;4949000;;40307000;440000;1952000;5686000;8078000;48385000;4581000;;8327000;;573000;8900000;71069000;;-31542000;39485000;48385000
MITK;369106;USD;2015;Q4;2015-09-30;2015-12-07;31080850;31780194;26674000;3937000;;31409000;975000;;6362000;7337000;38746000;3599000;;7404000;;909000;8313000;63937000;;-33501000;30433000;38746000
MITK;369106;USD;2014;Q4;2014-09-30;2014-12-05;30527232;30527232;24035760;2955350;;27695519;1293270;2072018;42049;3407337;31102856;3227180;;6211499;;949324;7160823;59976809;;-36026966;23942033;31102856
MITK;369106;USD;2013;Q4;2013-09-30;2013-12-12;30362667;30362667;29025328;1494627;;31181661;1629664;;42049;1671713;32853374;3331396;;5818464;;1306168;7124632;56462001;;-30735097;25728742;32853374
MITK;369106;USD;2012;Q4;2012-09-30;2012-12-07;25479519;22052189;12521627;1097311;;14104103;491079;2085690;42049;2618818;16722921;1438915;;3102656;;63586;3166242;37016686;;-23459391;13556679;16722921
MITK;369106;USD;2011;Q4;2011-09-30;2011-12-15;24063119;19119405;15843354;2956295;;19117031;196519;417230;120903;734652;19851683;854916;;1773331;;23061;1796392;33684541;;-15619395;18055291;19851683
MITK;369106;USD;2010;Q4;2010-09-30;2011-08-12;;;1305049;1221599;;2707320;34293;;266843;301136;3008456;425045;9193;1287480;679801;719517;2006997;16495797;;-15494338;1001459;3008456
MITK;369106;USD;2017;Q4;2017-09-30;2017-11-30;34145000;39346000;42568000;7099000;;50876000;613000;3780000;16450000;20843000;71719000;5627000;;9534000;;777000;10311000;78711000;;-17450000;61408000;71719000
MITK;369106;USD;2018;Q4;2018-09-30;2018-12-14;37871000;37871000;17476000;16821000;;37628000;4665000;0;84857000;89522000;127150000;11488000;;20407000;;11349000;31756000;116982000;;-21002000;95394000;127150000
Golf;370220;USD;2018;Q4;2018-12-31;2019-02-28;74828044;76199325;;186114000;361207000;664001000;228388000;;799232000;1027620000;1691621000;258322000;36545000;294867000;346953000;469770000;764637000;910965000;;72946000;926984000;1691621000
Golf;370220;USD;2017;Q4;2017-12-31;2018-03-07;74474619;74829868;;190851000;363962000;687076000;228922000;;817907000;1046829000;1733905000;259700000;47083000;306783000;416970000;573149000;879932000;894801000;;8199000;853973000;1733905000
Golf;370220;USD;2016;Q4;2016-12-31;2017-03-30;57467870;124515059;;177506000;323289000;664531000;239748000;;831892000;1071640000;1736171000;400863000;61245000;462108000;348348000;505240000;967348000;880650000;;-53951000;768823000;1736171000
Golf;370220;USD;2015;Q4;2015-12-31;2016-12-08;21951987;21754197;;192384000;326359000;671523000;254894000;;832556000;1087450000;1758973000;313887000;441704000;755591000;394511000;809876000;1565467000;309132000;;-81647000;193506000;1758973000
VERU;370817;USD;2018;Q4;2018-09-30;2018-12-13;55148495;55148495;3759509;3972632;2302030;11182516;404552;;36865571;37270123;48452639;4791440;;13552927;4455375;5418294;18971221;96071193;-7806605;-58201651;29481418;48452639
VERU;370817;USD;2017;Q4;2017-09-30;2018-01-02;45611348;45611348;3277602;3418738;2767924;10297973;555539;;44482854;45038393;55336366;3292538;;5487581;;1395580;6883161;91104591;-7806605;-34263262;48453205;55336366
VERU;370817;USD;2016;Q4;2016-09-30;2016-12-12;28723931;28598842;2385082;10775200;2492644;16289901;825087;;21508719;22333806;38623707;965906;;3346477;;1343819;4690296;69972750;-7806605;-27651215;33933411;38623707
VERU;370817;USD;2015;Q4;2015-09-30;2015-12-02;28566181;29349558;4105814;14088390;1745180;21585955;1239990;;14645766;15885756;37471711;1669777;;4225008;;113641;4338649;69517126;-7806605;-27995940;33133062;37471711
VERU;370817;USD;2014;Q4;2014-09-30;2014-12-02;28486208;28861931;5796223;2943850;2983447;13072763;1602307;;16998084;18600391;31673154;1561702;;3378210;;229618;3607828;68794476;-7805655;-32341976;28065326;31673154
VERU;370817;USD;2013;Q4;2013-09-30;2013-12-03;28401168;28706008;8922430;2362165;2459417;16888665;2094830;;16186458;18281288;35169953;1866742;;3465018;;301978;3766996;67767426;-7067910;-28715040;31402957;35169953
VERU;370817;USD;2012;Q4;2012-09-30;2012-12-04;28182996;28700763;5295462;7268917;1458199;16826215;2349876;;11270336;13620212;30446427;4740139;;5860441;;367796;6228237;67066407;-6672243;-35594455;24218190;30446427
VERU;370817;USD;2011;Q4;2011-09-30;2011-12-02;27300964;28922715;4249324;2305473;2026528;9746993;1979438;;7716360;9695798;19442791;1446819;;2293410;;396791;2690201;68413872;-6382632;-44697131;16752590;19442791
VERU;370817;USD;2010;Q4;2010-09-30;2011-08-05;27206215;28707640;2918776;4460517;2194330;11791328;2398060;;4178713;6576773;18368101;1031439;;1938433;12999;297538;2235971;67607291;-6349569;-44544073;16132130;18368101
INFU;371010;USD;2015;Q4;2015-12-31;2016-03-09;22519282;23400874;818000;12622000;1916000;18960000;32484000;;44047000;76531000;95491000;6586000;5060000;15287000;29884000;29884000;45171000;91240000;;-40920000;50320000;95491000
INFU;371010;USD;2014;Q4;2014-12-31;2015-03-09;22294898;22841636;515000;10300000;1758000;15458000;24520000;;40235000;64755000;80213000;5215000;6452000;14729000;19032000;19032000;33761000;90157000;;-43705000;46452000;80213000
INFU;371010;USD;2013;Q4;2013-12-31;2014-03-11;21919094;21968861;1138000;10697000;1234000;15883000;18974000;;42516000;61490000;77373000;4736000;5118000;13041000;21609000;21609000;34650000;89785000;;-47062000;42723000;77373000
INFU;371010;USD;2012;Q4;2012-12-31;2013-03-28;21789889;21564053;2326000;8511000;1339000;14831000;16564000;;46128000;62692000;77523000;2144000;3953000;10195000;27315000;27315000;37510000;88744000;;-48731000;40013000;77523000
INFU;371010;USD;2011;Q4;2011-12-31;2012-03-16;21067649;21067649;799000;7350000;1309000;11172000;17672000;;47419000;65091000;76263000;4063000;6576000;13132000;22966000;22966000;36098000;87543000;;-47242000;40165000;76263000
INFU;371010;USD;2010;Q4;2010-12-31;2011-08-15;20267534;16657217;5014000;6679000;1699000;15289000;16672000;;98403000;115075000;130364000;2016000;5551000;12381000;27052000;32840000;45221000;87006000;;-1799000;85143000;130364000
INFU;371010;USD;2016;Q4;2016-12-31;2017-03-22;22682294;21326835;3398000;11581000;2166000;20769000;31675000;;43900000;75575000;96344000;5315000;8252000;16439000;29216000;29216000;45655000;91831000;;-41142000;50689000;96344000
INFU;371010;USD;2017;Q4;2017-12-31;2018-03-19;22782016;22782016;3469000;11385000;1764000;17667000;26569000;;24645000;51214000;68881000;5516000;3544000;12474000;25392000;25454000;37928000;92586000;;-61633000;30953000;68881000
INFU;371010;USD;2018;Q4;2018-12-31;2019-03-22;19495188;19437288;4318000;9593000;2254000;17537000;26534000;;20002000;46536000;64073000;7091000;4903000;14790000;28842000;28842000;43632000;83169000;;-62728000;20441000;64073000
PHX;371566;USD;2016;Q4;2016-12-31;2016-12-12;16859860;16859860;471213;5287229;;6572253;191405651;157322;;191562973;198135226;4070181;;4473793;44500000;81872827;86346620;3471994;-4165672;112482284;111788606;198135226
PHX;371566;USD;2015;Q4;2015-12-31;2015-12-10;16776861;16776861;603915;7895591;;13784184;222792090;2248999;;225041089;238825273;3359647;;4876747;65000000;110028140;114904887;3274057;-4800144;125446473;123920386;238825273
PHX;371566;USD;2014;Q4;2014-12-31;2014-12-10;16743650;16743650;509755;16227469;;19368611;225084293;1936421;251279;227271993;246640604;8849474;;9449574;78000000;121112728;130562302;3142281;-5858167;118794188;116078302;246640604
PHX;371566;USD;2013;Q4;2013-12-31;2013-12-11;16814912;16814912;2867171;13720761;;17805179;127918127;1574642;540482;130033251;147838430;10173491;;10300591;8262256;44638879;54939470;2728362;-6283851;96454449;92898960;147838430
PHX;371566;USD;2012;Q4;2012-12-31;2012-12-11;;;1984099;8349865;;11622845;121617055;1034870;911960;123563885;135186730;7455471;;7627742;14874985;46383002;54010744;2160753;-5806162;84821395;81175986;135186730
PHX;371566;USD;2011;Q4;2011-12-31;2011-12-08;;;3506999;8811404;;13261058;96135963;667504;1359668;98163135;111424193;5939862;;5946962;;29340497;35287459;2065031;-5699860;79771563;76136734;111424193
PHX;371566;USD;2010;Q4;2010-12-31;2011-08-08;;;5597258;9063002;;17358685;86218548;754208;793398;87766154;105124839;6905724;;7259824;;26505146;33764970;1956889;-4196753;73599733;71359869;105124839
PHX;371566;USD;2017;Q4;2017-12-31;2017-12-12;16876929;16876929;557791;7585485;;9989375;196584358;170486;;196754844;206744219;3538019;;3538019;52222000;89958570;93496589;3007382;-3089968;113330216;113247630;206744219
PHX;371566;USD;2018;Q4;2018-12-31;2018-12-11;16908309;16908309;532502;7101629;;8246176;198284401;219109;;198503510;206749686;2673080;;5737126;51000000;75197760;80934886;3106193;-2558338;125266945;125814800;206749686
BL;371763;USD;2017;Q4;2017-12-31;2018-03-08;52928000;52928000;112580000;61918000;;188454000;12769000;;259590000;272359000;460813000;28128000;;134320000;;9188000;143508000;420158000;;-102790000;317305000;460813000
BL;371763;USD;2016;Q4;2016-12-31;2017-03-10;47749686;47749686;105248000;42294000;;163823000;11318000;;245296000;256614000;420437000;26096000;;108464000;;20563000;129027000;378785000;;-87334000;291410000;420437000
BL;371763;USD;2015;Q4;2015-12-31;2016-12-12;40663774;40663774;15205000;24235000;;48487000;12419000;;225844000;238263000;286750000;19660000;;74418000;28267000;46164000;120582000;214578000;-254000;-48156000;166168000;286750000
BL;371763;USD;2018;Q4;2018-12-31;2019-02-28;54679000;54679000;132577000;74902000;;221521000;13536000;;258811000;272347000;493868000;28147000;;159229000;;8683000;167912000;452118000;;-130594000;325956000;493868000
ZEDG;372279;USD;2017;Q4;2017-07-31;2017-10-30;9599000;8402000;4580000;1712000;;7034000;2678000;;2819000;5497000;12531000;1873000;;1909000;;0;1909000;21542000;;-10336000;10622000;12531000
ZEDG;372279;USD;2016;Q4;2016-07-31;2016-10-26;8863000;10034000;5978000;1668000;;7963000;1843000;;2627000;4470000;12433000;1523000;;1837000;;0;1837000;21138000;;-9725000;10596000;12433000
ZEDG;372279;USD;2015;Q4;2015-07-31;2016-06-14;8159000;8935000;2170000;1622000;;3958000;1724000;;2670000;4394000;8352000;1435000;;1808000;;100000;1908000;17807000;;-10708000;6444000;8352000
ZEDG;372279;USD;2018;Q4;2018-07-31;2018-10-29;9938000;9938000;3408000;1777000;;5803000;3344000;;2572000;5916000;11719000;1708000;;1709000;;0;1709000;22611000;;-11899000;10010000;11719000
TTWO;372538;USD;2017;Q4;2018-03-31;2018-05-17;111925000;105326000;1424379000;247649000;15162000;2409177000;102478000;;1226186000;1328664000;3737841000;949777000;;1726929000;8068000;521942000;2248871000;1889366000;-458180000;73516000;1488970000;3737841000
TTWO;372538;USD;2016;Q4;2017-03-31;2017-05-24;105492000;86074000;1392328000;219558000;16323000;2195242000;67300000;;886612000;953912000;3149154000;782767000;;1685892000;251929000;459534000;2145426000;1453952000;-303388000;-99694000;1003728000;3149154000
TTWO;372538;USD;2015;Q4;2016-03-31;2016-05-19;79849000;53394000;1269562000;168527000;15888000;2045276000;77127000;;467874000;545001000;2590277000;637927000;;1220411000;497935000;788481000;2008892000;1089666000;-303388000;-166997000;581385000;2590277000
TTWO;372538;USD;2014;Q4;2015-03-31;2015-05-22;74261000;54630000;1098049000;217860000;20051000;1779859000;69792000;;378422000;448214000;2228073000;483527000;;966260000;473030000;698725000;1664985000;1029243000;-276836000;-158695000;563088000;2228073000
TTWO;372538;USD;2013;Q4;2014-03-31;2014-05-14;120514000;-170174000;935400000;53143000;29780000;1399440000;42572000;;357618000;400190000;1799630000;413625000;;474820000;454031000;523004000;997824000;955751000;-276836000;120775000;801806000;1799630000
TTWO;372538;USD;2012;Q4;2013-03-31;2013-05-14;86176000;60155000;402502000;189596000;30218000;866152000;25362000;;386325000;411687000;1277839000;308848000;;336999000;335202000;352845000;689844000;833397000;;-240830000;587995000;1277839000
TTWO;372538;USD;2011;Q4;2012-03-31;2012-05-23;84414000;84414000;420279000;45035000;22477000;743617000;18949000;;386861000;405810000;1149427000;203449000;;218725000;316340000;334975000;553700000;800333000;;-211339000;595727000;1149427000
TTWO;372538;USD;2010;Q4;2011-03-31;2011-05-25;82172000;56340000;280359000;84217000;24578000;566603000;19632000;;385424000;405056000;971659000;214612000;;230888000;107239000;125492000;356380000;707343000;;-102523000;615279000;971659000
TTWO;372538;USD;2009;Q4;2010-03-31;2010-09-03;;;145838000;74135000;24479000;426600000;23571000;;389105000;412676000;839276000;180362000;;209867000;99865000;108786000;318653000;675317000;;-150981000;520623000;839276000
TTWO;372538;USD;2018;Q4;2019-03-31;2019-05-14;112595000;113975000;1571010000;395729000;28200000;2827835000;127882000;;1287348000;1415230000;4243065000;1108492000;;1951794000;0;250691000;2202485000;2020715000;-820572000;877626000;2040580000;4243065000
TMO;372802;USD;2016;Q4;2016-12-31;2017-02-28;394800000;396800000;786200000;3048500000;2213300000;7021000000;2577800000;;36308700000;38886500000;45907500000;1800300000;1255500000;4865800000;15372400000;19502400000;24368200000;12554700000;-2306000000;13926900000;21539300000;45907500000
TMO;372802;USD;2015;Q4;2015-12-31;2016-02-25;399600000;402700000;452100000;2544900000;1991700000;5741200000;2448800000;;32644300000;35093100000;40834300000;1632900000;1051800000;4146300000;11420200000;15337800000;19484100000;12213100000;-1007900000;12142300000;21350200000;40834300000
TMO;372802;USD;2014;Q4;2014-12-31;2015-02-26;400200000;404000000;1343500000;2473600000;1859500000;6539800000;2426500000;;33885800000;36312300000;42852100000;1654700000;2212400000;5349800000;12351600000;16954200000;22304000000;11882100000;-455900000;10406900000;20548100000;42852100000
TMO;372802;USD;2013;Q4;2013-12-31;2014-02-27;361900000;370700000;5830500000;1942300000;1494500000;9880700000;1767400000;;20215300000;21982700000;31863400000;1123500000;987700000;3126000000;9499600000;11881300000;15007300000;8592200000;-412200000;8753300000;16856100000;31863400000
TMO;372802;USD;2012;Q4;2012-12-31;2013-02-27;358300000;361700000;809900000;1804900000;1443300000;4834800000;1726400000;;20883400000;22609800000;27444600000;1029400000;93100000;2093300000;7031200000;9886600000;11979900000;10914600000;-2996800000;7697300000;15464700000;27444600000
TMO;372802;USD;2011;Q4;2011-12-31;2012-02-29;373200000;376000000;1020600000;1763700000;1330100000;4821900000;1611300000;;20400500000;22011800000;26833700000;936700000;1272800000;3113100000;5755200000;8682500000;11795600000;10558400000;-1837100000;6716300000;15038100000;26833700000
TMO;372802;USD;2010;Q4;2010-12-31;2011-02-24;393600000;399000000;926000000;1473800000;1172900000;4135000000;1360200000;;15854200000;17214400000;21349400000;851200000;105800000;1709800000;2031300000;4278600000;5988400000;10421500000;-490500000;5386400000;15361000000;21349400000
TMO;372802;USD;2009;Q4;2009-12-31;2010-02-26;408700000;422000000;1571200000;1409600000;1131400000;4530900000;1333400000;;15760700000;17094100000;21625000000;848000000;117500000;1639300000;2064000000;4554800000;6194100000;11564600000;-576500000;4350800000;15430900000;21625000000
TMO;372802;USD;2008;Q4;2008-12-31;2009-07-31;418200000;427500000;1288000000;1478100000;1171400000;4345900000;1275300000;;15468800000;16744100000;21090000000;868600000;14800000;1540200000;2003200000;4623300000;6163500000;11723100000;-151300000;3500500000;14926500000;21090000000
TMO;372802;USD;2017;Q4;2017-12-31;2018-02-28;402800000;405000000;1335000000;3879000000;2971000000;9421000000;4047000000;;43201000000;47248000000;56669000000;2346000000;2135000000;7048000000;18873000000;24208000000;31256000000;14605000000;-3103000000;15914000000;25413000000;56669000000
TMO;372802;USD;2018;Q4;2018-12-31;2019-02-27;401000000;406000000;2103000000;4136000000;3005000000;10625000000;4165000000;;41442000000;45607000000;56232000000;2597000000;1271000000;6147000000;17719000000;22499000000;28646000000;15053000000;-3665000000;18696000000;27586000000;56232000000
DE;373449;USD;2017;Q4;2017-10-31;2017-12-18;321300000;325800000;9786500000;3924900000;3904100000;48114300000;11661400000;;6010600000;17672000000;65786300000;8417000000;14154000000;30320500000;25891300000;25891300000;56211800000;4280500000;-15460800000;25301300000;9574500000;65786300000
DE;373449;USD;2016;Q4;2016-10-31;2016-12-19;315000000;316600000;4789300000;3011300000;3340500000;41004900000;11072100000;;5841500000;16913600000;57918500000;7240100000;11908500000;27670700000;23703000000;23703000000;51373700000;3911800000;-15677100000;23911300000;6544800000;57918500000
DE;373449;USD;2015;Q4;2015-10-31;2016-02-01;322800000;324500000;4599600000;3051100000;3817000000;42135800000;10151900000;;5659900000;15811800000;57947600000;7311500000;13016600000;27357200000;23832800000;23832800000;51190000000;3825600000;-15497600000;23144800000;6757600000;57947600000
DE;373449;USD;2014;Q4;2014-10-31;2014-12-19;351600000;354100000;5002100000;3277600000;4209700000;46044400000;9593300000;;5698700000;15292000000;61336400000;8554100000;12577700000;27890200000;24380700000;24380700000;52270900000;3675400000;-12834200000;22004400000;9065500000;61336400000
DE;373449;USD;2013;Q4;2013-10-31;2013-12-16;377600000;381100000;5128800000;3758200000;4934700000;45102700000;8619100000;;5799500000;14418600000;59521300000;8973600000;12898000000;27675900000;21577700000;21577700000;49253600000;3524200000;-10210900000;19645600000;10267700000;59521300000
DE;373449;USD;2012;Q4;2012-10-31;2012-12-17;389500000;394100000;6122600000;3799100000;5170000000;42719000000;7539700000;;6007100000;13546800000;56265800000;8988900000;9967300000;26950700000;22453100000;22453100000;49403800000;3352200000;-8813800000;16875200000;6862000000;56265800000
DE;373449;USD;2011;Q4;2011-10-31;2011-12-19;409700000;413700000;4434500000;3294500000;4370600000;36306700000;6502300000;;5398400000;11900700000;48207400000;7804800000;9629700000;24432600000;16959900000;16959900000;41392500000;3251700000;-7292800000;14519400000;6814900000;48207400000
DE;373449;USD;2010;Q4;2010-10-31;2010-12-17;423500000;428900000;4018500000;3464200000;3063000000;31430600000;5726900000;;6109300000;11836200000;43266800000;6481700000;7534500000;20148900000;16814500000;16814500000;36963400000;3106300000;-5789500000;12353100000;6303400000;43266800000
DE;373449;USD;2009;Q4;2009-10-31;2009-12-17;423100000;425400000;4843700000;2616900000;2397300000;29123900000;6265500000;;5743200000;12008700000;41132600000;5371400000;7158900000;18918100000;17391700000;17391700000;36309800000;2996200000;-5564700000;10980500000;4822800000;41132600000
DE;373449;USD;2008;Q4;2008-10-31;2009-08-28;423600000;427000000;3188800000;3234600000;3041800000;27836600000;5766300000;;5131700000;10898000000;38734600000;6393600000;8520500000;18303400000;13898500000;13898500000;32201900000;2934000000;-5594600000;10580600000;6532700000;38734600000
DE;373449;USD;2018;Q4;2018-10-31;2018-12-17;319900000;329200000;4394100000;5004300000;6148900000;48380000000;13032900000;;8695100000;21728000000;70108000000;10111000000;15018700000;31565400000;27237400000;27237400000;58802800000;4474200000;-16311800000;27553000000;11305200000;70108000000
ULTI;373736;USD;2018;Q4;2018-12-31;2018-08-08;31307000;32085000;188129000;195247000;;1085602000;274841000;;199576000;474417000;1560019000;108115000;6511000;953134000;6346000;19227000;972361000;629509000;-211359000;176521000;587658000;1560019000
ULTI;373736;USD;2017;Q4;2017-12-31;2018-02-26;30027000;31306000;165119000;190989000;;990772000;243664000;;142775000;386439000;1377211000;76493000;5474000;843086000;4477000;16100000;859186000;609508000;-211359000;125788000;518025000;1377211000
ULTI;373736;USD;2016;Q4;2016-12-31;2016-11-08;29207000;30833000;89314000;162240000;;779747000;179558000;8547000;166836000;354941000;1134688000;64492000;5056000;707640000;3985000;12833000;720473000;520864000;-211359000;111733000;414215000;1134688000
ULTI;373736;USD;2015;Q4;2015-12-31;2015-11-05;28759000;30011000;120105000;130106000;;1221206000;125492000;9278000;109593000;244363000;1465569000;49492000;4888000;1120539000;3665000;10964000;1131503000;463942000;-181674000;59627000;334066000;1465569000
ULTI;373736;USD;2014;Q4;2014-12-31;2014-11-07;28439000;29539000;116160000;100218000;;1011218000;86595000;2294000;90191000;179080000;1190298000;38359000;4222000;911220000;3359000;7329000;918549000;376936000;-138525000;36928000;271749000;1190298000
ULTI;373736;USD;2013;Q4;2013-12-31;2013-11-08;28010000;29378000;88476000;85676000;;466768000;58186000;1771000;71469000;131426000;598194000;32462000;5213000;402588000;2240000;7389000;409977000;316012000;-118544000;-7809000;188217000;598194000
ULTI;373736;USD;2012;Q4;2012-12-31;2012-11-09;27211000;28651000;68040000;70774000;;447142000;38068000;1311000;38763000;78142000;525284000;22639000;5279000;399599000;2469000;11015000;410614000;266444000;-118544000;-33339000;114670000;525284000
ULTI;373736;USD;2011;Q4;2011-12-31;2011-11-09;51626406;55586276;53733000;56186000;;252800000;24486000;1546000;39988000;66020000;318820000;17854000;2694000;222624000;2175000;10572000;233196000;242402000;-108750000;-47971000;85624000;318820000
ULTI;373736;USD;2010;Q4;2010-12-31;2011-05-10;50039245;54394177;49773000;47570000;;190265000;18075000;433000;40784000;59292000;249557000;15757000;2551000;162991000;2406000;13581000;176572000;216552000;-91440000;-52253000;72985000;249557000
CTL;373834;USD;2018;Q4;2018-12-31;2019-03-11;1066053000;1053111000;488000000;2398000000;;3820000000;26408000000;;40028000000;66436000000;70256000000;1933000000;652000000;5531000000;35409000000;44897000000;50428000000;23932000000;;-1643000000;19828000000;70256000000
CTL;373834;USD;2017;Q4;2017-12-31;2018-03-01;887892000;889136000;551000000;2557000000;;4194000000;26852000000;;44565000000;71417000000;75611000000;1555000000;443000000;4857000000;37283000000;47263000000;52120000000;24383000000;;1103000000;23491000000;75611000000
CTL;373834;USD;2016;Q4;2016-12-31;2016-11-04;539964000;541237000;222000000;2017000000;;5162000000;17039000000;;24816000000;41855000000;47017000000;1179000000;1503000000;5349000000;18185000000;28269000000;33618000000;15517000000;;-1000000;13399000000;47017000000
CTL;373834;USD;2015;Q4;2015-12-31;2015-11-05;541606000;542491000;126000000;1943000000;;2650000000;18069000000;;26885000000;44954000000;47604000000;968000000;1503000000;4604000000;18722000000;28940000000;33544000000;15722000000;;272000000;14060000000;47604000000
CTL;373834;USD;2014;Q4;2014-12-31;2014-11-06;565325000;567036000;128000000;1988000000;;2696000000;18433000000;;27974000000;46407000000;49103000000;1226000000;550000000;3918000000;19953000000;30162000000;34080000000;16893000000;;147000000;15023000000;49103000000
CTL;373834;USD;2013;Q4;2013-12-31;2013-11-08;585256000;582305000;168000000;1977000000;;3907000000;18646000000;;29234000000;47880000000;51787000000;1111000000;785000000;4409000000;20181000000;30187000000;34596000000;17927000000;;66000000;17191000000;51787000000
CTL;373834;USD;2012;Q4;2012-12-31;2012-11-08;621577000;623655000;211000000;1917000000;;3638000000;18909000000;;31393000000;50302000000;53940000000;1207000000;1205000000;4595000000;19400000000;30056000000;34651000000;19705000000;;1285000000;19289000000;53940000000
CTL;373834;USD;2011;Q4;2011-12-31;2011-11-07;616127000;618060000;128000000;1950000000;;3517000000;19444000000;;33083000000;52527000000;56044000000;1400000000;480000000;4017000000;21356000000;31200000000;35217000000;19520000000;;2319000000;20827000000;56044000000
CTL;373834;USD;2010;Q4;2010-12-31;2010-11-08;601416587;602897003;173000000;713000000;;1143000000;8754000000;;12141000000;20895000000;22038000000;300000000;12000000;1011000000;7316000000;11380000000;12391000000;6486000000;;3302000000;9647000000;22038000000
CTL;373834;USD;2009;Q4;2009-12-31;2010-11-08;298578000;299230000;161807000;685589000;35755000;1123591000;9097139000;;12341999000;21439138000;22562729000;394687000;7753718000;8960848000;;4135082000;13095930000;6313240000;;3232769000;9466799000;22562729000
SOFO;374032;USD;2016;Q4;2016-09-30;2016-12-22;4411522;4411522;1794000;11646000;1904000;16748000;2031000;;14379000;16410000;33158000;2844000;1943000;19393000;1102000;7249000;26642000;197108000;-169000;-190214000;6516000;33158000
SOFO;374032;USD;2015;Q4;2015-09-30;2015-12-10;4354859;4354859;1976000;12659000;2385000;17947000;2808000;;14048000;16856000;34803000;3692000;1696000;18565000;2368000;8435000;27000000;196017000;-169000;-186897000;7803000;34803000
SOFO;374032;USD;2014;Q4;2014-09-30;2014-12-17;4250650;4103893;4344000;8449000;1960000;16058000;3396000;;15169000;18565000;34623000;3695000;3266000;16040000;1626000;7268000;23308000;194303000;-169000;-182372000;11315000;34623000
SOFO;374032;USD;2013;Q4;2013-09-30;2013-12-26;3984613;3938214;3482000;6885000;1447000;12619000;3280000;385000;8049000;11714000;24333000;2717000;857000;10044000;282000;3585000;13629000;190693000;-169000;-179556000;10704000;24333000
SOFO;374032;USD;2012;Q4;2012-09-30;2012-12-12;3879537;4038546;4478000;5578000;1053000;11866000;2944000;420000;7591000;10955000;22821000;2454000;796000;8534000;897000;3748000;12282000;189498000;-169000;-178764000;10539000;22821000
SOFO;374032;USD;2011;Q4;2011-09-30;2011-11-22;3821264;3407593;5515000;5799000;536000;12590000;1636000;;7614000;9250000;21840000;2974000;986000;9507000;871000;3072000;12579000;188377000;-169000;-178921000;9261000;21840000
SOFO;374032;USD;2010;Q4;2010-09-30;2011-08-02;3632861;3632861;3358000;5038000;541000;9370000;1237000;;7660000;8897000;18267000;1890000;552000;7928000;1040000;3202000;11130000;186010000;-169000;-178678000;7137000;18267000
SOFO;374032;USD;2017;Q4;2017-09-30;2018-01-12;4458160;4458160;1211000;7903000;986000;12258000;1750000;;14348000;16098000;28356000;2701000;993000;17091000;367000;8147000;25238000;197881000;-169000;-195253000;3118000;28356000
SOFO;374032;USD;2018;Q4;2018-09-30;2019-03-15;4993179;4938432;1189000;7418000;1027000;10825000;1913000;;845000;2758000;13583000;3219000;841000;16590000;1544000;3451000;20041000;200181000;-169000;-207419000;-6458000;13583000
ALJJ;374775;USD;2016;Q4;2016-09-30;2016-12-23;35347788;36650313;5279000;44288000;8873000;63984000;51811000;;99515000;151326000;215310000;24505000;2046000;42151000;91371000;99212000;141363000;270716000;;-196769000;73947000;215310000
ALJJ;374775;USD;2015;Q4;2015-09-30;2016-05-16;36195000;33164000;5103000;35078000;6173000;52091000;50260000;;99934000;150194000;202285000;17983000;830000;29640000;96285000;108259000;137899000;272351000;-271000;-207694000;64386000;202285000
ALJJ;374775;USD;2017;Q4;2017-09-30;2017-12-19;36543000;37224000;5630000;49457000;9376000;70246000;54335000;;114548000;168883000;239129000;28453000;2571000;49706000;86762000;93670000;143376000;276849000;;-181096000;95753000;239129000
ALJJ;374775;USD;2018;Q4;2018-09-30;2018-12-17;38015000;38015000;2000000;46383000;7656000;61765000;60162000;;109541000;169703000;231468000;27267000;2909000;43953000;87816000;95987000;139940000;279956000;;-188428000;91528000;231468000
VSM;375160;USD;2017;Q4;2017-09-30;2017-11-22;108600000;109600000;271400000;145300000;151600000;606900000;330300000;;309600000;639900000;1246800000;152200000;5800000;158000000;977000000;1064200000;1222200000;113600000;;-105200000;24600000;1246800000
VSM;375160;USD;2016;Q4;2016-09-30;2016-12-21;108700000;108700000;105600000;130000000;127400000;468000000;296500000;;279300000;575800000;1043800000;98500000;5800000;104300000;980300000;915600000;1019900000;0;;0;23900000;1043800000
VSM;375160;USD;2015;Q4;2015-09-30;2016-12-21;;;17800000;127100000;124000000;295000000;301100000;;291300000;592400000;887400000;89600000;0;89600000;0;57100000;146700000;;;741500000;740700000;887400000
VSM;375160;USD;2018;Q4;2018-09-30;2018-11-21;108900000;110000000;399800000;184400000;177100000;813100000;405100000;;287100000;692200000;1505300000;181900000;5800000;187700000;974200000;1105200000;1292900000;115100000;;81600000;212400000;1505300000
HRL;375369;USD;2016;Q4;2016-10-31;2016-12-21;528740000;541223000;415143000;591310000;985683000;2029912000;1105449000;;3234706000;4340155000;6370067000;1053196000;;1053196000;250000000;865465000;1918661000;7742000;;4736567000;4451406000;6370067000
HRL;375369;USD;2015;Q4;2015-10-31;2015-12-16;528648000;541793000;347239000;605689000;993265000;2063032000;1011739000;;3065060000;4076799000;6139831000;1029025000;185000000;1214025000;250000000;924413000;2138438000;7741000;;4216125000;4001393000;6139831000
HRL;375369;USD;2014;Q4;2014-10-31;2014-12-17;527174000;539656000;334174000;609526000;1054552000;2132771000;1001767000;;2321081000;3322848000;5455619000;954692000;;954692000;250000000;888871000;1843563000;7724000;;3805654000;3612056000;5455619000
HRL;375369;USD;2013;Q4;2013-10-31;2013-12-18;527702000;540414000;434014000;551500000;967977000;2047413000;955333000;;1913134000;2868467000;4915880000;784009000;;784009000;250000000;815292000;1599301000;7725000;;3452529000;3316579000;4915880000
HRL;375369;USD;2012;Q4;2012-10-31;2012-12-19;525898000;536298000;759775000;507041000;950521000;2320684000;924480000;;1318802000;2243282000;4563966000;786300000;;786300000;250000000;952741000;1739041000;7707000;;3135317000;2824925000;4563966000
HRL;375369;USD;2011;Q4;2011-10-31;2011-12-21;529768000;540628000;539207000;461110000;885823000;1998231000;907090000;;1339070000;2246160000;4244391000;778186000;;778186000;250000000;806389000;1584575000;7734000;;2824331000;2659816000;4244391000
HRL;375369;USD;2010;Q4;2010-10-31;2010-12-21;532324000;541194000;518440000;430939000;793771000;1858166000;922103000;;1273649000;2195752000;4053918000;751213000;350000000;1101213000;;546066000;1647279000;7793000;;2568774000;2406639000;4053918000
HRL;375369;USD;2009;Q4;2009-10-31;2010-09-03;536020000;542804000;385252000;372292000;722371000;1574733000;952713000;;1164609000;2117322000;3692055000;685029000;0;685029000;350000000;882705000;1567734000;7828000;;2318390000;2124321000;3692055000
HRL;375369;USD;2017;Q4;2017-10-31;2017-12-20;527990000;537951000;444122000;618351000;921022000;2026523000;1203251000;;3746134000;4949385000;6975908000;1058212000;;1058212000;250000000;977999000;2036211000;21411000;;5162571000;4939697000;6975908000
HRL;375369;USD;2018;Q4;2018-10-31;2018-12-07;533110000;545421000;459136000;600438000;963527000;2050100000;1512600000;;4579592000;6092192000;8142292000;1138914000;;1138914000;624840000;1398560000;2537474000;114353000;;5729956000;5604818000;8142292000
COTY;376164;USD;2018;Q4;2018-06-30;2018-08-21;750500000;747400000;331600000;1536000000;1148900000;3651000000;1680800000;;17298400000;18979200000;22630200000;3825100000;218900000;4044000000;7305400000;9069700000;13113700000;10758900000;-1441800000;-626200000;9516500000;22630200000
COTY;376164;USD;2017;Q4;2017-06-30;2017-08-23;741000000;735200000;535400000;1470300000;1052600000;3581500000;1632100000;;17334600000;18966700000;22548200000;3594500000;209100000;3803600000;6928300000;8875800000;12679400000;11211300000;-1441800000;-459200000;9868800000;22548200000
COTY;376164;USD;2016;Q4;2016-06-30;2016-05-03;339100000;354700000;372400000;682900000;565800000;1938400000;638600000;;4458600000;5097200000;7035600000;1688500000;161800000;1855200000;3936400000;4740000000;6595200000;2042400000;-1405500000;-37000000;440400000;7035600000
COTY;376164;USD;2015;Q4;2015-06-30;2015-05-07;360900000;369900000;341300000;679600000;557800000;1856400000;500200000;;3662300000;4162500000;6018900000;1490000000;28800000;1526200000;2605900000;3421700000;4947900000;2048300000;-610600000;-193900000;1071000000;6018900000
COTY;376164;USD;2014;Q4;2014-06-30;2014-05-14;374400000;356000000;1238000000;664800000;617400000;2784800000;540300000;;3267400000;3807700000;6592500000;1563200000;33400000;1597300000;3260100000;4034600000;5631900000;1930700000;-575400000;-426400000;960600000;6592500000
COTY;376164;USD;2013;Q4;2013-06-30;2013-11-08;383100000;395400000;920400000;622700000;608200000;2416900000;500700000;;3552400000;4053100000;6470000000;1417600000;40100000;1463200000;2590100000;3391300000;4854500000;1947700000;-6100000;-329000000;1615500000;6470000000
COTY;376164;USD;2019;Q4;2019-06-30;2019-08-28;751500000;751500000;340400000;1161200000;1153300000;3272700000;1600600000;;12792100000;14392700000;17665400000;3283300000;193800000;3477100000;7469900000;9143100000;12620200000;10628600000;-1441800000;-4541200000;5045200000;17665400000
AVGO_old;378100;USD;2015;Q4;2015-10-31;2015-12-17;278000000;275000000;1822000000;1019000000;524000000;3775000000;1460000000;;5357000000;6817000000;10592000000;617000000;46000000;1119000000;3903000000;4759000000;5878000000;2547000000;;2240000000;4714000000;10592000000
AVGO_old;378100;USD;2014;Q4;2014-10-31;2014-12-29;252000000;303000000;1604000000;782000000;519000000;3835000000;1158000000;;5498000000;6656000000;10491000000;515000000;46000000;1016000000;4543000000;6232000000;7248000000;2009000000;;1284000000;3243000000;10491000000
AVGO_old;378100;USD;2013;Q4;2013-10-31;2013-12-20;248000000;254000000;985000000;418000000;285000000;1818000000;661000000;;936000000;1597000000;3415000000;278000000;0;414000000;0;115000000;529000000;1587000000;;1305000000;2886000000;3415000000
AVGO_old;378100;USD;2012;Q4;2012-10-31;2012-12-17;246000000;250000000;1084000000;341000000;194000000;1691000000;503000000;;668000000;1171000000;2862000000;248000000;1000000;346000000;2000000;97000000;443000000;1479000000;;951000000;2419000000;2862000000
AVGO_old;378100;USD;2011;Q4;2011-10-31;2011-12-16;247000000;253000000;829000000;328000000;194000000;1393000000;316000000;;737000000;1053000000;2446000000;221000000;2000000;350000000;4000000;90000000;440000000;1479000000;;525000000;2006000000;2446000000
AVGO_old;378100;USD;2010;Q4;2010-10-31;2011-03-10;239000000;247000000;561000000;285000000;189000000;1087000000;281000000;;789000000;1070000000;2157000000;210000000;232000000;565000000;4000000;87000000;652000000;1450000000;;59000000;1505000000;2157000000
CHRW;378101;USD;2016;Q4;2016-12-31;2017-03-01;141690000;142207000;247666000;1711191000;;2008102000;232953000;;1446703000;1679656000;3687758000;925559000;740000000;1845718000;500000000;584193000;2429911000;433406000;-2304695000;3190578000;1257847000;3687758000
CHRW;378101;USD;2015;Q4;2015-12-31;2016-02-29;143571000;144552000;168229000;1505620000;;1730698000;190874000;;1262786000;1453660000;3184358000;765633000;450000000;1448597000;500000000;585311000;2033908000;393789000;-2128013000;2922620000;1150450000;3184358000
CHRW;378101;USD;2014;Q4;2014-12-31;2015-03-02;145819000;146330000;128940000;1571591000;;2105459000;152471000;;956408000;1108879000;3214338000;766635000;605000000;1575860000;500000000;591463000;2167323000;336614000;-1909528000;2648539000;1047015000;3214338000
CHRW;378101;USD;2013;Q4;2013-12-31;2014-03-03;150281000;150669000;162047000;1449581000;;1664485000;160703000;;977630000;1138333000;2802818000;740617000;375000000;1269981000;500000000;593113000;1863094000;232914000;-1696403000;2413833000;939724000;2802818000
CHRW;378101;USD;2012;Q4;2012-12-31;2013-03-01;160866000;161558000;210019000;1412136000;;1672290000;149851000;;982084000;1131935000;2804225000;807212000;253646000;1232217000;0;67636000;1299853000;319612000;-1024124000;2218229000;1504372000;2804225000
CHRW;378101;USD;2011;Q4;2011-12-31;2012-02-29;162777000;163535000;373669000;1189637000;;1611543000;126830000;;399668000;526498000;2138041000;697029000;0;876632000;;12935000;889567000;222138000;-809581000;1845032000;1248474000;2138041000
CHRW;378101;USD;2010;Q4;2010-12-31;2011-03-01;164756000;165972000;407897000;1036070000;;1481768000;114333000;;399598000;513931000;1995699000;615016000;;771607000;;20024000;791631000;194692000;-598111000;1613912000;1204068000;1995699000
CHRW;378101;USD;2009;Q4;2009-12-31;2010-03-01;166477000;167719000;385618000;885543000;;1307269000;117699000;;409280000;526979000;1834248000;563694000;;731807000;;22541000;754348000;181814000;-502584000;1402306000;1079900000;1834248000
CHRW;378101;USD;2008;Q4;2008-12-31;2009-08-10;167928000;171224000;497387000;828884000;;1347871000;104088000;;363762000;467850000;1815721000;520631000;;697653000;;10847000;708500000;194530000;-296902000;1207428000;1107221000;1815721000
CHRW;378101;USD;2017;Q4;2017-12-31;2018-02-28;139473000;141061000;333890000;2113930000;;2510936000;230326000;;1494572000;1724898000;4235834000;1070774000;715000000;1987449000;750000000;822640000;2810089000;458234000;-2451122000;3437093000;1425745000;4235834000
CHRW;378101;USD;2018;Q4;2018-12-31;2019-02-25;137747000;139579000;378615000;2162438000;;2753074000;228301000;;1446037000;1674338000;4427412000;1062793000;5000000;1433323000;1341352000;1399002000;2832325000;535214000;-2713785000;3845593000;1595087000;4427412000
COG;378102;USD;2016;Q4;2016-12-31;2017-02-27;465330000;465330000;498542000;191045000;13304000;715881000;4250125000;;156563000;4406688000;5122569000;217553000;0;257812000;1520530000;2297090000;2554902000;1774814000;-306835000;1098703000;2567667000;5122569000
COG;378102;USD;2015;Q4;2015-12-31;2016-02-22;413881000;412454000;514000;120229000;17049000;144786000;4976879000;;131373000;5108252000;5253038000;215552000;20000000;235552000;1996139000;3008298000;3243850000;764374000;-306835000;1552014000;2009188000;5253038000
COG;378102;USD;2014;Q4;2014-12-31;2015-02-27;412996000;414706000;20954000;235397000;14026000;413447000;4925711000;;98558000;5024269000;5437716000;463745000;0;499018000;1752000000;2795965000;3294983000;752724000;-306835000;1698995000;2142733000;5437716000
COG;378102;USD;2013;Q4;2013-12-31;2014-02-28;418768000;419805000;23400000;222476000;17468000;378899000;4546227000;;55954000;4602181000;4981080000;393993000;;407905000;1147000000;2368573000;2776478000;753141000;-167983000;1627805000;2204602000;4981080000
COG;378102;USD;2012;Q4;2012-12-31;2013-02-28;419708000;421554000;30736000;172419000;14173000;270310000;4310977000;;35026000;4346003000;4616313000;363744000;75000000;444139000;1012000000;2040727000;2484866000;737652000;-3349000;1373264000;2131447000;4616313000
COG;378102;USD;2011;Q4;2011-12-31;2012-02-28;417212000;421620000;29911000;114381000;21278000;345800000;3934584000;;51109000;3985693000;4331493000;288212000;;343344000;950000000;1883381000;2226725000;745279000;-3349000;1258291000;2104768000;4331493000
COG;378102;USD;2010;Q4;2010-12-31;2011-02-28;415928000;422452000;55949000;94488000;29667000;203008000;3762760000;;39263000;3802023000;4005031000;303835000;;303835000;975000000;1828496000;2132331000;731341000;-3349000;1148391000;1872700000;4005031000
COG;378102;USD;2009;Q4;2009-12-31;2010-02-26;414623536;419551952;40158000;80362000;27990000;281502000;3358199000;;43700000;3401899000;3683401000;273637000;;308741000;805000000;1562146000;1870887000;715955000;-3349000;1057472000;1812514000;3683401000
COG;378102;USD;2008;Q4;2008-12-31;2009-07-30;413496000;416804000;28101000;109087000;45677000;460551000;3135828000;;105285000;3241113000;3701664000;279071000;35857000;378913000;831143000;1532189000;1911102000;685924000;-3349000;921561000;1790562000;3701664000
COG;378102;USD;2017;Q4;2017-12-31;2018-03-01;462326000;463791000;480047000;216004000;8006000;764957000;3072204000;;890183000;3962387000;4727344000;293061000;304000000;627698000;1217891000;1575741000;2203439000;1789974000;-430576000;1162430000;2523905000;4727344000
COG;378102;USD;2018;Q4;2018-12-31;2019-02-26;430610000;432499000;2287000;362403000;11076000;544545000;3463606000;;190678000;3654284000;4198829000;287264000;0;287264000;1226104000;1823406000;2110670000;1810752000;-1334688000;1607658000;2088159000;4198829000
HSIC;378104;USD;2018;Q4;2018-12-31;2019-02-20;25409200;25863425;56885000;1168776000;1415512000;4175220000;314221000;420367000;3590719000;4325307000;8500527000;940369000;8280000;3218827000;980344000;1427756000;4646583000;1514000;;3208589000;3853944000;8500527000
HSIC;378104;USD;2017;Q4;2017-12-31;2018-02-21;197331750;198551925;174658000;1522807000;1933803000;4086020000;375001000;432002000;2970972000;3777975000;7863995000;1341885000;16659000;2828975000;907756000;1378472000;4207447000;1537000;;2940029000;3656548000;7863995000
HSIC;378104;USD;2016;Q4;2016-12-31;2016-11-02;202362900;205173000;62381000;1254139000;1665750000;3342780000;333906000;442790000;2640920000;3417616000;6760396000;1158999000;65923000;2320646000;715457000;1031310000;3351956000;128330000;;2981777000;3408440000;6760396000
HSIC;378104;USD;2015;Q4;2015-12-31;2015-11-04;209699250;212802600;72086000;1229816000;1509957000;3231100000;318476000;454600000;2500564000;3273640000;6504740000;1167558000;17331000;2146997000;463752000;928735000;3075732000;208198000;;2895997000;3429008000;6504740000
HSIC;378104;USD;2014;Q4;2014-12-31;2014-11-06;213019350;216780600;89474000;1127517000;1327796000;2913166000;311496000;386286000;2527859000;3225641000;6138807000;1012158000;5815000;1780111000;542776000;977724000;2757835000;266203000;;2642523000;3380972000;6138807000
HSIC;378104;USD;2013;Q4;2013-12-31;2013-11-05;216836700;220126200;188616000;1055216000;1250403000;2834665000;275888000;461945000;2052138000;2789971000;5624636000;969656000;5441000;1550663000;450233000;788433000;2339096000;319081000;;2398267000;3285540000;5624636000
HSIC;378104;USD;2012;Q4;2012-12-31;2012-11-07;218853750;225486300;122080000;1015194000;1203507000;2704377000;273458000;292934000;2063228000;2629620000;5333997000;920432000;17992000;1472709000;488121000;810249000;2282958000;376825000;;2183905000;3051039000;5333997000
HSIC;378104;USD;2011;Q4;2011-12-31;2011-11-01;226562400;232060200;147284000;888248000;947849000;2272508000;262088000;298828000;1906720000;2467636000;4740144000;742702000;22819000;1271640000;363524000;632831000;1904471000;402161000;;2007477000;2835673000;4740144000
HSIC;378104;USD;2010;Q4;2010-12-31;2010-10-29;230859150;239008950;150348000;885784000;870206000;2169302000;252573000;295334000;1830262000;2378169000;4547471000;681610000;4487000;1168087000;395309000;662287000;1830374000;601933000;;1779178000;2717097000;4547471000
HSIC;378104;USD;2009;Q4;2009-12-31;2010-08-02;905814751;922978294;471154000;725397000;775199000;2203533000;259576000;182036000;1190840000;1632452000;3835985000;607113000;23560000;1076254000;243373000;598223000;1674477000;604678000;;1492607000;2161508000;3835985000
CBG;378105;USD;2016;Q4;2016-12-31;2017-03-01;336819521;339622404;762576000;2605602000;;5122450000;560756000;;5096381000;5657137000;10779587000;3168032000;1254680000;4525429000;2548126000;3196913000;7722342000;1148599000;;2656906000;3057245000;10779587000
CBG;378105;USD;2015;Q4;2015-12-31;2016-02-29;333803875;337244433;540403000;2471740000;;5305223000;529823000;;5182897000;5712720000;11017943000;3138277000;1785225000;4994157000;2645111000;3264716000;8258873000;1110100000;;2088227000;2759070000;11017943000
CBG;378105;USD;2014;Q4;2014-12-31;2015-03-02;331893312;335124851;740884000;1736229000;;3371769000;497926000;;3698315000;4196241000;7568010000;2293333000;548457000;2928765000;1808605000;2337847000;5266612000;1042755000;;1541095000;2301398000;7568010000
CBG;378105;USD;2013;Q4;2013-12-31;2014-03-03;329949011;332556277;491912000;1486489000;;2879812000;458596000;56800000;3603206000;4118602000;6998414000;1927737000;559342000;2605740000;1798435000;2456668000;5062408000;985316000;;1056592000;1936006000;6998414000
CBG;378105;USD;2012;Q4;2012-12-31;2013-03-01;325406715;329046699;1089976000;1262823000;;4084550000;379176000;57121000;3288695000;3724992000;7809542000;1562629000;1172517000;2972293000;2354449000;3155437000;6127730000;964201000;;740054000;1681812000;7809542000
CBG;378105;USD;2011;Q4;2011-12-31;2012-02-29;320687650;324166446;1095972000;1135371000;;3550047000;295488000;34605000;3339003000;3669096000;7219143000;1545820000;826041000;2680648000;2404848000;3121332000;5801980000;885421000;;424499000;1417163000;7219143000
CBG;378105;USD;2010;Q4;2010-12-31;2011-03-01;315911521;325409322;509592000;940167000;;2260870000;188397000;31936000;2640365000;2860698000;5121568000;1265797000;509453000;1956768000;1390236000;2099005000;4055773000;817480000;;185337000;1065795000;5121568000
CBG;378105;USD;2009;Q4;2009-12-31;2010-08-09;298803851;309337043;742422000;775929000;;2266725000;178975000;32016000;2561690000;2772681000;5039406000;977490000;478454000;1629041000;1982121000;2626070000;4255111000;759207000;;-15008000;784295000;5039406000
CBG;378105;USD;2017;Q4;2017-12-31;2018-03-01;338800759;341374611;751774000;3112289000;;5630584000;617739000;;5470073000;6087812000;11718396000;3627085000;910790000;4712944000;1999603000;2830838000;7543782000;1223903000;;3443007000;4174614000;11718396000
CBG;378105;USD;2018;Q4;2018-12-31;2019-03-01;339835254;342695694;777219000;3668591000;;6754210000;721692000;;5980891000;6702583000;13456793000;4298501000;1331907000;5803380000;1767260000;2643511000;8446891000;1152382000;;4504684000;5009902000;13456793000
CBS;378106;USD;2016;Q4;2016-12-31;2017-02-17;424000000;427000000;598000000;3314000000;1427000000;6063000000;1241000000;;16934000000;18175000000;24238000000;1439000000;473000000;3708000000;8902000000;16841000000;20549000000;43914000000;-20201000000;-19257000000;3689000000;24238000000
CBS;378106;USD;2015;Q4;2015-12-31;2016-02-16;;;317000000;3375000000;1270000000;5747000000;1253000000;;16765000000;18018000000;23765000000;1398000000;222000000;3560000000;8226000000;14642000000;18202000000;44056000000;-17205000000;-20518000000;5563000000;23765000000
CBS;378106;USD;2014;Q4;2014-12-31;2015-02-13;;;428000000;3459000000;922000000;5485000000;1433000000;;17017000000;18450000000;23935000000;1644000000;636000000;4033000000;6476000000;12932000000;16965000000;44042000000;-14406000000;-21931000000;6970000000;23935000000
CBS;378106;USD;2013;Q4;2013-12-31;2014-02-14;;;368000000;3234000000;772000000;5370000000;1461000000;;19556000000;21017000000;26387000000;1709000000;495000000;4207000000;5940000000;12214000000;16421000000;43475000000;-8074000000;-24890000000;9966000000;26387000000
CBS;378106;USD;2012;Q4;2012-12-31;2012-11-07;;;708000000;3137000000;859000000;5720000000;2271000000;;18475000000;20746000000;26466000000;1851000000;18000000;3941000000;5904000000;12312000000;16253000000;43425000000;-5874000000;-26769000000;10213000000;26466000000
CBS;378106;USD;2011;Q4;2011-12-31;2012-02-23;;;660000000;3254000000;735000000;5543000000;2510000000;;18144000000;20654000000;26197000000;1390000000;24000000;3933000000;5958000000;12356000000;16289000000;43396000000;-4706000000;-28343000000;9908000000;26197000000
CBS;378106;USD;2010;Q4;2010-12-31;2011-02-25;;;480000000;3248000000;751000000;5395000000;2694000000;;18054000000;20748000000;26143000000;2061000000;27000000;4026000000;5973000000;12296000000;16322000000;43444000000;-3689000000;-29648000000;9821000000;26143000000
CBS;378106;USD;2009;Q4;2009-12-31;2010-02-25;;;716700000;2900200000;1085000000;5636900000;2858700000;;18466400000;21325100000;26962000000;2171800000;443600000;4746500000;6553300000;13196100000;17942600000;43479900000;-3693400000;-30371700000;9019300000;26961900000
CBS;378106;USD;2008;Q4;2008-12-31;2009-08-06;;;419500000;2749900000;1027300000;5215900000;3008300000;;18856700000;21865000000;27080900000;2508200000;21300000;4800900000;6974800000;13682700000;18483600000;43495700000;-3693400000;-30598200000;8597200000;27080800000
CBS;378106;USD;2017;Q4;2017-12-31;2018-02-20;388000000;396000000;285000000;3697000000;1828000000;6273000000;1280000000;;13290000000;14570000000;20843000000;1525000000;698000000;3972000000;9464000000;14893000000;18865000000;43798000000;-22258000000;-18900000000;1978000000;20843000000
CBS;378106;USD;2018;Q4;2018-12-31;2019-02-15;373000000;378000000;322000000;4041000000;1988000000;6752000000;1209000000;;13898000000;15107000000;21859000000;1773000000;687000000;4573000000;9465000000;14482000000;19055000000;43638000000;-22858000000;-17201000000;2804000000;21859000000
CNC;378107;USD;2015;Q4;2015-12-31;2016-02-22;238988256;247192586;1936000000;;;3605000000;518000000;1927000000;1289000000;3734000000;7339000000;1183000000;5000000;3629000000;1216000000;1386000000;5015000000;956000000;-147000000;1358000000;2324000000;7339000000
CNC;378107;USD;2014;Q4;2014-12-31;2015-02-23;235341940;243840100;1787000000;;;2951000000;445000000;1280000000;1148000000;2873000000;5824000000;1004000000;5000000;2900000000;874000000;1033000000;3933000000;840000000;-98000000;1003000000;1891000000;5824000000
CNC;378107;USD;2013;Q4;2013-12-31;2014-02-21;219761460;228748192;1076000000;;;1800000000;395000000;792000000;542000000;1729000000;3529000000;376000000;3000000;1559000000;666000000;727000000;2286000000;594000000;-89000000;732000000;1243000000;3529000000
CNC;378107;USD;2012;Q4;2012-12-31;2013-02-19;207244140;224104660;884034000;;;1405825000;375893000;554770000;437417000;1368080000;2773905000;219066000;3373000;1229313000;535481000;590825000;1820138000;450911000;-69864000;566820000;953767000;2773905000
CNC;378107;USD;2011;Q4;2011-12-31;2012-02-21;202131288;211901868;704197000;;;940010000;349622000;506140000;394564000;1250326000;2190336000;216504000;3234000;837613000;348344000;416304000;1253917000;422035000;-57123000;564961000;936419000;2190336000
CNC;378107;USD;2010;Q4;2010-12-31;2011-02-22;197540464;204901396;455512000;;;656821000;326341000;595879000;364841000;1287061000;1943882000;188320000;2817000;765246000;327824000;381581000;1146827000;384258000;-50486000;453743000;797055000;1943882000
CNC;378107;USD;2009;Q4;2009-12-31;2010-07-27;172275484;178097636;443306000;;;616134000;230421000;525497000;330312000;1086230000;1702364000;132001000;646000;715908000;307085000;367029000;1082937000;281852000;-47262000;358907000;619427000;1702364000
CNC;378107;USD;2016;Q4;2016-12-31;2017-02-21;342787974;364535198;4435000000;;;8365000000;797000000;4545000000;6490000000;11832000000;20197000000;4377000000;4000000;8623000000;4651000000;5520000000;14143000000;4190000000;-179000000;1920000000;6054000000;20197000000
CNC;378107;USD;2017;Q4;2017-12-31;2018-02-20;345538064;355273420;4603000000;;;8703000000;1104000000;5312000000;6736000000;13152000000;21855000000;4714000000;4000000;9332000000;4695000000;5647000000;14979000000;4349000000;-244000000;2748000000;6876000000;21855000000
CNC;378107;USD;2018;Q4;2018-12-31;2019-02-19;411524000;420698000;6064000000;;;11998000000;1706000000;6861000000;10336000000;18903000000;30901000000;4717000000;38000000;11971000000;6648000000;7907000000;19878000000;7449000000;-139000000;3663000000;11023000000;30901000000
CNP;378108;USD;2015;Q4;2015-12-31;2016-02-26;430268000;427542000;1069000000;593000000;347000000;2689000000;11537000000;;7064000000;18601000000;21290000000;641000000;904000000;2458000000;5590000000;15371000000;17829000000;4184000000;;-657000000;3461000000;21290000000
CNP;378108;USD;2014;Q4;2014-12-31;2015-02-26;429804000;433131000;1228000000;837000000;379000000;3268000000;10502000000;;9430000000;19932000000;23200000000;877000000;848000000;2792000000;5335000000;15860000000;18652000000;;;;4548000000;23200000000
CNP;378108;USD;2013;Q4;2013-12-31;2014-02-26;428704000;432627000;975000000;851000000;285000000;2658000000;9593000000;;9619000000;19212000000;21870000000;873000000;540000000;3019000000;4771000000;14522000000;17541000000;;;;4329000000;21870000000
CNP;378108;USD;2012;Q4;2012-12-31;2013-02-27;427502000;431072000;1186000000;768000000;322000000;2874000000;13597000000;;6400000000;19997000000;22871000000;721000000;1438000000;3575000000;4957000000;14995000000;18570000000;;;;4301000000;22871000000
CNP;378108;USD;2011;Q4;2011-12-31;2012-02-29;426003000;430355000;606000000;773000000;353000000;2337000000;12402000000;;6964000000;19366000000;21703000000;767000000;546000000;2593000000;6426000000;14888000000;17481000000;;;;4222000000;21703000000
CNP;378108;USD;2010;Q4;2010-12-31;2011-03-30;424336000;429065000;566000000;835000000;375000000;2582000000;11732000000;;5797000000;17529000000;20111000000;823000000;481000000;2620000000;6479000000;14293000000;16913000000;;;;3198000000;20111000000
CNP;378108;USD;2009;Q4;2009-12-31;2010-02-26;1113915278;1121723274;1040000000;790000000;327000000;2904000000;10788000000;;6081000000;16869000000;19773000000;796000000;958000000;3038000000;6314000000;14096000000;17134000000;;;;2639000000;19773000000
CNP;378108;USD;2008;Q4;2008-12-31;2009-08-05;;;385000000;1009000000;569000000;3035000000;10296000000;;6345000000;16641000000;19676000000;1086000000;502000000;2848000000;7800000000;14806000000;17654000000;;;;2022000000;19676000000
CNP;378108;USD;2016;Q4;2016-12-31;2017-02-28;430682000;437769000;1294000000;740000000;312000000;2923000000;12307000000;;6599000000;18906000000;21829000000;829000000;1060000000;3080000000;5665000000;15289000000;18369000000;4199000000;;-668000000;3460000000;21829000000
CNP;378108;USD;2017;Q4;2017-12-31;2018-02-22;431040000;436001000;1220000000;1000000000;397000000;3395000000;13057000000;;6284000000;19341000000;22736000000;1264000000;645000000;3069000000;6761000000;14979000000;18048000000;4213000000;;543000000;4688000000;22736000000
CHTR;378110;USD;2016;Q4;2016-12-31;2017-02-16;371530365;458578288;1535000000;1432000000;;3300000000;32963000000;;112804000000;145767000000;149067000000;7544000000;2028000000;9572000000;59719000000;89129000000;98701000000;39413000000;0;733000000;50366000000;149067000000
CHTR;378110;USD;2015;Q4;2015-12-31;2016-02-10;0;0;5000000;279000000;;345000000;8345000000;;30626000000;38971000000;39316000000;1972000000;0;1972000000;35723000000;37390000000;39362000000;2028000000;;-2061000000;-46000000;39316000000
CHTR;378110;USD;2014;Q4;2014-12-31;2015-02-24;0;0;3000000;285000000;;345000000;8373000000;;15670000000;24043000000;24388000000;1635000000;;1635000000;20887000000;22607000000;24242000000;1930000000;;-1762000000;146000000;24388000000
CHTR;378110;USD;2013;Q4;2013-12-31;2014-02-21;0;0;21000000;234000000;;322000000;7981000000;;8992000000;16973000000;17295000000;1467000000;;1467000000;14181000000;15677000000;17144000000;1760000000;;-1568000000;151000000;17295000000
CHTR;378110;USD;2012;Q4;2012-12-31;2013-02-22;0;0;7000000;234000000;;330000000;7206000000;;8060000000;15266000000;15596000000;1224000000;;1224000000;12808000000;14223000000;15447000000;1616000000;;-1392000000;149000000;15596000000
CHTR;378110;USD;2011;Q4;2011-12-31;2012-02-27;0;0;2000000;268000000;;357000000;6897000000;;8347000000;15244000000;15601000000;1157000000;;1157000000;12856000000;14035000000;15192000000;1556000000;;-1082000000;409000000;15601000000
CHTR;378110;USD;2010;Q4;2010-12-31;2011-05-03;0;0;4000000;247000000;;326000000;6819000000;;8562000000;15381000000;15707000000;1049000000;;1049000000;12306000000;13180000000;14229000000;1776000000;-6000000;-235000000;1478000000;15707000000
CHTR;378110;USD;2017;Q4;2017-12-31;2018-02-02;240493327;387965203;621000000;1635000000;;2555000000;33888000000;;110180000000;144068000000;146623000000;9045000000;2045000000;11090000000;68186000000;88002000000;99092000000;35253000000;0;3832000000;47531000000;146623000000
CHTR;378110;USD;2018;Q4;2018-12-31;2019-01-31;226867963;229999202;551000000;1733000000;;2730000000;35126000000;;108274000000;143400000000;146130000000;8805000000;3290000000;12095000000;69537000000;89763000000;101858000000;33507000000;;2780000000;44272000000;146130000000
CHK;378111;USD;2017;Q4;2017-12-31;2018-02-22;901000000;694000000;5000000;1322000000;;1525000000;10680000000;;220000000;10900000000;12425000000;791000000;52000000;2356000000;9921000000;10441000000;12797000000;14446000000;-31000000;-16525000000;-372000000;12425000000
CHK;378111;USD;2016;Q4;2016-12-31;2016-11-03;887000000;887000000;882000000;1057000000;;2142000000;10609000000;;277000000;10886000000;13028000000;785000000;503000000;3648000000;9938000000;10583000000;14231000000;14495000000;-27000000;-17474000000;-1203000000;13028000000
CHK;378111;USD;2015;Q4;2015-12-31;2015-11-04;662000000;662000000;825000000;1129000000;;2480000000;14298000000;;536000000;14834000000;17314000000;1045000000;381000000;3685000000;10311000000;11232000000;14917000000;12410000000;-33000000;-13202000000;2397000000;17314000000
CHK;378111;USD;2014;Q4;2014-12-31;2014-11-06;659000000;1004000000;4108000000;2236000000;;7468000000;32515000000;265000000;503000000;33283000000;40751000000;2199000000;381000000;5656000000;11154000000;16890000000;22546000000;12538000000;-37000000;1483000000;18205000000;40751000000
CHK;378111;USD;2013;Q4;2013-12-31;2013-11-06;614893000;507893000;837000000;2222000000;;3656000000;37134000000;477000000;515000000;38126000000;41782000000;1796000000;0;5515000000;12886000000;18127000000;23642000000;12453000000;-46000000;688000000;18140000000;41782000000
CHK;378111;USD;2012;Q4;2012-12-31;2012-11-09;534104000;418891000;287000000;2245000000;;2948000000;37167000000;728000000;768000000;38663000000;41611000000;1936000000;463000000;6266000000;12157000000;17449000000;23715000000;12300000000;-48000000;437000000;17896000000;41611000000
CHK;378111;USD;2011;Q4;2011-12-31;2011-11-09;677537000;919590000;351000000;2505000000;;3177000000;36760000000;1531000000;367000000;38658000000;41835000000;3494000000;0;7082000000;10626000000;16792000000;23874000000;12153000000;-33000000;1608000000;17961000000;41835000000
CHK;378111;USD;2010;Q4;2010-12-31;2010-11-09;666967000;843486000;102000000;1974000000;;3266000000;32378000000;1208000000;327000000;33913000000;37179000000;2260000000;;4490000000;12640000000;17425000000;21915000000;12201000000;-24000000;190000000;15264000000;37179000000
CHK;378111;USD;2009;Q4;2009-12-31;2009-11-09;664853000;650055000;307000000;1325000000;;2446000000;26710000000;404000000;354000000;27468000000;29914000000;1175000000;;2688000000;12295000000;14885000000;17573000000;12152000000;-15000000;-1261000000;12341000000;29914000000
CHK;378111;USD;2008;Q4;2008-12-31;2009-08-10;607775000;538013000;1749000000;1324000000;58000000;4292000000;33308000000;444000000;549000000;34301000000;38593000000;1886000000;;3621000000;13175000000;17955000000;21576000000;11686000000;-10000000;4569000000;17017000000;38593000000
CHK;378111;USD;2018;Q4;2018-12-31;2019-02-27;910000000;763000000;4000000;1247000000;;1598000000;10818000000;;319000000;11137000000;12735000000;904000000;381000000;2887000000;7341000000;7715000000;10602000000;14387000000;-31000000;-13912000000;2133000000;12735000000
CHD;378113;USD;2015;Q4;2015-12-31;2016-02-19;260800000;265600000;330000000;276200000;274000000;906000000;609600000;;2741300000;3350900000;4256900000;515500000;357200000;872700000;692800000;1361000000;2233700000;522800000;-1103700000;2650000000;2023200000;4256900000
CHD;378113;USD;2014;Q4;2014-12-31;2015-02-20;267800000;272200000;423000000;322900000;245900000;1018100000;616200000;;2724900000;3341100000;4359200000;508700000;396600000;905300000;690000000;1352000000;2257300000;511200000;-789500000;2414900000;2101900000;4359200000
CHD;378113;USD;2013;Q4;2013-12-31;2014-02-21;277600000;283000000;496900000;330200000;250500000;1115800000;594100000;;2549800000;3143900000;4259700000;497400000;153800000;651200000;649500000;1308500000;1959700000;499300000;-368100000;2168500000;2300000000;4259700000
CHD;378113;USD;2012;Q4;2012-12-31;2013-02-22;278200000;283000000;343000000;303100000;242200000;933800000;586000000;;2578300000;3164300000;4098100000;471800000;253800000;725600000;649400000;1311400000;2037000000;465200000;-336100000;1929300000;2061100000;4098100000
CHD;378113;USD;2011;Q4;2011-12-31;2012-02-24;286000000;291400000;251400000;264600000;200700000;755200000;506000000;;1856400000;2362400000;3117600000;381000000;2600000;383600000;249700000;693200000;1076800000;418100000;-94400000;1714000000;2040800000;3117600000
CHD;378113;USD;2010;Q4;2010-12-31;2011-02-24;284400000;289600000;189200000;231100000;195400000;649500000;468300000;;1827400000;2295700000;2945200000;357100000;90000000;447100000;249700000;627200000;1074300000;377200000;-24600000;1501800000;1870900000;2945200000
CHD;378113;USD;2009;Q4;2009-12-31;2010-08-09;282416000;286684000;447143000;222158000;216870000;928265000;455636000;;1734545000;2190181000;3118446000;348083000;218949000;567032000;597347000;949642000;1516674000;349313000;-32925000;1275117000;1601772000;3118446000
CHD;378113;USD;2016;Q4;2016-12-31;2017-02-24;256600000;260300000;187800000;287000000;258200000;756800000;588600000;;3008700000;3597300000;4354100000;575100000;426800000;1001900000;693400000;1374300000;2376200000;544200000;-1428500000;2926000000;1977900000;4354100000
CHD;378113;USD;2017;Q4;2017-12-31;2018-02-23;248800000;253800000;278900000;345900000;330700000;1000200000;607700000;;4406900000;5014600000;6014800000;664100000;270900000;935000000;2103400000;2861800000;3796800000;557400000;-1782000000;3479000000;2218000000;6014800000
CHD;378113;USD;2018;Q4;2018-12-31;2019-02-21;246600000;252400000;316700000;345300000;382800000;1078200000;598200000;;4392800000;4991000000;6069200000;728000000;598300000;1326300000;1508800000;2289100000;3615400000;573600000;-1898800000;3832600000;2453800000;6069200000
XEC;378115;USD;2016;Q4;2016-12-31;2017-05-10;94220000;94220000;652876000;;33342000;969304000;2354267000;;914153000;3268420000;4237724000;168878000;;522352000;1487939000;1672383000;2194735000;2764403000;;-722359000;2042989000;4237724000
XEC;378115;USD;2015;Q4;2015-12-31;2016-02-23;100398000;;779382000;;54579000;1077930000;2741282000;;889210000;3630492000;4708422000;149128000;;410067000;1485620000;1839998000;2250065000;2763924000;;-306008000;2458357000;4708422000
XEC;378115;USD;2014;Q4;2014-12-31;2015-03-09;86098000;;405862000;;89780000;931804000;6903711000;;872954000;7776665000;8708469000;293168000;;776327000;1483176000;3431510000;4207837000;1997956000;;2501574000;4500632000;8708469000
XEC;378115;USD;2013;Q4;2013-12-31;2014-02-26;86077000;;4531000;;66772000;469139000;5965637000;;818359000;6783996000;7253135000;235091000;;683167000;924000000;2547760000;3230927000;1970985000;;2050034000;4022208000;7253135000
XEC;378115;USD;2012;Q4;2012-12-31;2013-02-26;86426000;;69538000;;81029000;470137000;5004769000;;830246000;5835015000;6305152000;237468000;;645862000;750000000;2184554000;2830416000;1940494000;;1533768000;3474736000;6305152000
XEC;378115;USD;2011;Q4;2011-12-31;2012-02-22;77933000;86596000;2406000;;85141000;457895000;4126208000;;773274000;4899482000;5357377000;215511000;;616339000;405000000;1610425000;2226764000;1909364000;;1221263000;3130613000;5357377000
XEC;378115;USD;2010;Q4;2010-12-31;2011-08-16;;;114126000;;81871000;561068000;2922358000;;874821000;3797179000;4358247000;168615000;;512313000;350000000;1236102000;1748415000;1883917000;;725651000;2609832000;4358247000
XEC;378115;USD;2009;Q4;2009-12-31;2010-09-03;;;2544000;;145153000;407258000;2184916000;;852363000;3037279000;3444537000;127141000;;388763000;392793000;1017668000;1406431000;1860090000;;178035000;2038106000;3444537000
XEC;378115;USD;2008;Q4;2008-12-31;2009-08-07;;;3715000;;186062000;514944000;2808505000;;841484000;3649989000;4164933000;193659000;;469589000;587630000;1343697000;1813286000;1875675000;-33344000;510271000;2351647000;4164933000
XEC;378115;USD;2017;Q4;2017-12-31;2018-02-23;93572000;93642000;400534000;;49722000;935635000;3241530000;;865474000;4107004000;5042639000;256156000;;679574000;1486920000;1794787000;2474361000;2765338000;;-199259000;2568278000;5042639000
XEC;378115;USD;2018;Q4;2018-12-31;2019-02-20;93900000;93917000;800666000;;55553000;1424139000;3715330000;;922615000;4637945000;6062084000;271738000;;708707000;1488554000;2023591000;2732298000;2786146000;;542885000;3329786000;6062084000
CME;378116;USD;2016;Q4;2016-12-31;2017-02-27;338089000;339466000;1951900000;364400000;;40031500000;425200000;;28912700000;29337900000;69369400000;26200000;;1402900000;2231200000;47625800000;49028700000;17830300000;;2524500000;20340700000;69369400000
CME;378116;USD;2015;Q4;2015-12-31;2016-02-26;336857000;338225000;1765100000;357800000;;37904500000;491700000;;28963200000;29454900000;67359400000;28700000;;1271500000;2229300000;45536100000;46807600000;17725000000;;2907600000;20551800000;67359400000
CME;378116;USD;2014;Q4;2014-12-31;2015-02-26;335210000;336636000;1440800000;341200000;;42545300000;508900000;;29187300000;29696200000;72241500000;36900000;;964400000;2107900000;50353600000;51318000000;17600000000;;3317300000;20923500000;72241500000
CME;378116;USD;2013;Q4;2013-12-31;2014-03-03;333655000;335473000;2538100000;302700000;;24405600000;513400000;;29358800000;29872200000;54277800000;36200000;749900000;1955900000;2107200000;31161400000;33117300000;17508200000;;3494600000;21160500000;54277800000
CME;378116;USD;2012;Q4;2012-12-31;2013-03-01;331739000;332805000;1661300000;267500000;;8717900000;724000000;;29421300000;30145300000;38863200000;41700000;749700000;1032100000;2106800000;16325400000;17357500000;17216400000;;3993400000;21505700000;38863200000
CME;378116;USD;2011;Q4;2011-12-31;2012-02-28;330580000;333260000;1089900000;289400000;;10945800000;821900000;;28991000000;29812900000;40758700000;31100000;0;281300000;2106800000;18855100000;19136400000;17115800000;;4324600000;21622300000;40758700000
CME;378116;USD;2010;Q4;2010-12-31;2011-02-28;334112000;335120000;905400000;297500000;;5387500000;786800000;;28871800000;29658600000;35046100000;51800000;420500000;742700000;2104800000;14175200000;14917900000;17278400000;;2885800000;20128200000;35046100000
CME;378116;USD;2009;Q4;2009-12-31;2010-02-26;332245000;333270000;303200000;248300000;;6699000000;738500000;;28213500000;28952000000;35651000000;46700000;299800000;541700000;2014700000;15808300000;16350000000;17187300000;;2239900000;19301000000;35651000000
CME;378116;USD;2008;Q4;2008-12-31;2009-09-04;333950000;334810000;1034900000;234000000;;19111500000;707200000;;28340000000;29047200000;48158700000;71000000;249900000;989500000;2966100000;28480600000;29470100000;17129200000;;1719700000;18688600000;48158700000
CME;378116;USD;2017;Q4;2017-12-31;2018-03-01;339162000;340609000;1993700000;359700000;;46906500000;399700000;;28485000000;28884700000;75791200000;31300000;;1487600000;2233100000;51891800000;53379400000;17900300000;;4497200000;22411800000;75791200000
CME;378116;USD;2018;Q4;2018-12-31;2019-02-28;351020000;352294000;1447400000;553300000;;41886700000;448700000;;35140300000;35589000000;77475700000;116000000;574200000;1817100000;3826800000;49693300000;51510400000;21057900000;;4855300000;25965300000;77475700000
CMS;378117;USD;2018;Q4;2018-12-31;2019-02-05;;283600000;153000000;1197000000;143000000;2468000000;18126000000;69000000;3866000000;22061000000;24529000000;986000000;996000000;2624000000;10684000000;17113000000;19737000000;5091000000;;-271000000;4792000000;24529000000
CMS;378117;USD;2017;Q4;2017-12-31;2018-02-14;;281400000;182000000;1230000000;133000000;2475000000;16761000000;64000000;3750000000;20575000000;23050000000;956000000;1103000000;2784000000;9214000000;15788000000;18572000000;5022000000;;-531000000;4478000000;23050000000
CMS;378117;USD;2016;Q4;2016-12-31;2017-02-07;;279200000;235000000;1001000000;119000000;2280000000;15715000000;65000000;3562000000;19342000000;21622000000;824000000;886000000;2655000000;8750000000;14677000000;17332000000;4919000000;;-616000000;4290000000;21622000000
CMS;378117;USD;2015;Q4;2015-12-31;2016-02-11;;277200000;266000000;902000000;126000000;2320000000;14705000000;64000000;3210000000;17979000000;20299000000;856000000;706000000;2302000000;8518000000;14022000000;16324000000;4840000000;;-855000000;3975000000;20299000000
CMS;378117;USD;2014;Q4;2014-12-31;2015-02-05;;276100000;207000000;979000000;117000000;2597000000;13412000000;61000000;3115000000;16588000000;19185000000;869000000;540000000;1948000000;8139000000;13530000000;15478000000;4777000000;;-1058000000;3707000000;19185000000
CMS;378117;USD;2013;Q4;2013-12-31;2014-02-06;;272500000;172000000;977000000;107000000;2526000000;12246000000;59000000;2585000000;14890000000;17416000000;770000000;562000000;1945000000;7239000000;11980000000;13925000000;4718000000;;-1242000000;3491000000;17416000000
CMS;378117;USD;2012;Q4;2012-12-31;2013-02-21;;270400000;93000000;896000000;96000000;2422000000;11551000000;57000000;3101000000;14709000000;17131000000;647000000;541000000;1797000000;6863000000;12096000000;13893000000;4672000000;;-1423000000;3238000000;17131000000
CMS;378117;USD;2011;Q4;2011-12-31;2012-02-23;;266100000;161000000;918000000;92000000;2565000000;10633000000;50000000;3204000000;13887000000;16452000000;840000000;1057000000;2338000000;6207000000;11042000000;13380000000;4630000000;;-1553000000;3072000000;16452000000
CMS;378117;USD;2010;Q4;2010-12-31;2011-02-24;;262200000;247000000;1051000000;104000000;2759000000;10069000000;49000000;2739000000;12857000000;15616000000;644000000;750000000;2021000000;6636000000;10758000000;12779000000;4590000000;;-1757000000;2837000000;15616000000
CMS;378117;USD;2009;Q4;2009-12-31;2010-07-28;;;90000000;1029000000;118000000;2742000000;9682000000;9000000;2823000000;12514000000;15256000000;771000000;694000000;1954000000;6092000000;10364000000;12318000000;4562000000;;-1927000000;2938000000;15256000000
CXO;378119;USD;2017;Q4;2017-12-31;2018-02-21;147581000;148950000;0;331000000;;578000000;13041000000;;113000000;13154000000;13732000000;489000000;;1165000000;2691000000;3652000000;4817000000;7142000000;-67000000;1840000000;8915000000;13732000000
CXO;378119;USD;2016;Q4;2016-12-31;2016-11-09;144770000;144770000;53000000;220000000;;546000000;11302000000;;271000000;11573000000;12119000000;387000000;;753000000;2741000000;3743000000;4496000000;6783000000;-44000000;884000000;7623000000;12119000000
CXO;378119;USD;2015;Q4;2015-12-31;2015-11-05;128962000;129957000;228550000;203972000;;1314550000;10976947000;;350379000;11327326000;12641876000;241723000;;596420000;3332188000;5102905000;5699325000;4628519000;-31609000;2345641000;6942551000;12641876000
CXO;378119;USD;2014;Q4;2014-12-31;2014-11-06;112014000;112172000;21000;250600000;;1188396000;10206014000;;357370000;10563384000;11751780000;831221000;;1264627000;3469137000;5206365000;6470992000;3027525000;-26478000;2279741000;5280788000;11751780000
CXO;378119;USD;2013;Q4;2013-12-31;2013-11-07;103810000;103457000;21000;223790000;;520875000;8946048000;;124241000;9070289000;9591164000;368950000;;756868000;3630421000;5076347000;5833215000;2027267000;-10884000;1741566000;3757949000;9591164000
CXO;378119;USD;2012;Q4;2012-12-31;2012-11-08;103500000;104198000;2880000;198053000;;458882000;7993424000;;137131000;8130555000;8589437000;407338000;;740086000;3101103000;4383155000;5123241000;1982819000;-7186000;1490563000;3466196000;8589437000
CXO;378119;USD;2011;Q4;2011-12-31;2011-11-03;102780000;105036000;342000;213921000;;411023000;6290118000;;148435000;6438553000;6849576000;356358000;;701477000;2080141000;3167360000;3868837000;1925861000;-3996000;1058874000;2980739000;6849576000
CXO;378119;USD;2010;Q4;2010-12-31;2010-11-04;99111000;100481000;384000;136471000;;330633000;4913787000;;124074000;5037861000;5368494000;267344000;;506989000;1668521000;2477631000;2984620000;1874752000;-1615000;510737000;2383874000;5368494000
CXO;378119;USD;2009;Q4;2009-12-31;2010-08-06;85254000;85254000;3234000;69199000;;217258000;2856289000;;97538000;2953827000;3171085000;183140000;;337014000;845836000;1498643000;1835657000;1029478000;-417000;306367000;1335428000;3171085000
CXO;378119;USD;2018;Q4;2018-12-31;2019-02-20;198884000;199153000;0;466000000;;1374000000;22313000000;;2607000000;24920000000;26294000000;783000000;;1356000000;4194000000;6170000000;7526000000;14773000000;-131000000;4126000000;18768000000;26294000000
COP;378120;USD;2016;Q4;2016-12-31;2017-02-21;1246350000;1246350000;3660000000;3249000000;1018000000;8609000000;58331000000;21091000000;1741000000;81163000000;89772000000;4137000000;1089000000;6909000000;26186000000;47637000000;54546000000;46525000000;-36906000000;31548000000;35226000000;89772000000
COP;378120;USD;2015;Q4;2015-12-31;2016-02-23;1243734000;1238994000;2368000000;4314000000;1124000000;8789000000;66446000000;20490000000;1759000000;88695000000;97484000000;5432000000;1427000000;9256000000;23453000000;48146000000;57402000000;46375000000;-36780000000;36414000000;40082000000;97484000000
COP;378120;USD;2014;Q4;2014-12-31;2015-02-24;1240041000;1248194000;5062000000;6675000000;1331000000;15068000000;75444000000;24335000000;1692000000;101471000000;116539000000;9077000000;182000000;11537000000;22383000000;52729000000;64266000000;46089000000;-36780000000;44504000000;52273000000;116539000000
COP;378120;USD;2013;Q4;2013-12-31;2014-02-25;1233793000;1245783000;6518000000;8273000000;1194000000;19023000000;72827000000;23907000000;2300000000;99034000000;118057000000;12027000000;589000000;15129000000;21073000000;50436000000;65565000000;45708000000;-36780000000;41160000000;52492000000;118057000000
COP;378120;USD;2012;Q4;2012-12-31;2013-02-19;1222941000;1231736000;3618000000;8929000000;965000000;23989000000;67263000000;23489000000;2403000000;93155000000;117144000000;13379000000;955000000;17443000000;20770000000;51274000000;68717000000;45342000000;-36780000000;35338000000;48427000000;117144000000
COP;378120;USD;2011;Q4;2011-12-31;2012-02-21;864085537;870514271;6361000000;14648000000;4631000000;30218000000;84180000000;32108000000;6724000000;123012000000;153230000000;23873000000;1013000000;28068000000;21610000000;59413000000;87481000000;44742000000;-31787000000;49049000000;65749000000;153230000000
COP;378120;USD;2010;Q4;2010-12-31;2011-02-23;61186375;63920156;11510000000;13787000000;5197000000;34660000000;82554000000;31581000000;7519000000;121654000000;156314000000;23273000000;936000000;27419000000;22656000000;59786000000;87205000000;43516000000;-20077000000;40397000000;69109000000;156314000000
COP;378120;USD;2009;Q4;2009-12-31;2010-02-25;1954400972;1969380416;542000000;11861000000;4940000000;21167000000;87708000000;35742000000;7521000000;130971000000;152138000000;18887000000;1728000000;23695000000;26925000000;65830000000;89525000000;43031000000;-16211000000;32214000000;62613000000;152138000000
COP;378120;USD;2008;Q4;2008-12-31;2009-08-04;1949245598;1874394290;755000000;10892000000;5095000000;20843000000;83947000000;30926000000;7149000000;122022000000;142865000000;18263000000;370000000;21780000000;27085000000;64820000000;86600000000;42711000000;-16211000000;30642000000;56265000000;142865000000
COP;378120;USD;2017;Q4;2017-12-31;2018-02-20;1191587000;1183258000;10097000000;4179000000;1060000000;16512000000;45683000000;9599000000;1568000000;56850000000;73362000000;5068000000;2575000000;9397000000;17128000000;33164000000;42561000000;46640000000;-39906000000;29391000000;30801000000;73362000000
COP;378120;USD;2018;Q4;2018-12-31;2019-02-19;2312662967;2333358306;7625000000;3920000000;1007000000;13274000000;45698000000;9329000000;1679000000;56706000000;69980000000;5215000000;112000000;7395000000;14856000000;30521000000;37916000000;46897000000;-42905000000;34010000000;32064000000;69980000000
ED;378121;USD;2015;Q4;2015-12-31;2016-02-18;293300000;295500000;944000000;1052000000;;3836000000;32209000000;884000000;8713000000;41806000000;45642000000;1241000000;739000000;4720000000;12006000000;27861000000;32581000000;13052000000;;;13061000000;45642000000
ED;378121;USD;2014;Q4;2014-12-31;2015-02-19;292900000;293900000;699000000;1201000000;;3716000000;29827000000;816000000;9712000000;40355000000;44071000000;1262000000;560000000;3757000000;11546000000;27729000000;31486000000;12576000000;;;12585000000;44071000000
ED;378121;USD;2013;Q4;2013-12-31;2014-02-21;292900000;294800000;674000000;1251000000;;3891000000;28436000000;461000000;7859000000;36756000000;40647000000;1358000000;485000000;4730000000;10489000000;23672000000;28402000000;12245000000;;;12245000000;40647000000
ED;378121;USD;2012;Q4;2012-12-31;2013-02-21;292900000;294500000;394000000;1222000000;;3451000000;26939000000;467000000;10352000000;37758000000;41209000000;1462000000;706000000;3945000000;10064000000;25395000000;29340000000;;;;11869000000;41209000000
ED;378121;USD;2011;Q4;2011-12-31;2012-02-21;292800000;295100000;648000000;1123000000;;3638000000;25093000000;455000000;10028000000;35576000000;39214000000;1206000000;530000000;2987000000;10145000000;24578000000;27565000000;11436000000;;;11649000000;39214000000
ED;378121;USD;2010;Q4;2010-12-31;2011-02-22;290800000;292800000;338000000;1173000000;;3669000000;23863000000;403000000;8413000000;32679000000;36348000000;1408000000;5000000;2530000000;10678000000;22544000000;25074000000;11061000000;;;11274000000;36348000000
ED;378121;USD;2009;Q4;2009-12-31;2010-08-06;277300000;279400000;260000000;1047000000;;3243000000;22464000000;385000000;7781000000;30630000000;33873000000;1420000000;731000000;2952000000;9868000000;20459000000;23411000000;10249000000;;;10462000000;33873000000
ED;378121;USD;2016;Q4;2016-12-31;2017-02-16;304300000;306500000;776000000;1106000000;;3406000000;35216000000;1921000000;7712000000;44849000000;48255000000;1398000000;39000000;3843000000;14735000000;30106000000;33949000000;14298000000;;;14306000000;48255000000
ED;378121;USD;2017;Q4;2017-12-31;2018-02-15;310100000;312800000;797000000;1103000000;;3537000000;37600000000;2001000000;4973000000;44574000000;48111000000;1534000000;1298000000;4902000000;14731000000;27784000000;32686000000;15418000000;;;15425000000;48111000000
ED;378121;USD;2018;Q4;2018-12-31;2019-02-21;314500000;315800000;895000000;1267000000;;3864000000;41749000000;1766000000;6541000000;50056000000;53920000000;1425000000;1475000000;6207000000;17495000000;30874000000;37081000000;16726000000;;;16839000000;53920000000
CCI;378122;USD;2017;Q4;2017-12-31;2018-02-26;406276000;408290000;314000000;398000000;;1134000000;12933000000;;18162000000;31095000000;32229000000;381000000;115000000;1292000000;16044000000;18598000000;19890000000;16848000000;;-4505000000;12339000000;32229000000
CCI;378122;USD;2016;Q4;2016-12-31;2016-11-01;352117000;351569000;567599000;373532000;;1324761000;9805315000;;11545016000;21350331000;22675092000;285535000;101749000;961355000;12069393000;14156622000;15117977000;10941841000;;-3378838000;7557115000;22675092000
CCI;378122;USD;2015;Q4;2015-12-31;2015-11-06;333156000;335319000;178810000;313296000;;981245000;9580057000;;11375664000;20955721000;21936966000;226604000;106219000;855369000;12043740000;13992376000;14847745000;9551918000;;-2458397000;7089221000;21936966000
CCI;378122;USD;2014;Q4;2014-12-31;2014-11-07;332417000;333693000;151312000;313308000;;1282996000;8982783000;;10877497000;19860280000;21143276000;229340000;113335000;932131000;11807526000;13473917000;14406048000;9515735000;;-2815428000;6737228000;21143276000
CCI;378122;USD;2013;Q4;2013-12-31;2013-11-08;319633000;320518000;223394000;249925000;;892683000;8947677000;;10754548000;19702225000;20594908000;210972000;103586000;756387000;11490914000;12897346000;13653733000;9486110000;;-2535879000;6941175000;20594908000
CCI;378122;USD;2012;Q4;2012-12-31;2012-11-02;290816000;295926000;441364000;192833000;;1581324000;6917531000;;7589854000;14507385000;16088709000;168591000;688056000;1237858000;10923186000;11899587000;13137445000;5626527000;;-2625990000;2951264000;16088709000
CCI;378122;USD;2011;Q4;2011-12-31;2011-11-03;280975000;283858000;80120000;77258000;;599152000;4861227000;;5084717000;9945944000;10545096000;97447000;32517000;402106000;7158214000;7756126000;8158232000;5315186000;;-2811945000;2386864000;10545096000
CCI;378122;USD;2010;Q4;2010-12-31;2010-11-05;286406000;286406000;112531000;59912000;;545145000;4893651000;;5030733000;9924384000;10469529000;104840000;28687000;440885000;7066788000;7583650000;8024535000;5584433000;;-2960082000;2444994000;10469529000
CCI;378122;USD;2009;Q4;2009-12-31;2009-11-06;287419000;285724000;766146000;44431000;;1196033000;4895983000;;4864590000;9760573000;10956606000;102529000;217196000;754105000;6677608000;7266416000;8020521000;5688801000;;-2628336000;2936085000;10956606000
CCI;378122;USD;2008;Q4;2008-12-31;2009-08-28;;;155219000;37621000;;485168000;5060126000;;4816428000;9876554000;10361722000;50579000;466217000;834358000;5950698000;6811499000;7645857000;5617392000;;-2493198000;2715865000;10361722000
CCI;378122;USD;2018;Q4;2018-12-31;2019-02-25;413000000;418000000;277000000;501000000;;1229000000;13676000000;;17880000000;31556000000;32785000000;461000000;107000000;1417000000;16575000000;19334000000;20751000000;17771000000;;-5732000000;12034000000;32785000000
CSRA;378123;USD;2016;Q4;2017-03-31;2016-02-16;208912720;211406168;126000000;748000000;;1000000000;610000000;;3278000000;3888000000;4888000000;876000000;116000000;992000000;2683000000;3537000000;4529000000;134000000;;165000000;359000000;4888000000
CSRA;378123;USD;2015;Q4;2016-03-31;2015-12-04;139128632;139128632;130000000;751000000;;1004000000;530000000;;3312000000;3842000000;4846000000;916000000;170000000;1086000000;2765000000;3670000000;4756000000;117000000;;-74000000;90000000;4846000000
APTV;378125;USD;2015;Q4;2015-12-31;2016-02-08;279160000;281500000;535000000;2750000000;1181000000;5121000000;3377000000;;3475000000;6852000000;11973000000;3745000000;52000000;3927000000;3956000000;5313000000;9240000000;1656000000;;1627000000;2733000000;11973000000
APTV;378125;USD;2014;Q4;2014-12-31;2015-02-09;293960000;296790000;859000000;2400000000;1013000000;5224000000;3021000000;;2476000000;5497000000;10721000000;3499000000;34000000;3889000000;2392000000;3819000000;7708000000;1703000000;;1548000000;3013000000;10721000000
APTV;378125;USD;2013;Q4;2013-12-31;2014-02-10;306990000;308530000;1389000000;2662000000;1093000000;5752000000;3216000000;;2079000000;5295000000;11047000000;3833000000;61000000;3894000000;2351000000;3719000000;7613000000;1702000000;;1446000000;3434000000;11047000000
APTV;378125;USD;2012;Q4;2012-12-31;2013-02-11;316720000;317270000;1105000000;2425000000;1066000000;5227000000;2860000000;;2089000000;4949000000;10176000000;3519000000;140000000;3659000000;2324000000;3687000000;7346000000;1726000000;;856000000;2830000000;10176000000
APTV;378125;USD;2011;Q4;2011-12-31;2012-04-26;323440000;323440000;1363000000;2459000000;1054000000;5501000000;2315000000;;1312000000;3627000000;9128000000;3605000000;107000000;3712000000;1996000000;3245000000;6957000000;1761000000;;110000000;2171000000;9128000000
APTV;378125;USD;2017;Q4;2017-12-31;2018-02-05;265790000;267390000;1596000000;2440000000;1083000000;5641000000;2804000000;;3724000000;6528000000;12169000000;3523000000;17000000;3540000000;4132000000;5112000000;8652000000;1652000000;;2118000000;3517000000;12169000000
APTV;378125;USD;2016;Q4;2016-12-31;2017-02-06;270350000;271620000;737000000;2130000000;859000000;5419000000;2325000000;;4548000000;6873000000;12292000000;3062000000;10000000;4148000000;3953000000;5381000000;9529000000;1636000000;;1980000000;2763000000;12292000000
APTV;378125;USD;2018;Q4;2018-12-31;2019-02-04;262580000;263630000;567000000;2487000000;1277000000;4777000000;3179000000;;4524000000;7703000000;12480000000;3388000000;306000000;3694000000;4038000000;5116000000;8810000000;1642000000;;2511000000;3670000000;12480000000
XRAY;378126;USD;2015;Q4;2015-12-31;2016-02-12;140100000;142500000;284600000;399900000;340400000;1196700000;558800000;;2647400000;3206200000;4402900000;463900000;12100000;476000000;1141000000;1587500000;2063500000;239400000;-898400000;3591000000;2339400000;4402900000
XRAY;378126;USD;2014;Q4;2014-12-31;2015-02-20;141157000;143883000;151600000;426600000;387100000;1207000000;588800000;;2850700000;3439500000;4646500000;540800000;111800000;652600000;1150100000;1671700000;2324300000;223300000;-841600000;3380700000;2322200000;4646500000
XRAY;378126;USD;2013;Q4;2013-12-31;2014-02-20;142682000;145070000;74954000;472802000;438559000;1143802000;637172000;;3297073000;3934245000;5078047000;486543000;309862000;796405000;1166178000;1703668000;2500073000;256900000;-748506000;3095721000;2577974000;5078047000
XRAY;378126;USD;2012;Q4;2012-12-31;2013-02-20;142099000;144049000;80132000;442412000;402940000;1111096000;614705000;;3246496000;3861201000;4972297000;628817000;298963000;927780000;1222035000;1795074000;2722854000;248176000;-713739000;2818461000;2249443000;4972297000
XRAY;378126;USD;2011;Q4;2011-12-31;2012-02-24;141529000;143400000;77128000;427709000;361762000;1012903000;591445000;;3151050000;3742495000;4755398000;447372000;276701000;724073000;1490010000;2147174000;2871247000;231315000;-727977000;2535709000;1884151000;4755398000
XRAY;378126;USD;2010;Q4;2010-12-31;2011-02-18;141864000;143644000;540038000;344796000;308738000;1315045000;423105000;;1519801000;1942906000;3257951000;352337000;7754000;360091000;604015000;987948000;1348039000;206530000;-711650000;2320350000;1909912000;3257951000
XRAY;378126;USD;2009;Q4;2009-12-31;2010-02-22;444464876;450402305;450348000;348684000;291640000;1217796000;439619000;;1430517000;1870136000;3087932000;362382000;82174000;444556000;387151000;736418000;1180974000;197123000;-532019000;2083459000;1906958000;3087932000
XRAY;378126;USD;2008;Q4;2008-12-31;2009-07-30;595828442;606259589;204249000;319260000;306125000;949862000;432276000;;1448262000;1880538000;2830400000;334167000;25795000;359962000;423679000;811025000;1170987000;188782000;-479630000;1838958000;1659413000;2830400000
XRAY;378126;USD;2016;Q4;2016-12-31;2017-03-01;230900000;234300000;383900000;636000000;517100000;1743500000;799800000;;9012500000;9812300000;11555800000;746500000;21100000;767600000;1511100000;2662300000;3429900000;6519300000;-1647300000;3948000000;8125900000;11555800000
XRAY;378126;USD;2017;Q4;2017-12-31;2018-03-15;228600000;221100000;320600000;746200000;623100000;2002500000;876000000;;7496000000;8372000000;10374500000;924400000;30100000;954500000;1611600000;2792100000;3746600000;6546500000;-1955400000;2316200000;6627900000;10374500000
XRAY;378126;USD;2018;Q4;2018-12-31;2019-03-08;222400000;218400000;309600000;701900000;598900000;1888000000;870600000;;5928400000;6799000000;8687000000;920900000;92400000;1013300000;1564900000;2540700000;3554000000;6524900000;-2151000000;1225900000;5133000000;8687000000
DLTR;378128;USD;2016;Q4;2017-02-28;2017-03-28;236100000;237200000;870400000;;2865800000;3938000000;3115800000;;8647800000;11763600000;15701600000;1209600000;152100000;2105900000;6293700000;8206200000;10312100000;;;;5389500000;15701600000
DLTR;378128;USD;2015;Q4;2016-02-29;2016-03-28;234800000;236900000;740100000;;2885500000;3935900000;3125500000;;8839800000;11965300000;15901200000;1264800000;108000000;2095400000;7387700000;9398900000;11494300000;2393600000;;2056400000;4406900000;15901200000
DLTR;378128;USD;2014;Q4;2015-02-28;2015-03-13;205800000;207100000;864100000;;1035700000;1994600000;1210500000;;287600000;1498100000;3492700000;476300000;0;861600000;682700000;846100000;1707700000;45100000;;1774000000;1785000000;3492700000
DLTR;378128;USD;2013;Q4;2014-02-28;2014-03-14;208200000;209300000;267700000;;1035300000;1378500000;1094000000;;299400000;1393400000;2771900000;441200000;12800000;686300000;757000000;914900000;1601200000;12800000;;1174800000;1170700000;2771900000
DLTR;378128;USD;2012;Q4;2013-02-28;2013-03-15;225600000;227400000;399900000;;971700000;1473500000;960700000;;317800000;1278500000;2752000000;426100000;14300000;676200000;257000000;408500000;1084700000;2500000;;1666300000;1667300000;2752000000
DLTR;378128;USD;2011;Q4;2012-02-29;2012-03-22;233000000;235000000;288300000;;867400000;1209400000;825300000;;293900000;1119200000;2328600000;350000000;15500000;581000000;250000000;403000000;984000000;1100000;;1344100000;1344600000;2328600000
DLTR;378128;USD;2010;Q4;2011-02-28;2011-03-17;1016399236;1023999230;486000000;;803100000;1333300000;741100000;;306100000;1047200000;2380500000;325800000;16500000;532800000;250000000;388700000;921500000;1200000;;1458200000;1459000000;2380500000
DLTR;378128;USD;2009;Q4;2010-02-28;2010-08-19;;;599400000;;679800000;1305600000;714300000;;269800000;984100000;2289700000;268500000;17500000;475900000;250000000;384600000;860500000;900000;;1430700000;1429200000;2289700000
DLTR;378128;USD;2017;Q4;2018-02-28;2018-03-16;237300000;238300000;1097800000;;3169300000;4576300000;3200700000;;8555800000;11756500000;16332800000;1206300000;915900000;2859100000;4862100000;6291400000;9150500000;2547700000;;4666900000;7182300000;16332800000
DLTR;378128;USD;2018;Q4;2019-02-28;2019-03-27;238300000;239000000;422100000;;3536000000;4293300000;3445300000;;5762600000;9207900000;13501200000;1476400000;0;2095700000;4344100000;5762600000;7858300000;;;;5642900000;13501200000
DPS;378130;USD;2017;Q4;2017-12-31;2018-02-14;180000000;180800000;90000000;483000000;384000000;1056000000;790000000;97000000;13801000000;14688000000;15744000000;1583000000;225000000;2018000000;3161000000;6063000000;8081000000;6385000000;;914000000;7663000000;15744000000
DPS;378130;USD;2016;Q4;2016-12-31;2017-02-14;183500000;185200000;1787000000;595000000;202000000;2736000000;1138000000;23000000;5894000000;7055000000;9791000000;307000000;10000000;1051000000;4468000000;6606000000;7657000000;97000000;;2266000000;2134000000;9791000000
DPS;378130;USD;2015;Q4;2015-12-31;2016-02-23;188800000;191100000;911000000;570000000;209000000;1817000000;1156000000;31000000;5865000000;7052000000;8869000000;304000000;507000000;1583000000;2875000000;5103000000;6686000000;213000000;;2165000000;2183000000;8869000000
DPS;378130;USD;2014;Q4;2014-12-31;2015-02-19;193900000;196100000;237000000;556000000;204000000;1211000000;1141000000;14000000;5899000000;7054000000;8265000000;299000000;3000000;1038000000;2580000000;4933000000;5971000000;660000000;;1771000000;2294000000;8265000000
DPS;378130;USD;2013;Q4;2013-12-31;2014-02-20;199600000;201500000;153000000;564000000;200000000;1119000000;1173000000;15000000;5894000000;7082000000;8201000000;304000000;66000000;1030000000;2508000000;4894000000;5924000000;972000000;;1393000000;2277000000;8201000000
DPS;378130;USD;2012;Q4;2012-12-31;2013-02-21;207500000;210000000;366000000;552000000;197000000;1335000000;1202000000;14000000;6377000000;7593000000;8928000000;328000000;250000000;1232000000;2554000000;5416000000;6648000000;1310000000;;1080000000;2280000000;8928000000
DPS;378130;USD;2011;Q4;2011-12-31;2012-02-22;213300000;215900000;701000000;585000000;212000000;1757000000;1152000000;13000000;6361000000;7526000000;9283000000;795000000;452000000;1915000000;2256000000;5105000000;7020000000;1633000000;;740000000;2263000000;9283000000
DPS;378130;USD;2010;Q4;2010-12-31;2011-02-22;225800000;228200000;315000000;536000000;244000000;1309000000;1168000000;11000000;6371000000;7550000000;8859000000;316000000;404000000;1338000000;1687000000;5062000000;6400000000;2087000000;;400000000;2459000000;8859000000
DPS;378130;USD;2009;Q4;2009-12-31;2010-05-06;254200000;255900000;280000000;540000000;262000000;1279000000;1109000000;9000000;6379000000;7497000000;8776000000;854000000;0;854000000;2960000000;4735000000;5589000000;3159000000;;87000000;3187000000;8776000000
ECL;378133;USD;2016;Q4;2016-12-31;2017-02-24;291600000;296300000;327400000;2341200000;1319400000;4279400000;3365000000;;10685800000;14050800000;18330200000;1070600000;541300000;3019400000;6145700000;8339900000;11359300000;5623400000;-3984400000;6975000000;6970900000;18330200000
ECL;378133;USD;2015;Q4;2015-12-31;2016-02-26;296000000;301300000;92800000;2390200000;1388200000;4447500000;3228300000;;10965900000;14194200000;18641700000;1101800000;2205300000;4764400000;4260200000;6896900000;11661300000;5436400000;-3263500000;6160300000;6980400000;18641700000
ECL;378133;USD;2014;Q4;2014-12-31;2015-02-27;300200000;306200000;209600000;2626700000;1466900000;4853000000;3050600000;;11523800000;14574400000;19427400000;1251000000;1704800000;4367900000;4843400000;7677400000;12045300000;5222200000;-2509500000;5555100000;7382100000;19427400000
ECL;378133;USD;2013;Q4;2013-12-31;2014-02-28;301500000;308100000;339200000;2568000000;1321900000;4698400000;2882000000;;12056100000;14938100000;19636500000;1102800000;861000000;3488700000;6043500000;8738400000;12227100000;5037100000;-2086600000;4699000000;7409400000;19636500000
ECL;378133;USD;2012;Q4;2012-12-31;2013-02-26;293900000;300900000;1157800000;2225100000;1088100000;4892000000;2409100000;;10271200000;12680300000;17572300000;957100000;805800000;3052700000;5736100000;8359500000;11412200000;4591200000;-2075100000;4020600000;6160100000;17572300000
ECL;378133;USD;2011;Q4;2011-12-31;2012-02-28;252100000;260300000;1843600000;2095300000;1069600000;5396000000;2295400000;;10493300000;12788700000;18184700000;897400000;1023000000;3166300000;6613200000;9277300000;12443600000;4316900000;-1865200000;3559900000;5741100000;18184700000
ECL;378133;USD;2010;Q4;2010-12-31;2011-02-25;232000000;237000000;242300000;999600000;447600000;1869900000;1148300000;;1854000000;3002300000;4872200000;386000000;189200000;1324800000;656400000;1414400000;2739200000;1643300000;-2521300000;3279100000;2133000000;4872200000
ECL;378133;USD;2009;Q4;2009-12-31;2010-02-26;237200000;241400000;73600000;1016100000;493400000;1814200000;1176200000;;2030500000;3206700000;5020900000;382700000;98500000;1250200000;868800000;1761100000;3011300000;1509100000;-2173400000;2898100000;2009600000;5020900000
ECL;378133;USD;2008;Q4;2008-12-31;2010-02-26;;;66700000;971000000;467200000;1691100000;1135200000;;1930600000;3065800000;4756900000;405900000;338900000;1441900000;799300000;1736000000;3177900000;1418500000;-2104800000;2617000000;1579000000;4756900000
ECL;378133;USD;2017;Q4;2017-12-31;2018-02-23;289000000;293500000;211400000;2571400000;1446500000;4594300000;3707100000;;11662100000;15369200000;19963500000;1360700000;564400000;3475200000;6758300000;8834500000;12309700000;5790400000;-4575000000;8011600000;7653800000;19963500000
ECL;378133;USD;2018;Q4;2018-12-31;2019-03-01;288200000;291800000;114700000;2662500000;1546400000;4677700000;3836000000;;11560800000;15396800000;20074500000;1356200000;743600000;3685600000;6301600000;8335300000;12020900000;5990200000;-5134800000;8909500000;8053600000;20074500000
EIX;378134;USD;2018;Q4;2018-12-31;2019-02-28;326000000;323000000;144000000;730000000;282000000;3359000000;41348000000;;12008000000;53356000000;56715000000;1511000000;799000000;5395000000;14632000000;38668000000;44063000000;2545000000;;7964000000;12652000000;56715000000
ENDP_old;378135;USD;2013;Q4;2013-12-31;2014-03-03;115106000;102509000;526597000;725827000;374439000;2854507000;372077000;2979000;3342293000;3717349000;6571856000;1246294000;414929000;1696672000;3323844000;4289968000;5986640000;1167819000;-763120000;126234000;585216000;6571856000
ENDP_old;378135;USD;2012;Q4;2012-12-31;2013-03-01;112810000;105165000;529689000;650547000;344935000;2213095000;359293000;1746000;3994425000;4355464000;6568559000;1554261000;132156000;1751188000;3035031000;3684165000;5435353000;1036515000;-768430000;811573000;1133206000;6568559000
ENDP_old;378135;USD;2011;Q4;2011-12-31;2012-02-29;116991000;120418000;547620000;733222000;262419000;1788096000;297731000;19105000;5187651000;5504487000;7292583000;1028588000;88265000;1121778000;3424329000;4131214000;5252992000;953708000;-518492000;1551910000;2039591000;7292583000
ENDP_old;378135;USD;2010;Q4;2010-12-31;2011-02-28;115780000;120516000;466214000;547807000;178805000;1359534000;215295000;23509000;2314051000;2552855000;3912389000;710835000;24993000;735828000;1045801000;1373232000;2109060000;862245000;-483790000;1364297000;1803329000;3912389000
ENDP_old;378135;USD;2009;Q4;2009-12-31;2010-08-02;117262000;117857000;733737000;323501000;84893000;1280581000;47529000;211792000;948901000;1208222000;2488803000;472180000;;472180000;322534000;519212000;991392000;818817000;-424816000;1105291000;1497411000;2488803000
EFX;378137;USD;2016;Q4;2016-12-31;2017-02-22;119700000;121200000;129300000;433300000;;672900000;466900000;;5524200000;5991100000;6664000000;389100000;585400000;1259600000;2086800000;2683100000;3942700000;1544000000;-2505600000;4153200000;2721300000;6664000000
EFX;378137;USD;2015;Q4;2015-12-31;2016-02-24;118400000;120400000;93300000;349800000;;561600000;366800000;;3573100000;3939900000;4501500000;292500000;49300000;603800000;1138400000;1547300000;2151100000;1491200000;-2529900000;3834400000;2350400000;4501500000
EFX;378137;USD;2014;Q4;2014-12-31;2015-02-25;119700000;121800000;128300000;337200000;;590500000;300600000;;3769900000;4070500000;4661000000;207700000;380400000;823100000;1145700000;1603300000;2426400000;1432400000;-2351700000;3554800000;2234600000;4661000000
EFX;378137;USD;2013;Q4;2013-12-31;2014-02-28;121700000;124200000;235900000;309700000;;648400000;288900000;;3602600000;3891500000;4539900000;205500000;296500000;662500000;1145500000;1536400000;2198900000;1405300000;-2101200000;3309200000;2341000000;4539900000
EFX;378137;USD;2012;Q4;2012-12-31;2013-02-22;119600000;122600000;146800000;317000000;;538700000;283700000;;3697700000;3981400000;4520100000;214700000;283300000;646500000;1447400000;1914400000;2560900000;1370300000;-2139700000;3064600000;1959200000;4520100000
EFX;378137;USD;2011;Q4;2011-12-31;2012-02-23;120200000;122200000;127700000;284400000;;456900000;292900000;;2768900000;3061800000;3518700000;163000000;47200000;364900000;966000000;1431700000;1796600000;1348700000;-2133700000;2879200000;1722100000;3518700000
EFX;378137;USD;2010;Q4;2010-12-31;2011-02-23;122900000;124800000;119400000;262600000;;433100000;298400000;;2706000000;3004400000;3437500000;158400000;20700000;319500000;978900000;1409600000;1729100000;1301200000;-1991000000;2725700000;1708400000;3437500000
EFX;378137;USD;2009;Q4;2009-12-31;2010-04-29;126300000;128400000;103100000;258700000;;416800000;319300000;;2814400000;3133700000;3550500000;161700000;183200000;492200000;990900000;1443300000;1935500000;1297400000;-1871700000;2494200000;1615000000;3550500000
EFX;378137;USD;2017;Q4;2017-12-31;2018-03-01;120000000;120800000;336400000;444800000;;998400000;567000000;;5668000000;6235000000;7233400000;390600000;965300000;1673500000;1739000000;2320900000;3994400000;1563400000;-2577600000;4600600000;3239000000;7233400000
EFX;378137;USD;2018;Q4;2018-12-31;2019-02-21;120600000;121300000;223600000;469100000;;902300000;764800000;;5486100000;6250900000;7153200000;519900000;4900000;826800000;2630600000;3170700000;3997500000;1587300000;-2571000000;4717800000;3155700000;7153200000
EQIX;378138;USD;2016;Q4;2016-12-31;2017-02-27;71417000;72860000;751885000;396245000;;1467526000;7199210000;10042000;3931593000;11140845000;12608371000;726581000;168974000;1028695000;6590599000;5244202000;6272897000;7413591000;-147559000;18584000;6335474000;12608371000
EQIX;378138;USD;2015;Q4;2015-12-31;2016-02-26;60482000;61498000;2241713000;291964000;;3259280000;5606436000;4584000;1486395000;7097415000;10356695000;504055000;956478000;1656354000;5564542000;4486483000;6142837000;4838506000;-7373000;-108216000;4213858000;10356695000
EQIX;378138;USD;2014;Q4;2014-12-31;2015-03-02;55369000;49160000;1140312000;262570000;;1490943000;4998270000;439000;1292326000;6291035000;7781978000;400265000;80828000;643757000;4563126000;4443703000;5087460000;3334362000;-11411000;-295990000;2694518000;7781978000
EQIX;378138;USD;2013;Q4;2013-12-31;2014-02-28;49789000;44024000;631702000;184840000;;888660000;4591650000;398390000;1613659000;6603699000;7492359000;327824000;70722000;546504000;4087934000;4362889000;4909393000;2693937000;-84663000;-36443000;2582966000;7492359000
EQIX;378138;USD;2012;Q4;2012-12-31;2013-02-26;48684000;51197000;418705000;163840000;;640092000;3915738000;127819000;1452148000;5495705000;6135797000;332362000;67366000;549072000;2943381000;3189106000;3738178000;2582287000;-36676000;-131128000;2397619000;6135797000
EQIX;378138;USD;2011;Q4;2011-12-31;2012-02-24;47247000;45766000;914544000;139057000;;1235757000;3225912000;161801000;1161854000;4549567000;5785324000;322267000;345297000;725254000;2753833000;3040257000;3765511000;2437671000;-86666000;-255095000;2019813000;5785324000
EQIX;378138;USD;2010;Q4;2010-12-31;2011-02-25;46154000;48266000;590033000;116358000;;778048000;2650953000;2806000;1016202000;3669961000;4448009000;237521000;27966000;318115000;2020619000;2249379000;2567494000;2341632000;;-349099000;1880515000;4448009000
EQIX;378138;USD;2009;Q4;2009-12-31;2010-08-04;39142000;40789000;594564000;64767000;;727887000;1808115000;9803000;492345000;2310263000;3038150000;208929000;65364000;315459000;1419605000;1540208000;1855667000;1665701000;;-385980000;1182483000;3038150000
EQIX;378138;USD;2017;Q4;2017-12-31;2018-02-26;78665000;79546000;1440788000;576313000;;2249128000;9394602000;9243000;7038484000;16442329000;18691457000;939624000;143196000;1242734000;9937223000;8006141000;9248875000;10121402000;-146320000;252689000;9442582000;18691457000
EQIX;378138;USD;2018;Q4;2018-12-31;2019-02-22;80524000;81104000;610706000;630119000;;1515682000;11026020000;0;7702936000;18728956000;20244638000;936104000;451972000;1515071000;10880525000;8179088000;9694159000;10751394000;-145161000;889948000;10550479000;20244638000
ESS;378140;USD;2017;Q4;2017-12-31;2018-02-22;66043166;65835553;44620000;100926000;;162052000;10935269000;190004000;1208381000;12333654000;12495706000;248921000;5510126000;6059675000;;0;6059675000;7129578000;;;6436031000;12495706000
ESS;378140;USD;2016;Q4;2016-12-31;2016-10-31;65521727;65600696;64921000;40970000;;211272000;10657222000;139189000;1209725000;12006136000;12217408000;248396000;5438260000;5880487000;;0;5880487000;7029685000;;;6336921000;12217408000
ESS;378140;USD;2015;Q4;2015-12-31;2015-11-04;65352361;65581658;29683000;19285000;;142340000;10650782000;137485000;1077777000;11866044000;12008384000;231681000;5303757000;5625909000;;0;5625909000;7003323000;;;6382475000;12008384000
ESS;378140;USD;2014;Q4;2014-12-31;2014-11-06;63725199;63725112;25610000;24923000;;120672000;10165271000;117240000;1123549000;11406060000;11526732000;223383000;4837865000;5367408000;;0;5367408000;6651171000;;;6159324000;11526732000
ESS;378140;USD;2013;Q4;2013-12-31;2013-11-04;31000763;35341702;18491000;68255000;;122021000;4239301000;90084000;735433000;5064818000;5186839000;117810000;2814103000;3184252000;;4349000;3188601000;2345767000;0;;1998238000;5186839000
ESS;378140;USD;2012;Q4;2012-12-31;2012-11-05;35930530;35940303;18606000;66163000;;108289000;4019006000;92713000;627215000;4738934000;4847223000;109910000;2677683000;2962758000;;4349000;2967107000;2204781000;0;;1880116000;4847223000
ESS;378140;USD;2011;Q4;2011-12-31;2011-11-07;33538719;33623550;12889000;66369000;;101832000;3437318000;74275000;423539000;3935132000;4036964000;87935000;2210858000;2478887000;;4349000;2483236000;1844614000;0;;1553728000;4036964000
ESS;378140;USD;2010;Q4;2010-12-31;2010-11-09;30680218;30753906;13753000;49444000;;85138000;3406539000;92310000;148900000;3647749000;3732887000;81155000;1832745000;2373524000;;4349000;2377873000;1515471000;0;;1355014000;3732887000
ESS;378140;USD;2009;Q4;2009-12-31;2010-08-06;28415577;30904326;20660000;36305000;;74239000;2938431000;134844000;107123000;3180398000;3254637000;72264000;1603549000;1971854000;4893000;9242000;1981096000;1275254000;0;;1273541000;3254637000
ESS;378140;USD;2018;Q4;2018-12-31;2019-02-21;66020351;66057678;134465000;;;151395000;10611182000;209545000;1411474000;12232201000;12383596000;255615000;5605942000;5954277000;;0;5954277000;7093079000;7000;;6429319000;12383596000
ES;378141;USD;2017;Q4;2017-12-31;2018-02-26;317396843;318105194;38165000;925083000;223063000;2267549000;23617463000;585419000;9749955000;33952837000;36220386000;2173121000;549631000;3589045000;11775889000;21389529000;24978574000;7909332000;-317771000;3561084000;11241812000;36220386000
ES;378141;USD;2016;Q4;2016-12-31;2017-02-23;317510248;318282128;30251000;847301000;328721000;2477672000;21350510000;544642000;7680349000;29575501000;32053173000;2033021000;773883000;3638605000;8829354000;17547266000;21185871000;7919616000;-317771000;3175171000;10867302000;32053173000
ES;378141;USD;2015;Q4;2015-12-31;2016-02-26;317191305;318274723;23947000;775480000;336476000;2618786000;19892441000;516478000;7552604000;27961523000;30580309000;1974599000;228883000;2989790000;8805574000;17082736000;20072526000;7931681000;-309977000;2797355000;10507783000;30580309000
ES;378141;USD;2014;Q4;2014-12-31;2015-02-25;316721279;318109811;38703000;856346000;349664000;2692465000;18647041000;515025000;7885856000;27047922000;29740387000;1825056000;245583000;3134381000;8568429000;16473623000;19608004000;7902630000;-300467000;2448661000;10132383000;29740387000
ES;378141;USD;2013;Q4;2013-12-31;2014-02-25;315670290;316661244;43364000;765391000;303233000;2087049000;17576186000;488515000;7643787000;25708488000;27795537000;1835251000;533346000;3275651000;7776833000;14752790000;18028441000;7858116000;-326537000;2125980000;9767096000;27795537000
ES;378141;USD;2012;Q4;2012-12-31;2013-02-28;314929366;315914391;45748000;792822000;267713000;2227295000;16605010000;400329000;9070190000;26075529000;28302824000;1884546000;763338000;3643690000;7282295000;15266516000;18910206000;7845814000;-338624000;1802714000;9392618000;28302824000
ES;378141;USD;2011;Q4;2011-12-31;2012-02-24;-354426218;-354668400;77529000;488002000;248958000;1357472000;10403065000;60311000;3826218000;14289594000;15647066000;950282000;331582000;1947682000;4727173000;9567558000;11515240000;2778148000;-346667000;1651875000;4131826000;15647066000
ES;378141;USD;2010;Q4;2010-12-31;2011-08-05;353741358;354510532;101701000;523644000;244043000;1507000000;9567726000;51201000;3346674000;12965601000;14472601000;866092000;66286000;1345147000;4814438000;9198621000;10543768000;2756501000;-354732000;1452777000;3928833000;14472601000
ES;378141;USD;2018;Q4;2018-12-31;2019-02-26;317379718;318130239;108068000;994055000;238042000;2292224000;25610428000;881794000;9456810000;35949032000;38241256000;2029995000;837319000;4112882000;12248743000;22485987000;26598869000;7910614000;-317771000;3953974000;11642387000;38241256000
EXPD;378143;USD;2015;Q4;2015-12-31;2016-02-25;185033000;186625000;807796000;1112260000;;1993370000;524724000;;64344000;589068000;2582438000;861373000;;861373000;;26389000;887762000;1852000;;1771379000;1694676000;2582438000
EXPD;378143;USD;2014;Q4;2014-12-31;2015-02-26;192598627;193100632;967443000;1236042000;;2289250000;538415000;;63240000;601655000;2890905000;983783000;;983783000;;35514000;1019297000;3029000;;1903196000;1871608000;2890905000
EXPD;378143;USD;2013;Q4;2013-12-31;2014-02-27;204544247;205404811;1273989000;1073500000;;2415269000;563064000;;36479000;599543000;3014812000;870200000;;870200000;;58281000;928481000;3672000;;2087376000;2086331000;3014812000
EXPD;378143;USD;2012;Q4;2012-12-31;2013-02-27;207734273;208930660;1260981000;1031376000;;2357599000;556204000;;40322000;596526000;2954125000;842558000;;842558000;;78997000;921555000;3347000;;2018618000;2032570000;2954125000
EXPD;378143;USD;2011;Q4;2011-12-31;2012-02-28;211988901;213894440;1294356000;934752000;;2286883000;538806000;;41138000;579944000;2866827000;796145000;;796145000;;60613000;856758000;15380000;;1991222000;2010069000;2866827000
EXPD;378143;USD;2010;Q4;2010-12-31;2011-02-28;212218493;216352831;1084989000;1003884000;;2140355000;498648000;;40176000;538824000;2679179000;861978000;;861978000;;69047000;931025000;15532000;;1717249000;1748154000;2679179000
EXPD;378143;USD;2009;Q4;2009-12-31;2010-02-26;211992313;216474954;926584000;810369000;;1787830000;495701000;;40191000;535892000;2323722000;708386000;;708386000;;53989000;762375000;20385000;;1532018000;1561347000;2323722000
EXPD;378143;USD;2008;Q4;2008-12-31;2009-08-07;211941524;216969989;741686000;788176000;;1573359000;493129000;;34351000;527480000;2100839000;670349000;;670349000;;46574000;716923000;9270000;;1372356000;1383916000;2100839000
EXPD;378143;USD;2016;Q4;2016-12-31;2017-02-23;180188000;181974000;974435000;1190130000;;2218579000;536572000;;35720000;572292000;2790871000;929931000;;929931000;;13727000;943658000;4441000;;1944789000;1847213000;2790871000
EXPD;378143;USD;2017;Q4;2017-12-31;2018-02-23;177498000;180749000;1051099000;1414741000;;2541452000;525203000;;50353000;575556000;3117008000;1093119000;;1093119000;;29516000;1122635000;2310000;;2063512000;1994373000;3117008000
EXPD;378143;USD;2018;Q4;2018-12-31;2019-02-22;172484000;176140000;923735000;1581530000;;2734816000;504105000;;75638000;579743000;3314559000;1136496000;;1326839000;;0;1326839000;3612000;;2088707000;1987720000;3314559000
FISV;378146;USD;2017;Q4;2017-12-31;2018-02-22;416000000;424800000;325000000;997000000;;1975000000;390000000;;7924000000;8314000000;10289000000;1359000000;3000000;1938000000;4897000000;5620000000;7558000000;1039000000;-8494000000;10240000000;2731000000;10289000000
FISV;378146;USD;2016;Q4;2016-12-31;2016-10-27;433000000;440000000;300000000;902000000;;1728000000;405000000;;7610000000;8015000000;9743000000;1242000000;95000000;1820000000;4467000000;5382000000;7202000000;1024000000;-7401000000;8994000000;2541000000;9743000000
FISV;378146;USD;2015;Q4;2015-12-31;2015-10-28;454800000;463200000;275000000;802000000;;1506000000;396000000;;7438000000;7834000000;9340000000;1024000000;5000000;1502000000;4288000000;5178000000;6680000000;956000000;-6286000000;8064000000;2660000000;9340000000
FISV;378146;USD;2014;Q4;2014-12-31;2014-10-29;486200000;494000000;294000000;798000000;;1444000000;317000000;;7547000000;7864000000;9308000000;905000000;92000000;1486000000;3698000000;4527000000;6013000000;901000000;-4895000000;7352000000;3295000000;9308000000
FISV;378146;USD;2013;Q4;2013-12-31;2013-10-30;515600000;523600000;400000000;751000000;;1572000000;266000000;;7675000000;7941000000;9513000000;756000000;92000000;1332000000;3756000000;4596000000;5928000000;848000000;-3801000000;6598000000;3585000000;9513000000
FISV;378146;USD;2012;Q4;2012-12-31;2012-10-31;534000000;540400000;358000000;661000000;;1443000000;248000000;;6806000000;7054000000;8497000000;721000000;2000000;1105000000;3228000000;3975000000;5080000000;806000000;-3279000000;5950000000;3417000000;8497000000
FISV;378146;USD;2011;Q4;2011-12-31;2011-11-02;562800000;569200000;337000000;666000000;;1356000000;258000000;;6934000000;7192000000;8548000000;836000000;179000000;1384000000;3216000000;3906000000;5290000000;779000000;-2782000000;5339000000;3258000000;8548000000
FISV;378146;USD;2010;Q4;2010-12-31;2010-11-05;592000000;598400000;563000000;572000000;;1417000000;267000000;;6597000000;6864000000;8281000000;537000000;3000000;891000000;3353000000;4161000000;5052000000;752000000;-2340000000;4867000000;3229000000;8281000000
FISV;378146;USD;2009;Q4;2009-12-31;2009-11-06;614400000;618400000;363000000;554000000;;1277000000;293000000;;6808000000;7101000000;8378000000;565000000;259000000;1161000000;3382000000;4191000000;5352000000;729000000;-2005000000;4371000000;3026000000;8378000000
FISV;378146;USD;2008;Q4;2008-12-31;2009-08-06;632400000;633200000;230000000;591000000;;2202000000;298000000;;6831000000;7129000000;9331000000;606000000;255000000;2040000000;3850000000;4697000000;6737000000;708000000;-1889000000;3895000000;2594000000;9331000000
FISV;378146;USD;2018;Q4;2018-12-31;2019-02-21;396700000;404800000;415000000;1049000000;;2224000000;398000000;;8640000000;9038000000;11262000000;1626000000;4000000;2010000000;5955000000;6959000000;8969000000;1065000000;-10340000000;11635000000;2293000000;11262000000
FLS;378147;USD;2016;Q4;2016-12-31;2017-08-11;130833000;131879000;367162000;882638000;897690000;2297689000;724805000;;1686429000;2411234000;4708923000;1093073000;85365000;1178438000;1485258000;1893097000;3071535000;712839000;-2078527000;3598396000;1637388000;4708923000
FLS;378147;USD;2015;Q4;2015-12-31;2016-02-18;130591000;131299000;366444000;985772000;978641000;2457322000;758427000;;1747357000;2505784000;4963106000;1289942000;60434000;1350376000;1560562000;1948348000;3298724000;715952000;-2106785000;3565958000;1664382000;4963106000
FLS;378147;USD;2014;Q4;2014-12-31;2015-02-17;136061000;136978000;450350000;1082447000;995564000;2794163000;693881000;;1479976000;2173857000;4968020000;1405787000;53131000;1471875000;1101791000;1554302000;3026177000;716591000;-1830919000;3415738000;1941843000;4968020000
FLS;378147;USD;2013;Q4;2013-12-31;2014-02-18;139350000;140118000;363804000;1155327000;1060670000;2847382000;716289000;;1473062000;2189351000;5036733000;1473102000;72678000;1558099000;1127619000;1601513000;3159612000;697209000;-1600266000;2985391000;1877121000;5036733000
FLS;378147;USD;2012;Q4;2012-12-31;2013-02-21;149089000;150135000;304252000;1103724000;1086663000;2740216000;654179000;;1416563000;2070742000;4810958000;1523493000;59478000;1590625000;869116000;1325858000;2916483000;688847000;-1164496000;2579308000;1894475000;4810958000
FLS;378147;USD;2011;Q4;2011-12-31;2012-02-22;165380000;167002000;337356000;1060249000;1008379000;2628354000;598746000;;1395514000;1994260000;4622614000;1405943000;53623000;1470321000;451593000;874063000;2344384000;694747000;-424052000;2205524000;2278230000;4622614000
FLS;378147;USD;2010;Q4;2010-12-31;2011-02-23;167094000;168903000;557579000;839566000;886731000;2523744000;581245000;;1354921000;1936166000;4459910000;1388858000;51481000;1456375000;476230000;890502000;2346877000;687525000;-292210000;1848680000;2113033000;4459910000
FLS;378147;USD;2009;Q4;2009-12-31;2010-02-24;;;654320000;791722000;795233000;2499322000;560472000;;1189100000;1749572000;4248894000;1410251000;27355000;1458083000;539373000;989064000;2447147000;685339000;-275656000;1526774000;1801747000;4248894000
FLS;378147;USD;2008;Q4;2008-12-31;2010-02-24;;;472056000;808522000;834612000;2332425000;547235000;;1144034000;1691269000;4023694000;1565597000;27731000;1607996000;545617000;1041500000;2649496000;659848000;-248073000;1159634000;1374198000;4023694000
FLS;378147;USD;2017;Q4;2017-12-31;2018-02-28;130758000;131420000;703445000;856711000;884273000;2558745000;671796000;;1679933000;2351729000;4910474000;1167309000;75599000;1242908000;1499658000;1996612000;3239520000;709317000;-2059558000;3503947000;1670954000;4910474000
FLS;378147;USD;2018;Q4;2018-12-31;2019-02-20;130844000;131413000;619683000;792434000;633871000;2383145000;610096000;;1623036000;2233132000;4616277000;810299000;68218000;1080975000;1414829000;1874522000;2955497000;715542000;-2049404000;3543007000;1660780000;4616277000
FLR;378148;USD;2017;Q4;2017-12-31;2018-02-20;139896000;141966000;1965209000;1602751000;;5601257000;1093681000;992485000;1640269000;3726435000;9327692000;2672773000;27361000;3574170000;1591598000;2261123000;5835293000;89621000;;3654931000;3492399000;9327692000
FLR;378148;USD;2016;Q4;2016-12-31;2017-02-17;139258000;141058000;1961473000;1700224000;;5610270000;1017223000;883938000;1704986000;3606147000;9216417000;2970012000;82243000;3816029000;1517949000;2157557000;5973586000;39710000;;3582150000;3242831000;9216417000
FLR;378148;USD;2015;Q4;2015-12-31;2016-02-18;140935000;142967000;2146978000;1203024000;;5105400000;892340000;558564000;1069102000;2520006000;7625406000;2181315000;;2935352000;986564000;1576555000;4511907000;1390000;;3428732000;3113499000;7625406000
FLR;378148;USD;2014;Q4;2014-12-31;2015-02-18;153938000;156194000;2098256000;1471705000;;5758047000;980263000;533449000;922670000;2436382000;8194429000;2732693000;28742000;3330853000;991685000;1639746000;4970599000;1486000;;3593597000;3223830000;8194429000
FLR;378148;USD;2013;Q4;2013-12-31;2014-02-18;162119000;164445000;2469605000;1274024000;;6003683000;966953000;473588000;879626000;2320167000;8323850000;2633797000;29839000;3407160000;496604000;1035867000;4443027000;14524000;;4040664000;3880823000;8323850000
FLR;378148;USD;2012;Q4;2012-12-31;2013-02-20;164708000;166150000;2291668000;1242691000;;6094137000;951255000;461249000;769402000;2181906000;8276043000;2996175000;20792000;3887114000;520205000;961835000;4848949000;1624000;;3597521000;3427094000;8276043000
FLR;378148;USD;2011;Q4;2011-12-31;2012-02-22;169184000;170799000;2257849000;1234023000;;5878711000;921585000;632849000;835219000;2389653000;8268364000;2726034000;19458000;3838199000;513500000;970259000;4808458000;4264000;;3590553000;3459906000;8268364000
FLR;378148;USD;2010;Q4;2010-12-31;2011-02-23;177563000;184247000;2328276000;1215007000;;5562825000;866343000;413986000;771769000;2052098000;7614923000;2351695000;96692000;3523383000;17759000;562915000;4086298000;563353000;;3109957000;3528625000;7614923000
FLR;378148;USD;2009;Q4;2009-12-31;2010-02-25;178170000;179922000;2290622000;988991000;;5122088000;837034000;520445000;698916000;2056395000;7178483000;2211172000;109789000;3301398000;17740000;543192000;3844590000;684092000;;2842428000;3333893000;7178483000
FLR;378148;USD;2008;Q4;2008-12-31;2009-02-25;180412000;182275000;2107894000;1227224000;;4668518000;799836000;214846000;740377000;1755059000;6423577000;2029925000;133194000;3162226000;17722000;538167000;3700393000;780353000;;2247938000;2723184000;6423577000
FLR;378148;USD;2007;Q4;2007-12-31;2008-11-06;175092000;179156000;1714386000;946565000;;4059500000;784387000;184973000;767319000;1736679000;5796179000;1780387000;307222000;2860094000;17704000;661626000;3521720000;707015000;;1641616000;2274459000;5796179000
FLR;378148;USD;2018;Q4;2018-12-31;2019-02-21;140186000;142134000;1979574000;1534339000;;5440893000;1013732000;938490000;1520522000;3472744000;8913637000;2669678000;26887000;3552513000;1661565000;2243074000;5795587000;83502000;;3422157000;3118050000;8913637000
FMC;378149;USD;2016;Q4;2016-12-31;2017-02-28;154335968;155163822;64200000;1692500000;478900000;2849200000;538100000;;2752000000;3290100000;6139300000;940700000;94200000;1438200000;1798800000;2708100000;4146300000;437200000;-1506600000;3505500000;1993000000;6139300000
FMC;378149;USD;2015;Q4;2015-12-31;2016-02-26;154137652;152638752;78600000;1851400000;800200000;2971900000;1016400000;;2337600000;3354000000;6325900000;1023600000;112600000;1453300000;2036300000;2964300000;4417600000;436300000;-1498300000;3385000000;1908300000;6325900000
FMC;378149;USD;2014;Q4;2014-12-31;2015-02-27;153934724;154649584;109500000;1602500000;607600000;2934400000;930000000;;1461600000;2391600000;5326000000;1056400000;525200000;1910400000;1138900000;1851600000;3762000000;420500000;-1498700000;2984500000;1564000000;5326000000
FMC;378149;USD;2013;Q4;2013-12-31;2014-02-18;153736408;154903244;123200000;1484300000;688400000;2945000000;1248300000;;1041900000;2290200000;5235200000;1033900000;697800000;1986700000;1154100000;1676400000;3663100000;466900000;-1502500000;2757300000;1572100000;5235200000
FMC;378149;USD;2012;Q4;2012-12-31;2013-02-19;159003312;160326956;77100000;1073700000;642400000;2181900000;956200000;;1235800000;2192000000;4373900000;854200000;55600000;1135500000;908800000;1683600000;2819100000;500500000;-1147800000;2536500000;1554800000;4373900000
FMC;378149;USD;2011;Q4;2011-12-31;2012-02-21;161562972;163186396;158900000;931300000;470300000;1869400000;986800000;;887300000;1874100000;3743500000;778700000;46500000;919900000;779100000;1519500000;2439400000;473100000;-1018700000;2176200000;1304100000;3743500000
FMC;378149;USD;2010;Q4;2010-12-31;2011-02-22;165432440;167231120;161500000;852900000;347800000;1646200000;918500000;;755200000;1673700000;3319900000;804400000;134900000;963400000;503000000;1167300000;2130700000;452900000;-862700000;1853000000;1189200000;3319900000
FMC;378149;USD;2009;Q4;2009-12-31;2010-02-22;;;76600000;749600000;350500000;1487700000;964500000;;684000000;1648500000;3136200000;603800000;55900000;709200000;588000000;1293900000;2003100000;397900000;-759200000;1716900000;1133100000;3136200000
FMC;378149;USD;2008;Q4;2008-12-31;2009-08-05;;;52400000;687700000;380800000;1432800000;939200000;;621900000;1561100000;2993900000;708100000;30700000;759100000;592900000;1268400000;2027500000;404800000;-750500000;1524700000;966400000;2993900000
FMC;378149;USD;2017;Q4;2017-12-31;2018-02-28;155016238;150337364;283000000;2043500000;992500000;3652700000;1025200000;;4528400000;5553600000;9206300000;1583400000;192600000;2209400000;2993000000;4289800000;6499200000;469300000;-1499600000;3952400000;2707100000;9206300000
FMC;378149;USD;2018;Q4;2018-12-31;2019-02-28;153828648;155373668;134400000;2143800000;1025500000;4030200000;756900000;;5187200000;5944100000;9974300000;1822900000;547700000;2993400000;2145000000;3770500000;6763900000;794800000;-1699100000;4334300000;3210400000;9974300000
FTI_old;378150;USD;2015;Q4;2015-12-31;2016-02-24;456200000;458000000;916200000;884000000;764100000;3930200000;1371500000;29600000;1088100000;2489200000;6419400000;762300000;21900000;2305300000;1134100000;1570900000;3876200000;754900000;-1607800000;4249700000;2543200000;6419400000
FTI_old;378150;USD;2014;Q4;2014-12-31;2015-02-20;469400000;471200000;638800000;2127000000;1021200000;4436400000;1458400000;35900000;1241400000;2735700000;7172100000;1133200000;11700000;2783600000;1293700000;1910800000;4694400000;726800000;-1431100000;3844300000;2477700000;7172100000
FTI_old;378150;USD;2013;Q4;2013-12-31;2014-02-21;476000000;477600000;399100000;2067200000;980400000;4023000000;1349100000;44300000;1189200000;2582600000;6605600000;1110800000;42500000;2614700000;1329800000;1654600000;4269300000;708400000;-1196600000;3146100000;2336300000;6605600000
FTI_old;378150;USD;2012;Q4;2012-12-31;2013-02-22;478000000;480200000;342100000;1765500000;965100000;3488300000;1243500000;37400000;1133700000;2414600000;5902900000;906400000;60400000;1970400000;1580400000;2079300000;4049700000;690800000;-1102600000;2644700000;1853200000;5902900000
FTI_old;378150;USD;2011;Q4;2011-12-31;2012-02-27;479400000;483800000;344000000;1341600000;712200000;2787900000;767900000;161400000;553800000;1483100000;4271000000;818000000;587600000;2232900000;36000000;600400000;2833300000;695600000;-1041900000;2214700000;1437700000;4271000000
FTI_old;378150;USD;2010;Q4;2010-12-31;2011-02-28;482200000;486800000;315500000;1103400000;566500000;2345300000;609000000;148200000;541700000;1298900000;3644200000;529100000;12200000;1495400000;351100000;826500000;2321900000;696700000;-947800000;1814900000;1322300000;3644200000
FTI_old;378150;USD;2009;Q4;2009-12-31;2010-03-01;491600000;498000000;460700000;879200000;591800000;2268100000;581900000;141800000;564600000;1288300000;3556400000;542300000;28500000;1721000000;391600000;723600000;2444600000;705800000;-816100000;1438900000;1111800000;3556400000
FTI_old;378150;USD;2008;Q4;2008-12-31;2009-08-07;502800000;509200000;340100000;996100000;559300000;2438300000;494900000;151200000;496500000;1142600000;3580900000;542200000;23000000;1963300000;472000000;918900000;2882200000;723800000;-706000000;1081000000;698700000;3580900000
FTV;378151;USD;2017;Q4;2017-12-31;2018-02-28;348100000;353800000;962100000;1143600000;580600000;2936800000;712500000;;6851300000;7563800000;10500600000;1602300000;0;1602300000;4056200000;5090100000;6692400000;2447600000;;1350300000;3808200000;10500600000
FTV;378151;USD;2016;Q4;2016-12-31;2017-02-28;346400000;349600000;803200000;945400000;544600000;2488700000;547600000;;5153500000;5701100000;8189800000;1466500000;;1466500000;3358000000;4032300000;5498800000;2430700000;;403000000;2691000000;8189800000
FTV;378151;USD;2015;Q4;2015-12-31;2016-08-02;345200000;345200000;0;979300000;522900000;1594100000;514800000;;5101700000;5616500000;7210600000;1323500000;;1323500000;0;704600000;2028100000;5193900000;;0;5182500000;7210600000
FTV;378151;USD;2018;Q4;2018-12-31;2019-02-28;334300000;338100000;1178400000;1195100000;574500000;3171200000;576100000;;9158300000;9734400000;12905600000;1705800000;455600000;2192100000;2974700000;4100600000;6292700000;3129400000;;3552700000;6612900000;12905600000
FBHS;378152;USD;2015;Q4;2015-12-31;2016-02-25;159700000;163000000;238500000;502600000;555600000;1418000000;627900000;;2829800000;3457700000;4875700000;345000000;;757900000;1168700000;1664000000;2421900000;2603900000;-602100000;501600000;2453800000;4875700000
FBHS;378152;USD;2014;Q4;2014-12-31;2015-02-25;158100000;162100000;191900000;458900000;462200000;1299100000;539800000;;2214000000;2753800000;4052900000;333800000;26300000;699600000;643700000;1090200000;1789800000;2519000000;-532300000;279500000;2263100000;4052900000
FBHS;378152;USD;2013;Q4;2013-12-31;2014-02-26;166300000;172000000;241400000;402800000;428900000;1327400000;468300000;;2382400000;2850700000;4178100000;320800000;0;738700000;350000000;786300000;1525000000;2433000000;-79800000;200800000;2653100000;4178100000
FBHS;378152;USD;2012;Q4;2012-12-31;2013-02-27;162900000;169000000;336000000;381700000;357200000;1227900000;509400000;;2136600000;2646000000;3873900000;292500000;22500000;632400000;297500000;856800000;1489200000;2326400000;-16900000;41000000;2384700000;3873900000
FBHS;378152;USD;2011;Q4;2011-12-31;2012-02-22;155500000;155500000;120800000;346100000;336300000;953500000;525800000;;2158600000;2684400000;3637900000;264500000;17500000;597800000;389300000;915600000;1513400000;2188000000;-100000;-77700000;2124500000;3637900000
FBHS;378152;USD;2010;Q4;2010-12-31;2011-11-10;;;60700000;374200000;332100000;1466000000;550000000;;2241600000;2791600000;4257600000;255800000;;576500000;16800000;3737800000;4314300000;703300000;;-793000000;-56700000;4257600000
FBHS;378152;USD;2016;Q4;2016-12-31;2017-02-28;153900000;157900000;251500000;550700000;531100000;1445200000;662500000;;3020800000;3683300000;5128500000;393800000;;842800000;1431100000;1922700000;2765500000;2655500000;-1036700000;814600000;2363000000;5128500000
FBHS;378152;USD;2017;Q4;2017-12-31;2018-02-28;151800000;154500000;323000000;555300000;580800000;1601700000;740000000;;3169700000;3909700000;5511400000;428800000;;906800000;1507600000;2003500000;2910300000;2726600000;-1262100000;1174200000;2601100000;5511400000
FBHS;378152;USD;2018;Q4;2018-12-31;2019-02-25;141200000;142600000;262900000;571700000;678900000;1686100000;813400000;;3465100000;4278500000;5964600000;459000000;525000000;1492100000;1809000000;2292500000;3784600000;2767800000;-1970700000;1448100000;2180000000;5964600000
FCX;378154;USD;2017;Q4;2017-12-31;2018-02-20;1447000000;1455000000;4447000000;1246000000;2727000000;10689000000;22934000000;;3679000000;26613000000;37302000000;2886000000;1414000000;5011000000;11703000000;20995000000;26006000000;26909000000;-3723000000;-14722000000;11296000000;37302000000
FCX;378154;USD;2016;Q4;2016-12-31;2017-02-24;1406000000;1401000000;4245000000;1126000000;3642000000;10435000000;23293000000;;3589000000;26882000000;37317000000;2459000000;1232000000;4265000000;14795000000;23795000000;28060000000;26847000000;-3708000000;-16540000000;9257000000;37317000000
FCX;378154;USD;2015;Q4;2015-12-31;2016-02-26;1177000000;1177000000;177000000;645000000;4075000000;7462000000;31079000000;;8036000000;39115000000;46577000000;3255000000;649000000;4307000000;19675000000;29462000000;33769000000;24420000000;-3702000000;-12387000000;12808000000;46577000000
FCX;378154;USD;2014;Q4;2014-12-31;2015-02-27;1040000000;1021000000;464000000;953000000;3800000000;9045000000;45494000000;;4135000000;49629000000;58674000000;4398000000;478000000;5172000000;18371000000;30277000000;35449000000;22398000000;-3695000000;128000000;23225000000;58674000000
FCX;378154;USD;2013;Q4;2013-12-31;2014-02-27;1040000000;1044000000;1985000000;1728000000;3435000000;9972000000;47401000000;;6100000000;53501000000;63473000000;4225000000;312000000;4773000000;20394000000;32753000000;37526000000;22278000000;-3681000000;2742000000;25947000000;63473000000
FCX;378154;USD;2012;Q4;2012-12-31;2013-02-22;949000000;955000000;3705000000;927000000;3176000000;10297000000;20999000000;;4144000000;25143000000;35440000000;2716000000;2000000;3343000000;3525000000;10786000000;14129000000;19226000000;-3576000000;2399000000;21311000000;35440000000
FCX;378154;USD;2011;Q4;2011-12-31;2012-02-27;947000000;954000000;4822000000;892000000;2643000000;10047000000;18449000000;;3574000000;22023000000;32070000000;2597000000;4000000;2940000000;3533000000;10577000000;13517000000;19114000000;-3553000000;546000000;18553000000;32070000000
FCX;378154;USD;2010;Q4;2010-12-31;2011-02-25;943000000;955000000;3738000000;2132000000;2118000000;9851000000;16785000000;;2750000000;19535000000;29386000000;3329000000;95000000;3763000000;4660000000;11063000000;14826000000;18858000000;-3441000000;-2590000000;14560000000;29386000000
FCX;378154;USD;2009;Q4;2009-12-31;2010-02-26;860000000;1064000000;2656000000;1517000000;1760000000;7433000000;16195000000;;2368000000;18563000000;25996000000;2611000000;16000000;3002000000;6330000000;12237000000;15239000000;15735000000;-3413000000;-5805000000;10757000000;25996000000
FCX;378154;USD;2008;Q4;2008-12-31;2009-05-11;754000000;360000000;872000000;374000000;1735000000;5233000000;16002000000;;2118000000;18120000000;23353000000;2929000000;67000000;3158000000;7284000000;13094000000;16252000000;14040000000;-3402000000;-8267000000;7101000000;23353000000
FCX;378154;USD;2018;Q4;2018-12-31;2019-02-15;1448000000;1458000000;4217000000;829000000;2981000000;10720000000;28010000000;;3486000000;31496000000;42216000000;2863000000;17000000;3329000000;11124000000;20995000000;24324000000;26171000000;-3727000000;-12041000000;17892000000;42216000000
GGP_old;378155;USD;2009;Q4;2009-12-31;2010-03-01;;;654396000;404041000;1753175000;2811612000;22102630000;;3235532000;25338162000;28149774000;1122888000;;18928430000;7300772000;8167172000;27095602000;3732591000;-76752000;-2832627000;1054172000;28149774000
GGP_old;378155;USD;2008;Q4;2008-12-31;2009-08-10;;;168993000;385334000;1823362000;2377689000;23800065000;;3379576000;27179641000;29557330000;1539149000;;1571443000;24756577000;25625555000;27196998000;3457607000;-76752000;-1488586000;2360332000;29557330000
GT;378156;USD;2016;Q4;2016-12-31;2017-02-08;259000000;259000000;1132000000;1769000000;2627000000;5718000000;7040000000;;3753000000;10793000000;16511000000;2589000000;681000000;4817000000;4798000000;6969000000;11786000000;2897000000;;5808000000;4725000000;16511000000
GT;378156;USD;2015;Q4;2015-12-31;2016-02-09;267000000;270000000;1476000000;2033000000;2464000000;6126000000;6777000000;;3488000000;10265000000;16391000000;2769000000;634000000;4955000000;5074000000;7294000000;12249000000;3360000000;;4570000000;4142000000;16391000000
GT;378156;USD;2014;Q4;2014-12-31;2015-02-17;273000000;308000000;2161000000;2126000000;2671000000;7159000000;7153000000;;3732000000;10885000000;18044000000;2878000000;178000000;4730000000;6216000000;8887000000;13617000000;3410000000;;4331000000;4427000000;18044000000
GT;378156;USD;2013;Q4;2013-12-31;2014-02-13;247000000;300000000;2996000000;2435000000;2816000000;8644000000;7320000000;;1563000000;8883000000;17527000000;3097000000;87000000;5025000000;6162000000;10057000000;15082000000;3095000000;;1958000000;2445000000;17527000000
GT;378156;USD;2012;Q4;2012-12-31;2013-02-12;246000000;182000000;2281000000;2563000000;3250000000;8498000000;6956000000;;1519000000;8475000000;16973000000;3223000000;198000000;5322000000;4888000000;10492000000;15814000000;3060000000;;1370000000;1159000000;16973000000
GT;378156;USD;2011;Q4;2011-12-31;2012-02-14;245000000;310000000;2772000000;2849000000;3856000000;9812000000;6375000000;;1442000000;7817000000;17629000000;3668000000;412000000;5929000000;4789000000;10076000000;16005000000;3053000000;;1187000000;1624000000;17629000000
GT;378156;USD;2010;Q4;2010-12-31;2011-02-10;242000000;240000000;2005000000;2736000000;2977000000;8045000000;6165000000;;1420000000;7585000000;15630000000;3107000000;426000000;5307000000;4319000000;8818000000;14125000000;3048000000;;866000000;1505000000;15630000000
GT;378156;USD;2009;Q4;2009-12-31;2010-07-29;241000000;241000000;1922000000;2540000000;2443000000;7225000000;5843000000;;1342000000;7185000000;14410000000;2278000000;338000000;4095000000;4182000000;8736000000;12831000000;3025000000;;1082000000;1579000000;14410000000
GT;378156;USD;2017;Q4;2017-12-31;2018-02-08;242000000;246000000;1043000000;2025000000;2787000000;6079000000;7451000000;;3534000000;10985000000;17064000000;2807000000;653000000;5025000000;5076000000;7189000000;12214000000;2535000000;;6044000000;4850000000;17064000000
GT;378156;USD;2018;Q4;2018-12-31;2019-02-08;233000000;233000000;801000000;2030000000;2856000000;5925000000;7259000000;;3688000000;10947000000;16872000000;2920000000;653000000;4781000000;5110000000;7021000000;11802000000;2343000000;;6597000000;5070000000;16872000000
HOG;378159;USD;2016;Q4;2016-12-31;2017-02-21;176250000;177277000;765503000;2361367000;499917000;3853852000;981593000;4759197000;295598000;6036388000;9890240000;721970000;2140592000;2862562000;4666975000;5107520000;7970082000;1383668000;-235802000;1337673000;1920158000;9890240000
HOG;378159;USD;2015;Q4;2015-12-31;2016-02-18;188847000;189786000;767401000;2300987000;585907000;3977883000;942418000;4814571000;238105000;5995094000;9972977000;707578000;2039729000;2747307000;4832469000;5386016000;8133323000;1332010000;-7839136000;8961985000;1839654000;9972977000
HOG;378159;USD;2014;Q4;2014-12-31;2015-02-19;212900000;214277000;964005000;2164256000;448871000;3948095000;883077000;4516246000;180679000;5580002000;9528097000;646185000;1743101000;2389286000;3761528000;4229525000;6618811000;1268699000;-6303510000;8459040000;2909286000;9528097000
HOG;378159;USD;2013;Q4;2013-12-31;2014-02-20;220483000;222180000;1165621000;2034751000;424507000;3988803000;842477000;4225877000;347883000;5416237000;9405040000;667129000;1842457000;2509586000;3416713000;3885968000;6395554000;1178484000;-5689051000;7852729000;3009486000;9405040000
HOG;378159;USD;2012;Q4;2012-12-31;2013-02-22;224630000;226720000;1203772000;1973124000;393524000;4050936000;815464000;4038807000;265566000;5119837000;9170773000;770977000;732105000;1503082000;4370544000;5110067000;6613149000;1069482000;-5210604000;7306424000;2557624000;9170773000
HOG;378159;USD;2011;Q4;2011-12-31;2012-02-23;229600000;231740000;1680330000;1979506000;418006000;4542206000;809459000;4026214000;296285000;5131958000;9674164000;819885000;1878733000;2698618000;3843886000;4555290000;7253908000;971783000;-4898974000;6824180000;2420256000;9674164000
HOG;378159;USD;2010;Q4;2010-12-31;2011-02-24;233566000;235281000;1162051000;2041840000;326446000;4066626000;815112000;4238111000;310891000;5364114000;9430740000;782017000;1231765000;2013782000;4520591000;5210092000;7223874000;911437000;-4674426000;6336077000;2206866000;9430740000
HOG;378159;USD;2009;Q4;2009-12-31;2010-02-23;;;1670118000;1705485000;323029000;4341949000;906906000;3621048000;285615000;4813569000;9155518000;676599000;1522090000;2268224000;4114039000;4779176000;7047400000;874468000;-4672720000;6324268000;2108118000;9155518000
HOG;378159;USD;2008;Q4;2008-12-31;2009-07-31;;;568894000;4087745000;379141000;5526552000;1056928000;817102000;428043000;2302073000;7828625000;806743000;1738649000;2623333000;2176238000;3089689000;5713022000;850153000;-4670802000;6458778000;2115603000;7828625000
HOG;378159;USD;2017;Q4;2017-12-31;2018-02-21;167720000;168646000;687521000;2435648000;538202000;3884742000;967781000;4859424000;260725000;6087930000;9972672000;757419000;2400751000;3158170000;4587258000;4970225000;8128395000;1424621000;-687865000;1607570000;1844277000;9972672000
HOG;378159;USD;2018;Q4;2018-12-31;2019-02-28;162033000;162974000;1213773000;2520898000;556128000;4484442000;904132000;5007507000;269583000;6181222000;10665664000;885991000;2711609000;3597600000;4887667000;5294115000;8891715000;1461439000;-1065389000;2007583000;1773949000;10665664000
HAR;378160;USD;2016;Q4;2016-06-30;2016-08-11;71333000;72100000;602300000;1122920000;706084000;2918455000;593290000;;2536124000;3129414000;6047869000;1745165000;86641000;1831806000;1310333000;1763590000;3595396000;1411777000;-1372633000;2490570000;2452473000;6047869000
HAR;378160;USD;2015;Q4;2015-06-30;2015-08-07;71909000;72233000;649513000;1024139000;693574000;2828592000;552421000;;2484887000;3037308000;5865900000;2065396000;5571000;2070967000;1080667000;1402107000;3473074000;1366264000;-1232602000;2229517000;2392826000;5865900000
HAR;378160;USD;2014;Q4;2014-06-30;2014-08-07;69091000;69719000;581312000;894579000;662128000;2458871000;509856000;;1156863000;1666719000;4125590000;1446291000;39361000;1485652000;519407000;846917000;2332569000;1041238000;-1267693000;1979234000;1793021000;4125590000
HAR;378160;USD;2013;Q4;2013-06-30;2013-08-09;69160000;69847000;464266000;722711000;549831000;2089052000;425182000;;721451000;1146633000;3235685000;1042584000;34930000;1077514000;255043000;513300000;1590814000;972718000;-1176914000;1827267000;1644871000;3235685000
HAR;378160;USD;2012;Q4;2012-06-30;2012-08-10;70820000;71547000;820370000;582835000;427597000;2116245000;430234000;;622985000;1053219000;3169464000;986264000;395636000;1381900000;0;257953000;1639853000;944932000;-1171516000;1726486000;1529611000;3169464000
HAR;378160;USD;2011;Q4;2011-06-30;2011-08-11;71218000;71893000;921214000;579272000;423137000;2108155000;470300000;;480040000;950340000;3058495000;1045410000;2171000;1047581000;378401000;587256000;1634837000;916389000;-1047570000;1418106000;1423658000;3058495000
HAR;378160;USD;2010;Q4;2010-06-30;2010-08-06;71141000;71194000;645570000;517092000;353123000;1673979000;421949000;;460287000;882236000;2556215000;849516000;13935000;863451000;363902000;557872000;1421323000;893081000;-1047570000;1285715000;1134892000;2556215000
HAR;378160;USD;2009;Q4;2009-06-30;2010-04-29;59432000;59432000;586359000;410703000;333595000;1506322000;513826000;;453349000;967175000;2473497000;718932000;605000;743530000;576691000;722049000;1465579000;870558000;-1047570000;1126946000;1007918000;2473497000
HCA;378161;USD;2016;Q4;2016-12-31;2017-02-22;373362000;384578000;646000000;5826000000;1503000000;9086000000;16352000000;542000000;7778000000;24672000000;33758000000;5618000000;216000000;5834000000;31160000000;33557000000;39391000000;4000000;;-6968000000;-5633000000;33758000000
HCA;378161;USD;2015;Q4;2015-12-31;2016-02-26;405278000;415765000;741000000;5889000000;1439000000;9232000000;15014000000;610000000;7888000000;23512000000;32744000000;5283000000;233000000;5516000000;30255000000;33274000000;38790000000;4000000;;-7338000000;-6046000000;32744000000
HCA;378161;USD;2014;Q4;2014-12-31;2015-02-26;429072000;443690000;566000000;5694000000;1279000000;8930000000;14355000000;659000000;7036000000;22050000000;30980000000;5142000000;338000000;5480000000;29088000000;31998000000;37478000000;4000000;;-7575000000;-6498000000;30980000000
HCA;378161;USD;2013;Q4;2013-12-31;2014-02-26;441922000;458531000;414000000;5208000000;1179000000;8037000000;13619000000;569000000;6606000000;20794000000;28831000000;4909000000;786000000;5695000000;27590000000;30064000000;35759000000;1390000000;;-9403000000;-6928000000;28831000000
HCA;378161;USD;2012;Q4;2012-12-31;2013-02-27;442404000;461164000;705000000;4672000000;1086000000;7763000000;13185000000;619000000;6508000000;20312000000;28075000000;4737000000;1435000000;6172000000;27495000000;30244000000;36416000000;1757000000;;-10960000000;-8341000000;28075000000
HCA;378161;USD;2011;Q4;2011-12-31;2012-02-24;437369000;455731000;373000000;4533000000;1054000000;7233000000;12834000000;649000000;6182000000;19665000000;26898000000;4147000000;1407000000;5554000000;25645000000;28358000000;33912000000;1605000000;;-9423000000;-7014000000;26898000000
HCA;378161;USD;2010;Q4;2010-12-31;2011-05-11;426656000;437572000;411000000;3832000000;897000000;6919000000;11352000000;1511000000;4070000000;16933000000;23852000000;3677000000;592000000;4269000000;27633000000;30377000000;34646000000;390000000;;-11888000000;-10794000000;23852000000
HCA;378161;USD;2017;Q4;2017-12-31;2018-02-23;352914000;363732000;732000000;6501000000;1573000000;9977000000;17895000000;617000000;8104000000;26616000000;36593000000;5958000000;200000000;6158000000;32858000000;35430000000;41588000000;4000000;;-6532000000;-4995000000;36593000000
HCA;378161;USD;2018;Q4;2018-12-31;2019-02-21;343900000;352785000;502000000;6789000000;1732000000;10213000000;19757000000;594000000;8643000000;28994000000;39207000000;6781000000;788000000;7569000000;32033000000;34556000000;42125000000;3000000;;-4572000000;-2918000000;39207000000
HES;378163;USD;2016;Q4;2016-12-31;2017-02-23;313400000;313400000;2732000000;940000000;323000000;4276000000;23595000000;;750000000;24345000000;28621000000;2139000000;112000000;2251000000;6694000000;10779000000;13030000000;6090000000;;10147000000;15591000000;28621000000
HES;378163;USD;2015;Q4;2015-12-31;2016-02-26;283100000;283100000;2716000000;847000000;399000000;4404000000;26352000000;;3401000000;29753000000;34157000000;2542000000;86000000;2628000000;6506000000;11128000000;13756000000;4413000000;;16637000000;20401000000;34157000000
HES;378163;USD;2014;Q4;2014-12-31;2015-02-27;286300000;289100000;2444000000;1642000000;527000000;6313000000;27517000000;;4577000000;32094000000;38407000000;4783000000;68000000;4851000000;5919000000;11236000000;16087000000;3563000000;;20052000000;22320000000;38407000000
HES;378163;USD;2013;Q4;2013-12-31;2014-02-28;328100000;333700000;1814000000;3093000000;954000000;8599000000;28771000000;;5384000000;34155000000;42754000000;6180000000;378000000;6558000000;5420000000;11412000000;17970000000;3823000000;;21235000000;24784000000;42754000000
HES;378163;USD;2012;Q4;2012-12-31;2013-02-28;338500000;340500000;642000000;4057000000;1259000000;8387000000;28807000000;;6247000000;35054000000;43441000000;7056000000;787000000;8382000000;7324000000;13856000000;22238000000;3866000000;;17717000000;21203000000;43441000000
HES;378163;USD;2011;Q4;2011-12-31;2012-02-27;337167000;339796000;351000000;4761000000;1423000000;8339000000;24712000000;;6085000000;30797000000;39136000000;8048000000;52000000;8100000000;6005000000;12444000000;20544000000;3757000000;;15826000000;18592000000;39136000000
HES;378163;USD;2010;Q4;2010-12-31;2011-02-25;328397000;331128000;1608000000;4478000000;1452000000;8780000000;21127000000;;5489000000;26616000000;35396000000;7567000000;46000000;7613000000;5537000000;10974000000;18587000000;3594000000;;14254000000;16809000000;35396000000
HES;378163;USD;2009;Q4;2009-12-31;2010-02-26;324172000;328660000;1362000000;3650000000;1438000000;7987000000;16627000000;;4851000000;21478000000;29465000000;6702000000;148000000;6850000000;4319000000;9087000000;15937000000;2808000000;;12251000000;13528000000;29465000000
HES;378163;USD;2008;Q4;2008-12-31;2009-08-07;;326288000;908000000;4059000000;1308000000;7332000000;16271000000;;4986000000;21257000000;28589000000;7587000000;143000000;7730000000;3812000000;8468000000;16198000000;2673000000;;11642000000;12391000000;28589000000
HES;378163;USD;2017;Q4;2017-12-31;2018-02-21;313600000;313600000;4847000000;677000000;232000000;6157000000;16192000000;;763000000;16955000000;23112000000;1855000000;580000000;2435000000;6397000000;8323000000;10758000000;6139000000;;5597000000;12354000000;23112000000
HES;378163;USD;2018;Q4;2018-12-31;2019-02-21;291500000;291500000;2694000000;;245000000;4459000000;16083000000;;891000000;16974000000;21433000000;2136000000;67000000;2203000000;6605000000;8342000000;10545000000;5677000000;;4257000000;10888000000;21433000000
ITW;378165;USD;2016;Q4;2016-12-31;2017-02-10;347900000;350500000;2472000000;2357000000;1076000000;6123000000;1652000000;;7426000000;9078000000;15201000000;2108000000;652000000;2760000000;7177000000;8182000000;10942000000;1194000000;-14638000000;19505000000;4259000000;15201000000
ITW;378165;USD;2015;Q4;2015-12-31;2016-02-12;363700000;365700000;3090000000;2203000000;1086000000;6720000000;1577000000;;7432000000;9009000000;15729000000;1842000000;526000000;2368000000;6896000000;8133000000;10501000000;1141000000;-12729000000;18316000000;5228000000;15729000000
ITW;378165;USD;2014;Q4;2014-12-31;2015-02-13;386200000;389000000;3990000000;2293000000;1180000000;7864000000;1686000000;;7915000000;9601000000;17465000000;2049000000;1476000000;3525000000;5943000000;7116000000;10641000000;1102000000;-10798000000;17173000000;6824000000;17465000000
ITW;378165;USD;2013;Q4;2013-12-31;2014-02-14;437600000;441000000;3618000000;2365000000;1247000000;9816000000;1709000000;;8441000000;10150000000;19966000000;2156000000;3551000000;6034000000;2793000000;4223000000;10257000000;1052000000;-6676000000;14943000000;9709000000;19966000000
ITW;378165;USD;2012;Q4;2012-12-31;2013-02-19;459500000;463000000;2779000000;2742000000;1585000000;7960000000;1994000000;;9355000000;11349000000;19309000000;2184000000;459000000;2651000000;4589000000;6088000000;8739000000;1017000000;-4722000000;13973000000;10570000000;19309000000
ITW;378165;USD;2011;Q4;2011-12-31;2012-02-17;482900000;485000000;1178000000;2819000000;1716000000;6849000000;2025000000;409000000;8701000000;11135000000;17984000000;2363000000;502000000;2977000000;3488000000;4973000000;7950000000;691000000;-2692000000;11794000000;10034000000;17984000000
ITW;378165;USD;2010;Q4;2010-12-31;2011-02-28;496760000;498940000;1186367000;2581592000;1634856000;5970488000;2066156000;440760000;7934907000;10441823000;16412311000;2696616000;326236000;3022852000;2542087000;3817460000;6840312000;466191000;-1740682000;10407946000;9571999000;16412311000
ITW;378165;USD;2009;Q4;2009-12-31;2010-02-26;501817000;505433000;1318772000;2491492000;1356233000;5674595000;2136527000;451293000;7819569000;10407389000;16081984000;2621957000;213681000;2835638000;2914874000;4428470000;7264108000;276335000;-1390594000;9521740000;8817876000;16081984000
ITW;378165;USD;2008;Q4;2008-12-31;2009-08-07;508778000;508874000;742950000;2571987000;1774697000;5753979000;2109432000;465894000;6874246000;9449572000;15203551000;2370574000;2433973000;4825093000;1247883000;2703367000;7528460000;110815000;-1390594000;9196465000;7675091000;15203551000
ITW;378165;USD;2017;Q4;2017-12-31;2018-02-15;342100000;344700000;3094000000;2628000000;1220000000;7278000000;1778000000;;7724000000;9502000000;16780000000;2203000000;850000000;3053000000;7478000000;9138000000;12191000000;1224000000;-15562000000;20210000000;4589000000;16780000000
ITW;378165;USD;2018;Q4;2018-12-31;2019-02-15;329800000;331400000;1504000000;2622000000;1318000000;5778000000;1791000000;;7301000000;9092000000;14870000000;2191000000;1351000000;3542000000;6029000000;8070000000;11612000000;1259000000;-17545000000;21217000000;3258000000;14870000000
ICE;378167;USD;2017;Q4;2017-12-31;2018-02-07;583000000;590000000;535000000;903000000;;53562000000;1246000000;;23456000000;24702000000;78264000000;817000000;1833000000;54175000000;4267000000;7104000000;61279000000;11398000000;-1076000000;6858000000;16985000000;78264000000
ICE;378167;USD;2016;Q4;2016-12-31;2016-11-01;595000000;599000000;430000000;777000000;;57133000000;1129000000;432000000;23309000000;24870000000;82003000000;749000000;2493000000;58617000000;3871000000;7596000000;66213000000;11312000000;-40000000;4789000000;15790000000;82003000000
ICE;378167;USD;2015;Q4;2015-12-31;2015-05-05;555000000;560000000;656000000;700000000;;53313000000;1037000000;299000000;23338000000;24674000000;77987000000;729000000;2591000000;54743000000;4717000000;8369000000;63112000000;12296000000;-1448000000;4148000000;14875000000;77987000000
ICE;378167;USD;2014;Q4;2014-12-31;2014-11-04;560000000;570000000;1852000000;508000000;;50232000000;874000000;379000000;16769000000;18022000000;68254000000;751000000;2042000000;50436000000;2235000000;5261000000;55697000000;9939000000;-743000000;3210000000;12557000000;68254000000
ICE;378167;USD;2013;Q4;2013-12-31;2013-11-05;465000000;480000000;1035000000;546000000;;44269000000;889000000;324000000;18940000000;20153000000;64422000000;839000000;1135000000;44321000000;3923000000;7398000000;51719000000;9795000000;-53000000;2482000000;12703000000;64422000000
ICE;378167;USD;2012;Q4;2012-12-31;2014-02-14;;;1612000000;127000000;;33750000000;144000000;391000000;2930000000;3465000000;37215000000;125000000;163000000;32246000000;969000000;1292000000;33538000000;1904000000;-717000000;2509000000;3677000000;37215000000
IPG;378168;USD;2017;Q4;2017-12-31;2018-02-26;384900000;392400000;790900000;4585000000;;7475500000;650400000;;4578800000;5229200000;12704700000;7094900000;86900000;7675300000;1285600000;2531000000;10206300000;993800000;-59000000;2104500000;2498400000;12704700000
IPG;378168;USD;2016;Q4;2016-12-31;2016-10-27;393200000;405000000;1097600000;4389700000;1518100000;7438000000;622000000;;4425200000;5047200000;12485200000;7097600000;409600000;7706000000;1280700000;2469700000;10175700000;1238600000;-63300000;1804300000;2309500000;12485200000
IPG;378168;USD;2015;Q4;2015-12-31;2015-10-22;403200000;418600000;1509700000;4361000000;1594400000;7693100000;567200000;;4324800000;4892000000;12585100000;7437600000;134800000;7584300000;1610300000;2747100000;10331400000;1444500000;-71000000;1437600000;2253700000;12585100000
IPG;378168;USD;2014;Q4;2014-12-31;2014-10-23;413700000;424300000;1667200000;4376600000;1424200000;7810200000;548200000;;4378200000;4926400000;12736600000;7354000000;109300000;7463300000;1612900000;2864700000;10328000000;1588700000;-19000000;1183300000;2408600000;12736600000
IPG;378168;USD;2013;Q4;2013-12-31;2013-10-24;425400000;429800000;1642100000;4565400000;1536400000;8084000000;540000000;;4281000000;4821000000;12905000000;7632600000;532700000;8165300000;1129800000;2239800000;10405100000;3028200000;-1266300000;864500000;2499900000;12905000000
IPG;378168;USD;2012;Q4;2012-12-31;2012-10-26;423700000;554200000;2590800000;4496600000;1318800000;8738300000;504800000;;4250800000;4755600000;13493900000;7313000000;388700000;7701700000;2060800000;3108400000;10810100000;2514200000;-765400000;738300000;2683800000;13493900000
IPG;378168;USD;2011;Q4;2011-12-31;2011-10-28;448100000;579000000;2315600000;4425400000;1247200000;8352200000;459800000;;4096700000;4556500000;12908700000;7477200000;558300000;8035500000;1210900000;2132500000;10168000000;2475700000;-414900000;405100000;2740700000;12908700000
IPG;378168;USD;2010;Q4;2010-12-31;2010-10-29;475400000;589200000;2689400000;4317600000;1217100000;8453500000;454300000;;4163000000;4617300000;13070800000;7587200000;153700000;7740900000;1583300000;2471800000;10212700000;2504300000;-14100000;-63700000;2858100000;13070800000
IPG;378168;USD;2009;Q4;2009-12-31;2010-07-29;470900000;630500000;2506100000;3756500000;1100100000;7637700000;490100000;;4135300000;4625400000;12263100000;6597000000;308600000;6905600000;1638000000;2543400000;9449000000;2488100000;-14000000;-324800000;2814100000;12263100000
IPG;378168;USD;2018;Q4;2018-12-31;2019-02-25;383600000;394700000;673400000;5126600000;;8182900000;790900000;;6646500000;7437400000;15620300000;7505000000;73800000;8123900000;3660200000;4895700000;13019600000;934200000;0;2400100000;2600700000;15620300000
IFF;378169;USD;2016;Q4;2016-12-31;2017-02-28;79582000;79894000;323992000;550658000;592017000;1609014000;775716000;;1632254000;2407970000;4016984000;389850000;258516000;898297000;1066855000;1487553000;2385850000;166951000;-1679147000;3818535000;1631134000;4016984000
IFF;378169;USD;2015;Q4;2015-12-31;2016-03-01;80022000;80440000;181988000;546125000;572047000;1437109000;732794000;;1532107000;2264901000;3702010000;330325000;132349000;725156000;935373000;1381865000;2107021000;155272000;-1555769000;3604254000;1594989000;3702010000
IFF;378169;USD;2014;Q4;2014-12-31;2015-03-02;80800000;81306000;478573000;502915000;568729000;1710027000;720268000;;1064326000;1784594000;3494621000;254006000;8090000;518808000;934232000;1453124000;1971932000;154478000;-1446221000;3350734000;1522689000;3494621000
IFF;378169;USD;2013;Q4;2013-12-31;2014-02-25;81251000;81612000;405505000;534986000;533806000;1652903000;687215000;;991613000;1678828000;3331731000;258473000;149000;560366000;932665000;1304314000;1864680000;145931000;-1365805000;3075657000;1467051000;3331731000
IFF;378169;USD;2012;Q4;2012-12-31;2013-02-26;81314000;81985000;324422000;508736000;540658000;1572687000;654641000;;1018864000;1673505000;3246192000;199272000;150071000;629878000;881104000;1363759000;1993637000;141974000;-1330707000;2841166000;1252555000;3246192000
IFF;378169;USD;2011;Q4;2011-12-31;2012-02-28;80680000;81601000;88279000;478177000;544439000;1317220000;608065000;;1040296000;1648361000;2965581000;233845000;116688000;564566000;778248000;1293608000;1858174000;143101000;-1356273000;2692893000;1107407000;2965581000
IFF;378169;USD;2010;Q4;2010-12-31;2011-02-24;80668000;81691000;131332000;458128000;531675000;1325195000;538118000;;1009142000;1547260000;2872455000;221810000;133899000;660951000;787668000;1208349000;1869300000;138279000;-1383212000;2519706000;1003155000;2872455000
IFF;378169;USD;2009;Q4;2009-12-31;2010-08-05;78574000;79418000;80135000;454528000;444977000;1128066000;501293000;;1015415000;1516708000;2644774000;180813000;76780000;484454000;934749000;1388410000;1872864000;124844000;-1424072000;2339205000;771910000;2644774000
IFF;378169;USD;2017;Q4;2017-12-31;2018-02-27;79047000;79404000;368046000;663663000;649448000;1896544000;880580000;;1821802000;2702382000;4598926000;480969000;6966000;768768000;1632186000;2140864000;2909632000;177297000;-1726234000;3870621000;1689294000;4598926000
IFF;378169;USD;2018;Q4;2018-12-31;2019-02-26;110858000;112141000;634897000;937765000;1078537000;2941860000;1241152000;;8706383000;9947535000;12889395000;670241000;48642000;1128311000;4504417000;5635904000;6764215000;3809675000;-1030718000;3956221000;6125180000;12889395000
IVZ;378170;USD;2016;Q4;2016-12-31;2017-02-23;408600000;409100000;2865500000;650400000;;12413000000;464700000;5116100000;7740500000;13321300000;25734300000;1466700000;4403100000;14767400000;2761700000;3071400000;17838800000;6325500000;-2845800000;4833400000;7895500000;25734300000
IVZ;378170;USD;2015;Q4;2015-12-31;2016-02-19;422700000;423400000;3233800000;701600000;;10872300000;426900000;6016100000;7757900000;14200900000;25073200000;1524400000;5437000000;13286600000;2634700000;2923600000;16210200000;6295800000;-2404100000;4439600000;8863000000;25073200000
IVZ;378170;USD;2014;Q4;2014-12-31;2015-02-20;433200000;433800000;2803600000;707200000;;6246900000;402600000;5762800000;8037700000;14203100000;20450000000;1424600000;5149600000;8553000000;2306900000;2611700000;11164700000;6231700000;-1898100000;3943600000;9285300000;20450000000
IVZ;378170;USD;2013;Q4;2013-12-31;2014-02-21;445200000;446100000;2754500000;559100000;;5770500000;350800000;4734700000;8414500000;13500000000;19270500000;1439500000;4181700000;7499000000;2470600000;2794200000;10293200000;6198900000;-1700400000;3466200000;8977300000;19270500000
IVZ;378170;USD;2012;Q4;2012-12-31;2013-02-22;449900000;451400000;1734000000;533500000;;3971200000;349600000;4550600000;8621000000;13521200000;17492400000;1236200000;3899400000;6393500000;1738500000;2049900000;8443400000;6239100000;-1382900000;2930100000;9049000000;17492400000
IVZ;378170;USD;2011;Q4;2011-12-31;2012-10-30;;;1393400000;522900000;;3834100000;312800000;6829800000;8370300000;15512900000;19347000000;;5728000000;7227800000;1509200000;2981600000;10209400000;6278700000;-1280400000;2747500000;9137600000;19347000000
IVZ;378170;USD;2010;Q4;2010-12-31;2011-02-25;;;1686000000;583500000;;4274500000;272400000;7370400000;8526800000;16169600000;20444100000;;5865400000;7793500000;1820500000;3289700000;11083200000;6360700000;-991500000;2399900000;9360900000;20444100000
IVZ;378170;USD;2009;Q4;2009-12-31;2010-02-26;;;972400000;289300000;;3186800000;220700000;842400000;6659700000;7722800000;10909600000;;0;1287800000;1113600000;2001000000;3288800000;5780300000;-892400000;1631400000;7620800000;10909600000
IVZ;378170;USD;2008;Q4;2008-12-31;2009-10-30;;;781800000;239300000;;2411200000;205300000;965100000;6175300000;7345700000;9756900000;;297200000;1137400000;1150300000;2023300000;3160700000;5437900000;-1128900000;1476300000;6596200000;9756900000
IVZ;378170;USD;2017;Q4;2017-12-31;2018-02-23;410000000;410800000;3192300000;754000000;;17184600000;490700000;5658000000;8335500000;14484200000;31668800000;1591800000;4799800000;19334900000;2859600000;3135100000;22470000000;6380100000;-2781900000;5489100000;9198800000;31668800000
IVZ;378170;USD;2018;Q4;2018-12-31;2019-02-22;410100000;409700000;2418900000;714800000;;14709800000;468700000;6213500000;9586400000;16268600000;30978400000;1733700000;5226000000;18732100000;2587500000;2913900000;21646000000;6432900000;-3003600000;5884500000;9332400000;30978400000
IRM;378171;USD;2018;Q4;2018-12-31;2019-02-14;286250000;287068122;165485000;846889000;;1208114000;4489557000;;6154576000;10644133000;11852247000;1071449000;126406000;1462678000;8016417000;8433448000;9896126000;4266211000;;;1956121000;11852247000
IRM;378171;USD;2017;Q4;2017-12-31;2018-02-16;270322000;271500932;925699000;835742000;;1950315000;3417679000;;5604408000;9022087000;10972402000;942283000;146300000;1330173000;6896971000;7251969000;8582142000;4167393000;;;2390260000;10972402000
IRM;378171;USD;2016;Q4;2016-12-31;2016-11-01;263530000;265708000;236484000;691249000;;1112107000;3083326000;;5291367000;8374693000;9486800000;672454000;172975000;1046557000;6078206000;6448875000;7495432000;3492431000;;;1991368000;9486800000
IRM;378171;USD;2015;Q4;2015-12-31;2015-10-30;211208000;212229730;128381000;564401000;;857912000;2497158000;;2995517000;5492675000;6350587000;570651000;88068000;841831000;4757610000;4980149000;5821980000;1625976000;;;528607000;6350587000
IRM;378171;USD;2014;Q4;2014-12-31;2014-10-31;203492000;205496760;125933000;604265000;;917719000;2550727000;;3054819000;5605546000;6523265000;607499000;52095000;856736000;4564359000;4796574000;5653310000;1590939000;;;869955000;6523265000
IRM;378171;USD;2013;Q4;2013-12-31;2013-10-31;160363048;161157322;120526000;616797000;;933607000;2578260000;;3141138000;5719398000;6653005000;677794000;52583000;969101000;4119139000;4632170000;5601271000;982078000;;;1051734000;6653005000
IRM;378171;USD;2012;Q4;2012-12-31;2012-11-02;137843856;139531918;243415000;572200000;;1024092000;2477727000;;2856520000;5334247000;6358339000;594933000;92887000;904953000;3732116000;4290938000;5195891000;944099000;;185558000;1162448000;6358339000
IRM;378171;USD;2011;Q4;2011-12-31;2011-11-08;196509594;197435786;179845000;543467000;;914450000;2407083000;;2719725000;5126808000;6041258000;575212000;73320000;849030000;3280268000;3937972000;4787002000;345324000;;902567000;1254256000;6041258000
IRM;378171;USD;2010;Q4;2010-12-31;2010-11-08;216538496;214019600;258693000;524326000;;1212462000;2468244000;;2735687000;5203931000;6416393000;526435000;96081000;874703000;2912126000;3588825000;4463528000;1230656000;;685310000;1952865000;6416393000
IRM;378171;USD;2009;Q4;2009-12-31;2010-05-10;220148048;221464060;446656000;585376000;;1211425000;2568200000;;3067209000;5635409000;6846834000;566091000;40561000;814714000;3211223000;3874649000;4689363000;1300692000;;825014000;2157471000;6846834000
JEC;378172;USD;2016;Q4;2016-09-30;2016-11-22;239156000;242768000;655716000;2115663000;;2864470000;319673000;;4175879000;4495552000;7360022000;1460805000;2421000;1782686000;385330000;1247154000;3029840000;1289223000;;3586647000;4330182000;7360022000
JEC;378172;USD;2015;Q4;2015-09-30;2015-11-24;243984000;245400000;460859000;2548743000;;3122678000;381238000;;4282010000;4663248000;7785926000;1657851000;13364000;1981166000;584434000;1448302000;3429468000;1260297000;;3496212000;4356458000;7785926000
JEC;378172;USD;2014;Q4;2014-09-30;2014-11-24;261378000;264228000;732647000;2867555000;;3892071000;456797000;;4104791000;4561588000;8453659000;1902431000;36732000;2349846000;764075000;1598153000;3947999000;1305611000;;3527193000;4505660000;8453659000
JEC;378172;USD;2013;Q4;2013-09-30;2013-11-22;259752000;264172000;1256405000;2548990000;;4039558000;379296000;;2855290000;3234586000;7274144000;1519739000;22783000;1887619000;415086000;1138190000;3025809000;1216263000;;3300961000;4248335000;7274144000
JEC;378172;USD;2012;Q4;2012-09-30;2012-11-20;256642000;258270000;1032457000;2348892000;;3612077000;331131000;;2896225000;3227356000;6839433000;1483777000;0;1747052000;528260000;1324598000;3071650000;1083919000;;2920441000;3767783000;6839433000
JEC;378172;USD;2011;Q4;2011-09-30;2011-11-21;252902000;254718000;905633000;2077494000;;3180091000;284633000;;2734502000;3019135000;6199226000;1325756000;566031000;2168526000;2042000;707315000;2875841000;986245000;;2564281000;3323385000;6199226000
JEC;378172;USD;2010;Q4;2010-09-30;2010-11-23;249350000;252652000;938842000;1659844000;;2767042000;215032000;;1701843000;1916875000;4683917000;965155000;79399000;1239453000;509000;579536000;1818989000;893423000;;2251366000;2864928000;4683917000
JEC;378172;USD;2009;Q4;2009-09-30;2009-11-20;246618000;250118000;1033619000;1618561000;;2818449000;240350000;;1369815000;1610165000;4428614000;1026257000;17495000;1295901000;737000;501238000;1797139000;828090000;;2009338000;2631475000;4428614000
JEC;378172;USD;2008;Q4;2008-09-30;2009-07-30;;;604420000;1957773000;;2750234000;256140000;;1271864000;1528004000;4278238000;1341828000;966000;1576997000;55675000;449916000;2026913000;753744000;;1620673000;2251325000;4278238000
JEC;378172;USD;2017;Q4;2017-09-30;2017-11-21;-86000;-5907000;774151000;2102543000;;2996180000;349911000;;4034768000;4384679000;7380859000;1623292000;3071000;1926227000;235000000;967281000;2893508000;1360168000;;3721698000;4487351000;7380859000
JEC;378172;USD;2018;Q4;2018-09-30;2018-11-21;142222000;143841000;793358000;3554930000;;4556584000;457706000;;7631505000;8089211000;12645795000;2616300000;4954000;3145693000;2146877000;3555748000;6701441000;2851057000;;3809991000;5944354000;12645795000
JBHT;378173;USD;2018;Q4;2018-12-31;2019-02-22;109043000;109932000;7600000;1051698000;21977000;6219841000;-1271749000;;143555000;-1128194000;5091647000;826503000;250706000;1352348000;898398000;1637915000;2990263000;342128000;-2429179000;4188435000;2101384000;5091647000
JBHT;378173;USD;2017;Q4;2017-12-31;2018-02-23;109737000;110720000;14612000;920767000;20688000;5497606000;-1175547000;;143290000;-1032257000;4465349000;669864000;0;921844000;1085649000;1704180000;2626024000;312482000;-2277001000;3803844000;1839325000;4465349000
JBHT;378173;USD;2016;Q4;2016-12-31;2017-02-23;111525000;112317000;6377000;745288000;18577000;4887859000;-1001648000;;64516000;-937132000;3950727000;463389000;;694873000;986278000;1841793000;2536666000;294758000;-2099640000;3218943000;1414061000;3950727000
JBHT;378173;USD;2015;Q4;2015-12-31;2016-02-23;114224000;115019000;5566000;624294000;23191000;4494692000;-935438000;;70290000;-865148000;3629544000;532417000;;532417000;998003000;1796775000;2329192000;270399000;-1855890000;2885843000;1300352000;3629544000
JBHT;378173;USD;2014;Q4;2014-12-31;2015-02-24;116936000;118075000;5961000;653795000;27740000;4198028000;-853997000;;34455000;-819542000;3378486000;521070000;250000000;771070000;683539000;1402893000;2173963000;249312000;-1600761000;2555972000;1204523000;3378486000
JBHT;378173;USD;2013;Q4;2013-12-31;2014-02-21;117381000;118962000;5831000;568519000;26248000;3584492000;-792085000;;26997000;-765088000;2819404000;459811000;250000000;712296000;458417000;1094656000;1806952000;228266000;-1490598000;2274784000;1012452000;2819404000
JBHT;378173;USD;2012;Q4;2012-12-31;2013-02-22;117914000;120030000;5589000;466011000;23065000;3125615000;-685609000;;24635000;-660974000;2464641000;402010000;100000000;502760000;585347000;1170021000;1672781000;208744000;-1402097000;1985213000;791860000;2464641000
JBHT;378173;USD;2011;Q4;2011-12-31;2012-02-24;116788000;119311000;5450000;411479000;20932000;2858142000;-617730000;;26920000;-590810000;2267332000;388515000;50000000;438515000;699177000;1261274000;1699789000;194141000;-1384888000;1758290000;567543000;2267332000
JBHT;378173;USD;2010;Q4;2010-12-31;2011-02-25;122490000;125347000;7651000;351187000;17336000;2495140000;-553011000;;19531000;-533480000;1961660000;301084000;200000000;509949000;454207000;878690000;1388639000;182657000;-1173163000;1563527000;573021000;1961660000
JBHT;378173;USD;2009;Q4;2009-12-31;2010-07-30;127195000;130095000;7843000;310339000;17273000;2284466000;-447330000;;19778000;-427552000;1856914000;258713000;;269218000;565000000;943843000;1213061000;177680000;-957647000;1423820000;643853000;1856914000
KIM;378175;USD;2016;Q4;2016-12-31;2017-02-27;423157000;425316000;142486000;205020000;;347506000;9394755000;512310000;976029000;10883094000;11230600000;4051768000;1139117000;5740773000;;0;5740773000;5927208000;;;5489827000;11230600000
KIM;378175;USD;2015;Q4;2015-12-31;2016-02-26;412039000;410236000;189534000;199076000;;388610000;9274299000;750124000;931138000;10955561000;11344171000;4026569000;1614982000;6075511000;;0;6075511000;5613015000;;;5268660000;11344171000
KIM;378175;USD;2014;Q4;2014-12-31;2015-02-27;409757000;410263000;187322000;246399000;;433721000;7930489000;1127453000;769737000;9827679000;10261400000;3412394000;1424228000;5268155000;;0;5268155000;5736139000;;;4993245000;10261400000
KIM;378175;USD;2013;Q4;2013-12-31;2014-02-26;408162000;409093000;148768000;194569000;;343337000;7146845000;1319776000;853672000;9320293000;9663630000;3414833000;1035354000;4807951000;;0;4807951000;5693355000;;;4855679000;9663630000
KIM;378175;USD;2012;Q4;2012-12-31;2013-02-27;406346000;406254000;141875000;242244000;;384119000;7104562000;1464696000;797857000;9367115000;9751234000;3400526000;1003190000;4737678000;;0;4737678000;5655248000;;;5013556000;9751234000
KIM;378175;USD;2011;Q4;2011-12-31;2012-02-27;406557000;408461000;112882000;267025000;;379907000;6898445000;1437754000;912656000;9248855000;9628762000;3201589000;1085371000;4608417000;;45128000;4653545000;5496091000;;;4975217000;9628762000
KIM;378175;USD;2017;Q4;2017-12-31;2018-02-23;423737000;422675000;238513000;211595000;;450108000;9817875000;497126000;998617000;11313618000;11763726000;4910734000;882787000;6225436000;;0;6225436000;6157020000;;;5538290000;11763726000
KIM;378175;USD;2018;Q4;2018-12-31;2019-02-15;419199000;419303000;143581000;198976000;;342557000;9250519000;581224000;824800000;10656543000;10999100000;4686621000;492416000;5564365000;;0;5564365000;6121468000;;;5434735000;10999100000
LLL;378176;USD;2015;Q4;2015-12-31;2016-02-26;78400000;79400000;207000000;746000000;333000000;4232000000;1097000000;;6738000000;7835000000;12067000000;1204000000;499000000;2879000000;3125000000;4759000000;7638000000;6052000000;-6851000000;5728000000;4429000000;12067000000
LLL;378176;USD;2014;Q4;2014-12-31;2015-02-26;84300000;85900000;442000000;803000000;288000000;5665000000;1061000000;;6989000000;8050000000;13715000000;1213000000;;2634000000;3939000000;5721000000;8355000000;5799000000;-6111000000;6181000000;5360000000;13715000000
LLL;378176;USD;2013;Q4;2013-12-31;2014-02-25;87800000;90500000;500000000;991000000;366000000;4613000000;1042000000;;8352000000;9394000000;14007000000;1575000000;;2553000000;3630000000;5398000000;7951000000;5653000000;-5288000000;5726000000;6056000000;14007000000
LLL;378176;USD;2012;Q4;2012-12-31;2013-02-27;92900000;94300000;349000000;968000000;358000000;4484000000;1023000000;;8293000000;9316000000;13800000000;1550000000;;2563000000;3629000000;5710000000;8273000000;5314000000;-4488000000;5175000000;5527000000;13800000000
LLL;378176;USD;2011;Q4;2011-12-31;2012-02-29;95160000;96520000;764000000;1093000000;317000000;6598000000;921000000;;7989000000;8910000000;15508000000;1558000000;;2814000000;4125000000;5970000000;8784000000;5064000000;-3616000000;5641000000;6724000000;15508000000
LLL;378176;USD;2010;Q4;2010-12-31;2011-02-24;98088000;98376000;607000000;1299000000;303000000;5078000000;923000000;;9450000000;10373000000;15451000000;1753000000;11000000;2733000000;4126000000;5863000000;8596000000;4801000000;-2658000000;4877000000;6855000000;15451000000
LLL;378176;USD;2009;Q4;2009-12-31;2010-02-26;120536000;121264000;1016000000;1149000000;258000000;5213000000;854000000;;8808000000;9662000000;14875000000;1661000000;0;2544000000;4112000000;5671000000;8215000000;4449000000;-1824000000;4108000000;6660000000;14875000000
LLL;378176;USD;2008;Q4;2008-12-31;2009-08-04;124176000;124800000;867000000;1226000000;259000000;4961000000;821000000;;8702000000;9523000000;14484000000;1826000000;;2707000000;4493000000;5836000000;8543000000;4136000000;-1319000000;3373000000;5941000000;14484000000
LH;378177;USD;2018;Q4;2018-12-31;2019-02-28;100200000;101300000;426800000;1467900000;237300000;2835400000;1740300000;;11609600000;13349900000;16185300000;1504600000;10000000;1878900000;5990900000;7315900000;9194800000;1462800000;-1108100000;7079800000;6990500000;16185300000
LH;378177;USD;2017;Q4;2017-12-31;2018-02-27;102500000;103900000;316600000;1531000000;227200000;2733800000;1706600000;;12232600000;13939200000;16673000000;1367200000;417500000;2185700000;6344600000;7662400000;9848100000;2001800000;-1060100000;6196100000;6824900000;16673000000
LH;378177;USD;2016;Q4;2016-12-31;2017-02-27;103300000;104800000;433600000;1328700000;205200000;2478700000;1718600000;;10049700000;11768300000;14247000000;1102100000;549500000;1827600000;5300000000;6898400000;8726000000;2143800000;-1012700000;4955800000;5521000000;14247000000
LH;378177;USD;2015;Q4;2015-12-31;2016-02-29;101500000;103200000;716400000;1217900000;191000000;2621200000;1747400000;;9736100000;11483500000;14104700000;1130500000;423900000;1700500000;5940300000;7444200000;9144700000;1986500000;-978100000;4223700000;4960000000;14104700000
LH;378177;USD;2014;Q4;2014-12-31;2015-02-26;84400000;86200000;580000000;815700000;139500000;1692700000;786500000;;4822600000;5609100000;7301800000;623700000;347100000;976300000;2682700000;3487300000;4463600000;10400000;-965500000;3786100000;2838200000;7301800000
LH;378177;USD;2013;Q4;2013-12-31;2014-02-25;86700000;88100000;404000000;784700000;136500000;1432100000;707400000;;4826400000;5533800000;6965900000;614500000;111300000;735700000;2889100000;3719500000;4455200000;10500000;-958900000;3373500000;2510700000;6965900000
LH;378177;USD;2012;Q4;2012-12-31;2013-02-26;102200000;103900000;466800000;718500000;121000000;1391800000;630800000;;4772400000;5403200000;6795000000;548500000;480000000;1028500000;2175000000;3028400000;4056900000;11300000;-951800000;3588500000;2738100000;6795000000
LH;378177;USD;2011;Q4;2011-12-31;2012-02-24;98500000;99000000;159300000;699800000;110800000;1060000000;578300000;;4473500000;5051800000;6111800000;597100000;135500000;732600000;2085500000;2855500000;3588100000;11700000;-940900000;3387200000;2523700000;6111800000
LH;378177;USD;2010;Q4;2010-12-31;2011-03-07;101800000;105600000;230700000;655600000;103400000;1143800000;586900000;;4457100000;5044000000;6187800000;610700000;361700000;972400000;1826700000;2580400000;3552800000;66100000;-934900000;3246600000;2635000000;6187800000
LH;378177;USD;2009;Q4;2009-12-31;2010-02-24;105600000;109100000;148500000;574200000;90000000;935600000;500800000;;3401400000;3902200000;4837800000;458800000;417200000;876000000;977200000;1713300000;2589300000;49200000;-932500000;2927900000;2248500000;4837800000
LH;378177;USD;2008;Q4;2008-12-31;2009-08-28;;;219700000;631600000;91000000;1032800000;496400000;;3140300000;3636700000;4669500000;426100000;120800000;546900000;1600500000;2313000000;2859900000;250200000;-929800000;2384600000;1809600000;4669500000
LEG;378178;USD;2018;Q4;2018-12-31;2019-02-27;134000000;134800000;268100000;571600000;633900000;1524600000;728500000;;1128900000;1857400000;3382000000;728100000;1200000;815700000;1167800000;1408700000;2224400000;529100000;-1908300000;2613800000;1157600000;3382000000
LEG;378178;USD;2017;Q4;2017-12-31;2018-02-22;135500000;136800000;526100000;595100000;571100000;1766500000;663900000;;1120400000;1784300000;3550800000;733700000;153800000;976200000;1097900000;1383800000;2360000000;516700000;-1828300000;2511300000;1190800000;3550800000
LEG;378178;USD;2016;Q4;2016-12-31;2017-02-22;137300000;139300000;281900000;486600000;519600000;1324900000;565500000;;1093700000;1659200000;2984100000;608800000;3600000;706600000;956200000;1183500000;1890100000;508200000;-1713500000;2410500000;1094000000;2984100000
LEG;378178;USD;2015;Q4;2015-12-31;2016-02-25;139900000;141900000;253200000;520200000;504600000;1311200000;540800000;;1111700000;1652500000;2963700000;593900000;3400000;701200000;941500000;1164800000;1866000000;531500000;-1564000000;2209200000;1097700000;2963700000
LEG;378178;USD;2014;Q4;2014-12-31;2015-02-26;141000000;143200000;332800000;523300000;481400000;1429300000;548800000;;1162500000;1711300000;3140600000;707400000;201700000;992200000;766700000;993500000;1985700000;504400000;-1416600000;2061300000;1154900000;3140600000
LEG;378178;USD;2013;Q4;2013-12-31;2014-02-26;144200000;146100000;272700000;467400000;495900000;1281700000;574600000;;1251800000;1826400000;3108100000;569000000;181100000;829500000;688400000;879400000;1708900000;481100000;-1320700000;2136400000;1399200000;3108100000
LEG;378178;USD;2012;Q4;2012-12-31;2013-02-28;145100000;147400000;359100000;446200000;489000000;1339100000;572800000;;1343000000;1915800000;3254900000;505900000;201500000;731000000;853900000;1081700000;1812700000;460600000;-1206700000;2109600000;1442200000;3254900000
LEG;378178;USD;2011;Q4;2011-12-31;2012-02-24;143000000;144700000;236300000;503600000;441000000;1224000000;580600000;;1110500000;1691100000;2915100000;466200000;2500000;586000000;833300000;1021400000;1607400000;458900000;-1254300000;2027400000;1307700000;2915100000
LEG;378178;USD;2010;Q4;2010-12-31;2011-02-24;150100260;152072740;244500000;478900000;435300000;1219100000;624200000;;1157700000;1781900000;3001000000;435900000;2200000;523000000;762200000;953600000;1476600000;465200000;-1093000000;2033300000;1524400000;3001000000
LEG;378178;USD;2009;Q4;2009-12-31;2010-08-05;154924912;156258492;260500000;469500000;409100000;1213600000;668600000;;1179000000;1847600000;3061200000;429100000;10100000;535100000;789300000;950600000;1485700000;469700000;-1033800000;2013300000;1575500000;3061200000
LUK;378180;USD;2016;Q4;2016-11-30;2017-02-27;369517000;366582000;3807558000;;;4664895000;709242000;27970344000;11726826000;40406412000;45071307000;;525842000;18525269000;8406872000;15780580000;34305849000;5172012000;;4645391000;10765458000;45071307000
LUK;378180;USD;2015;Q4;2015-11-30;2016-03-17;369978000;365802000;3638648000;;;4389732000;721875000;29910268000;11309309000;41941452000;46331184000;;310659000;20132257000;8309323000;15416404000;35548661000;5349436000;;4612982000;10782523000;46331184000
LUK;378180;USD;2014;Q4;2014-11-30;2015-02-27;373743000;369430000;4276775000;;;7721449000;726376000;32296075000;11880008000;44902459000;52623908000;;12000000;22187236000;9233055000;19754964000;41942200000;5427007000;;4428069000;10681708000;52623908000
LUK;378180;USD;2013;Q4;2013-11-30;2014-02-28;347564000;373825000;3907595000;;;7524197000;885859000;28810559000;10646166000;40342584000;47866781000;;12000000;20591069000;8415576000;16736584000;37327653000;5245572000;;4318840000;10539128000;47866781000
LUK;378180;USD;2012;Q4;2012-11-30;2013-02-25;244583000;253218000;145960000;;;145960000;857360000;4440988000;3904810000;9203158000;9349118000;;;391705000;1358695000;1948129000;2339834000;1822111000;;4240028000;7009284000;9349118000
LUK;378180;USD;2011;Q4;2011-11-30;2012-02-27;244517000;240066000;318625000;;354578000;882373000;884109000;2565885000;4930822000;8380816000;9263189000;;29264000;502811000;1874389000;2346208000;2849019000;1815267000;;3446708000;6414170000;9263189000
LUK;378180;USD;2010;Q4;2010-11-30;2011-02-25;243596000;252210000;705912000;;58280000;835262000;587371000;3982987000;3944678000;8515036000;9350298000;;142659000;571248000;1548469000;1815669000;2386917000;1786772000;;3482623000;6963381000;9350298000
LUK;378180;USD;2009;Q4;2009-11-30;2010-02-26;242916000;257051000;215182000;;;307929000;657898000;2292101000;3504436000;6454435000;6762364000;;114010000;480498000;1657779000;1907369000;2387867000;1772352000;;1604263000;4374497000;6762364000
LUK;378180;USD;2008;Q4;2008-11-30;2009-08-07;;;603967000;17756000;;746031000;534640000;1166375000;2751447000;4452462000;5198493000;;248713000;357046000;1832743000;2146056000;2503102000;1652094000;;1053983000;2695391000;5198493000
LUK;378180;USD;2017;Q4;2017-11-30;2018-02-27;366481000;365333000;5275480000;;;5853494000;750403000;29940055000;10625156000;41315614000;47169108000;;436215000;20395602000;8915268000;16082934000;36478536000;5032265000;;4700968000;10690572000;47169108000
LLY;378181;USD;2016;Q4;2016-12-31;2017-02-21;1057996000;1063300000;6038600000;4029400000;3561900000;15101400000;8252600000;5207500000;10244400000;23704500000;38805900000;2016500000;1937400000;10986600000;8367800000;13738800000;24725400000;3315900000;-80500000;16046300000;14080500000;38805900000
LLY;378181;USD;2015;Q4;2015-12-31;2016-02-19;1060352000;1065080000;4451800000;3513000000;3445800000;12573600000;8053500000;3646600000;11295200000;22995300000;35568900000;2236100000;6100000;8229600000;7972400000;12749000000;20978600000;3230200000;-90000000;16011800000;14590300000;35568900000
LLY;378181;USD;2014;Q4;2014-12-31;2015-02-19;1065728000;1070544000;4827000000;3234600000;2740000000;11928300000;7963900000;4568900000;11846500000;24379300000;36307600000;1751900000;2688700000;9741000000;5332800000;11178500000;20919500000;2973700000;-91400000;16482700000;15388100000;36307600000
LLY;378181;USD;2013;Q4;2013-12-31;2014-02-19;1075196000;1078964000;5397300000;3434400000;2928800000;13104700000;7975500000;7624900000;6543600000;22144000000;35248700000;1897200000;1012600000;8916600000;4200300000;8691400000;17608000000;2735300000;-93600000;16992400000;17640700000;35248700000
LLY;378181;USD;2012;Q4;2012-12-31;2013-02-21;;;5684300000;3336300000;2643800000;13038700000;7760200000;6313900000;7286100000;21360200000;34398900000;1873200000;11900000;8389500000;5519400000;11235500000;19625000000;2666500000;-192400000;16088200000;14773900000;34398900000
LLY;378181;USD;2011;Q4;2011-12-31;2012-02-24;;;6897100000;3597700000;2299800000;14248200000;7760300000;4029800000;7621500000;19411600000;33659800000;1929100000;1522300000;8930900000;5464700000;11193300000;20124200000;2597800000;-95300000;14897800000;13535600000;33659800000
LLY;378181;USD;2010;Q4;2010-12-31;2011-02-22;;;6727000000;3493800000;2517700000;14840000000;7940700000;1779500000;6441200000;16161400000;31001400000;2069700000;156000000;6926900000;6770500000;11661700000;18588600000;2506600000;-96400000;12732600000;12412800000;31001400000
LLY;378181;USD;2009;Q4;2009-12-31;2010-02-22;;;4497600000;3343300000;2849900000;12486500000;8197400000;1155800000;5621200000;14974400000;27460900000;1852800000;27400000;6568100000;6634700000;11367500000;17935600000;2341100000;-98500000;9830400000;9525300000;27460900000
LLY;378181;USD;2008;Q4;2008-12-31;2009-10-30;;;5926100000;2778800000;2493200000;12453300000;8626300000;1544600000;6588400000;16759300000;29212600000;1651800000;5846300000;13184400000;4615700000;9290500000;22474900000;2052700000;-99200000;7654900000;6737700000;29212600000
LLY;378181;USD;2017;Q4;2017-12-31;2018-02-20;1043392000;1038692000;8034100000;4546300000;4458300000;19202100000;8826500000;5678800000;11273600000;25778900000;44981000000;2534200000;3706600000;14535900000;9940500000;18777200000;33313100000;3492500000;-75800000;13894100000;11667900000;44981000000
LLY;378181;USD;2018;Q4;2018-12-31;2019-02-19;1012284000;1028368000;7408900000;4593900000;3098100000;20549600000;7996100000;2005400000;13357300000;23358800000;43908400000;2251300000;1102200000;11888100000;9196400000;21111200000;32999300000;4231400000;-69400000;11395900000;10909100000;43908400000
LYB;378183;USD;2018;Q4;2018-12-31;2019-02-21;;;1224000000;3355000000;4515000000;10566000000;12477000000;2103000000;3132000000;17712000000;28278000000;4096000000;890000000;5513000000;8497000000;12369000000;17882000000;7063000000;-2206000000;6763000000;10396000000;28278000000
LYB;378183;USD;2017;Q4;2017-12-31;2018-02-22;;;2830000000;3359000000;4217000000;11738000000;10997000000;2072000000;1399000000;14468000000;26206000000;4070000000;70000000;4777000000;8549000000;12479000000;17256000000;10237000000;-15749000000;15746000000;8950000000;26206000000
LYB;378183;USD;2016;Q4;2016-12-31;2017-02-17;;;2022000000;2716000000;3809000000;9599000000;10137000000;2010000000;1696000000;13843000000;23442000000;3443000000;596000000;4540000000;8385000000;12829000000;17369000000;10222000000;-14945000000;12282000000;6073000000;23442000000
LYB;378183;USD;2015;Q4;2015-12-31;2016-02-16;;;1988000000;2363000000;4051000000;9789000000;8991000000;2127000000;1850000000;12968000000;22757000000;3437000000;357000000;4349000000;7671000000;11834000000;16183000000;10233000000;-12086000000;9841000000;6574000000;22757000000
LYB;378183;USD;2014;Q4;2014-12-31;2015-02-17;;;2624000000;3226000000;4517000000;11645000000;8758000000;2064000000;1754000000;12576000000;24221000000;3793000000;350000000;5437000000;6695000000;10440000000;15877000000;10418000000;-7853000000;6775000000;8344000000;24221000000
LYB;378183;USD;2013;Q4;2013-12-31;2014-02-20;;;4450000000;3828000000;5279000000;14599000000;8457000000;2114000000;2128000000;12699000000;27298000000;4121000000;59000000;5510000000;5776000000;9274000000;14784000000;10413000000;-2035000000;4004000000;12514000000;27298000000
LYB;378183;USD;2012;Q4;2012-12-31;2013-02-12;;;2732000000;3720000000;5075000000;12286000000;7696000000;2363000000;1875000000;11934000000;24220000000;3597000000;96000000;5096000000;4304000000;7945000000;13041000000;10382000000;-106000000;1274000000;11179000000;24220000000
LYB;378183;USD;2011;Q4;2011-12-31;2012-02-29;;;1065000000;3582000000;5499000000;11435000000;7333000000;2043000000;2028000000;11404000000;22839000000;3804000000;52000000;5018000000;3980000000;7174000000;12192000000;10303000000;-124000000;841000000;10647000000;22839000000
Mac;378184;USD;2015;Q4;2015-12-31;2016-02-23;156310000;156429000;86510000;130002000;;906120000;8796912000;1532552000;;10329464000;11235584000;815382000;4608587000;5512182000;652163000;652163000;6164345000;4928174000;;-212760000;5071239000;11235584000
Mac;378184;USD;2014;Q4;2014-12-31;2015-02-23;149999000;150251000;84907000;132026000;;1069756000;11067890000;984132000;;12052022000;13121778000;684122000;5404521000;6194050000;887879000;887879000;7081929000;5043379000;;596741000;6039849000;13121778000
Mac;378184;USD;2013;Q4;2013-12-31;2014-02-21;140770000;140805000;69715000;99497000;;749245000;7621766000;701483000;2756000;8326005000;9075250000;440099000;4415190000;5188996000;167537000;167537000;5356533000;3907555000;;-548806000;3718717000;9075250000
Mac;378184;USD;2012;Q4;2012-12-31;2013-02-22;137007000;137112000;65793000;127411000;;854060000;7479546000;974258000;3345000;8457149000;9311209000;388425000;4437343000;5070931000;824027000;824027000;5894958000;3717270000;;-639741000;3416251000;9311209000
Mac;378184;USD;2011;Q4;2011-12-31;2012-02-24;132151000;132151000;67248000;133925000;;756951000;6079043000;1098560000;3995000;7181598000;7938549000;371968000;3328438000;3896262000;877636000;877636000;4773898000;3491968000;;-678631000;3164651000;7938549000
Mac;378184;USD;2010;Q4;2010-12-31;2011-02-25;130774000;130774000;445645000;121018000;;961665000;5674127000;1006123000;3095000;6683345000;7645010000;328263000;3259475000;3813053000;632595000;643961000;4457014000;3457873000;;-564357000;3187996000;7645010000
Mac;378184;USD;2009;Q4;2009-12-31;2010-08-09;91210000;91210000;93255000;128190000;;546020000;5657939000;1046196000;2316000;6706451000;7252471000;336679000;3236036000;3807816000;1295598000;1316189000;5124005000;2228898000;;-345930000;2128466000;7252471000
Mac;378184;USD;2016;Q4;2016-12-31;2017-02-24;143845000;143936000;94046000;136998000;;827280000;7357310000;1773558000;;9130868000;9958148000;427481000;4085418000;4650498000;880482000;880482000;5530980000;4594669000;;-488782000;4427168000;9958148000
Mac;378184;USD;2017;Q4;2017-12-31;2018-02-23;140918000;140959000;91038000;112653000;;787110000;7109230000;1709522000;;8818752000;9605862000;384113000;4238080000;4705679000;932184000;932184000;5637863000;4511899000;;-830279000;3967999000;9605862000
Mac;378184;USD;2018;Q4;2018-12-31;2019-02-25;141211000;141193000;102711000;123492000;;748377000;6785776000;1492655000;;8278431000;9026808000;362443000;4073916000;4929832000;908544000;908544000;5838376000;4569055000;;-1614357000;3188432000;9026808000
MRO;378185;USD;2016;Q4;2016-12-31;2017-02-24;851000000;851000000;2488000000;748000000;136000000;3665000000;16727000000;931000000;9771000000;27429000000;31094000000;1190000000;686000000;2240000000;6581000000;11313000000;13553000000;8383000000;-3431000000;12672000000;17541000000;31094000000
MRO;378185;USD;2015;Q4;2015-12-31;2016-02-25;679000000;679000000;1221000000;912000000;313000000;2590000000;27061000000;1003000000;1657000000;29721000000;32311000000;1578000000;1000000;1729000000;7276000000;12029000000;13758000000;7268000000;-3554000000;14974000000;18553000000;32311000000
MRO;378185;USD;2014;Q4;2014-12-31;2015-03-02;676000000;679000000;2398000000;1729000000;357000000;4593000000;29040000000;1113000000;1237000000;31390000000;35983000000;3021000000;1068000000;4379000000;5295000000;10584000000;14963000000;7301000000;-3642000000;17638000000;21020000000;35983000000
MRO;378185;USD;2013;Q4;2013-12-31;2014-02-28;695000000;699000000;264000000;2134000000;364000000;2975000000;28145000000;1201000000;3299000000;32645000000;35620000000;3891000000;203000000;4333000000;6394000000;11943000000;16276000000;7362000000;-2903000000;15135000000;19344000000;35620000000
MRO;378185;USD;2012;Q4;2012-12-31;2013-02-22;706000000;712000000;684000000;2418000000;361000000;3762000000;28272000000;1279000000;1993000000;31544000000;35306000000;4524000000;384000000;5081000000;6512000000;11942000000;17023000000;7386000000;-2560000000;13890000000;18283000000;35306000000
MRO;378185;USD;2011;Q4;2011-12-31;2012-02-29;705000000;710000000;493000000;1917000000;361000000;3224000000;25324000000;1383000000;1440000000;28147000000;31371000000;4072000000;141000000;4394000000;4674000000;9818000000;14212000000;7450000000;-2716000000;12788000000;17159000000;31371000000
MRO;378185;USD;2010;Q4;2010-12-31;2011-02-28;231432400;232079600;3951000000;5972000000;3453000000;13829000000;32222000000;1802000000;2161000000;36185000000;50014000000;9865000000;295000000;11113000000;7601000000;15130000000;26243000000;7526000000;-2665000000;19907000000;23771000000;50014000000
MRO;378185;USD;2009;Q4;2009-12-31;2010-02-26;-729702800;-731761200;2057000000;4677000000;3622000000;10637000000;32121000000;1970000000;2324000000;36415000000;47052000000;7928000000;96000000;9057000000;8436000000;16085000000;25142000000;7507000000;-2706000000;18043000000;21910000000;47052000000
MRO;378185;USD;2008;Q4;2008-12-31;2009-08-28;;;1285000000;3094000000;3507000000;8403000000;29414000000;2080000000;2789000000;34283000000;42686000000;6245000000;98000000;7753000000;7087000000;13524000000;21277000000;7463000000;-2720000000;17259000000;21409000000;42686000000
MRO;378185;USD;2017;Q4;2017-12-31;2018-02-22;851000000;851000000;563000000;1082000000;126000000;2566000000;17665000000;847000000;934000000;19446000000;22012000000;1680000000;;1968000000;5494000000;8336000000;10304000000;8316000000;-3325000000;6779000000;11708000000;22012000000
MLM;378186;USD;2015;Q4;2015-12-31;2016-02-23;65466000;65663000;168409000;410921000;469141000;1081635000;3156000000;;2719976000;5875976000;6957611000;284829000;18713000;366658000;1550061000;2530776000;2897434000;3288470000;;874436000;4060177000;6957611000
MLM;378186;USD;2014;Q4;2014-12-31;2015-02-24;67620000;68013000;108651000;421001000;484919000;1044178000;3402770000;;2772806000;6175576000;7219754000;297591000;14336000;396648000;1571059000;2470358000;2867006000;3244290000;;1213035000;4352748000;7219754000
MLM;378186;USD;2013;Q4;2013-12-31;2014-02-24;46255000;46503000;42437000;245421000;347307000;755366000;1799241000;;705219000;2504460000;3259826000;153373000;12403000;210549000;1018518000;1474358000;1684907000;433253000;;1148738000;1574919000;3259826000
MLM;378186;USD;2012;Q4;2012-12-31;2013-02-22;45937000;46249000;25394000;224050000;332311000;700401000;1753241000;;707284000;2460525000;3160926000;131680000;5676000;173335000;1042183000;1537292000;1710627000;415116000;;1101598000;1450299000;3160926000
MLM;378186;USD;2011;Q4;2011-12-31;2012-02-29;45706000;45995000;26022000;203748000;322607000;657850000;1774291000;;715681000;2489972000;3147822000;135350000;7182000;173712000;1052902000;1525246000;1698958000;402320000;;1090891000;1448864000;3147822000
MLM;378186;USD;2010;Q4;2010-12-31;2011-02-25;45551000;45901000;70323000;183361000;331894000;696211000;1687830000;;690702000;2378532000;3074743000;103497000;248714000;385493000;782045000;1220991000;1606484000;396940000;;1082160000;1468259000;3074743000
MLM;378186;USD;2009;Q4;2009-12-31;2010-08-03;44930000;45123000;263591000;162815000;332569000;856860000;1692905000;;689518000;2382423000;3239283000;93340000;226119000;373553000;1023492000;1459319000;1832872000;381626000;;1058698000;1406411000;3239283000
MLM;378186;USD;2016;Q4;2016-12-31;2017-02-24;63298000;63569000;50038000;457910000;521624000;1086385000;3423395000;;2791125000;6214520000;7300905000;302956000;180036000;546588000;1506153000;2611727000;3158315000;3335091000;;935574000;4142590000;7300905000
MLM;378186;USD;2017;Q4;2017-12-31;2018-02-23;62950000;63250000;1446364000;487240000;600591000;2631160000;3592813000;;2768538000;6361351000;8992511000;292851000;299909000;694216000;2727294000;3615818000;4310034000;3368635000;;1440069000;4682477000;8992511000
MLM;378186;USD;2018;Q4;2018-12-31;2019-02-25;62670000;62914000;44892000;523276000;663035000;1365816000;5157229000;;3028374000;8185603000;9551419000;342961000;390042000;786750000;2730439000;3815257000;4602007000;3396683000;;1693259000;4949412000;9551419000
MAT;378187;USD;2016;Q4;2016-12-31;2017-02-23;342664000;351411000;869531000;1115217000;613798000;2940064000;773965000;;2779765000;3553730000;6493794000;1313405000;192168000;1505573000;2134271000;2580439000;4086012000;2232201000;-2426749000;3545359000;2407782000;6493794000
MAT;378187;USD;2015;Q4;2015-12-31;2016-02-25;339846000;341780000;892814000;1145099000;587521000;3001059000;741147000;;2792937000;3534084000;6535143000;1328615000;316914000;1645529000;1784721000;2256360000;3901889000;2231239000;-2494901000;3745815000;2633254000;6535143000
MAT;378187;USD;2014;Q4;2014-12-31;2015-02-25;338401000;341873000;971650000;1094452000;561755000;3186931000;737869000;;2797183000;3535052000;6721983000;1088886000;0;1088886000;2100000000;2684026000;3772912000;2208465000;-2533566000;3896261000;2949071000;6721983000
MAT;378187;USD;2013;Q4;2013-12-31;2014-02-26;339368000;343922000;1039216000;1260105000;568843000;3377993000;659333000;;2402300000;3061633000;6439626000;1043162000;4278000;1047440000;1600000000;2140627000;3188067000;2225814000;-2448701000;3918122000;3251559000;6439626000
MAT;378187;USD;2012;Q4;2012-12-31;2013-02-26;343665000;348296000;1335711000;1226833000;465057000;3556805000;593213000;;2376767000;2969980000;6526785000;1306168000;409844000;1716012000;1100000000;1743729000;3459741000;2169051000;-2152702000;3515181000;3067044000;6526785000
MAT;378187;USD;2011;Q4;2011-12-31;2012-02-23;339280000;343253000;1369113000;1246687000;487000000;3443707000;523941000;;1703990000;2227931000;5671638000;980910000;58018000;1038928000;1500000000;2022107000;3061035000;2131774000;-2242522000;3167996000;2610603000;5671638000
MAT;378187;USD;2010;Q4;2010-12-31;2011-02-24;355802000;362802000;1281123000;1146106000;463838000;3226610000;484705000;;1706418000;2191123000;5417733000;1100282000;250000000;1350282000;950000000;1438867000;2789149000;2147830000;-1880692000;2720645000;2628584000;5417733000
MAT;378187;USD;2009;Q4;2009-12-31;2010-02-24;361782000;364343000;1116997000;749335000;355663000;2554619000;504808000;;1721128000;2225936000;4780555000;1008924000;51950000;1060874000;700000000;1188692000;2249566000;2126063000;-1555046000;2339506000;2530989000;4780555000
MAT;378187;USD;2008;Q4;2008-12-31;2009-07-29;359011000;361326000;617694000;873542000;485925000;2386850000;536162000;;1752027000;2288189000;4675039000;1109974000;150000000;1259974000;750000000;1297930000;2557904000;2083461000;-1621264000;2085573000;2117135000;4675039000
MAT;378187;USD;2017;Q4;2017-12-31;2018-02-27;344356000;344356000;1079221000;1128610000;600704000;3111588000;785285000;;2341630000;3126915000;6238503000;1373803000;250000000;1623803000;2873119000;3357245000;4981048000;2249760000;-2389877000;2179358000;1257455000;6238503000
MAT;378187;USD;2018;Q4;2018-12-31;2019-02-22;345745000;345358000;594481000;970083000;542889000;2352440000;657595000;;2233430000;2891025000;5243465000;1248432000;4176000;1252608000;2851723000;3321392000;4574000000;2254051000;-2354617000;1629257000;669465000;5243465000
MJN;378188;USD;2016;Q4;2016-12-31;2017-02-27;184000000;184500000;1724400000;355000000;498500000;2817300000;963600000;;446200000;1409800000;4227100000;1293400000;4500000;1308800000;2973300000;3311100000;4619900000;-497600000;-362600000;812400000;-392800000;4227100000
MJN;378188;USD;2015;Q4;2015-12-31;2016-02-17;189500000;189900000;1701400000;342500000;484900000;2602400000;964000000;;431700000;1395700000;3998100000;1214800000;3000000;1253300000;2981000000;3337300000;4590600000;-562300000;-362600000;640400000;-592500000;3998100000
MJN;378188;USD;2014;Q4;2014-12-31;2015-02-27;202100000;203000000;1297700000;387800000;555500000;2331300000;912700000;;519800000;1432500000;3763800000;1166900000;4100000;1205300000;1492800000;1908700000;3114000000;-639200000;-362600000;1775000000;649800000;3763800000
MJN;378188;USD;2013;Q4;2013-12-31;2014-02-18;202000000;203200000;1050800000;384400000;534800000;2118100000;867500000;;488500000;1356000000;3474100000;1227100000;507600000;1781300000;1009100000;1342600000;3123900000;-719400000;-351900000;1432300000;350200000;3474100000
MJN;378188;USD;2012;Q4;2012-12-31;2013-02-21;202800000;203600000;1042100000;364600000;435900000;2015000000;689900000;;553300000;1243200000;3258200000;1146800000;187000000;1369900000;1523200000;1823000000;3192900000;-674500000;-244600000;1124800000;65300000;3258200000
MJN;378188;USD;2011;Q4;2011-12-31;2012-02-17;204000000;204900000;840300000;352600000;534900000;1889700000;576100000;;301000000;877100000;2766800000;1153100000;0;1200100000;1531900000;1734700000;2934800000;-726300000;-89700000;770000000;-168000000;2766800000
MJN;378188;USD;2010;Q4;2010-12-31;2011-04-28;205200000;205800000;595600000;352000000;356700000;1449000000;550500000;;293600000;844100000;2293100000;937900000;1200000;976100000;1532500000;1675300000;2651400000;-773600000;-3200000;474000000;-358300000;2293100000
MDT_old;378189;USD;2013;Q4;2013-04-30;2014-06-20;1001500000;1013800000;14241000000;3811000000;1725000000;21210000000;2392000000;;14341000000;16733000000;37943000000;1921000000;1613000000;5559000000;10315000000;12941000000;18500000000;100000000;;19940000000;19443000000;37943000000
MDT_old;378189;USD;2012;Q4;2012-04-30;2013-06-24;1015500000;1024100000;11130000000;3727000000;1712000000;17852000000;2490000000;;14558000000;17048000000;34900000000;1780000000;910000000;3950000000;9741000000;12279000000;16229000000;102000000;;19061000000;18671000000;34900000000
MDT_old;378189;USD;2011;Q4;2011-04-30;2012-06-26;1039600000;1046700000;9350000000;3808000000;1800000000;16336000000;2473000000;;14009000000;16482000000;32818000000;1631000000;3274000000;5927000000;7359000000;9778000000;15705000000;104000000;;17482000000;17113000000;32818000000
MDT_old;378189;USD;2010;Q4;2010-04-30;2011-06-28;1069500000;1075500000;2428000000;3761000000;1619000000;9150000000;2488000000;6116000000;12921000000;21525000000;30675000000;1419000000;1723000000;4726000000;8112000000;9981000000;14707000000;107000000;;16085000000;15968000000;30675000000
MDT_old;378189;USD;2009;Q4;2009-04-30;2010-06-29;1100800000;1105100000;3775000000;3335000000;1481000000;9839000000;2421000000;4632000000;11198000000;18251000000;28090000000;1656000000;2575000000;5121000000;6944000000;8340000000;13461000000;110000000;;14826000000;14629000000;28090000000
MDT_old;378189;USD;2008;Q4;2008-04-30;2009-09-09;2237898881;2242798879;1676000000;3123000000;1426000000;7452000000;2279000000;2769000000;11088000000;16136000000;23588000000;1413000000;522000000;3147000000;6253000000;7259000000;10406000000;112000000;;13272000000;13182000000;23588000000
MYL_old;378191;USD;2014;Q4;2014-12-31;2015-03-02;374600000;400600000;225500000;2268500000;1651400000;6786900000;1785700000;;7314000000;9099700000;15886600000;1066300000;2805100000;5305700000;5732800000;7304900000;12610600000;4486100000;-3857700000;3614500000;3276000000;15886600000
MYL_old;378191;USD;2013;Q4;2013-12-31;2014-02-27;376700000;396400000;291300000;1820000000;1656900000;4471200000;1665500000;;9158100000;10823600000;15294800000;1122500000;443400000;2964000000;7586500000;9370900000;12334900000;4375600000;-3878800000;2685100000;2959900000;15294800000
MYL_old;378191;USD;2012;Q4;2012-12-31;2013-02-28;406799000;412479000;349969000;1554342000;1525242000;3902717000;1397216000;;6631964000;8029180000;11931897000;811639000;397035000;2193503000;5337196000;6382566000;8576069000;4256578000;-2890732000;2061370000;3355828000;11931897000
MYL_old;378191;USD;2011;Q4;2011-12-31;2012-02-21;426560000;429689000;375056000;1426438000;1396742000;3568844000;1298034000;;6731265000;8029299000;11598143000;746115000;819668000;2563156000;4479080000;5530205000;8093361000;4060531000;-1901437000;1420520000;3504782000;11598143000
MYL_old;378191;USD;2010;Q4;2010-12-31;2011-02-24;372402000;251640000;691137000;1157081000;1240271000;3559443000;1209342000;;6768019000;7977361000;11536804000;579812000;169770000;1809612000;5263376000;6111791000;7921403000;4112591000;-1566289000;883710000;3615401000;11536804000
MYL_old;378191;USD;2009;Q4;2009-12-31;2010-07-29;305795000;309394000;408075000;1234634000;1114219000;3285386000;1122648000;;6393700000;7516348000;10801734000;587374000;193874000;1718147000;4984987000;5938389000;7656536000;4033016000;-1574877000;660130000;3145198000;10801734000
NDAQ;378192;USD;2017;Q4;2017-12-31;2018-02-28;166873379;339015361;612000000;356000000;;5510000000;400000000;;9444000000;9844000000;15354000000;475000000;480000000;5234000000;3727000000;4240000000;9474000000;3026000000;-247000000;3963000000;5880000000;15354000000
NDAQ;378192;USD;2016;Q4;2016-12-31;2017-03-01;165822279;169132657;648000000;429000000;;4560000000;362000000;;9228000000;9590000000;14150000000;490000000;0;4082000000;3603000000;4638000000;8720000000;3106000000;-176000000;3479000000;5430000000;14150000000
NDAQ;378192;USD;2015;Q4;2015-12-31;2016-02-26;164534330;168862303;502000000;316000000;;3260000000;323000000;;8278000000;8601000000;11861000000;427000000;;2920000000;2364000000;3332000000;6252000000;3013000000;-111000000;3571000000;5609000000;11861000000
NDAQ;378192;USD;2014;Q4;2014-12-31;2014-05-09;168185490;172779142;601000000;389000000;;3400000000;292000000;;8379000000;8671000000;12071000000;456000000;;2980000000;2297000000;3297000000;6277000000;3224000000;-41000000;3292000000;5794000000;12071000000
NDAQ;378192;USD;2013;Q4;2013-12-31;2014-02-24;168315593;173156156;587000000;393000000;;3163000000;268000000;;9146000000;9414000000;12577000000;464000000;45000000;2800000000;2589000000;3593000000;6393000000;4280000000;-1005000000;2976000000;6184000000;12577000000
NDAQ;378192;USD;2012;Q4;2012-12-31;2013-02-21;164473127;168864539;720000000;333000000;;1492000000;211000000;;7429000000;7640000000;9132000000;380000000;136000000;1018000000;1840000000;2905000000;3923000000;3773000000;-1058000000;2678000000;5209000000;9132000000
NDAQ;378192;USD;2011;Q4;2011-12-31;2012-02-24;175489059;177522194;785000000;308000000;;6581000000;193000000;;7317000000;7510000000;14091000000;402000000;45000000;6038000000;2072000000;3067000000;9105000000;3795000000;-860000000;2391000000;4986000000;14091000000
NDAQ;378192;USD;2010;Q4;2010-12-31;2011-02-24;195226545;198444787;568000000;298000000;;8510000000;164000000;;7533000000;7697000000;16207000000;346000000;140000000;8231000000;2181000000;3247000000;11478000000;3782000000;-796000000;2004000000;4729000000;16207000000
NDAQ;378192;USD;2009;Q4;2009-12-31;2010-08-04;;;902000000;301000000;;3370000000;164000000;;7188000000;7352000000;10722000000;376000000;225000000;2854000000;1867000000;2924000000;5778000000;3738000000;-10000000;1610000000;4944000000;10722000000
NDAQ;378192;USD;2018;Q4;2018-12-31;2019-02-22;164500992;167082137;813000000;384000000;;6370000000;376000000;;8954000000;9330000000;15700000000;506000000;875000000;6570000000;2956000000;3681000000;10251000000;2718000000;-297000000;4558000000;5449000000;15700000000
NOV;378193;USD;2015;Q4;2015-12-31;2016-02-19;374000000;370000000;2080000000;2926000000;4678000000;11425000000;3124000000;327000000;11094000000;14545000000;25970000000;3171000000;2000000;3958000000;3907000000;5552000000;9510000000;8009000000;;9927000000;16460000000;25970000000
NOV;378193;USD;2014;Q4;2014-12-31;2015-02-17;427000000;430000000;3536000000;4416000000;5281000000;16162000000;3362000000;362000000;13676000000;17400000000;33562000000;5138000000;152000000;7374000000;3014000000;5416000000;12790000000;8345000000;;13181000000;20772000000;33562000000
NOV;378193;USD;2013;Q4;2013-12-31;2014-02-14;379566000;381348000;3436000000;4896000000;5603000000;16423000000;3408000000;390000000;14591000000;18389000000;34812000000;4594000000;1000000;6678000000;3149000000;5804000000;12482000000;8911000000;;13323000000;22330000000;34812000000
NOV;378193;USD;2012;Q4;2012-12-31;2013-02-22;288243000;288480000;3319000000;4320000000;5891000000;15678000000;2945000000;393000000;12468000000;15806000000;31484000000;4126000000;1000000;5649000000;3148000000;5479000000;11128000000;8747000000;;11385000000;20356000000;31484000000
NOV;378193;USD;2011;Q4;2011-12-31;2012-02-23;470216000;469107000;3535000000;3291000000;4030000000;12110000000;2445000000;391000000;10569000000;13405000000;25515000000;3986000000;351000000;5416000000;159000000;2371000000;7787000000;8539000000;;9103000000;17728000000;25515000000
NOV;378193;USD;2010;Q4;2010-12-31;2011-02-23;462453000;464671000;3333000000;2425000000;3388000000;10535000000;1840000000;386000000;10289000000;12515000000;23050000000;3201000000;373000000;4536000000;514000000;2652000000;7188000000;8357000000;;7300000000;15862000000;23050000000
NOV;378193;USD;2009;Q4;2009-12-31;2010-02-26;461344000;459126000;2622000000;2187000000;3490000000;9598000000;1836000000;393000000;9705000000;11934000000;21532000000;3077000000;7000000;4514000000;876000000;2790000000;7304000000;8218000000;;5805000000;14228000000;21532000000
NOV;378193;USD;2008;Q4;2008-12-31;2009-08-10;460235000;462453000;1543000000;3136000000;3806000000;9657000000;1677000000;421000000;9724000000;11822000000;21479000000;3458000000;4000000;5623000000;870000000;3132000000;8755000000;7993000000;;4796000000;12724000000;21479000000
NOV;378193;USD;2016;Q4;2016-12-31;2017-02-17;378000000;378000000;1408000000;2083000000;3325000000;7876000000;3150000000;307000000;9807000000;13264000000;21140000000;2101000000;506000000;3047000000;2708000000;4090000000;7137000000;8107000000;;7285000000;14003000000;21140000000
NOV;378193;USD;2017;Q4;2017-12-31;2018-02-16;378000000;378000000;1437000000;2015000000;3003000000;7217000000;3002000000;309000000;9678000000;12989000000;20206000000;1829000000;6000000;2354000000;2706000000;3692000000;6046000000;8238000000;;6966000000;14160000000;20206000000
NOV;378193;USD;2018;Q4;2018-12-31;2019-02-14;378000000;371000000;1427000000;2101000000;2986000000;7279000000;2797000000;301000000;9419000000;12517000000;19796000000;1876000000;7000000;2341000000;2704000000;3566000000;5907000000;8394000000;;6862000000;13889000000;19796000000
NWL;378194;USD;2017;Q4;2017-12-31;2018-03-01;487900000;488800000;485700000;1879300000;1662400000;11249600000;972400000;;20913500000;21885900000;33135500000;2584600000;661800000;4957700000;9889200000;13996500000;18954200000;10870100000;-573500000;4611200000;14181300000;33135500000
NWL;378194;USD;2016;Q4;2016-12-31;2016-11-08;484200000;485900000;587500000;2746900000;2116000000;7484500000;1543400000;;24809600000;26353000000;33837500000;3349600000;601900000;4292000000;11290900000;18161100000;22453100000;10649000000;-545300000;2289900000;11384400000;33837500000
NWL;378194;USD;2015;Q4;2015-12-31;2015-11-09;268200000;270600000;274800000;1250700000;721800000;2493500000;599200000;;4166800000;4766000000;7259500000;1556500000;388800000;1988600000;2669100000;3444500000;5433100000;1088900000;-523100000;2090900000;1826400000;7259500000
NWL;378194;USD;2014;Q4;2014-12-31;2014-11-07;272600000;275700000;199400000;1248200000;708500000;2292200000;559100000;;3713000000;4272100000;6564300000;1491200000;397400000;1888600000;2084500000;2820800000;4709400000;1027700000;-493100000;2111200000;1854900000;6564300000
NWL;378194;USD;2013;Q4;2013-12-31;2013-11-08;283400000;286900000;226300000;1105100000;684400000;2151200000;539600000;;3378900000;3918500000;6069700000;1429700000;174800000;1604500000;1661600000;2390200000;3994700000;951800000;-477200000;2242100000;2075000000;6069700000
NWL;378194;USD;2012;Q4;2012-12-31;2012-11-06;289900000;293000000;183800000;1112400000;696400000;2135300000;560200000;;3526500000;4086700000;6222000000;1358900000;211900000;1570800000;1706500000;2651000000;4221800000;938800000;-448000000;2294900000;2000200000;6222000000
NWL;378194;USD;2011;Q4;2011-12-31;2011-11-07;295100000;290900000;170200000;1002000000;699900000;2017300000;551400000;;3592200000;4143600000;6160900000;1293400000;367500000;1660900000;1809300000;2647400000;4308300000;891600000;-432800000;2097300000;1852600000;6160900000
NWL;378194;USD;2010;Q4;2010-12-31;2010-11-09;293700000;297400000;139600000;997900000;701600000;1952800000;529300000;;3923200000;4452500000;6405300000;1360900000;305000000;1665900000;2063900000;2833900000;4499800000;875400000;-425700000;2057300000;1905500000;6405300000
NWL;378194;USD;2009;Q4;2009-12-31;2010-08-06;281100000;308500000;278300000;894100000;688200000;1998300000;578100000;;3847500000;4425600000;6423900000;1266000000;493500000;1759500000;2015300000;2882200000;4641700000;963800000;-420600000;1820700000;1782200000;6423900000
NWL;378194;USD;2018;Q4;2018-12-31;2019-03-04;451600000;450600000;495700000;1850700000;1583100000;7748800000;925600000;;9042000000;9967600000;17716400000;2360900000;318700000;3330000000;6696300000;9108600000;12438600000;9227200000;-584700000;-2486700000;5277800000;17716400000
NRG;378196;USD;2016;Q4;2016-12-31;2017-02-28;318000000;317000000;938000000;1058000000;721000000;6714000000;15369000000;;8599000000;23968000000;30682000000;1803000000;516000000;4702000000;16187000000;21488000000;26190000000;8362000000;-2399000000;-3787000000;4492000000;30682000000
NRG;378196;USD;2015;Q4;2015-12-31;2016-02-29;316000000;315000000;1518000000;1157000000;1252000000;7391000000;18732000000;;6759000000;25491000000;32882000000;1679000000;481000000;4375000000;20129000000;22742000000;27117000000;8300000000;-2413000000;-3007000000;5765000000;32882000000
NRG;378196;USD;2014;Q4;2014-12-31;2015-02-27;337000000;352000000;2116000000;1322000000;1247000000;8408000000;22367000000;;9691000000;32058000000;40466000000;1865000000;474000000;4859000000;20945000000;23621000000;28480000000;8331000000;-1983000000;3588000000;11986000000;40466000000
NRG;378196;USD;2013;Q4;2013-12-31;2014-09-10;323000000;315000000;2254000000;1214000000;898000000;7596000000;19851000000;;6455000000;26306000000;33902000000;1703000000;1050000000;4204000000;16944000000;18980000000;23184000000;7844000000;-1942000000;3695000000;10718000000;33902000000
NRG;378196;USD;2012;Q4;2012-12-31;2013-02-27;244000000;251000000;2087000000;1061000000;903000000;7972000000;20153000000;;6858000000;27011000000;34983000000;1902000000;147000000;4670000000;17014000000;19795000000;24465000000;7591000000;-1920000000;4230000000;10518000000;34983000000
NRG;378196;USD;2011;Q4;2011-12-31;2012-02-28;230000000;233000000;1105000000;834000000;308000000;7749000000;13621000000;;5530000000;19151000000;26900000000;1254000000;87000000;5861000000;9928000000;13121000000;18982000000;5349000000;-1924000000;3987000000;7918000000;26900000000
NRG;378196;USD;2010;Q4;2010-12-31;2011-02-22;266000000;272000000;2951000000;734000000;453000000;7137000000;12517000000;;7242000000;19759000000;26896000000;1282000000;463000000;4220000000;8971000000;14356000000;18576000000;5326000000;-1503000000;3800000000;8320000000;26896000000
NRG;378196;USD;2009;Q4;2009-12-31;2010-02-23;245000000;262000000;2304000000;876000000;541000000;6208000000;11564000000;;5606000000;17170000000;23378000000;1198000000;571000000;3762000000;8141000000;11672000000;15434000000;4951000000;-1163000000;3332000000;7944000000;23378000000
NRG;378196;USD;2017;Q4;2017-12-31;2018-03-01;319000000;314000000;991000000;1079000000;532000000;4415000000;13908000000;;4995000000;18903000000;23318000000;1804000000;688000000;3317000000;15923000000;17955000000;21272000000;8380000000;-2386000000;-6268000000;2046000000;23318000000
NRG;378196;USD;2018;Q4;2018-12-31;2019-02-28;289000000;297000000;563000000;1024000000;412000000;3600000000;3048000000;;3980000000;7028000000;10628000000;1543000000;72000000;2463000000;6449000000;9380000000;11843000000;8514000000;-3632000000;-6022000000;-1215000000;10628000000
PKI;378197;USD;2017;Q4;2018-01-31;2017-08-08;110064000;111477000;180800000;575740000;374808000;1234004000;307234000;;4584948000;4892182000;6126186000;693634000;217751000;925984000;1859698000;2644950000;3570934000;176278000;;2406952000;2555252000;6126186000
PKI;378197;USD;2016;Q4;2017-01-31;2016-08-09;;;359265000;425588000;246847000;1189931000;145494000;;2941258000;3086752000;4276683000;567733000;1172000;603355000;1045254000;1519758000;2123113000;135747000;;2118684000;2153570000;4276683000
PKI;378197;USD;2015;Q4;2016-01-31;2016-03-01;111737000;112566000;237932000;415064000;259486000;1033161000;137564000;;2995570000;3133134000;4166295000;523314000;1123000;561485000;1011762000;1494369000;2055854000;164966000;;1991431000;2110441000;4166295000
PKI;378197;USD;2014;Q4;2015-01-31;2015-02-24;112385000;113449000;174821000;470563000;285457000;1068551000;176194000;1568000;2881263000;3059025000;4127576000;576974000;1075000;597310000;1045393000;1488164000;2085474000;206757000;;1810545000;2042102000;4127576000
PKI;378197;USD;2013;Q4;2014-01-31;2014-02-25;112160000;113463000;173242000;466749000;260858000;1044838000;183188000;1319000;2717367000;2901874000;3946712000;570559000;2624000;602796000;932104000;1349429000;1952225000;232532000;;1684364000;1994487000;3946712000
PKI;378197;USD;2012;Q4;2013-01-31;2013-02-26;114440000;115745000;171444000;457011000;247688000;971754000;210516000;1149000;2718343000;2930008000;3901762000;556969000;1772000;581100000;938824000;1380850000;1961950000;324646000;;1548573000;1939812000;3901762000
PKI;378197;USD;2011;Q4;2012-01-31;2012-02-28;112709000;113268000;142342000;409888000;240763000;883052000;174567000;1105000;2796917000;2972589000;3855641000;583295000;0;598682000;944908000;1414743000;2013425000;277447000;;1510683000;1842216000;3855641000
PKI;378197;USD;2010;Q4;2011-01-31;2011-03-01;116411000;117486000;420086000;356763000;206851000;1084612000;161820000;1350000;1961164000;2124334000;3208946000;484080000;2255000;515202000;424000000;768353000;1283555000;339728000;;1534635000;1925391000;3208946000
PKI;378197;USD;2009;Q4;2010-01-31;2010-08-10;116319000;116899000;179707000;320180000;178666000;884018000;153026000;2287000;2019709000;2175022000;3059040000;429504000;146000;497204000;558197000;932879000;1430083000;367622000;;1288586000;1628957000;3059040000
PKI;378197;USD;2018;Q4;2019-01-31;2018-08-07;110747000;111606000;163392000;564041000;366961000;1202413000;304538000;;4450827000;4755365000;5957778000;685770000;17315000;712693000;1983953000;2727908000;3440601000;184456000;;2463287000;2517177000;5957778000
PCG;378198;USD;2015;Q4;2015-12-31;2016-02-18;493000000;495000000;123000000;1106000000;439000000;5813000000;46723000000;;10698000000;57421000000;63234000000;2018000000;1179000000;6363000000;15925000000;40043000000;46406000000;11282000000;;5301000000;16828000000;63234000000
PCG;378198;USD;2014;Q4;2014-12-31;2015-02-10;474000000;477000000;151000000;960000000;476000000;6389000000;43941000000;;9797000000;53738000000;60127000000;1917000000;633000000;5920000000;15050000000;38207000000;44127000000;10421000000;;5316000000;16000000000;60127000000
PCG;378198;USD;2013;Q4;2013-12-31;2014-02-11;454000000;455000000;296000000;1091000000;454000000;5977000000;41252000000;;8376000000;49628000000;55605000000;2656000000;2063000000;7493000000;12717000000;33518000000;41011000000;9550000000;;4742000000;14594000000;55605000000
PCG;378198;USD;2012;Q4;2012-12-31;2013-02-21;431000000;430000000;401000000;937000000;444000000;5121000000;37523000000;;9805000000;47328000000;52449000000;2555000000;892000000;6256000000;12517000000;32867000000;39123000000;8428000000;;4747000000;13326000000;52449000000
PCG;378198;USD;2011;Q4;2011-12-31;2012-02-16;406000000;407000000;513000000;992000000;420000000;6480000000;33655000000;;9615000000;43270000000;49750000000;2550000000;1697000000;7749000000;11766000000;29648000000;37397000000;7602000000;;4712000000;12353000000;49750000000
PCG;378198;USD;2010;Q4;2010-12-31;2011-02-17;394000000;397000000;291000000;944000000;357000000;5542000000;31449000000;;9034000000;40483000000;46025000000;2447000000;1662000000;7185000000;11329000000;27306000000;34491000000;6878000000;;4606000000;11534000000;46025000000
PCG;378198;USD;2009;Q4;2009-12-31;2010-02-19;370000000;421000000;527000000;859000000;314000000;5657000000;28892000000;;8396000000;37288000000;42945000000;2365000000;1175000000;6813000000;11208000000;25547000000;32360000000;6280000000;;4213000000;10585000000;42945000000
PCG;378198;USD;2008;Q4;2008-12-31;2009-08-05;360000000;361000000;219000000;1751000000;423000000;6403000000;26261000000;;8196000000;34457000000;40860000000;2241000000;887000000;7626000000;10534000000;23605000000;31231000000;5984000000;;3614000000;9629000000;40860000000
PCG;378198;USD;2016;Q4;2016-12-31;2017-02-16;505000000;508000000;177000000;1252000000;463000000;6164000000;50581000000;;11853000000;62434000000;68598000000;2144000000;2216000000;7564000000;16220000000;42842000000;50406000000;12198000000;;5751000000;18192000000;68598000000
PCG;378198;USD;2017;Q4;2017-12-31;2018-02-09;516000000;512000000;449000000;1243000000;481000000;6281000000;53789000000;;7942000000;61731000000;68012000000;2380000000;1376000000;7129000000;17753000000;41411000000;48540000000;12632000000;;6596000000;19472000000;68012000000
PXD;378199;USD;2015;Q4;2015-12-31;2016-02-19;149000000;148000000;1391000000;384000000;155000000;3194000000;11545000000;0;415000000;11960000000;15154000000;865000000;448000000;1462000000;3207000000;5317000000;6779000000;6269000000;-199000000;2298000000;8375000000;15154000000
PXD;378199;USD;2014;Q4;2014-12-31;2015-02-19;147000000;147000000;1025000000;436000000;241000000;2359000000;11781000000;239000000;530000000;12550000000;14909000000;1238000000;0;1419000000;2648000000;4901000000;6320000000;6169000000;-171000000;2583000000;8589000000;14909000000
PXD;378199;USD;2013;Q4;2013-12-31;2014-02-27;138000000;133000000;393000000;431000000;220000000;1730000000;9850000000;225000000;489000000;10564000000;12294000000;972000000;;1250000000;2653000000;4429000000;5679000000;5081000000;-144000000;1665000000;6615000000;12294000000
PXD;378199;USD;2012;Q4;2012-12-31;2013-02-13;123381000;131614000;229396000;316854000;197056000;1050355000;11296044000;204129000;518502000;12018675000;13069030000;798233000;;1034790000;3721193000;6166932000;7201722000;3685284000;-510570000;2514640000;5867308000;13069030000
PXD;378199;USD;2011;Q4;2011-12-31;2012-02-29;119253000;125324000;537484000;275991000;241609000;1402292000;9173942000;169532000;701390000;10044864000;11447156000;714483000;;1069511000;2528905000;4726507000;5796018000;3615139000;-458281000;2335066000;5651138000;11447156000
PXD;378199;USD;2010;Q4;2010-12-31;2011-02-25;115298000;117831000;111160000;237511000;173615000;1197183000;7847328000;72045000;562546000;8481919000;9679102000;433066000;;769220000;2601670000;4683857000;5453077000;3024030000;-421235000;1510427000;4226025000;9679102000
PXD;378199;USD;2009;Q4;2009-12-31;2010-02-26;114350000;114350000;27368000;330711000;139177000;616118000;7721686000;;529461000;8251147000;8867265000;285779000;;571191000;2761011000;4653043000;5224234000;2982702000;-415211000;917688000;3643031000;8867265000
PXD;378199;USD;2008;Q4;2008-12-31;2009-08-12;115440000;115493000;48337000;206794000;76901000;486911000;8021268000;;653606000;8674874000;9161785000;369553000;;694997000;2899241000;4787175000;5482172000;2910981000;-411659000;988786000;3679613000;9161785000
PXD;378199;USD;2016;Q4;2016-12-31;2017-02-17;168000000;168000000;2559000000;517000000;181000000;3298000000;12370000000;420000000;371000000;13161000000;16459000000;809000000;485000000;1566000000;2728000000;4482000000;6048000000;8894000000;-218000000;1728000000;10411000000;16459000000
PXD;378199;USD;2017;Q4;2017-12-31;2018-02-20;170000000;170000000;2109000000;644000000;212000000;3007000000;13528000000;66000000;402000000;13996000000;17003000000;1233000000;449000000;2128000000;2283000000;3596000000;5724000000;8976000000;-249000000;2547000000;11279000000;17003000000
PXD;378199;USD;2018;Q4;2018-12-31;2019-02-26;173000000;171000000;1268000000;694000000;242000000;2408000000;14839000000;297000000;359000000;15495000000;17903000000;1496000000;0;1818000000;2284000000;3974000000;5792000000;9064000000;-423000000;3470000000;12111000000;17903000000
PBI;378200;USD;2018;Q4;2018-12-31;2019-02-20;187595000;188824000;926653000;1214649000;62279000;2315007000;456342000;536369000;2636439000;3629150000;5944157000;1405646000;199535000;1880781000;3066073000;3961534000;5842315000;444813000;-4674089000;5279682000;101842000;5944157000
PBI;378200;USD;2017;Q4;2017-12-31;2018-02-22;186516000;187731000;1058009000;1255025000;40769000;2830383000;557459000;652087000;2647491000;3857037000;6687420000;1467677000;271057000;2069308000;3559278000;4429551000;6498859000;461705000;-4710997000;5229584000;188561000;6687420000
PBI;378200;USD;2016;Q4;2016-12-31;2016-11-07;186541000;187674000;802970000;1349477000;92726000;2325183000;502657000;673207000;2336086000;3511950000;5837133000;1413256000;614485000;2327619000;2750405000;3613174000;5940793000;471463000;-4743208000;5107734000;-103660000;5837133000
PBI;378200;USD;2015;Q4;2015-12-31;2015-11-06;196417000;197244000;767578000;1394966000;88824000;2325352000;507603000;760657000;2529520000;3797780000;6123132000;1464941000;461085000;2279051000;2489583000;3368990000;5648041000;484618000;-4573305000;5155537000;475091000;6123132000
PBI;378200;USD;2014;Q4;2014-12-31;2014-11-07;200910000;203520000;1103253000;1437579000;84827000;2763687000;485471000;819721000;2430823000;3736015000;6499702000;1603498000;324879000;2315223000;2927127000;3810850000;6126073000;502190000;-4477032000;4897708000;373629000;6499702000
PBI;378200;USD;2013;Q4;2013-12-31;2013-11-08;201914000;203675000;938934000;1572721000;103580000;2838212000;471317000;962363000;2500816000;3934496000;6772708000;1801922000;0;2227755000;3346295000;4043407000;6271162000;520315000;-4456742000;4715564000;501546000;6772708000
PBI;378200;USD;2012;Q4;2012-12-31;2012-11-02;200751000;202079000;949887000;1916542000;179678000;3212127000;626569000;1061035000;2960160000;4647764000;7859891000;2049907000;375000000;2877037000;3642375000;4575853000;7452890000;547185000;-4500795000;4744802000;407001000;7859891000
PBI;378200;USD;2011;Q4;2011-12-31;2011-05-05;199749000;200590000;869209000;1974720000;178599000;3259858000;662857000;1244062000;2980327000;4887246000;8147104000;2083437000;550000000;3091862000;3683909000;4797858000;7889720000;563922000;-4542143000;4600217000;257384000;8147104000
PBI;378200;USD;2010;Q4;2010-12-31;2010-11-05;203637000;205139000;514972000;2113731000;168967000;3008241000;726671000;1495505000;3213606000;5435782000;8444023000;2021679000;50000000;2553579000;4239248000;5690655000;8244234000;574266000;-4480113000;4282316000;199789000;8444023000
PBI;378200;USD;2009;Q4;2009-12-31;2009-11-06;207106000;207694000;427419000;2187770000;156502000;2971236000;875111000;1588801000;3135891000;5599803000;8571039000;1892639000;226022000;2566447000;4213640000;5711374000;8277821000;579471000;-4415096000;4291393000;293218000;8571039000
PBI;378200;USD;2008;Q4;2008-12-31;2009-08-05;;;398222000;2335368000;161321000;3043082000;972209000;1621885000;3173060000;5767154000;8810236000;2014215000;770501000;3226272000;3934865000;5496578000;8722850000;582644000;-4453969000;4179904000;87386000;8810236000
PX;378201;USD;2015;Q4;2015-12-31;2016-02-24;285287000;287155000;147000000;1601000000;531000000;2626000000;10998000000;;4695000000;15693000000;18319000000;791000000;256000000;1893000000;8975000000;11520000000;13413000000;4009000000;-7253000000;12229000000;4906000000;18319000000
PX;378201;USD;2014;Q4;2014-12-31;2015-02-25;290666000;293964000;126000000;1796000000;551000000;2839000000;11997000000;693000000;4240000000;16930000000;19769000000;864000000;589000000;2490000000;8636000000;11093000000;13583000000;3998000000;-6651000000;11461000000;6186000000;19769000000
PX;378201;USD;2013;Q4;2013-12-31;2014-02-25;294696000;299149000;138000000;1892000000;506000000;2916000000;12278000000;702000000;4359000000;17339000000;20255000000;921000000;785000000;2664000000;8026000000;10281000000;12945000000;3974000000;-5912000000;10528000000;7310000000;20255000000
PX;378201;USD;2012;Q4;2012-12-31;2013-02-27;296886000;300281000;157000000;1834000000;476000000;2792000000;11453000000;654000000;3191000000;15298000000;18090000000;928000000;677000000;2479000000;6685000000;8938000000;11417000000;3893000000;-5511000000;9534000000;6673000000;18090000000
PX;378201;USD;2011;Q4;2011-12-31;2012-02-29;299574000;304417000;90000000;1795000000;456000000;2607000000;10131000000;523000000;3095000000;13749000000;16356000000;896000000;724000000;2535000000;5838000000;7804000000;10339000000;3813000000;-5089000000;8510000000;6017000000;16356000000
PX;378201;USD;2010;Q4;2010-12-31;2011-02-23;306134000;311704000;39000000;1664000000;399000000;2378000000;9532000000;564000000;2800000000;12896000000;15274000000;830000000;402000000;2110000000;5155000000;7019000000;9129000000;3706000000;-4371000000;7475000000;6145000000;15274000000
PX;378201;USD;2009;Q4;2009-12-31;2010-02-24;307569000;313606000;45000000;1579000000;377000000;2223000000;8990000000;435000000;2669000000;12094000000;14317000000;730000000;298000000;1813000000;4757000000;6856000000;8669000000;3477000000;-3838000000;6831000000;5648000000;14317000000
PX;378201;USD;2008;Q4;2008-12-31;2009-04-29;307635000;311206000;32000000;1604000000;445000000;2301000000;7922000000;416000000;2415000000;10753000000;13054000000;820000000;1316000000;2979000000;3709000000;5764000000;8743000000;3332000000;-3623000000;6068000000;4311000000;13054000000
PX;378201;USD;2016;Q4;2016-12-31;2017-03-01;285719000;288441000;524000000;1641000000;550000000;2880000000;11477000000;;4975000000;16452000000;19332000000;906000000;598000000;2478000000;8917000000;11402000000;13880000000;4078000000;-7336000000;12879000000;5452000000;19332000000
PX;378201;USD;2017;Q4;2017-12-31;2018-02-28;286978000;291321000;617000000;1804000000;614000000;3285000000;12057000000;727000000;4367000000;17151000000;20436000000;972000000;1217000000;3307000000;7783000000;10607000000;13914000000;4088000000;-7196000000;13224000000;6522000000;20436000000
PSA;378204;USD;2016;Q4;2016-12-31;2017-03-01;173192000;173814000;183688000;;;183688000;8922576000;;1024074000;9946650000;10130338000;297935000;;297935000;390749000;390749000;688684000;5627097000;;-487581000;9441654000;10130338000
PSA;378204;USD;2015;Q4;2015-12-31;2016-02-29;172876000;173758000;104285000;;;104285000;8557713000;;1116234000;9673947000;9778232000;261578000;;261578000;319016000;319016000;580594000;5618799000;;-434610000;9197638000;9778232000
PSA;378204;USD;2014;Q4;2014-12-31;2015-02-25;172434000;173258000;187712000;;;187712000;8485288000;;1145676000;9630964000;9818676000;247141000;;247141000;64364000;64364000;311505000;5578775000;;-374823000;9507171000;9818676000
PSA;378204;USD;2013;Q4;2013-12-31;2014-02-26;171768000;172798000;19169000;428139000;;447308000;8239778000;;1189180000;9428958000;9876266000;268458000;;268458000;788953000;788953000;1057411000;5548212000;;-318482000;8818855000;9876266000
PSA;378204;USD;2012;Q4;2012-12-31;2013-02-26;170867000;171981000;17239000;410995000;;428234000;7331932000;;1033237000;8365169000;8793403000;334711000;;334711000;335828000;335828000;670539000;5536735000;;-279474000;8122864000;8793403000
PSA;378204;USD;2011;Q4;2011-12-31;2012-02-27;170093000;171387000;139008000;402693000;;541701000;7379197000;;1011664000;8390861000;8932562000;210966000;;210966000;398314000;398314000;609280000;5459530000;;-259578000;8323282000;8932562000
PSA;378204;USD;2010;Q4;2010-12-31;2011-03-01;169213000;170172000;558531000;495229000;;1053760000;7532816000;;908757000;8441573000;9495333000;205769000;;205769000;568417000;568417000;774186000;5532754000;;-236410000;8721147000;9495333000
PSA;378204;USD;2009;Q4;2009-12-31;2010-03-01;168399000;169028000;763789000;561703000;;1325492000;7562033000;;918120000;8480153000;9805645000;212253000;;212253000;518889000;518889000;731142000;5697391000;;-153759000;9074503000;9805645000
PSA;378204;USD;2008;Q4;2008-12-31;2009-08-10;168256000;168681000;680701000;552361000;;1233062000;7821889000;;881094000;8702983000;9936045000;212353000;;212353000;643811000;643811000;856164000;5606922000;;-290323000;9079881000;9936045000
PSA;378204;USD;2017;Q4;2017-12-31;2018-03-01;173771000;174220000;433376000;;;433376000;9230099000;;1069417000;10299516000;10732892000;337201000;;337201000;1431322000;1431322000;1768523000;5665784000;;-675711000;8964369000;10732892000
PSA;378204;USD;2018;Q4;2018-12-31;2019-02-27;174077000;174468000;361218000;;;361218000;9442111000;;1124941000;10567052000;10928270000;371259000;;371259000;1412283000;1412283000;1783542000;5735898000;;-577360000;9144728000;10928270000
PWR;378205;USD;2015;Q4;2015-12-31;2016-02-29;162981000;162970000;128771000;1621133000;75285000;2277519000;1101959000;;1834065000;2936024000;5213543000;782134000;7067000;1203744000;475364000;921984000;2125728000;3497742000;-1795257000;1677698000;3087815000;5213543000
PWR;378205;USD;2014;Q4;2014-12-31;2015-03-02;220535000;220526000;190515000;1801110000;38921000;2495704000;1099574000;;2658305000;3757879000;6253583000;825231000;8876000;1106311000;72489000;621732000;1728043000;3592908000;-321936000;1366791000;4525540000;6253583000
PWR;378205;USD;2013;Q4;2013-12-31;2014-03-03;217083000;217116000;488777000;1439115000;31877000;2313318000;1205608000;;2274319000;3479927000;5793245000;802180000;1181000;1042467000;1053000;509459000;1551926000;3416587000;-215240000;1070077000;4241319000;5793245000
PWR;378205;USD;2012;Q4;2012-12-31;2013-03-01;213490000;213419000;394701000;1328081000;38261000;2201727000;1045983000;;1893047000;2939030000;5140757000;707285000;9000;881179000;;487662000;1368841000;3287088000;-203149000;668156000;3771916000;5140757000
PWR;378205;USD;2011;Q4;2011-12-31;2012-02-29;211015000;212790000;315349000;959887000;62519000;1765154000;938902000;;1995058000;2933960000;4699114000;570572000;56000;781076000;;528775000;1309851000;3216208000;-196493000;361527000;3389263000;4699114000
PWR;378205;USD;2010;Q4;2010-12-31;2011-03-01;212684000;214664000;539221000;766387000;51754000;1596364000;900768000;;1844080000;2744848000;4341212000;415947000;1327000;500395000;;473898000;974293000;3162781000;-40360000;229012000;3366919000;4341212000
PWR;378205;USD;2009;Q4;2009-12-31;2010-03-01;208320000;203908000;699629000;688260000;33451000;1582792000;854437000;;1679725000;2534162000;4116954000;422034000;3426000;495688000;126608000;510705000;1006393000;3065583000;-35738000;75836000;3110561000;4116954000
PWR;378205;USD;2008;Q4;2008-12-31;2009-08-10;195628000;197551000;437901000;795251000;25813000;1385407000;635456000;;1537296000;2172752000;3558159000;400253000;1155000;451798000;122275000;423987000;875785000;2803838000;-32182000;-86326000;2682374000;3558159000
PWR;378205;USD;2016;Q4;2016-12-31;2017-03-01;155193000;155192000;112183000;1500115000;88548000;2288745000;1174094000;;1891220000;3065314000;5354059000;922819000;7563000;1205228000;353562000;806129000;2011357000;1749307000;-14288000;1876081000;3342702000;5354059000
PWR;378205;USD;2017;Q4;2017-12-31;2018-02-28;156754000;158667000;138285000;1985077000;80890000;2869907000;1288602000;;2321645000;3610247000;6480154000;1057460000;1220000;1492067000;670721000;1192458000;2684525000;1889358000;-85451000;2191059000;3795629000;6480154000
PWR;378205;USD;2018;Q4;2018-12-31;2019-02-28;149419000;151066000;78687000;2354737000;107732000;3326104000;1276032000;;2473651000;3749683000;7075787000;1314520000;65646000;1806127000;1040532000;1664207000;3470334000;1967354000;-554440000;2477291000;3605451000;7075785000
RHI;378208;USD;2016;Q4;2016-12-31;2017-02-13;126482000;127407000;260201000;703228000;;1284234000;161509000;;332228000;493737000;1777971000;679729000;167000;679896000;840000;11476000;691372000;1022539000;;84562000;1086599000;1777971000
RHI;378208;USD;2015;Q4;2015-12-31;2016-02-17;130135000;131393000;224577000;704640000;;1197997000;142906000;;330141000;473047000;1671044000;655396000;153000;655549000;1007000;11714000;667263000;979608000;;34467000;1003781000;1671044000
RHI;378208;USD;2014;Q4;2014-12-31;2015-02-13;133346000;134929000;287119000;657676000;;1323283000;121754000;;202230000;323984000;1647267000;623222000;140000;623362000;1159000;44047000;667409000;928292000;;36836000;979858000;1647267000
RHI;378208;USD;2013;Q4;2013-12-31;2014-02-14;135189000;137062000;275764000;551905000;;1172528000;112644000;;205099000;317743000;1490271000;535725000;128000;535853000;1300000;34775000;570628000;868257000;;13315000;919643000;1490271000
RHI;378208;USD;2012;Q4;2012-12-31;2013-02-15;136914000;138313000;287635000;512852000;;1064685000;107680000;;208906000;316586000;1381271000;501520000;117000;501637000;1428000;37623000;539260000;798232000;;0;842011000;1381271000
RHI;378208;USD;2011;Q4;2011-12-31;2012-02-17;138528000;140006000;279336000;493327000;;1006678000;107972000;;197186000;305158000;1311836000;472890000;111000;473001000;1545000;38330000;511331000;759618000;;0;800505000;1311836000
RHI;378208;USD;2010;Q4;2010-12-31;2011-02-17;141763000;143108000;315137000;423175000;;971860000;103651000;;198473000;302124000;1273984000;408337000;123000;408460000;1656000;31153000;439613000;787251000;;0;834371000;1273984000
RHI;378208;USD;2009;Q4;2009-12-31;2010-08-02;144106000;145141000;365794000;362392000;;922634000;124658000;;236243000;360901000;1283535000;366855000;113000;366968000;1779000;16757000;383725000;854230000;;0;899810000;1283535000
RHI;378208;USD;2017;Q4;2017-12-31;2018-02-20;122885000;123846000;294753000;732405000;;1431869000;144887000;;290698000;435585000;1867454000;747713000;183000;747896000;657000;14293000;762189000;1064725000;;37033000;1105265000;1867454000
RHI;378208;USD;2018;Q4;2018-12-31;2019-02-15;118696000;119810000;276579000;794446000;;1473610000;125176000;;304311000;429487000;1903097000;819336000;200000;819536000;457000;20363000;839899000;1079307000;;0;1063198000;1903097000
COL;378209;USD;2017;Q4;2017-09-30;2017-11-14;162500000;164600000;703000000;1426000000;2451000000;4760000000;1398000000;;11839000000;13237000000;17997000000;1214000000;479000000;3069000000;6676000000;8878000000;11947000000;4561000000;-781000000;3838000000;6050000000;17997000000
COL;378209;USD;2016;Q4;2016-09-30;2016-11-15;129800000;131800000;340000000;1094000000;1939000000;3490000000;1035000000;;3174000000;4209000000;7699000000;773000000;740000000;2346000000;1374000000;3269000000;5615000000;1507000000;-858000000;3327000000;2084000000;7699000000
COL;378209;USD;2015;Q4;2015-09-30;2015-11-17;131900000;133000000;252000000;1038000000;1824000000;3224000000;964000000;;3116000000;4080000000;7304000000;719000000;448000000;2060000000;1680000000;3364000000;5424000000;1521000000;-3071000000;5124000000;1880000000;7304000000
COL;378209;USD;2014;Q4;2014-09-30;2014-11-18;134500000;136000000;323000000;1033000000;1709000000;3204000000;919000000;;2940000000;3859000000;7063000000;737000000;504000000;2198000000;1663000000;2976000000;5174000000;1491000000;-2846000000;4605000000;1889000000;7063000000
COL;378209;USD;2013;Q4;2013-09-30;2013-11-12;134900000;136700000;391000000;1058000000;1518000000;3094000000;773000000;;1533000000;2306000000;5400000000;647000000;436000000;1981000000;563000000;1796000000;3777000000;1471000000;-2729000000;4163000000;1623000000;5400000000
COL;378209;USD;2012;Q4;2012-09-30;2012-11-13;142200000;143500000;335000000;971000000;1332000000;2787000000;773000000;;1754000000;2527000000;5314000000;649000000;0;1440000000;779000000;2610000000;4050000000;1462000000;-2304000000;3708000000;1264000000;5314000000
COL;378209;USD;2011;Q4;2011-09-30;2011-11-15;153100000;154500000;530000000;969000000;1195000000;2889000000;754000000;;1746000000;2500000000;5389000000;613000000;;1495000000;528000000;2366000000;3861000000;1439000000;-1707000000;3288000000;1528000000;5389000000
COL;378209;USD;2010;Q4;2010-09-30;2010-11-23;156900000;158700000;435000000;1024000000;1004000000;2689000000;707000000;;1668000000;2375000000;5064000000;420000000;24000000;1452000000;525000000;2126000000;3578000000;1422000000;-1497000000;2816000000;1486000000;5064000000
COL;378209;USD;2009;Q4;2009-09-30;2009-11-23;157000000;159400000;235000000;913000000;943000000;2362000000;719000000;;1564000000;2283000000;4645000000;366000000;0;1359000000;532000000;1991000000;3350000000;1397000000;-1469000000;2444000000;1295000000;4645000000
COL;378209;USD;2008;Q4;2008-09-30;2009-08-17;158700000;160500000;175000000;950000000;970000000;2338000000;680000000;;1126000000;1806000000;4144000000;419000000;287000000;1740000000;228000000;996000000;2736000000;1380000000;-1452000000;2058000000;1408000000;4144000000
COL;378209;USD;2018;Q4;2018-09-30;2018-11-26;164200000;166100000;738000000;2109000000;2649000000;5778000000;1429000000;;11819000000;13248000000;19026000000;1101000000;2248000000;4686000000;5681000000;7226000000;11912000000;4606000000;-682000000;4654000000;7114000000;19026000000
R;378210;USD;2016;Q4;2016-12-31;2017-02-14;52974000;53413000;58801000;831947000;69529000;1101557000;8893592000;;907305000;9800897000;10902454000;952659000;791410000;1744069000;4599864000;7106110000;8850179000;1059281000;;1827026000;2052275000;10902454000
R;378210;USD;2015;Q4;2015-12-31;2016-02-12;52945000;53306000;60945000;835489000;63725000;1098302000;8899705000;;954573000;9854278000;10952580000;1045725000;634530000;1680255000;4868097000;7285214000;8965469000;1032766000;;1667080000;1987111000;10952580000
R;378210;USD;2014;Q4;2014-12-31;2015-02-13;52461000;53001000;50092000;794864000;66007000;1043644000;7901480000;;905747000;8807227000;9850871000;1074531000;36284000;1110815000;4694335000;6920969000;8031784000;988848000;;1450509000;1819087000;9850871000
R;378210;USD;2013;Q4;2013-12-31;2015-02-13;52277000;52740000;61562000;777370000;64298000;1062493000;7124663000;;916626000;8041289000;9103782000;971701000;259438000;1231139000;3929987000;5975929000;7207068000;944206000;;1390756000;1896714000;9103782000
R;378210;USD;2012;Q4;2012-12-31;2013-02-14;50497000;50789000;66392000;775765000;64146000;1040237000;6379461000;;899281000;7278742000;8318979000;904690000;367975000;1272665000;3452821000;5578827000;6851492000;833916000;;1221190000;1467487000;8318979000
R;378210;USD;2011;Q4;2011-12-31;2012-03-19;50402000;50745000;104572000;754644000;65912000;1088173000;5673851000;;855811000;6529662000;7617835000;899457000;274366000;1173823000;3107779000;5125859000;6299682000;794955000;;1090363000;1318153000;7617835000
R;378210;USD;2010;Q4;2010-12-31;2011-02-15;50736000;51038000;213053000;615003000;58701000;1023301000;4808061000;;821012000;5629073000;6652374000;711395000;420124000;1131519000;2326878000;4116542000;5248061000;761127000;;1019785000;1404313000;6652374000
R;378210;USD;2009;Q4;2009-12-31;2010-07-23;;;98525000;598661000;50146000;880373000;4722569000;;656888000;5379457000;6259830000;617657000;232617000;850274000;2265074000;3982561000;4832835000;769736000;;1036178000;1426995000;6259830000
R;378210;USD;2017;Q4;2017-12-31;2018-02-20;52439000;52873000;78348000;1010908000;73543000;1322282000;9131966000;;997983000;10129949000;11452231000;1186709000;826069000;2012778000;4583582000;6604437000;8617215000;1077495000;;2465022000;2835016000;11452231000
R;378210;USD;2018;Q4;2018-12-31;2019-02-21;52388000;52377000;68111000;1219426000;79228000;1568391000;10341783000;;1140910000;11482693000;13051084000;1362369000;929952000;2292321000;5693646000;7848436000;10140757000;1110950000;;2710696000;2910327000;13051084000
SNI;378211;USD;2016;Q4;2016-12-31;2017-02-24;129673000;130361000;122937000;808133000;;1658099000;286399000;699481000;3556315000;4542195000;6200294000;265106000;249932000;716531000;2952454000;3255335000;3971866000;1391704000;;871766000;2228428000;6200294000
SNI;378211;USD;2015;Q4;2015-12-31;2016-02-25;128999000;129506000;223444000;816679000;;1727881000;293230000;807630000;3843573000;4944433000;6672314000;264169000;499174000;974649000;3511098000;3761489000;4736138000;1348778000;;305386000;1936176000;6672314000
SNI;378211;USD;2014;Q4;2014-12-31;2015-02-27;135786000;136480000;878164000;629775000;;2096330000;226246000;463344000;1871561000;2561151000;4657481000;151846000;883895000;1156855000;1485359000;1719788000;2876643000;1360344000;;79994000;1780838000;4657481000
SNI;378211;USD;2013;Q4;2013-12-31;2014-03-03;146781000;148046000;686371000;619619000;;1861310000;246350000;488198000;1842589000;2577137000;4438447000;141084000;;278699000;1384488000;1607856000;1886555000;1448958000;;662574000;2551892000;4438447000
SNI;378211;USD;2012;Q4;2012-12-31;2013-03-01;150531000;151601000;437525000;565298000;;1484276000;237308000;489703000;1927511000;2654522000;4138798000;151173000;;252629000;1384216000;1621618000;1874247000;1407188000;;452598000;2264551000;4138798000
SNI;378211;USD;2011;Q4;2011-12-31;2012-02-29;159598000;160270000;760092000;553022000;;1715968000;219845000;455267000;1570590000;2245702000;3961670000;130165000;;232899000;1383945000;1632376000;1865275000;1348000000;;364073000;2096395000;3961670000
SNI;378211;USD;2010;Q4;2010-12-31;2011-03-01;167786000;169412000;549897000;505392000;;1670875000;214131000;48536000;1454890000;1717557000;3388432000;105002000;;224075000;884395000;1084063000;1308138000;1372726000;;414972000;2080294000;3388432000
SNI;378211;USD;2009;Q4;2009-12-31;2010-08-09;;;254370000;430410000;;982269000;239644000;46395000;1694754000;1980793000;2963062000;150466000;;210708000;884239000;1103416000;1314124000;1272867000;;113853000;1648938000;2963062000
SNI;378211;USD;2017;Q4;2017-12-31;2018-02-27;130401000;131363000;130357000;914812000;;1748520000;333068000;740810000;3699282000;4773160000;6521680000;322809000;;573270000;2522005000;2837222000;3410492000;1450024000;;1341974000;3111188000;6521680000
STX;378212;USD;2018;Q4;2018-06-30;2018-08-03;288000000;294000000;1853000000;1184000000;1053000000;4310000000;1792000000;;3308000000;5100000000;9410000000;2691000000;499000000;3190000000;4320000000;4555000000;7745000000;6377000000;;-4696000000;1665000000;9410000000
STX;378212;USD;2017;Q4;2017-06-30;2017-08-04;293000000;297000000;2539000000;1199000000;982000000;5041000000;1875000000;;2352000000;4227000000;9268000000;2626000000;0;2626000000;5021000000;5278000000;7904000000;6152000000;;-4771000000;1364000000;9268000000
STX;378212;USD;2016;Q4;2016-06-30;2016-04-29;297000000;301000000;1131000000;1318000000;868000000;3533000000;2160000000;;2520000000;4680000000;8213000000;2249000000;;2249000000;4091000000;4371000000;6620000000;5929000000;;-4311000000;1593000000;8213000000
STX;378212;USD;2015;Q4;2015-06-30;2015-04-30;318000000;321000000;2485000000;1735000000;993000000;5568000000;2278000000;;1999000000;4277000000;9845000000;2343000000;;2343000000;4155000000;4484000000;6827000000;5734000000;;-2686000000;3018000000;9845000000
STX;378212;USD;2014;Q4;2014-06-30;2014-04-30;328000000;336000000;2654000000;1729000000;985000000;5777000000;2136000000;;1579000000;3715000000;9492000000;2398000000;;2398000000;3920000000;4262000000;6660000000;5511000000;;-2677000000;2832000000;9492000000
STX;378212;USD;2013;Q4;2013-06-30;2013-05-02;359000000;371000000;2188000000;1670000000;854000000;5412000000;2269000000;;1562000000;3831000000;9243000000;2608000000;3000000;2611000000;2774000000;3126000000;5737000000;5286000000;;-1778000000;3506000000;9243000000
STX;378212;USD;2012;Q4;2012-06-30;2012-04-30;410000000;429000000;2118000000;2319000000;909000000;6310000000;2284000000;;1512000000;3796000000;10106000000;3396000000;0;3396000000;2863000000;3213000000;6609000000;4950000000;;-1444000000;3497000000;10106000000
STX;378212;USD;2011;Q4;2011-06-30;2011-05-03;427000000;442000000;3151000000;1495000000;872000000;6425000000;2245000000;;555000000;2800000000;9225000000;2903000000;560000000;3463000000;2952000000;3299000000;6762000000;3980000000;;-1511000000;2463000000;9225000000
STX;378212;USD;2010;Q4;2010-06-30;2010-11-03;479000000;504000000;2515000000;1400000000;757000000;5418000000;2263000000;;566000000;2829000000;8247000000;2668000000;329000000;2997000000;2173000000;2526000000;5523000000;3851000000;;-1123000000;2724000000;8247000000
SEE;378213;USD;2017;Q4;2017-12-31;2018-02-21;174800000;176200000;594000000;552400000;506800000;1866400000;998400000;;2415500000;3413900000;5280300000;771100000;27500000;1378200000;3230500000;3749800000;5128000000;1962600000;-2700600000;1735200000;152300000;5280300000
SEE;378213;USD;2016;Q4;2016-12-31;2016-10-31;192300000;197200000;333700000;460500000;456700000;2215300000;889600000;;4310600000;5200200000;7415500000;587500000;380000000;2119000000;3762600000;4686800000;6805800000;1996900000;-1478100000;1040000000;609700000;7415500000
SEE;378213;USD;2015;Q4;2015-12-31;2015-11-03;195300000;198000000;351700000;758400000;660800000;2215700000;945700000;;4243600000;5189300000;7405000000;669000000;294800000;1807100000;4266800000;5070800000;6877900000;1937600000;-1265700000;675200000;527100000;7405000000
SEE;378213;USD;2014;Q4;2014-12-31;2014-11-05;209400000;212900000;286400000;1002000000;688500000;2618600000;943000000;;4391600000;5334600000;7953200000;624200000;144300000;1727200000;4282000000;5063200000;6790400000;1809500000;-481400000;448500000;1162800000;7953200000
SEE;378213;USD;2013;Q4;2013-12-31;2013-11-08;194900000;215200000;992400000;1126400000;730200000;3459500000;1134500000;;4582000000;5716500000;9176000000;524500000;283100000;2700800000;4116400000;5058900000;7759700000;1717700000;-327600000;302200000;1416300000;9176000000
SEE;378213;USD;2012;Q4;2012-12-31;2012-11-09;193100000;193100000;679600000;1213000000;728900000;3289300000;1194200000;;4848200000;6042400000;9331700000;480200000;41000000;2335000000;4540800000;5552400000;7887400000;1707300000;-353400000;254800000;1444300000;9331700000
SEE;378213;USD;2011;Q4;2011-12-31;2011-11-09;190800000;209300000;703600000;;777500000;3350200000;1269200000;;6812600000;8081800000;11432000000;554900000;36400000;2506200000;4966700000;5973400000;8479600000;1711700000;-375600000;1766500000;2952400000;11432000000
SEE;378213;USD;2010;Q4;2010-12-31;2010-11-08;158800000;177500000;675600000;;495800000;2040000000;948300000;;2411100000;3359400000;5399400000;232000000;30000000;1447700000;1399200000;1550100000;2997800000;1171500000;-362700000;1706100000;2401600000;5399400000
SEE;378213;USD;2009;Q4;2009-12-31;2010-08-11;157500000;175700000;694500000;;469400000;2073400000;1010700000;;2336000000;3346700000;5420100000;214200000;34700000;1433800000;1626300000;1786000000;3219800000;1145800000;-364600000;1531100000;2200300000;5420100000
SEE;378213;USD;2018;Q4;2018-12-31;2019-02-19;155400000;156900000;271700000;473400000;544900000;1554800000;1036200000;;2459200000;3495400000;5050200000;788500000;237700000;1488600000;3236500000;3910200000;5398800000;2072800000;-3336500000;1835500000;-348600000;5050200000
SRE;378214;USD;2017;Q4;2017-12-31;2018-02-27;251910000;250768000;288000000;1584000000;307000000;3511000000;36503000000;0;10440000000;46943000000;50454000000;2388000000;2967000000;6635000000;16445000000;28679000000;35314000000;3149000000;;10147000000;15140000000;50454000000
SRE;378214;USD;2016;Q4;2016-12-31;2016-11-02;250652000;752042000;349000000;1554000000;258000000;3344000000;32931000000;;11511000000;44442000000;47786000000;2257000000;2692000000;5927000000;14429000000;26618000000;32545000000;2982000000;;10717000000;15241000000;47786000000
SRE;378214;USD;2015;Q4;2015-12-31;2015-11-03;248796000;249992000;403000000;1473000000;298000000;3011000000;28039000000;;10100000000;38139000000;41150000000;2275000000;1529000000;4612000000;13134000000;23959000000;28571000000;2621000000;;9994000000;12579000000;41150000000
SRE;378214;USD;2014;Q4;2014-12-31;2014-11-04;246464000;252020000;570000000;1394000000;396000000;4184000000;25902000000;;9565000000;35467000000;39651000000;2008000000;2202000000;5069000000;12086000000;22482000000;27551000000;2484000000;;9339000000;12100000000;39651000000
SRE;378214;USD;2013;Q4;2013-12-31;2013-11-05;244452000;252028000;904000000;1522000000;287000000;3997000000;25460000000;;7787000000;33247000000;37244000000;1862000000;1692000000;4369000000;11253000000;21025000000;25394000000;2409000000;;8827000000;11850000000;37244000000
SRE;378214;USD;2012;Q4;2012-12-31;2012-11-06;241988000;250872000;475000000;1299000000;408000000;3695000000;25191000000;;7613000000;32804000000;36499000000;1713000000;1271000000;4258000000;11621000000;21558000000;25816000000;2217000000;;8441000000;10683000000;36499000000
SRE;378214;USD;2011;Q4;2011-12-31;2011-11-03;239880000;241492000;252000000;1345000000;346000000;2332000000;23465000000;;7452000000;30917000000;33249000000;1654000000;785000000;4152000000;10078000000;18919000000;23071000000;2104000000;;8162000000;10178000000;33249000000
SRE;378214;USD;2010;Q4;2010-12-31;2011-02-24;239409000;241857000;912000000;1032000000;258000000;3353000000;19876000000;;7054000000;26930000000;30283000000;1363000000;507000000;3786000000;8980000000;17259000000;21045000000;2036000000;;7329000000;9238000000;30283000000
SRE;378214;USD;2009;Q4;2009-12-31;2011-02-24;244947000;248968000;110000000;1130000000;197000000;2295000000;18281000000;;7936000000;26217000000;28512000000;1147000000;1191000000;3888000000;7460000000;15373000000;19261000000;2418000000;;6971000000;9251000000;28512000000
SHW;378215;USD;2016;Q4;2016-12-31;2017-02-22;92096964;94396672;889793000;1230987000;1068326000;3627298000;1095888000;;2029335000;3125223000;6752521000;1034608000;741214000;2829179000;1211326000;2044901000;4874080000;2605127000;-4235832000;4049497000;1878441000;6752521000
SHW;378215;USD;2015;Q4;2015-12-31;2016-02-24;91591944;93870315;205744000;1114275000;1018530000;2657180000;1041862000;;2079895000;3121757000;5778937000;1157561000;42616000;2141859000;1907278000;2769168000;4911027000;2446187000;-4220058000;3228876000;867910000;5778937000
SHW;378215;USD;2014;Q4;2014-12-31;2015-02-25;94527134;98847251;40732000;1130565000;1033527000;2565566000;1021030000;;2112737000;3133767000;5699333000;1042182000;682701000;2680666000;1115996000;2022197000;4702863000;2194164000;-3150410000;2424674000;996470000;5699333000
SHW;378215;USD;2013;Q4;2013-12-31;2014-02-27;99503067;101419927;744889000;1097751000;970815000;3158717000;1021383000;;2202407000;3223790000;6382507000;998484000;599499000;2528557000;1122373000;2079415000;4607972000;1960703000;-1639174000;1774050000;1774535000;6382507000
SHW;378215;USD;2012;Q4;2012-12-31;2013-02-28;101816954;103241180;862590000;1032508000;920324000;3149238000;965896000;;2119603000;3085499000;6234737000;922999000;72724000;1876436000;1632165000;2566497000;4442933000;1785411000;-849685000;1226467000;1791804000;6234737000
SHW;378215;USD;2011;Q4;2011-12-31;2012-02-23;102066637;104325490;32696000;989873000;926809000;2261593000;956530000;;2011129000;2967659000;5229252000;965149000;354136000;2162661000;639231000;1549672000;3712333000;1405079000;-276654000;756372000;1516919000;5229252000
SHW;378215;USD;2010;Q4;2010-12-31;2011-02-23;105986521;107417668;58585000;916661000;917701000;2213722000;952118000;;2003395000;2955513000;5169235000;909649000;396467000;2063940000;648326000;1495855000;3559795000;1454255000;-4390983000;4824489000;1609440000;5169235000
SHW;378215;USD;2009;Q4;2009-12-31;2010-02-24;-113224655924;-115474025345;69329000;696055000;738488000;1770019000;818685000;;1735151000;2553836000;4323855000;674766000;34941000;1393668000;782670000;1439237000;2832905000;1297610000;-4007633000;4518428000;1490950000;4323855000
SHW;378215;USD;2008;Q4;2008-12-31;2009-10-27;-351079879268;-358513330084;26212000;769985000;864200000;1909205000;860125000;;1646429000;2506554000;4415759000;738093000;530008000;1936736000;303727000;873375000;2810111000;1243509000;-3472384000;4245141000;1605648000;4415759000
SHW;378215;USD;2007;Q4;2007-12-31;2009-10-27;;;27325000;870675000;887465000;2069580000;899372000;;1886388000;2785760000;4855340000;740797000;671994000;2141385000;293454000;928228000;3069613000;1123233000;-3074388000;3935485000;1785727000;4855340000
SHW;378215;USD;2017;Q4;2017-12-31;2018-02-23;93254727;94990473;204213000;2104555000;1801375000;4465840000;1877115000;;13615472000;15492587000;19958427000;1791552000;634910000;3987180000;9885745000;12279059000;16266239000;2840744000;-4266416000;5502730000;3692188000;19958427000
SHW;378215;USD;2018;Q4;2018-12-31;2019-02-22;92604129;94386684;155505000;2018768000;1815275000;4344487000;1776839000;;13012953000;14789792000;19134279000;1935757000;635594000;4297747000;8708057000;11105787000;15403534000;3014821000;-4900690000;6246548000;3730745000;19134279000
SE;378216;USD;2015;Q4;2015-12-31;2015-11-05;671000000;671000000;213000000;806000000;307000000;1648000000;22918000000;;8357000000;31275000000;32923000000;768000000;1764000000;3392000000;12892000000;19999000000;23391000000;5054000000;;1741000000;9532000000;32923000000
SE;378216;USD;2014;Q4;2014-12-31;2015-02-27;672000000;670000000;215000000;1336000000;313000000;2332000000;22307000000;;9359000000;31666000000;33998000000;730000000;1910000000;3809000000;12727000000;19791000000;23600000000;4957000000;;2541000000;10398000000;33998000000
SE;378216;USD;2013;Q4;2013-12-31;2014-02-28;668000000;671000000;201000000;1336000000;263000000;2081000000;21829000000;;9623000000;31452000000;33533000000;713000000;2229000000;4039000000;12488000000;19171000000;23210000000;4870000000;;2383000000;10323000000;33533000000
SE;378216;USD;2012;Q4;2012-12-31;2013-02-22;654000000;659000000;94000000;970000000;309000000;1663000000;19905000000;;9019000000;28924000000;30587000000;716000000;2180000000;3791000000;10653000000;16953000000;20744000000;5298000000;;2165000000;9843000000;30587000000
SE;378216;USD;2011;Q4;2011-12-31;2012-02-27;651000000;657000000;174000000;962000000;393000000;1764000000;18258000000;;8116000000;26374000000;28138000000;758000000;1577000000;3101000000;10146000000;16141000000;19242000000;4815000000;;1977000000;8896000000;28138000000
SE;378216;USD;2010;Q4;2010-12-31;2011-02-24;648000000;651000000;130000000;1018000000;287000000;1638000000;16980000000;;8068000000;25048000000;26686000000;595000000;1151000000;2523000000;10169000000;15676000000;18199000000;4727000000;;1487000000;8487000000;26686000000
SE;378216;USD;2009;Q4;2009-12-31;2010-02-25;649000000;650000000;166000000;778000000;321000000;1429000000;15347000000;;7315000000;22662000000;24091000000;639000000;971000000;2495000000;8947000000;14015000000;16510000000;4646000000;;1088000000;7581000000;24091000000
SE;378216;USD;2008;Q4;2008-12-31;2009-08-07;610000000;609000000;214000000;795000000;279000000;1450000000;13639000000;;6835000000;20474000000;21924000000;548000000;1757000000;3044000000;8290000000;12870000000;15914000000;4105000000;;899000000;6010000000;21924000000
SE;378216;USD;2016;Q4;2016-12-31;2017-02-24;702000000;705000000;305000000;1003000000;253000000;1772000000;26208000000;;8862000000;35070000000;36842000000;1099000000;2004000000;3905000000;13624000000;21398000000;25303000000;5996000000;;1307000000;11539000000;36842000000
SPGI;378217;USD;2016;Q4;2016-12-31;2017-02-09;258800000;261600000;2392000000;1122000000;;3671000000;271000000;;4727000000;4998000000;8669000000;687000000;;2611000000;3564000000;4277000000;6888000000;914000000;-8701000000;9210000000;1781000000;8669000000
SPGI;378217;USD;2015;Q4;2015-12-31;2016-02-12;268500000;272000000;1487000000;991000000;;3296000000;270000000;;4617000000;4887000000;8183000000;766000000;143000000;2908000000;3468000000;4112000000;7020000000;887000000;-7729000000;7636000000;1163000000;8183000000
SPGI;378217;USD;2014;Q4;2014-12-31;2015-02-13;271800000;257300000;2500000000;932000000;;3962000000;206000000;;2605000000;2811000000;6773000000;2264000000;0;3920000000;795000000;1504000000;5424000000;905000000;-6849000000;6946000000;1349000000;6773000000
SPGI;378217;USD;2013;Q4;2013-12-31;2014-02-07;270400000;277800000;1560000000;949000000;;2941000000;249000000;;2871000000;3120000000;6061000000;648000000;;2372000000;799000000;1535000000;3907000000;859000000;-6746000000;7384000000;2154000000;6061000000
SPGI;378217;USD;2012;Q4;2012-12-31;2013-03-20;278000000;284700000;761000000;954000000;;3899000000;368000000;;2785000000;3153000000;7052000000;860000000;457000000;3667000000;799000000;1735000000;5402000000;904000000;-6145000000;6525000000;1650000000;7052000000
SPGI;378217;USD;2011;Q4;2011-12-31;2012-02-07;285800000;292000000;864000000;702000000;;4312000000;373000000;;1935000000;2308000000;6620000000;671000000;400000000;3369000000;798000000;1667000000;5036000000;506000000;-6240000000;7667000000;1584000000;6620000000
SPGI;378217;USD;2010;Q4;2010-12-31;2011-02-23;305800000;310000000;1548000000;973000000;275000000;3375000000;522000000;;3150000000;3672000000;7047000000;1028000000;0;2681000000;1198000000;2074000000;4755000000;479000000;-4958000000;7057000000;2292000000;7047000000
SPGI;378217;USD;2009;Q4;2009-12-31;2010-02-24;311286000;313308000;1234529000;969662000;301229000;2936396000;579796000;;2959058000;3538854000;6475250000;883744000;;2451954000;1197791000;2094119000;4546073000;416834000;-4749143000;6522613000;1929177000;6475250000
SPGI;378217;USD;2008;Q4;2008-12-31;2009-10-28;311329000;312948000;471671000;1060858000;369679000;2302723000;621062000;;3156357000;3777419000;6080142000;886654000;70022000;2530703000;1197611000;2196568000;4727271000;466859000;-4811294000;6070793000;1352871000;6080142000
SPGI;378217;USD;2017;Q4;2017-12-31;2018-02-09;254200000;257000000;2791000000;1319000000;;4324000000;275000000;;4826000000;5101000000;9425000000;851000000;399000000;3214000000;3170000000;4093000000;7307000000;937000000;-9602000000;10025000000;2118000000;9425000000
SPGI;378217;USD;2018;Q4;2018-12-31;2019-02-13;248800000;251600000;1935000000;1449000000;;3604000000;270000000;;5584000000;5854000000;9458000000;638000000;0;2629000000;3662000000;4525000000;7154000000;1127000000;-11041000000;11284000000;2304000000;9458000000
STJ;378218;USD;2015;Q4;2015-12-31;2016-02-23;282500000;286300000;667000000;1237000000;909000000;3265000000;1320000000;0;8479000000;9799000000;13064000000;793000000;1163000000;2473000000;5229000000;6549000000;9022000000;176000000;;4211000000;4042000000;13064000000
STJ;378218;USD;2014;Q4;2014-12-31;2015-02-26;286200000;290600000;1442000000;1215000000;784000000;3900000000;1343000000;0;4950000000;6293000000;10193000000;580000000;1593000000;2666000000;2259000000;3283000000;5949000000;147000000;;4225000000;4244000000;10193000000
STJ;378218;USD;2013;Q4;2013-12-31;2014-02-26;291300000;296300000;1373000000;1422000000;708000000;3910000000;1410000000;0;4928000000;6338000000;10248000000;663000000;62000000;1380000000;3518000000;4464000000;5844000000;249000000;;3936000000;4404000000;10248000000
STJ;378218;USD;2012;Q4;2012-12-31;2013-02-26;308900000;310000000;1194000000;1349000000;610000000;3551000000;1425000000;0;4295000000;5720000000;9271000000;763000000;530000000;1775000000;2550000000;3402000000;5177000000;30000000;;4018000000;4094000000;9271000000
STJ;378218;USD;2011;Q4;2011-12-31;2012-02-29;319100000;320100000;986000000;1367000000;624000000;3384000000;1388000000;0;4346000000;5734000000;9118000000;575000000;83000000;1061000000;2713000000;3582000000;4643000000;75000000;;4384000000;4475000000;9118000000
STJ;378218;USD;2010;Q4;2010-12-31;2011-03-02;332336000;334698000;500336000;1331210000;667545000;2912148000;1323931000;;4330369000;5654300000;8566448000;617874000;79637000;1017250000;2431966000;3177527000;4194777000;189028000;;4098639000;4371671000;8566448000
STJ;378218;USD;2009;Q4;2009-12-31;2010-03-02;330252000;332711000;392927000;1170579000;659960000;2560206000;1153086000;;2712519000;3865605000;6425811000;415334000;334787000;1067313000;1587615000;2034947000;3102260000;38314000;;3191203000;3323551000;6425811000
STJ;378218;USD;2008;Q4;2008-12-31;2009-08-12;344496000;348936000;136443000;1101258000;546499000;2080063000;980176000;;2662265000;3642441000;5722504000;553205000;75518000;1028524000;1126084000;1458074000;2486598000;253574000;;2977630000;3235906000;5722504000
TGNA;378222;USD;2017;Q4;2017-12-31;2018-03-01;215679000;216436000;98801000;406852000;;636923000;335340000;137166000;3852686000;4325192000;4962115000;107382000;646000;325352000;3007047000;3641722000;3967074000;706546000;-5667577000;6062995000;995041000;4962115000
TGNA;378222;USD;2016;Q4;2016-12-31;2017-02-28;91466625;91586625;15879000;386074000;;790688000;375321000;180616000;7196100000;7752037000;8542725000;150144000;646000;619181000;4042749000;5324274000;5943455000;798161000;-5749726000;7384556000;2599270000;8542725000
TGNA;378222;USD;2015;Q4;2015-12-31;2016-02-29;-160868313;-165380063;129200000;556351000;;805159000;458319000;256990000;6985490000;7700799000;8505958000;221264000;646000;606783000;4169016000;5417765000;6024548000;863924000;-5652131000;7111129000;2481410000;8505958000
TGNA;378222;USD;2014;Q4;2014-12-31;2015-02-25;273877841;280106764;110305000;537457000;;1313063000;666918000;249450000;9012764000;9929132000;11242195000;270791000;7854000;1133453000;4488028000;6598999000;7732452000;870825000;-5439511000;8602369000;3509743000;11242195000
TGNA;378222;USD;2013;Q4;2013-12-31;2014-02-27;115481894;117490121;469203000;834052000;49950000;1923485000;1669632000;379886000;5267703000;7317221000;9240706000;337311000;5890000;1007192000;3707010000;5324103000;6331295000;876787000;-5410537000;7720903000;2909411000;9240706000
TGNA;378222;USD;2012;Q4;2012-12-31;2013-02-26;438011608;446661428;175030000;678845000;56389000;1072720000;1518678000;283431000;3505057000;5307166000;6379886000;324991000;0;934516000;1432100000;2894804000;3829320000;891934000;-5355037000;7514858000;2550566000;6379886000
TGNA;378222;USD;2011;Q4;2011-12-31;2012-02-22;453424537;459575945;166926000;693194000;49122000;1075545000;1640227000;324948000;3575730000;5540905000;6616450000;264726000;;901937000;1760363000;3202488000;4104425000;942146000;-5294616000;7276200000;2512025000;6616450000
TGNA;378222;USD;2010;Q4;2010-12-31;2011-02-23;456641696;463454505;183014000;717377000;72025000;1139134000;1758111000;393457000;3526142000;5677710000;6816844000;300935000;;893186000;2352242000;3505409000;4398595000;954735000;-5300288000;6874641000;2418249000;6816844000
TGNA;378222;USD;2009;Q4;2009-12-31;2010-02-24;;;98795000;759934000;63752000;1049042000;1971818000;405355000;3722217000;6099390000;7148432000;332654000;;900103000;3061951000;4422550000;5322653000;954133000;-5357962000;6324586000;1825779000;7148432000
TGNA;378222;USD;2008;Q4;2008-12-31;2009-11-04;;;98949000;846590000;121484000;1245944000;2221494000;413230000;3916146000;6550870000;7796814000;443470000;;1157141000;3816942000;5392145000;6549286000;1067618000;-5549237000;6006753000;1247528000;7796814000
TDC;378223;USD;2015;Q4;2015-12-31;2016-02-26;132100000;127400000;839000000;580000000;49000000;1734000000;143000000;;650000000;793000000;2527000000;216000000;210000000;953000000;567000000;725000000;1678000000;1129000000;;-204000000;849000000;2527000000
TDC;378223;USD;2014;Q4;2014-12-31;2015-02-27;151400000;153800000;834000000;619000000;38000000;1572000000;159000000;;1401000000;1560000000;3132000000;251000000;273000000;995000000;195000000;430000000;1425000000;1055000000;;656000000;1707000000;3132000000
TDC;378223;USD;2013;Q4;2013-12-31;2014-02-27;161600000;164400000;695000000;717000000;56000000;1563000000;161000000;;1372000000;1533000000;3096000000;250000000;26000000;776000000;248000000;463000000;1239000000;975000000;-1184000000;2033000000;1857000000;3096000000
TDC;378223;USD;2012;Q4;2012-12-31;2013-02-28;167400000;170500000;729000000;668000000;47000000;1534000000;150000000;;1382000000;1532000000;3066000000;299000000;;806000000;274000000;481000000;1287000000;900000000;-806000000;1656000000;1779000000;3066000000
TDC;378223;USD;2011;Q4;2011-12-31;2012-02-29;167400000;171700000;772000000;494000000;61000000;1412000000;120000000;;1084000000;1204000000;2616000000;266000000;;695000000;290000000;427000000;1122000000;767000000;-526000000;1237000000;1494000000;2616000000
TDC;378223;USD;2010;Q4;2010-12-31;2011-03-01;167600000;171200000;883000000;402000000;65000000;1406000000;105000000;;372000000;477000000;1883000000;236000000;;569000000;0;125000000;694000000;692000000;-399000000;884000000;1189000000;1883000000
TDC;378223;USD;2009;Q4;2009-12-31;2010-08-05;170400000;173300000;661000000;387000000;47000000;1152000000;95000000;;322000000;417000000;1569000000;211000000;;543000000;;116000000;659000000;624000000;-311000000;583000000;910000000;1569000000
TDC;378223;USD;2016;Q4;2016-12-31;2017-02-27;129900000;133500000;974000000;548000000;34000000;1621000000;138000000;;654000000;792000000;2413000000;242000000;30000000;729000000;538000000;713000000;1442000000;1221000000;;-161000000;971000000;2413000000
TDC;378223;USD;2017;Q4;2017-12-31;2018-02-23;121200000;119100000;1089000000;554000000;30000000;1750000000;162000000;;644000000;806000000;2556000000;247000000;300000000;1063000000;478000000;825000000;1888000000;1321000000;;-579000000;668000000;2556000000
TDC;378223;USD;2018;Q4;2018-12-31;2019-02-26;117200000;121200000;715000000;588000000;28000000;1428000000;295000000;;637000000;932000000;2360000000;365000000;19000000;1009000000;478000000;856000000;1865000000;1419000000;;-823000000;495000000;2360000000
ANDV;378224;USD;2016;Q4;2016-12-31;2017-02-21;116700000;118500000;3295000000;1108000000;2640000000;7414000000;9976000000;;3008000000;12984000000;20398000000;2032000000;465000000;3554000000;6468000000;8717000000;12271000000;1500000000;-2284000000;6437000000;8127000000;20398000000
ANDV;378224;USD;2015;Q4;2015-12-31;2016-02-25;119900000;121400000;942000000;792000000;2302000000;4307000000;9541000000;;2484000000;12025000000;16332000000;1568000000;6000000;2530000000;4067000000;6062000000;8592000000;1417000000;-2009000000;5954000000;7740000000;16332000000
ANDV;378224;USD;2014;Q4;2014-12-31;2015-02-24;125500000;128200000;1000000000;1435000000;2439000000;5074000000;9045000000;;2372000000;11417000000;16491000000;2483000000;;3430000000;4161000000;6085000000;9515000000;1281000000;-1320000000;4642000000;6976000000;16491000000
ANDV;378224;USD;2013;Q4;2013-12-31;2014-02-24;132600000;134600000;1238000000;1313000000;2565000000;5326000000;6875000000;;1188000000;8063000000;13389000000;2596000000;;3408000000;2823000000;4496000000;7904000000;1212000000;-798000000;3940000000;5485000000;13389000000
ANDV;378224;USD;2012;Q4;2012-12-31;2013-02-22;138900000;141600000;1639000000;1126000000;1338000000;4636000000;5232000000;;834000000;6066000000;10702000000;2196000000;3000000;2881000000;1585000000;3084000000;5965000000;1095000000;-356000000;3649000000;4737000000;10702000000
ANDV;378224;USD;2011;Q4;2011-12-31;2012-02-24;138900000;140700000;900000000;1272000000;1763000000;4151000000;5148000000;;593000000;5741000000;9892000000;2305000000;418000000;3249000000;1283000000;2665000000;5914000000;1025000000;-226000000;2944000000;3978000000;9892000000
ANDV;378224;USD;2010;Q4;2010-12-31;2011-03-01;141500000;138400000;648000000;908000000;1257000000;2928000000;5170000000;;634000000;5804000000;8732000000;1852000000;152000000;2496000000;1843000000;3021000000;5517000000;995000000;-128000000;2398000000;3215000000;8732000000
ANDV;378224;USD;2009;Q4;2009-12-31;2010-07-29;138800000;134000000;413000000;1116000000;622000000;2223000000;5190000000;;657000000;5847000000;8070000000;1441000000;4000000;1889000000;1837000000;3094000000;4983000000;971000000;-140000000;2427000000;3087000000;8070000000
ANDV;378224;USD;2017;Q4;2017-12-31;2018-02-21;155900000;157600000;543000000;1961000000;3630000000;6883000000;14742000000;;6948000000;21690000000;28573000000;3330000000;17000000;5001000000;7668000000;10157000000;15158000000;5257000000;-2841000000;7651000000;13415000000;28573000000
TSS;378227;USD;2016;Q4;2016-12-31;2017-02-24;364215000;-364621000;425354000;432847000;;1022689000;282345000;133556000;4927587000;5343488000;6366177000;106367000;50727000;420353000;3313276000;3821811000;4242164000;299903000;-646047000;2502222000;2124013000;6366177000
TSS;378227;USD;2015;Q4;2015-12-31;2016-02-25;363361000;-362304000;389328000;314705000;;858232000;289898000;106118000;2623647000;3019663000;3877895000;118807000;53546000;338932000;1377541000;1666871000;2005803000;262168000;-641664000;2256058000;1872092000;3877895000
TSS;378227;USD;2014;Q4;2014-12-31;2015-02-26;183242000;-552867000;289183000;283203000;;690553000;290585000;100468000;2651975000;3043028000;3733581000;86794000;50911000;296513000;1405106000;1714932000;2011445000;191548000;-453230000;1966370000;1722136000;3733581000
TSS;378227;USD;2013;Q4;2013-12-31;2014-02-25;187599000;190178000;247700000;255773000;;653933000;259968000;94133000;2678534000;3032635000;3686568000;71990000;56919000;297215000;1435751000;1747275000;2044490000;186120000;-326996000;1718204000;1642078000;3686568000
TSS;378227;USD;2012;Q4;2012-12-31;2013-02-26;;;247612000;247083000;;574726000;260389000;87764000;1100959000;1449112000;2023838000;89613000;40624000;230519000;192014000;308879000;539398000;162040000;-287301000;1549063000;1484440000;2023838000
TSS;378227;USD;2011;Q4;2011-12-31;2012-02-24;;;316337000;248541000;;650181000;266608000;82924000;858679000;1208211000;1858392000;59099000;195614000;380576000;63593000;156807000;537383000;146134000;-225034000;1380634000;1321009000;1858392000
TSS;378227;USD;2010;Q4;2010-12-31;2011-02-28;;;394795000;237646000;;721813000;300102000;77127000;853219000;1230448000;1952261000;63482000;52748000;227270000;225276000;321186000;548456000;139855000;-115449000;1219303000;1403805000;1952261000
TSS;378227;USD;2009;Q4;2009-12-31;2010-08-09;;;450254000;231162000;;810896000;289069000;75495000;535494000;900058000;1710954000;53718000;13277000;220779000;205123000;300728000;521507000;159828000;-69950000;1080250000;1189447000;1710954000
TSS;378227;USD;2017;Q4;2017-12-31;2018-02-23;182358000;185687000;450357000;412322000;;1079244000;325218000;163518000;4763709000;5252445000;6331689000;144445000;565812000;989092000;2628002000;2985915000;3975007000;183083000;-909960000;3004018000;2356682000;6331689000
TSS;378227;USD;2018;Q4;2018-12-31;2019-02-21;181795000;184957000;471156000;450322000;;1140783000;383074000;180661000;5764191000;6327926000;7468709000;171099000;29125000;515601000;3889541000;4367202000;4882803000;210166000;-1042687000;3478650000;2585906000;7468709000
TSCO;378228;USD;2015;Q4;2015-12-31;2016-02-23;134336000;135504000;63813000;;1284375000;1439461000;847576000;;83789000;931365000;2370826000;670406000;878000;671284000;166992000;306248000;977532000;597483000;-1429790000;2225601000;1393294000;2370826000
TSCO;378228;USD;2014;Q4;2014-12-31;2015-02-18;136197000;137735000;51134000;;1115450000;1273990000;721000000;;39581000;760581000;2034571000;602880000;213000;603093000;4957000;137917000;741010000;512339000;-1137085000;1918307000;1293561000;2034571000
TSCO;378228;USD;2013;Q4;2013-12-31;2014-02-19;139896000;141976000;142743000;;979308000;1209248000;664932000;;29211000;694143000;1903391000;532099000;42000;532141000;1200000;124356000;656497000;453999000;-838588000;1631483000;1246894000;1903391000
TSCO;378228;USD;2012;Q4;2012-12-31;2013-02-20;140438000;143466000;138630000;;908116000;1130052000;549998000;;26758000;576756000;1706808000;560467000;38000;560505000;1242000;121329000;681834000;362413000;-709172000;1371733000;1024974000;1706808000
TSCO;378228;USD;2011;Q4;2011-12-31;2012-02-29;142342000;146468000;176965000;;830819000;1090249000;480855000;;23728000;504583000;1594832000;460592000;33000;460625000;1284000;125917000;586542000;299069000;-437373000;1146594000;1008290000;1594832000
TSCO;378228;USD;2010;Q4;2010-12-31;2010-11-02;580340852;597040780;273252000;;736520000;1043717000;395789000;;23968000;419757000;1463474000;417619000;91000;426564000;1316000;103668000;530232000;235914000;-257376000;954704000;933242000;1463474000
TSCO;378228;USD;2009;Q4;2009-12-31;2010-08-03;575416546;585936914;172851000;;601249000;834329000;370245000;;26271000;396516000;1230845000;404233000;392000;404625000;1407000;93017000;497642000;191268000;-219204000;761139000;733203000;1230845000
TSCO;378228;USD;2016;Q4;2016-12-31;2017-02-23;131034000;131725000;53916000;;1369656000;1517809000;962308000;;194825000;1157133000;2674942000;765900000;11294000;777194000;289769000;444530000;1221724000;672875000;-1761498000;2540449000;1453218000;2674942000
TSCO;378228;USD;2017;Q4;2017-12-31;2018-02-22;125474000;126085000;109148000;;1453208000;1655368000;1044503000;;168898000;1213401000;2868769000;820669000;28545000;849214000;433686000;600882000;1450096000;717591000;-2130901000;2829220000;1418673000;2868769000
TSCO;378228;USD;2018;Q4;2018-12-31;2019-02-21;122151000;123174000;86299000;;1589542000;1794399000;1134464000;;156399000;1290863000;3085262000;908211000;29896000;938107000;381100000;585335000;1523442000;824788000;-2480677000;3213895000;1561820000;3085262000
TDG;378229;USD;2017;Q4;2018-03-31;2017-11-13;54812000;54812000;650561000;636127000;730681000;2133552000;324924000;;7517185000;7842109000;9975661000;484649000;369041000;870994000;11393620000;12055871000;12926865000;1095880000;-774721000;-3187220000;-2951204000;9975661000
TDG;378229;USD;2016;Q4;2017-03-31;2016-08-10;55857000;55857000;1586994000;576339000;724011000;2930697000;310580000;;7485000000;7795580000;10726277000;500187000;252416000;752603000;9943191000;10625164000;11377767000;1029530000;-384270000;-1146963000;-651490000;10726277000
TDG;378229;USD;2015;Q4;2016-03-31;2015-08-05;56621000;56621000;714033000;444072000;591401000;1786587000;260684000;;6256664000;6517348000;8303935000;414375000;243219000;657594000;8106383000;8684647000;9342241000;950875000;-175940000;-1717232000;-1038306000;8303935000
TDG;378229;USD;2014;Q4;2015-03-31;2014-08-06;56743000;56743000;819548000;351307000;459074000;1689576000;212108000;;4855164000;5067272000;6756848000;346612000;239295000;585907000;7233836000;7727040000;8312947000;795305000;-175940000;-2150293000;-1556099000;6756848000
TDG;378229;USD;2013;Q4;2014-03-31;2013-08-07;56908000;56908000;564740000;290449000;413581000;1320495000;208964000;;4619420000;4828384000;6148879000;291455000;31045000;322500000;5700193000;6162760000;6485260000;690467000;-16088000;-1004244000;-336381000;6148879000
TDG;378229;USD;2012;Q4;2013-03-31;2012-08-08;53882000;53882000;440524000;235783000;320503000;1050531000;172737000;;4236349000;4409086000;5459617000;213415000;20500000;233915000;3598625000;4006868000;4240783000;553744000;-16088000;689229000;1218834000;5459617000
TDG;378229;USD;2011;Q4;2012-03-31;2011-08-10;53333000;53333000;376183000;189293000;265317000;870292000;150800000;;3492544000;3643344000;4513636000;191359000;15500000;206859000;3122875000;3495828000;3702687000;465208000;-15242000;364260000;810949000;4513636000
TDG;378229;USD;2010;Q4;2011-03-31;2010-08-11;;;234112000;134461000;188756000;583508000;99613000;;1994697000;2094310000;2677818000;113012000;;113012000;1771646000;1971827000;2084839000;419895000;-15242000;192126000;592979000;2677818000
TDG;378229;USD;2009;Q4;2010-03-31;2010-08-11;;;190167000;106446000;167766000;494754000;96751000;;1862935000;1959686000;2454440000;99752000;;99752000;1356761000;1535526000;1635278000;389266000;-15242000;450647000;819162000;2454440000
UHS;378232;USD;2016;Q4;2016-12-31;2017-02-28;96998000;97915000;33747000;1439553000;125365000;1681371000;4330956000;;4305475000;8636431000;10317802000;1209329000;105895000;1317373000;4030230000;4393516000;5710889000;;;;4606913000;10317802000
UHS;378232;USD;2015;Q4;2015-12-31;2016-02-25;98416000;100043000;61228000;1302429000;116037000;1718304000;3835978000;;4061162000;7897140000;9615444000;684894000;62722000;1100406000;3368634000;3963368000;5063774000;-293745000;;4566521000;4551670000;9615444000
UHS;378232;USD;2014;Q4;2014-12-31;2015-02-26;98808000;100751000;32069000;1282735000;108115000;1615138000;3679689000;;3679616000;7359305000;8974443000;785968000;68319000;1182827000;3210215000;3760984000;4943811000;-254209000;;4015387000;4030632000;8974443000
UHS;378232;USD;2013;Q4;2013-12-31;2014-02-27;98237000;100075000;17238000;1116961000;101781000;1432329000;3442169000;;3437225000;6879394000;8311723000;624167000;99312000;1059888000;3209762000;3733499000;4793387000;-224548000;;3499337000;3518336000;8311723000
UHS;378232;USD;2012;Q4;2012-12-31;2013-02-28;97183000;97713000;23471000;1067197000;99000000;1407496000;3382235000;;3411112000;6793347000;8200843000;567282000;2589000;894058000;3727431000;4307509000;5201567000;-205910000;;2962433000;2999276000;8200843000
UHS;378232;USD;2011;Q4;2011-12-31;2012-02-27;193754603;195923402;41229000;969802000;96775000;1364905000;3287980000;;3012360000;6300340000;7665245000;517607000;2479000;836933000;3651428000;4263894000;5100827000;-147515000;;2494076000;2564418000;7665245000
UHS;378232;USD;2010;Q4;2010-12-31;2011-02-28;97125000;98453000;29474000;837820000;94330000;1331116000;3252967000;;2943853000;6196820000;7527936000;551251000;3449000;826299000;3912102000;4467076000;5293375000;-128049000;;2125989000;2234561000;7527936000
UHS;378232;USD;2009;Q4;2009-12-31;2010-08-09;97290000;98080000;9180000;602559000;84272000;796197000;2315238000;;853028000;3168266000;3964463000;381883000;2573000;582817000;956429000;1392100000;1974917000;-107657000;;1879981000;1989546000;3964463000
UHS;378232;USD;2017;Q4;2017-12-31;2018-02-28;94530000;94909000;74423000;1500898000;136177000;1798002000;4571837000;;4391989000;8963826000;10761828000;1284081000;545619000;1848034000;3494390000;3855656000;5703690000;;;;5058138000;10761828000
UHS;378232;USD;2018;Q4;2018-12-31;2019-02-27;92187000;92706000;105220000;1509909000;148206000;1937802000;4847940000;;4479738000;9327678000;11265480000;1253714000;63446000;1446310000;3935187000;4349085000;5795395000;;;;5470085000;11265480000
VRSN;378234;USD;2017;Q4;2017-12-31;2018-02-16;98159000;124202000;2414751000;;;2446153000;263513000;;231522000;495035000;2941188000;219603000;627616000;1560528000;1782529000;2640931000;4201459000;16437460000;;-17694790000;-1260271000;2941188000
VRSN;378234;USD;2016;Q4;2016-12-31;2017-02-17;104038000;125413000;1797907000;;;1842342000;266125000;;226105000;492230000;2334572000;203920000;629764000;1521949000;1237189000;2013218000;3535167000;16987812000;;-18184954000;-1200595000;2334572000
VRSN;378234;USD;2015;Q4;2015-12-31;2016-02-19;110870000;133302000;1915430000;12638000;;1967924000;295570000;;94243000;389813000;2357737000;188171000;634326000;1502980000;1235354000;1925204000;3428184000;17559145000;;-18625599000;-1070447000;2357737000
VRSN;378234;USD;2014;Q4;2014-12-31;2015-02-13;119964000;135726000;1424684000;13448000;;1479790000;319028000;;102332000;421360000;1901150000;190278000;620620000;1432205000;740175000;1352411000;2784616000;18120367000;;-19000835000;-883466000;1901150000
VRSN;378234;USD;2013;Q4;2013-12-31;2014-02-21;135544000;150206000;1723285000;13631000;;1803199000;339653000;;517915000;857568000;2660767000;149276000;624056000;2029186000;750000000;1055139000;3084325000;18935622000;;-19356095000;-423558000;2660767000
VRSN;378234;USD;2012;Q4;2012-12-31;2013-02-28;154608000;162002000;1556436000;11477000;;1643464000;333861000;;85151000;419012000;2062476000;130391000;0;695018000;697614000;1376781000;2071799000;19891610000;;-19900545000;-9323000;2062476000
VRSN;378234;USD;2011;Q4;2011-12-31;2012-02-24;160922000;164196000;1346209000;14974000;;1447781000;327136000;;81262000;408398000;1856179000;156385000;;658923000;690086000;1285363000;1944286000;20135554000;;-20220577000;-88107000;1856179000
VRSN;378234;USD;2010;Q4;2010-12-31;2011-02-24;172270000;173814000;2060866000;14874000;;2177957000;190319000;;75730000;266049000;2444006000;195235000;;652713000;581626000;1114863000;1767576000;21041232000;;-20363468000;676430000;2444006000
VRSN;378234;USD;2009;Q4;2009-12-31;2010-02-26;189705000;190598000;1477351000;63133000;;1709058000;403821000;;357265000;761086000;2470144000;243967000;;886474000;574378000;985006000;1871480000;21736517000;;-21194435000;598664000;2470144000
VRSN;378234;USD;2008;Q4;2008-12-31;2009-08-06;192938000;193555000;789068000;83749000;;1624835000;385498000;;356539000;742037000;2366872000;263535000;;971415000;571749000;877036000;1848451000;21892195000;;-21439988000;518421000;2366872000
VRSN;378234;USD;2018;Q4;2018-12-31;2019-02-15;120940000;121677000;1269669000;;;1317034000;253905000;;343565000;597470000;1914504000;215208000;0;947590000;1785047000;2352388000;3299978000;15707126000;;-17089789000;-1385474000;1914504000
VRSK;378235;USD;2015;Q4;2015-12-31;2016-02-24;169392360;172566722;141924000;250947000;;604569000;350311000;;4638772000;4989083000;5593652000;222112000;874811000;1479257000;2270904000;2742384000;4221641000;2023527000;-2571190000;2161726000;1372011000;5593652000
VRSK;378235;USD;2014;Q4;2014-12-31;2015-02-24;163782060;167082091;43160000;220668000;;384483000;302273000;;1658574000;1960847000;2345330000;180726000;336058000;771270000;1100874000;1363017000;2134287000;1171333000;-2533764000;1654149000;211043000;2345330000
VRSK;378235;USD;2013;Q4;2013-12-31;2014-02-25;167855890;171722558;169712000;158547000;;474845000;233373000;;1796233000;2029606000;2504451000;188264000;4448000;431179000;1271439000;1525683000;1956862000;1202243000;-1864967000;1254107000;547589000;2504451000
VRSK;378235;USD;2012;Q4;2012-12-31;2013-02-26;166799951;171925360;94702000;178430000;;390559000;154084000;;1815693000;1969777000;2360336000;187648000;195263000;585350000;1266162000;1519395000;2104745000;1044883000;-1605376000;905727000;255591000;2360336000
VRSK;378235;USD;2011;Q4;2011-12-31;2012-02-28;163874594;170532544;196669000;153339000;;453654000;119411000;;968041000;1087452000;1541106000;162992000;5554000;349650000;1100332000;1289946000;1639596000;874945000;-1471042000;576585000;-98490000;1541106000
VRSK;378235;USD;2010;Q4;2010-12-31;2011-05-03;171701120;179394532;60627000;126564000;;240435000;93409000;;883246000;976655000;1217090000;111995000;437717000;720882000;401826000;610650000;1331532000;754845000;-1106321000;293827000;-114440000;1217092000
VRSK;378235;USD;2016;Q4;2016-12-31;2017-02-21;167369019;170200722;138500000;263900000;;500900000;380300000;;3750000000;4130300000;4631200000;184000000;106800000;621600000;2280200000;2677200000;3298800000;2121700000;-2891400000;2752900000;1332400000;4631200000
VRSK;378235;USD;2017;Q4;2017-12-31;2018-02-20;164730093;168333256;146100000;345500000;;597600000;478300000;;4944400000;5422700000;6020300000;228500000;724400000;1337600000;2284400000;2757300000;4094900000;2180200000;-3150500000;3308000000;1925400000;6020300000
VRSK;378235;USD;2018;Q4;2018-12-31;2019-02-19;164344501;167346841;139500000;356400000;;644500000;555900000;;4699900000;5255800000;5900300000;268700000;672800000;1324600000;2050500000;2505100000;3829700000;2283100000;-3563200000;3942600000;2070600000;5900300000
VIAB;378236;USD;2016;Q4;2016-09-30;2016-11-09;396800000;398200000;379000000;2712000000;844000000;4522000000;932000000;;17054000000;17986000000;22508000000;1226000000;17000000;3672000000;12207000000;14295000000;17967000000;10139000000;-20798000000;15628000000;4541000000;22508000000
VIAB;378236;USD;2015;Q4;2015-09-30;2015-11-12;398200000;404200000;506000000;2807000000;786000000;4578000000;947000000;;16618000000;17565000000;22143000000;1254000000;18000000;3853000000;12623000000;14472000000;18325000000;10017000000;-20725000000;14780000000;3818000000;22143000000
VIAB;378236;USD;2014;Q4;2014-09-30;2014-11-13;419400000;426400000;1000000000;3066000000;846000000;5252000000;1016000000;;16779000000;17795000000;23047000000;1444000000;18000000;3935000000;13140000000;15149000000;19084000000;9772000000;-19225000000;13465000000;3963000000;23047000000
VIAB;378236;USD;2013;Q4;2013-09-30;2013-11-14;468700000;477900000;2403000000;2987000000;770000000;6726000000;1040000000;;16063000000;17103000000;23829000000;1390000000;18000000;3790000000;12394000000;14649000000;18439000000;9490000000;-15825000000;11629000000;5390000000;23829000000
VIAB;378236;USD;2012;Q4;2012-09-30;2012-11-15;511000000;518000000;848000000;2533000000;832000000;4853000000;1068000000;;16329000000;17397000000;22250000000;1198000000;18000000;3830000000;8773000000;10802000000;14632000000;8916000000;-11025000000;9820000000;7617000000;22249000000
VIAB;378236;USD;2011;Q4;2011-09-30;2011-11-10;568700000;576500000;1021000000;2732000000;828000000;5261000000;1057000000;;16483000000;17540000000;22801000000;1579000000;23000000;3942000000;8113000000;10074000000;14016000000;8615000000;-8225000000;8418000000;8785000000;22801000000
VIAB;378236;USD;2017;Q4;2017-09-30;2017-11-16;402400000;402400000;1389000000;2970000000;919000000;5801000000;978000000;;16919000000;17897000000;23698000000;1300000000;19000000;3753000000;11577000000;13578000000;17331000000;10119000000;-20590000000;17124000000;6367000000;23698000000
VIAB;378236;USD;2018;Q4;2018-09-30;2018-11-16;402900000;403200000;1557000000;3141000000;896000000;6076000000;919000000;;16788000000;17707000000;23783000000;1281000000;567000000;4054000000;10013000000;12018000000;16072000000;10145000000;-20562000000;18561000000;7711000000;23783000000
VMC;378238;USD;2015;Q4;2015-12-31;2016-02-25;133604000;136921000;284060000;418024000;347073000;1084591000;3156290000;40558000;4020193000;7217041000;8301632000;353349000;130000;353479000;1980334000;3493965000;3847444000;2955750000;;1618507000;4454188000;8301632000
VMC;378238;USD;2014;Q4;2014-12-31;2015-02-27;132088000;133405000;141273000;354935000;321804000;920469000;3071630000;41650000;4007348000;7120628000;8041097000;301221000;150137000;451878000;1834642000;3412520000;3864398000;2866568000;;1471845000;4176699000;8041097000
VMC;378238;USD;2013;Q4;2013-12-31;2014-02-26;130386000;133030000;193738000;323369000;344606000;951496000;3312017000;42387000;3953243000;7307647000;8259143000;298965000;170000;299135000;2522243000;4021902000;4321037000;2741903000;;1295834000;3938106000;8259143000
VMC;378238;USD;2012;Q4;2012-12-31;2013-02-28;129958000;129496000;275478000;277539000;335022000;984972000;3159185000;42081000;3940361000;7141627000;8126599000;285008000;150602000;436411000;2526401000;3929126000;4365537000;2709930000;;1276649000;3761062000;8126599000
VMC;378238;USD;2011;Q4;2011-12-31;2012-02-29;129507000;129232000;155839000;299166000;327657000;863100000;3418179000;29004000;3919031000;7366214000;8229314000;271491000;134762000;406253000;2680677000;4031444000;4437697000;2673985000;;1334476000;3791617000;8229314000
VMC;378238;USD;2010;Q4;2010-12-31;2011-02-28;128738000;128430000;47541000;260814000;319845000;773751000;3632914000;37386000;3895485000;7565785000;8339536000;291486000;290746000;582348000;2427516000;3801390000;4383738000;2629456000;;1503681000;3955798000;8339536000
VMC;378238;USD;2009;Q4;2009-12-31;2010-02-26;126128000;127434000;26376000;254753000;325033000;732889000;3874671000;33283000;3884028000;7791982000;8524871000;234433000;621893000;856695000;2116120000;3630939000;4487634000;2494140000;;1737455000;4037237000;8524871000
VMC;378238;USD;2008;Q4;2008-12-31;2009-08-05;110401000;111305000;46928000;326204000;364311000;893890000;4155812000;27998000;3838924000;8022734000;8916624000;268881000;1394185000;1663066000;2153588000;3699806000;5362872000;1845105000;;1893929000;3553752000;8916624000
VMC;378238;USD;2016;Q4;2016-12-31;2017-02-24;132561000;137280000;258986000;491821000;345616000;1137182000;3261438000;39226000;4033629000;7334293000;8471475000;372106000;138000;372244000;1982751000;3526755000;3898999000;2940334000;;1771518000;4572476000;8471475000
VMC;378238;USD;2017;Q4;2017-12-31;2018-02-27;132519000;135044000;141646000;588337000;384338000;1180101000;3918931000;35115000;4370744000;8324790000;9504891000;401489000;41383000;442872000;2813482000;4093126000;4535998000;2937911000;;2180448000;4968893000;9504891000
VMC;378238;USD;2018;Q4;2018-12-31;2019-02-26;132053000;133400000;40037000;512279000;429330000;1079145000;4237307000;44615000;4471063000;8752985000;9832130000;469527000;133023000;602550000;2779357000;4026677000;4629227000;2930248000;;2444870000;5202903000;9832130000
WAT;378240;USD;2018;Q4;2018-12-31;2019-02-26;74677000;75183000;1735224000;568316000;291569000;2663163000;343083000;;721180000;1064263000;3727426000;190961000;178000;448931000;1148172000;1711237000;2160168000;1836346000;-6146322000;5995205000;1567258000;3727426000
WAT;378240;USD;2017;Q4;2017-12-31;2018-02-27;79408000;80370000;3393701000;533825000;270294000;4270134000;349278000;;704942000;1054220000;5324354000;219595000;100273000;606157000;1897501000;2484409000;3090566000;1746686000;-4808211000;5405380000;2233788000;5324354000
WAT;378240;USD;2016;Q4;2016-12-31;2017-02-24;80388000;80851000;2813032000;489340000;262682000;3635445000;337118000;;689496000;1026614000;4662059000;153840000;125297000;520321000;1701966000;1839789000;2360110000;1608827000;-4475667000;5385069000;2301949000;4662059000
WAT;378240;USD;2015;Q4;2015-12-31;2016-02-26;81719000;82480000;2399263000;468315000;263415000;3213533000;333355000;;721789000;1055144000;4268677000;153469000;175309000;564076000;1493027000;1645750000;2209826000;1491919000;-4149908000;4863566000;2058851000;4268677000
WAT;378240;USD;2014;Q4;2014-12-31;2015-02-27;84330000;85153000;2055388000;433616000;246430000;2817044000;321583000;;736063000;1057646000;3874690000;141311000;225230000;580486000;1237463000;1399538000;1980024000;1394061000;-3815203000;4394513000;1894666000;3874690000
WAT;378240;USD;2013;Q4;2013-12-31;2014-02-27;84988000;86029000;1803670000;430985000;242800000;2556255000;324932000;;701442000;1026374000;3582629000;140998000;133346000;487532000;1190000000;1331924000;1819456000;1272160000;-3477759000;3962893000;1763173000;3582629000
WAT;378240;USD;2012;Q4;2012-12-31;2013-02-26;86644000;87815000;1539025000;404556000;229565000;2257726000;273279000;;637145000;910424000;3168150000;159875000;132781000;504242000;1045000000;1196551000;1700793000;1157041000;-3176179000;3512890000;1467357000;3168150000
WAT;378240;USD;2011;Q4;2011-12-31;2012-02-24;89333000;90656000;1281351000;367085000;212864000;1942104000;237095000;;544035000;781130000;2723234000;127973000;290832000;601863000;700000000;894793000;1496656000;1091487000;-2880301000;3051447000;1226578000;2723234000
WAT;378240;USD;2010;Q4;2010-12-31;2011-02-25;91585000;93441000;946419000;358237000;204300000;1586641000;215060000;;525969000;741029000;2327670000;140418000;66055000;385850000;700000000;873023000;1258873000;971579000;-2509466000;2618479000;1068797000;2327670000
WAT;378240;USD;2009;Q4;2009-12-31;2010-02-26;94502000;96012000;630257000;314247000;178666000;1172376000;210926000;;524629000;735555000;1907931000;109999000;131772000;394568000;500000000;664414000;1058982000;809833000;-2213174000;2236716000;848949000;1907931000
WAT;378240;USD;2008;Q4;2008-12-31;2009-08-07;97963000;98770000;428522000;291763000;173051000;956302000;171588000;;495008000;666596000;1622898000;101051000;36120000;289506000;500000000;672387000;961893000;757980000;-2001797000;1913403000;661005000;1622898000
WELL;378241;USD;2017;Q4;2017-12-31;2018-02-28;370801000;372463000;243777000;1377658000;;3923579000;23506960000;;513906000;24020866000;27944445000;;;911863000;11731936000;11731936000;12643799000;8564088000;-64559000;5316580000;15300646000;27944445000
WELL;378241;USD;2016;Q4;2016-12-31;2016-11-02;362446000;364729000;419378000;1784941000;;4839904000;23499821000;;525459000;24025280000;28865184000;;;827034000;12358245000;12358245000;13185279000;9220840000;-54741000;4803575000;15679905000;28865184000
WELL;378241;USD;2015;Q4;2015-12-31;2015-10-30;354042000;355411000;360908000;1921360000;;3864585000;24548658000;;610602000;25159260000;29023845000;;;697191000;12967686000;12967686000;13664877000;9991153000;-44372000;3725772000;15358968000;29023845000
WELL;378241;USD;2014;Q4;2014-12-31;2014-11-04;617425394;619890083;473726000;1126001000;;3139178000;21011273000;;812472000;21823745000;24962923000;;;626825000;10776640000;10776640000;11403465000;9439131000;-35241000;2842022000;13559458000;24962923000
WELL;378241;USD;2013;Q4;2013-12-31;2013-11-05;288569000;290498000;158780000;885456000;;2206313000;20258819000;;618825000;20877644000;23083957000;;;640573000;10652014000;10652014000;11292587000;8113147000;-21263000;2329869000;11791370000;23083957000
WELL;378241;USD;2012;Q4;2012-12-31;2012-11-08;259822000;260758000;1033764000;1306760000;;3367078000;15608447000;;573584000;16182031000;19549109000;;;462099000;8531899000;8531899000;8993998000;7115968000;-17875000;2184819000;10555111000;19549109000
WELL;378241;USD;2011;Q4;2011-12-31;2011-11-03;186302000;186782000;163482000;673034000;;1370450000;13185529000;;368627000;13554156000;14924606000;;;371557000;7240752000;7240752000;7612309000;4246004000;-13535000;1893806000;7312297000;14924606000
WELL;378241;USD;2010;Q4;2010-12-31;2010-11-08;138248000;139420000;131570000;764292000;;1256451000;7874009000;;321274000;8195283000;9451734000;;;244345000;4469736000;4469736000;4714081000;2657439000;-11352000;1676196000;4737653000;9451734000
WELL;378241;USD;2009;Q4;2009-12-31;2010-11-08;122793000;123201000;35476000;621519000;;853308000;5485364000;;28514000;5513878000;6367186000;;;145713000;2414022000;2414022000;2559735000;1971197000;-7619000;1547669000;3807451000;6367186000
WELL;378241;USD;2018;Q4;2018-12-31;2019-02-25;378391000;380181000;215376000;1384278000;;3871837000;25919000000;;551235000;26470235000;30342072000;;;1034283000;13297144000;13297144000;14331427000;7990570000;-68499000;6121534000;16010645000;30342072000
WU;378242;USD;2016;Q4;2016-12-31;2017-02-22;483500000;487500000;877500000;;;877500000;220500000;;8321600000;8542100000;9419600000;1536900000;;5645400000;2786100000;2872000000;8517400000;645700000;;419300000;902200000;9419600000
WU;378242;USD;2015;Q4;2015-12-31;2016-02-19;504600000;508600000;1315900000;;;1315900000;231800000;;7901500000;8133300000;9449200000;818100000;;4555800000;3215900000;3488500000;8044300000;571500000;;977300000;1404900000;9449200000
WU;378242;USD;2014;Q4;2014-12-31;2015-02-20;522800000;526900000;1783200000;;;1783200000;206400000;;7900800000;8107200000;9890400000;766700000;;4564600000;3720400000;4025400000;8590000000;450600000;;968700000;1300400000;9890400000
WU;378242;USD;2013;Q4;2013-12-31;2014-02-24;551000000;555000000;2073100000;;;2073100000;209900000;;7838300000;8048200000;10121300000;855800000;;4484400000;4213000000;4532200000;9016600000;396400000;;877300000;1104700000;10121300000
WU;378242;USD;2012;Q4;2012-12-31;2013-02-22;588100000;590400000;1776500000;;;1776500000;196100000;;7493100000;7689200000;9465700000;774500000;;4143800000;4029200000;4381300000;8525100000;338500000;;754700000;940600000;9465700000
WU;378242;USD;2011;Q4;2011-12-31;2012-02-24;619500000;621800000;1370900000;;;1370900000;198100000;;7500900000;7699000000;9069900000;837400000;;4202200000;3583200000;3972900000;8175100000;253300000;;760000000;894800000;9069900000
WU;378242;USD;2010;Q4;2010-12-31;2011-02-25;655700000;658500000;2157400000;;;2157400000;196500000;;5575300000;5771800000;7929200000;877000000;;3766700000;3289900000;3579800000;7346500000;123900000;;591600000;582700000;7929200000
WU;378242;USD;2009;Q4;2009-12-31;2010-02-26;689500000;691700000;1685200000;;;1685200000;204300000;;5463900000;5668200000;7353400000;1020200000;;3682500000;3048500000;3317400000;6999900000;47600000;;433200000;353500000;7353400000
WU;378242;USD;2008;Q4;2008-12-31;2009-05-04;712300000;711300000;1295600000;;;1295600000;192300000;;4090400000;4282700000;5578300000;767300000;;2172800000;3143500000;3413600000;5586400000;-7300000;;29200000;-8100000;5578300000
WU;378242;USD;2017;Q4;2017-12-31;2018-02-22;459600000;450800000;838200000;;;838200000;214200000;;8179000000;8393200000;9231400000;1970500000;;6516200000;3033600000;3206600000;9722800000;702400000;;-965900000;-491400000;9231400000
WU;378242;USD;2018;Q4;2018-12-31;2019-02-21;442900000;445400000;973400000;;;973400000;270400000;;7753000000;8023400000;8996800000;1618900000;;5711800000;3433700000;3594800000;9306600000;760000000;;-838800000;-309800000;8996800000
WLTW;378243;USD;2017;Q4;2017-12-31;2018-02-28;133000000;135000000;1030000000;2246000000;;15861000000;985000000;;15612000000;16597000000;32458000000;1711000000;85000000;14755000000;4450000000;7426000000;22181000000;10538000000;-3000000;1104000000;10277000000;32458000000
WLTW;378243;USD;2016;Q4;2016-12-31;2016-11-07;136000000;138000000;870000000;2080000000;;13792000000;839000000;;15622000000;16461000000;30253000000;1481000000;508000000;13370000000;3357000000;6649000000;20019000000;10596000000;-99000000;1452000000;10234000000;30253000000
WLTW;378243;USD;2015;Q4;2015-12-31;2015-11-05;68000000;69000000;532000000;1258000000;;12503000000;563000000;;5773000000;6336000000;18839000000;752000000;988000000;12801000000;2278000000;3625000000;16426000000;1672000000;-3000000;1597000000;2413000000;18839000000
WLTW;378243;USD;2014;Q4;2014-12-31;2014-11-06;65660000;67395000;635000000;1044000000;;10839000000;483000000;169000000;3930000000;4582000000;15421000000;652000000;167000000;10211000000;2130000000;3144000000;13355000000;1524000000;-3000000;1530000000;2066000000;15421000000
WLTW;378243;USD;2013;Q4;2013-12-31;2013-11-05;65812500;71547500;796000000;1041000000;;10461000000;481000000;176000000;3682000000;4339000000;14800000000;607000000;15000000;9474000000;2311000000;3083000000;12557000000;1316000000;-3000000;1595000000;2243000000;14800000000
WLTW;378243;USD;2012;Q4;2012-12-31;2012-05-10;64930000;62287500;500000000;933000000;;10898000000;468000000;174000000;3572000000;4214000000;15112000000;560000000;15000000;10194000000;2338000000;3193000000;13387000000;1125000000;-3000000;1427000000;1725000000;15112000000
WLTW;378243;USD;2011;Q4;2011-12-31;2011-11-09;66440000;67572500;436000000;910000000;;10987000000;406000000;170000000;4165000000;4741000000;15728000000;335000000;15000000;9996000000;2354000000;3215000000;13211000000;1073000000;-3000000;2160000000;2517000000;15728000000
WLTW;378243;USD;2010;Q4;2010-12-31;2010-11-05;64175000;64552500;316000000;839000000;;11100000000;381000000;161000000;4208000000;4750000000;15850000000;355000000;110000000;10309000000;2157000000;2933000000;13242000000;985000000;-3000000;2136000000;2608000000;15850000000
WLTW;378243;USD;2009;Q4;2009-12-31;2010-08-06;;;221000000;816000000;;10975000000;352000000;156000000;4142000000;4650000000;15625000000;347000000;209000000;10498000000;2165000000;2898000000;13396000000;918000000;-3000000;1859000000;2229000000;15625000000
WLTW;378243;USD;2018;Q4;2018-12-31;2019-02-27;128000000;130000000;1033000000;2379000000;;16420000000;942000000;;15023000000;15965000000;32385000000;1647000000;186000000;15301000000;4389000000;7087000000;22388000000;10615000000;-3000000;1201000000;9997000000;32385000000
WEC;378244;USD;2015;Q4;2015-12-31;2016-02-26;315700000;317300000;49800000;1028600000;687000000;2206800000;19189700000;1466700000;6492000000;27148400000;29355200000;1052500000;1252700000;2709000000;9124100000;17961000000;20670000000;4350400000;;4299800000;8685200000;29355200000
WEC;378244;USD;2014;Q4;2014-12-31;2015-02-27;225600000;227300000;61900000;643400000;400600000;1292700000;11257700000;456900000;1897700000;13612300000;14905000000;458400000;1041700000;1668700000;4170700000;8786200000;10454900000;302400000;;4117000000;4450100000;14905000000
WEC;378244;USD;2013;Q4;2013-12-31;2014-02-27;226300000;228300000;26000000;406000000;329400000;1551100000;10906600000;438800000;1872900000;13218300000;14769400000;439500000;879600000;1496400000;4363200000;9009600000;10506000000;4233000000;;;4263400000;14769400000
WEC;378244;USD;2012;Q4;2012-12-31;2013-02-27;229500000;232000000;35600000;285300000;360700000;1272600000;10572200000;413800000;2026400000;13012400000;14285000000;469300000;806700000;1441400000;4453800000;8678100000;10119500000;4135100000;;;4165500000;14285000000
WEC;378244;USD;2011;Q4;2011-12-31;2012-02-28;230800000;233500000;14100000;349400000;382000000;1426200000;10160400000;393300000;1882200000;12435900000;13862100000;431600000;702500000;1364500000;4614300000;8503900000;9868400000;3963300000;;;3993700000;13862100000
WEC;378244;USD;2010;Q4;2010-12-31;2011-02-25;233800000;236600000;24500000;344600000;379100000;1331100000;9601500000;376300000;1750900000;11728700000;13059800000;403700000;1131300000;1721100000;3932000000;7506200000;9227300000;3802100000;;;3832500000;13059800000
WEC;378244;USD;2009;Q4;2009-12-31;2010-02-26;233800000;236000000;20200000;298700000;378100000;1529300000;9015800000;358700000;1794100000;11168600000;12697900000;513400000;1120800000;1894100000;3875800000;7206500000;9100600000;3566900000;;;3597300000;12697900000
WEC;378244;USD;2008;Q4;2008-12-31;2009-08-04;233800000;236400000;32500000;369500000;344700000;1707500000;8502600000;490300000;1917400000;10910300000;12617800000;751800000;664100000;1735100000;4074700000;7515400000;9250500000;3336900000;;;3367300000;12617800000
WEC;378244;USD;2016;Q4;2016-12-31;2017-02-28;315500000;316600000;37500000;1241700000;587600000;2168700000;19915500000;1443900000;6595100000;27954500000;30123200000;1025300000;1017400000;2431600000;9158200000;18731400000;21163000000;4313000000;;4613900000;8960200000;30123200000
WEC;378244;USD;2017;Q4;2017-12-31;2018-02-28;315600000;316700000;38900000;1350700000;539000000;2213500000;21347000000;1553400000;6476600000;29377000000;31590500000;1207500000;2286700000;3869300000;8746600000;18229400000;22098700000;4281700000;;5176800000;9491800000;31590500000
WEC;378244;USD;2018;Q4;2018-12-31;2019-02-26;315500000;316900000;84500000;1280900000;548200000;2247600000;22000900000;1665300000;7562000000;31228200000;33475800000;1061800000;1805100000;3331700000;9994000000;20301400000;23633100000;4253300000;;5538200000;9842700000;33475800000
WYNN;378245;USD;2017;Q4;2017-12-31;2018-02-28;102414000;103035000;2971247000;224128000;71636000;3423784000;8498756000;160682000;598517000;9257955000;12681739000;817971000;62690000;1930290000;9565936000;9673099000;11603389000;1499092000;-1184468000;635067000;1078350000;12681739000
WYNN;378245;USD;2016;Q4;2016-12-31;2017-02-24;101511000;102414000;2626559000;218968000;91541000;2990367000;8259631000;128023000;575536000;8963190000;11953557000;816735000;0;1416301000;10125352000;10279375000;11695676000;1228065000;-1166697000;95097000;257881000;11953557000
WYNN;378245;USD;2015;Q4;2015-12-31;2016-02-29;202360000;203839000;2195386000;187887000;74493000;2505778000;7477478000;136256000;339647000;7953381000;10459159000;657762000;;1110171000;9149665000;9327143000;10437314000;984277000;-1152680000;55332000;21845000;10459159000
WYNN;378245;USD;2014;Q4;2014-12-31;2015-03-02;101012000;101698000;2422304000;237957000;72223000;2782331000;5855842000;10173000;414515000;6280530000;9062861000;728686000;;1308318000;7345262000;7543452000;8851770000;949710000;-1145481000;164487000;211091000;9062861000
WYNN;378245;USD;2013;Q4;2013-12-31;2014-02-28;100754000;102095000;2609440000;241932000;74739000;2968814000;4934449000;79989000;393778000;5408216000;8377030000;716707000;1050000;1455534000;6586518000;6789145000;8244679000;889869000;-1143419000;66130000;132351000;8377030000
WYNN;378245;USD;2012;Q4;2012-12-31;2013-03-01;100011000;101086000;1864106000;238573000;63799000;2202378000;4727899000;;346317000;5074216000;7276594000;550737000;1050000;1131377000;5781770000;6041285000;7172662000;819958000;-1127947000;44775000;103932000;7276594000
WYNN;378245;USD;2011;Q4;2011-12-31;2012-02-29;124253000;125708000;1384653000;238490000;72061000;1726452000;4865332000;;307712000;5173044000;6899496000;574477000;407934000;1579893000;2809785000;3096149000;4676042000;3178850000;-1127036000;36368000;2223454000;6899496000
WYNN;378245;USD;2010;Q4;2010-12-31;2011-03-01;123445000;126187000;1258499000;187464000;86847000;1561136000;4921259000;;192102000;5113361000;6674497000;501393000;2675000;887929000;3264854000;3405983000;4293912000;3347424000;-1119407000;9042000;2380585000;6674497000
WYNN;378245;USD;2009;Q4;2009-12-31;2010-08-09;479002967;480382211;1991830000;152879000;107005000;2282956000;5062059000;;236754000;5298813000;7581769000;351753000;2675000;725585000;3566428000;3695821000;4421406000;4240858000;-1119407000;-89559000;3160363000;7581769000
WYNN;378245;USD;2018;Q4;2018-12-31;2019-02-28;107690000;108620000;2215001000;276644000;66627000;2641376000;9385920000;;1188973000;10574893000;13216269000;914653000;11960000;1882063000;9411140000;9519417000;11401480000;2458300000;-1344012000;921785000;1814789000;13216269000
XEL;378246;USD;2016;Q4;2016-12-31;2017-02-24;508638000;509654000;84476000;776289000;604226000;2842081000;32841750000;;5471446000;38313196000;41155277000;1847708000;647529000;3247043000;14194718000;26887385000;30134428000;7149551000;;3981652000;11020849000;41155277000
XEL;378246;USD;2015;Q4;2015-12-31;2016-02-19;508351000;508778000;84940000;724606000;608584000;2770226000;31205851000;;4845400000;36051251000;38821477000;1728410000;1503021000;4058297000;12398880000;24162260000;28220557000;7157945000;;3552728000;10600920000;38821477000
XEL;378246;USD;2014;Q4;2014-12-31;2015-02-20;506511000;506901000;79608000;826506000;597183000;3364380000;28756916000;;4836588000;33593504000;36957884000;1879877000;1277226000;4064583000;11499634000;22678819000;26743402000;7101663000;;3220958000;10214482000;36957884000
XEL;378246;USD;2013;Q4;2013-12-31;2014-02-21;498615000;498920000;107144000;744160000;576538000;3218040000;26122159000;;4567291000;30689450000;33907490000;1938808000;1039763000;3654498000;10910754000;20687042000;24341540000;6864242000;;2807983000;9565950000;33907490000
XEL;378246;USD;2012;Q4;2012-12-31;2013-02-22;488435000;489146000;82323000;718046000;535574000;2625139000;23809348000;;4706199000;28515547000;31140686000;1587776000;860155000;2937073000;10143905000;19329536000;22266609000;6572914000;;2413816000;8874077000;31140686000
XEL;378246;USD;2011;Q4;2011-12-31;2012-02-24;486253000;487024000;60684000;753120000;618232000;2982564000;22353367000;;4161336000;26514703000;29497267000;1495389000;1278922000;3588639000;8848513000;17426430000;21015069000;6543677000;;2032556000;8482198000;29497267000
XEL;378246;USD;2010;Q4;2010-12-31;2011-02-28;468778000;471416000;108437000;718474000;560800000;2732643000;20663082000;;3991965000;24655047000;27387690000;1520824000;521815000;2536533000;9263144000;16662658000;19199191000;6434909000;;1701703000;8188499000;27387690000
XEL;378246;USD;2009;Q4;2009-12-31;2010-02-26;457464000;458385000;115648000;730152000;566205000;2976635000;18508296000;;3821030000;22329326000;25305961000;1614144000;1002814000;3089999000;7888628000;14827737000;17917736000;5913753000;;1419201000;7388225000;25305961000
XEL;378246;USD;2008;Q4;2008-12-31;2009-07-31;453683000;457104000;249198000;900781000;666709000;3015529000;17688720000;;4254246000;21942966000;24958495000;1618336000;1014022000;3046245000;7731688000;14843529000;17889774000;6963741000;;;7068721000;24958495000
XEL;378246;USD;2017;Q4;2017-12-31;2018-02-23;510599000;509249000;83000000;797000000;610000000;2973000000;34329000000;;5728000000;40057000000;43030000000;2048000000;1271000000;4088000000;14520000000;27487000000;31575000000;7167000000;;4413000000;11455000000;43030000000
XEL;378246;USD;2018;Q4;2018-12-31;2019-02-22;515000000;514000000;147000000;860000000;548000000;3094000000;36944000000;;5949000000;42893000000;45987000000;2056000000;1444000000;4460000000;15803000000;29305000000;33765000000;7453000000;;4893000000;12222000000;45987000000
XRX;378247;USD;2016;Q4;2016-12-31;2017-02-27;-2235627;-2027233;2223000000;961000000;841000000;6992000000;1135000000;1294000000;8630000000;11059000000;18051000000;1546000000;1011000000;4654000000;5305000000;8436000000;13090000000;4112000000;;4934000000;4961000000;18051000000
XRX;378247;USD;2015;Q4;2015-12-31;2016-02-19;-41533894;-41851083;1228000000;1068000000;901000000;6685000000;1212000000;1382000000;16262000000;18856000000;25541000000;1748000000;962000000;5254000000;6317000000;10821000000;16075000000;4030000000;;9686000000;9466000000;25541000000
XRX;378247;USD;2014;Q4;2014-12-31;2015-02-24;-42407037;-43333860;1411000000;2652000000;934000000;8874000000;1648000000;1338000000;15798000000;18784000000;27658000000;2338000000;1427000000;6076000000;6314000000;10480000000;16556000000;5407000000;-105000000;9535000000;11102000000;27658000000
XRX;378247;USD;2013;Q4;2013-12-31;2014-02-21;114780439;117726593;1764000000;2929000000;998000000;8511000000;2025000000;1285000000;17215000000;20525000000;29036000000;2360000000;1117000000;5686000000;6904000000;10582000000;16268000000;6492000000;-252000000;8839000000;12768000000;29036000000
XRX;378247;USD;2012;Q4;2012-12-31;2013-02-21;117963780;119807012;1246000000;2866000000;1011000000;8273000000;2091000000;1381000000;18270000000;21742000000;30015000000;2654000000;1042000000;5910000000;7447000000;12092000000;18002000000;6861000000;-104000000;7991000000;12013000000;30015000000
XRX;378247;USD;2011;Q4;2011-12-31;2012-02-23;128453634;139995558;902000000;2600000000;1021000000;7912000000;2145000000;1395000000;18664000000;22204000000;30116000000;2773000000;1545000000;6381000000;7088000000;11361000000;17742000000;7670000000;-124000000;7046000000;12374000000;30116000000
XRX;378247;USD;2010;Q4;2010-12-31;2011-02-23;239289481;243485233;1211000000;2826000000;991000000;8639000000;2201000000;1291000000;18469000000;21961000000;30600000000;2869000000;1370000000;6417000000;7237000000;11675000000;18092000000;7978000000;0;6016000000;12508000000;30600000000
XRX;378247;USD;2009;Q4;2009-12-31;2010-02-26;82663070;84686279;3799000000;1702000000;900000000;9731000000;1860000000;1056000000;11385000000;14301000000;24032000000;2146000000;988000000;4461000000;8276000000;12380000000;16841000000;3364000000;;5674000000;7191000000;24032000000
XRX;378247;USD;2008;Q4;2008-12-31;2009-04-30;;;1229000000;2184000000;1232000000;8150000000;2013000000;1080000000;11204000000;14297000000;22447000000;2071000000;1610000000;5450000000;6774000000;10639000000;16089000000;3313000000;;5341000000;6358000000;22447000000
XRX;378247;USD;2017;Q4;2017-12-31;2018-02-23;445151563;435649500;1293000000;1357000000;915000000;5230000000;1083000000;1404000000;8229000000;10716000000;15946000000;1552000000;282000000;2741000000;5235000000;7698000000;10439000000;4148000000;;4856000000;5507000000;15946000000
XRX;378247;USD;2018;Q4;2018-12-31;2019-02-25;;;1084000000;1276000000;818000000;4695000000;941000000;1403000000;7835000000;10179000000;14874000000;1440000000;961000000;3251000000;4269000000;6370000000;9621000000;3553000000;-55000000;5072000000;5253000000;14874000000
FPRX;378616;USD;2015;Q4;2015-12-31;2016-03-11;26057000;31553000;517466000;4054000;;528281000;4539000;;15465000;20004000;548285000;61091000;;79368000;;35711000;115079000;372631000;;60649000;433206000;548285000
FPRX;378616;USD;2014;Q4;2014-12-31;2015-03-18;21633000;21633000;149054000;410000;;151258000;3794000;;579000;4373000;155631000;7245000;;19815000;;50611000;70426000;274202000;;-188998000;85205000;155631000
FPRX;378616;USD;2013;Q4;2013-12-31;2014-03-26;18203771;18203771;75722000;296000;;77658000;3744000;;389000;4133000;81791000;5361000;;13823000;;9942000;23765000;209597000;;-151574000;58026000;81791000
FPRX;378616;USD;2012;Q4;2012-12-31;2013-11-13;4784430;4784430;38015000;397000;;39101000;4631000;;359000;4990000;44091000;5023000;;13084000;;10603000;23687000;6817000;;-122702000;20404000;44091000
FPRX;378616;USD;2016;Q4;2016-12-31;2017-02-24;27406000;27406000;421748000;3959000;;440125000;6207000;;1949000;8156000;448281000;23726000;;38741000;;17965000;56706000;396662000;;-5048000;391575000;448281000
FPRX;378616;USD;2017;Q4;2017-12-31;2018-02-27;28157000;28157000;292690000;13133000;;311190000;30762000;;2095000;32857000;344047000;36912000;;50981000;;27864000;78845000;421285000;;-155607000;265202000;344047000
FPRX;378616;USD;2018;Q4;2018-12-31;2019-02-26;34707000;34707000;270138000;5096000;;288568000;28718000;;4248000;32966000;321534000;24703000;;27487000;;28908000;56395000;559926000;;-294681000;265139000;321534000
MCK;380928;USD;2016;Q4;2017-03-31;2016-01-27;226000000;230000000;2783000000;18215000000;15278000000;36948000000;2292000000;4063000000;17666000000;24021000000;60969000000;34026000000;1240000000;35612000000;7305000000;12755000000;48367000000;6031000000;-5982000000;13189000000;12602000000;60969000000
MCK;380928;USD;2015;Q4;2016-03-31;2015-02-05;233000000;234000000;4048000000;17980000000;15335000000;38435000000;2278000000;0;15810000000;18088000000;56523000000;32533000000;1617000000;35069000000;6497000000;11038000000;46107000000;5848000000;-3721000000;8360000000;10416000000;56523000000
MCK;380928;USD;2014;Q4;2015-03-31;2014-01-30;230000000;233000000;4193000000;13780000000;12986000000;32836000000;2196000000;;16727000000;18923000000;51759000000;25126000000;1665000000;29615000000;8929000000;11849000000;41464000000;6556000000;-9507000000;11453000000;10295000000;51759000000
MCK;380928;USD;2013;Q4;2014-03-31;2013-01-31;233000000;236000000;2456000000;9975000000;10335000000;23170000000;1321000000;;10295000000;11616000000;34786000000;18020000000;352000000;21357000000;4521000000;6373000000;27730000000;6082000000;-9363000000;10402000000;7056000000;34786000000
MCK;380928;USD;2012;Q4;2013-03-31;2012-01-30;243000000;249000000;3149000000;9977000000;10073000000;23603000000;1043000000;;8447000000;9490000000;33093000000;18263000000;908000000;21686000000;3072000000;4580000000;26266000000;5575000000;-8204000000;9451000000;6827000000;33093000000
MCK;380928;USD;2011;Q4;2012-03-31;2011-02-01;254000000;260000000;3612000000;9187000000;9225000000;22357000000;991000000;;7538000000;8529000000;30886000000;15951000000;417000000;18726000000;3587000000;4950000000;23676000000;5343000000;-6470000000;8250000000;7210000000;30886000000
MCK;380928;USD;2010;Q4;2011-03-31;2010-01-26;270000000;275000000;3731000000;8075000000;9441000000;21504000000;851000000;;5834000000;6685000000;28189000000;14814000000;3000000;17012000000;2293000000;3633000000;20645000000;4760000000;-4458000000;7236000000;7544000000;28189000000
MCK;380928;USD;2009;Q4;2010-03-31;2009-10-27;275000000;279000000;2109000000;7774000000;8527000000;18671000000;796000000;;5800000000;6596000000;25267000000;14242000000;219000000;15606000000;2290000000;3460000000;19066000000;4421000000;-4144000000;6103000000;6201000000;25267000000
MCK;380928;USD;2017;Q4;2018-03-31;2018-05-24;174000000;172000000;2672000000;17711000000;16310000000;37136000000;2464000000;3728000000;17053000000;23245000000;60381000000;35556000000;1129000000;36685000000;6751000000;12179000000;48864000000;6191000000;-7655000000;12986000000;11517000000;60381000000
MCK;380928;USD;2018;Q4;2019-03-31;2019-05-15;190000000;192000000;2981000000;18246000000;16709000000;38465000000;2548000000;3513000000;15146000000;21207000000;59672000000;37296000000;330000000;37626000000;7265000000;12364000000;49990000000;6438000000;-8902000000;12409000000;9682000000;59672000000
JNPR;385619;USD;2016;Q4;2016-12-31;2017-02-24;379800000;391100000;2585500000;1054100000;;3971900000;1063800000;1071800000;3549000000;5684600000;9656500000;454600000;0;1735900000;2133700000;2958100000;4694000000;8281600000;;-3281800000;4962500000;9656500000
JNPR;385619;USD;2015;Q4;2015-12-31;2016-02-19;382600000;397000000;1948000000;780700000;;2912400000;1021000000;1244200000;3430300000;5695500000;8607900000;428800000;299900000;1801900000;1637500000;2231600000;4033500000;8334800000;;-3741200000;4574400000;8607900000
JNPR;385619;USD;2014;Q4;2014-12-31;2015-02-20;424700000;401800000;1971800000;598900000;;2810600000;904300000;1133100000;3433400000;5470800000;8281400000;459600000;0;1513400000;1349000000;1848900000;3362300000;8794000000;;-3861100000;4919100000;8281400000
JNPR;385619;USD;2013;Q4;2013-12-31;2014-02-26;498000000;513600000;2845900000;578300000;;3703900000;882300000;1251900000;4487900000;6622100000;10326000000;474300000;;1441400000;999300000;1582400000;3023800000;9868900000;;-2631300000;7302200000;10326000000
JNPR;385619;USD;2012;Q4;2012-12-31;2013-02-26;507400000;514800000;2849300000;438400000;;3600700000;811900000;988100000;4431400000;6231400000;9832100000;488600000;;1422000000;999200000;1410600000;2832600000;9905700000;;-2911400000;6999500000;9832100000
JNPR;385619;USD;2011;Q4;2011-12-31;2012-02-24;526216000;533740000;3551700000;577400000;;4439700000;598600000;740700000;4204800000;5544100000;9983800000;588700000;;1466700000;999000000;1427400000;2894100000;10079200000;;-2972400000;7089700000;9983800000
JNPR;385619;USD;2010;Q4;2010-12-31;2011-02-25;523415000;544655000;2286401000;596622000;;3214370000;493881000;535178000;4224422000;5253481000;8467851000;574016000;;1471976000;0;387075000;1859051000;9717788000;;-3108337000;6608800000;8467851000
JNPR;385619;USD;2009;Q4;2009-12-31;2010-02-26;523000000;540649000;2175245000;458652000;;2878959000;455651000;483505000;3772148000;4711304000;7590263000;661607000;;1375785000;;389713000;1765498000;9060094000;;-3236525000;5824765000;7590263000
JNPR;385619;USD;2008;Q4;2008-12-31;2009-08-07;516666000;519936000;2191980000;429970000;;2816206000;436433000;101415000;3833287000;4371135000;7187341000;483462000;;1056610000;;229326000;1285936000;8811502000;;-2905852000;5901405000;7187341000
JNPR;385619;USD;2017;Q4;2017-12-31;2018-02-23;371200000;380500000;3032600000;852000000;;4184500000;1021100000;988400000;3639800000;5649300000;9833800000;403600000;0;1738200000;2136300000;3414700000;5152900000;8042100000;;-3355800000;4680900000;9833800000
JNPR;385619;USD;2018;Q4;2018-12-31;2019-02-22;345500000;355200000;3559100000;754600000;;4581800000;951700000;199000000;3630800000;4781500000;9363300000;429800000;349900000;1842500000;1789100000;2697600000;4540100000;7672800000;;-2831400000;4823200000;9363300000
GRMN;388839;USD;2017;Q4;2017-12-31;2018-02-21;187606000;188915000;1053175000;590882000;517644000;2346138000;595684000;1260033000;746434000;2602151000;4948289000;688975000;;792115000;;303755000;1095870000;1846365000;-468818000;2418444000;3852419000;4948289000
GRMN;388839;USD;2016;Q4;2016-12-31;2017-02-22;188191000;189127000;1113835000;527062000;484821000;2263016000;482878000;1213285000;565954000;2262117000;4525133000;636171000;;782735000;;324395000;1107130000;1854026000;-455964000;2056702000;3418003000;4525133000
GRMN;388839;USD;2015;Q4;2015-12-31;2016-02-17;189319000;189665000;1048231000;531481000;500554000;2211087000;446089000;1343387000;498828000;2288304000;4499391000;701016000;;865998000;;288267000;1154265000;1859674000;-414637000;1930517000;3345126000;4499391000
GRMN;388839;USD;2014;Q4;2014-12-31;2015-02-18;191324000;193606000;1364257000;570191000;420475000;2510976000;430887000;1407344000;344096000;2182327000;4693303000;811990000;;1033261000;;256675000;1289936000;1870956000;-330132000;1859972000;3403367000;4693303000
GRMN;388839;USD;2013;Q4;2013-12-31;2014-02-19;195119000;196299000;1329011000;701965000;382226000;2595636000;414848000;1502106000;367013000;2283967000;4879603000;647407000;;905304000;;314593000;1219897000;1876698000;-120620000;1865587000;3659706000;4879603000
GRMN;388839;USD;2012;Q4;2012-12-31;2013-02-27;195133000;196757000;1384263000;603673000;389931000;2536120000;409751000;1488312000;384941000;2283004000;4819124000;656319000;;909026000;;378302000;1287328000;1869897000;-81280000;1604625000;3531796000;4819124000
GRMN;388839;USD;2011;Q4;2011-12-31;2012-02-29;194335000;195153000;1398313000;607450000;397741000;2574837000;417105000;1097002000;382394000;1896501000;4471338000;663510000;;858279000;;356478000;1214757000;1859304000;-103498000;1413582000;3256581000;4471338000
GRMN;388839;USD;2010;Q4;2010-12-31;2011-02-23;194560000;195538000;1285354000;747249000;387577000;2498755000;427805000;777401000;284727000;1489933000;3988688000;574526000;;669037000;;270089000;939126000;1835703000;-106758000;1264613000;3049562000;3988688000
GRMN;388839;USD;2009;Q4;2009-12-31;2010-02-24;200386000;201467000;1111164000;874110000;309938000;2396079000;441338000;746464000;244201000;1432003000;3828082000;655758000;;685876000;;305759000;991635000;33222000;;2816607000;2836447000;3828082000
GRMN;388839;USD;2008;Q4;2008-12-31;2009-09-01;;;709221000;741321000;425312000;1984425000;445252000;262009000;242735000;949996000;2934421000;478496000;;479176000;;229391000;708567000;1002000;;2262503000;2225854000;2934421000
GRMN;388839;USD;2018;Q4;2018-12-31;2019-02-20;188877000;190178000;1384721000;569833000;561840000;2665368000;663527000;1330123000;723840000;2717490000;5382858000;824941000;;921313000;;298571000;1219884000;1841617000;-397692000;2710619000;4162974000;5382858000
FTR;388949;USD;2017;Q4;2017-12-31;2018-03-01;77730609;77574609;362000000;819000000;;1323000000;14377000000;;9184000000;23561000000;24884000000;1223000000;656000000;2508000000;16970000000;20102000000;22610000000;5054000000;-151000000;-2263000000;2274000000;24884000000
FTR;388949;USD;2016;Q4;2016-12-31;2017-03-01;77633531;77633531;522000000;938000000;;1656000000;14902000000;;12455000000;27357000000;29013000000;1433000000;363000000;2444000000;17560000000;22050000000;24494000000;5581000000;-215000000;-460000000;4519000000;29013000000
FTR;388949;USD;2015;Q4;2015-12-31;2016-02-25;76377770;76377770;936000000;571000000;;10131000000;8493000000;;8460000000;16953000000;27084000000;957000000;384000000;1893000000;15508000000;19577000000;21470000000;6332000000;-278000000;-87000000;5614000000;27084000000
FTR;388949;USD;2014;Q4;2014-12-31;2015-02-25;66324546;66865416;682000000;614000000;;1415000000;8566000000;;8829000000;17395000000;18810000000;673000000;298000000;1512000000;9393000000;13640000000;15152000000;4247000000;-294000000;109000000;3658000000;18810000000
FTR;388949;USD;2013;Q4;2013-12-31;2014-02-27;66235568;66441271;880039000;479210000;;1618839000;7255762000;;7760883000;15016645000;16635484000;582171000;257916000;1301587000;7873667000;11278416000;12580003000;4578053000;-338150000;76108000;4055481000;16635484000
FTR;388949;USD;2012;Q4;2012-12-31;2013-02-27;66086160;66369902;1326532000;533704000;;2087203000;7504896000;;8141532000;15646428000;17733631000;613817000;560550000;1553520000;8381947000;12060840000;13614360000;4896560000;-368593000;63205000;4119271000;17733631000
FTR;388949;USD;2011;Q4;2011-12-31;2012-02-23;66035868;66327414;326094000;585157000;;1239030000;7547523000;;8661766000;16209289000;17448319000;753280000;94016000;1152216000;8224392000;11826969000;12979185000;5030380000;-415001000;226721000;4469134000;17448319000
FTR;388949;USD;2010;Q4;2010-12-31;2011-02-25;56942123;57202387;251263000;568308000;;1128419000;7590614000;;9171197000;16761811000;17890230000;774971000;280002000;1439357000;7983614000;11241130000;12680487000;5782468000;-433286000;77107000;5209743000;17890230000
FTR;388949;USD;2009;Q4;2009-12-31;2010-08-05;;;358693000;190745000;;680080000;3133521000;;3064654000;6198175000;6878255000;275425000;7236000;392677000;4794129000;6146508000;6539185000;1043765000;-473391000;2756000;339070000;6878255000
FTR;388949;USD;2018;Q4;2018-12-31;2019-03-01;99625000;99625000;354000000;723000000;;1330000000;14187000000;;8142000000;22329000000;23659000000;1058000000;814000000;2561000000;16358000000;19498000000;22059000000;4829000000;-14000000;-2752000000;1600000000;23659000000
XLNX;396684;USD;2017;Q4;2018-03-31;2018-05-15;248286000;249718000;3447570000;382246000;236077000;4154588000;304117000;97896000;503946000;905959000;5060547000;412759000;499186000;911945000;1214440000;1788249000;2700194000;881206000;;1513656000;2360353000;5060547000
XLNX;396684;USD;2016;Q4;2017-03-31;2017-05-15;251855000;267892000;3321457000;243915000;227033000;3880116000;303825000;116288000;440303000;860416000;4740532000;386301000;456328000;897196000;995247000;1335703000;2232899000;806002000;;1726312000;2507633000;4740532000
XLNX;396684;USD;2015;Q4;2016-03-31;2016-05-17;256625000;268281000;3337699000;307458000;178550000;3916658000;283346000;220807000;398458000;902611000;4819269000;307222000;585417000;944397000;993639000;1284979000;2229376000;729458000;;1867066000;2589893000;4819269000
XLNX;396684;USD;2014;Q4;2015-03-31;2015-05-13;265449000;273318000;3303061000;246615000;231328000;3935051000;301038000;266902000;395074000;963014000;4898065000;321082000;576053000;963206000;994839000;1323265000;2286471000;656465000;;1966278000;2611594000;4898065000
XLNX;396684;USD;2013;Q4;2014-03-31;2014-05-16;265313000;290413000;2457321000;267833000;233999000;3067147000;355089000;1190775000;424338000;1970202000;5037349000;369260000;565001000;989360000;993870000;1295307000;2284667000;807759000;;1945471000;2752682000;5037349000
XLNX;396684;USD;2012;Q4;2013-03-31;2013-05-23;262258000;275033000;1714745000;229175000;201250000;2297639000;365687000;1651033000;415092000;2431812000;4729451000;333430000;0;386788000;922666000;1379367000;1766155000;1278914000;;1675722000;2963296000;4729451000
XLNX;396684;USD;2011;Q4;2012-03-31;2012-05-25;264556000;276740000;1917627000;214965000;204866000;2450309000;394982000;1209228000;409603000;2013813000;4464122000;275774000;;342776000;906569000;1413661000;1756437000;1198094000;;1502327000;2707685000;4464122000
XLNX;396684;USD;2010;Q4;2011-03-31;2011-05-31;264710000;269805000;1926413000;286464000;264745000;2622786000;380570000;766452000;371042000;1518064000;4140850000;268377000;;368140000;890980000;1358093000;1726233000;1166056000;;1238044000;2414617000;4140850000
XLNX;396684;USD;2009;Q4;2010-03-31;2010-08-09;275340000;276000000;1386605000;262735000;130628000;1907066000;365878000;582202000;329172000;1277252000;3184318000;277029000;;357161000;354798000;706687000;1063848000;1105146000;;1016545000;2120470000;3184318000
XLNX;396684;USD;2018;Q4;2019-03-31;2019-05-10;252318000;257905000;3175684000;335165000;315358000;3891978000;328929000;53433000;877008000;1259370000;5151348000;475036000;;475036000;1234807000;1814803000;2289839000;1007950000;;1876969000;2861509000;5151348000
SWN;401903;USD;2016;Q4;2016-12-31;2017-02-23;490398796;490398796;1423000000;363000000;;1872000000;4955000000;;249000000;5204000000;7076000000;633000000;41000000;1064000000;4612000000;5095000000;6159000000;4682000000;-1000000;-3725000000;917000000;7076000000
SWN;401903;USD;2015;Q4;2015-12-31;2016-02-26;382428035;382294011;15000000;327000000;;393000000;7543000000;;150000000;7693000000;8086000000;679000000;1000000;707000000;4704000000;5097000000;5804000000;3413000000;-1000000;-1082000000;2282000000;8086000000
SWN;401903;USD;2014;Q4;2014-12-31;2015-02-26;351715825;352750139;53000000;530000000;37000000;1115000000;13712000000;;98000000;13810000000;14925000000;779000000;4501000000;5428000000;2466000000;4835000000;10263000000;1023000000;0;3577000000;4662000000;14925000000
SWN;401903;USD;2013;Q4;2013-12-31;2014-02-27;350863147;351361862;23000000;464000000;38000000;644000000;7297000000;;107000000;7404000000;8048000000;608000000;1000000;688000000;1950000000;3738000000;4426000000;973000000;0;2653000000;3622000000;8048000000
SWN;401903;USD;2012;Q4;2012-12-31;2013-02-21;349629585;347638934;53583000;377638000;28141000;808912000;5836976000;;91639000;5928615000;6737527000;556980000;68919000;767771000;1668273000;2933884000;3701655000;938450000;-1532000;1949150000;3035872000;6737527000
SWN;401903;USD;2011;Q4;2011-12-31;2012-02-28;347614735;350018717;15627000;341915000;46234000;978278000;6645480000;;279139000;6924619000;7902897000;575327000;84082000;884913000;1342100000;3048680000;3933593000;906890000;-2228000;2656214000;3969304000;7902897000
SWN;401903;USD;2010;Q4;2010-12-31;2011-03-03;346350683;349274360;16055000;351573000;35098000;580893000;5298197000;;138373000;5436570000;6017463000;543895000;82905000;693983000;1093000000;2358604000;3052587000;865900000;-3444000;2018445000;2964876000;6017463000
SWN;401903;USD;2009;Q4;2009-12-31;2010-02-25;344433672;333304176;13184000;263076000;30009000;564501000;4127253000;;78496000;4205749000;4770250000;449970000;53606000;536416000;997500000;1892853000;2429269000;836955000;-4333000;1414327000;2340981000;4770250000
SWN;401903;USD;2008;Q4;2008-12-31;2009-08-20;341699385;345604193;196277000;254557000;50377000;883263000;3700258000;;176637000;3876895000;4760158000;504405000;131803000;780397000;674200000;1461798000;2242195000;814928000;-4740000;1449977000;2517963000;4760158000
SWN;401903;USD;2017;Q4;2017-12-31;2018-03-01;503756543;508206815;916000000;428000000;;1509000000;5772000000;;240000000;6012000000;7521000000;692000000;;780000000;4391000000;4762000000;5542000000;4703000000;-1000000;-2679000000;1979000000;7521000000
SWN;401903;USD;2018;Q4;2018-12-31;2019-02-28;564898267;568676914;201000000;581000000;;956000000;4656000000;;185000000;4841000000;5797000000;719000000;;846000000;2318000000;2589000000;3435000000;4721000000;-181000000;-2142000000;2362000000;5797000000
RCL;403292;USD;2017;Q4;2017-12-31;2018-02-21;213819000;215077000;120112000;318641000;111393000;843028000;19735180000;;1718109000;21453289000;22296317000;1310604000;1188514000;4790264000;6350937000;6803750000;11594014000;3392469000;-1378306000;9022405000;10702303000;22296317000
RCL;403292;USD;2016;Q4;2016-12-31;2017-02-23;214574000;215597000;132603000;291899000;114087000;748305000;20161427000;;1400592000;21562019000;22310324000;1043801000;1285735000;4441601000;8101701000;8747311000;13188912000;3330863000;-1153308000;7860341000;9121412000;22310324000
RCL;403292;USD;2015;Q4;2015-12-31;2016-02-22;218646000;219875000;121565000;238972000;121332000;837022000;18777778000;;1167243000;19945021000;20782043000;998998000;899542000;4292692000;7627701000;8426312000;12719004000;3299958000;-853348000;6944862000;8063039000;20782043000
RCL;403292;USD;2014;Q4;2014-12-31;2016-02-22;220625000;222265000;189241000;261392000;123490000;801083000;18193627000;;1718480000;19912107000;20713190000;1015717000;799630000;3849247000;7644318000;8579584000;12428831000;3255883000;-649778000;6575248000;8284359000;20713190000
RCL;403292;USD;2013;Q4;2013-12-31;2014-02-20;220209000;221628000;204687000;259746000;151244000;956374000;17517752000;;1598821000;19116573000;20072947000;1014665000;1563378000;4267010000;6511426000;6997672000;11264682000;3161346000;-413704000;6054952000;8808265000;20072947000
RCL;403292;USD;2012;Q4;2012-12-31;2013-02-25;218330000;221436000;194855000;281421000;146295000;888060000;17451034000;;1488836000;18939870000;19827930000;999675000;1519483000;4066151000;6970464000;7453030000;11519181000;3112178000;-413704000;5744791000;8308749000;19827930000
RCL;403292;USD;2011;Q4;2011-12-31;2012-02-29;217288000;218986000;262186000;292447000;144553000;969288000;16934817000;;1900300000;18835117000;19804405000;992748000;638891000;3067642000;7856962000;8328940000;11396582000;3074035000;-413704000;5823430000;8407823000;19804405000
RCL;403292;USD;2010;Q4;2010-12-31;2011-02-24;215597000;218796000;419929000;266710000;126797000;1015071000;16771677000;;1867081000;18638758000;19653829000;963171000;1198929000;3445173000;7951187000;8307904000;11753077000;3029392000;-413704000;5259998000;7900752000;19653829000
RCL;403292;USD;2009;Q4;2009-12-31;2010-04-29;213930000;218044000;284619000;338804000;107877000;1026391000;15268053000;;1939050000;17207103000;18233494000;933291000;756215000;2749030000;7663555000;7984747000;10733777000;2975738000;-413704000;4754950000;7499717000;18233494000
RCL;403292;USD;2018;Q4;2018-12-31;2019-02-22;208943000;210177000;287852000;324507000;153573000;1242044000;23466163000;;2990063000;26456226000;27698270000;1462523000;2422329000;7112165000;8355370000;8938624000;16050789000;3423258000;-1953345000;10263282000;11647481000;27698270000
PHM;404717;USD;2017;Q4;2017-12-31;2018-02-07;291747000;293063000;272683000;;7215514000;8092282000;;62957000;1531410000;1594367000;9686649000;5007894000;;5445698000;;86925000;5532623000;3174410000;;980061000;4154026000;9686649000
PHM;404717;USD;2016;Q4;2016-12-31;2017-02-01;325762000;327595000;698882000;;6802383000;8065127000;;51447000;2061626000;2113073000;10178200000;5152356000;;5483977000;;34860000;5518837000;3119681000;;1540208000;4659363000;10178200000
PHM;404717;USD;2015;Q4;2015-12-31;2016-02-08;348400000;351449000;754161000;;5531550000;6749700000;;41267000;2398439000;2439706000;9189406000;2529072000;1576082000;4373031000;;57050000;4430081000;3097293000;;1662641000;4759325000;9189406000
PHM;404717;USD;2014;Q4;2014-12-31;2015-02-04;347914000;351646000;1292862000;;4493290000;6142041000;;40368000;2387001000;2427369000;8569410000;1756932000;1818561000;3715734000;;48722000;3764456000;3076691000;;1728953000;4804954000;8569410000
PHM;404717;USD;2013;Q4;2013-12-31;2014-02-05;379808000;379860000;1580329000;;4040296000;5981273000;24024000;45323000;2683523000;2752870000;8734143000;1715344000;2058168000;3879176000;;206015000;4085191000;3055829000;;1593918000;4648952000;8734143000
PHM;404717;USD;2012;Q4;2012-12-31;2013-02-06;383736000;390981000;1404760000;;4305150000;6100791000;31066000;45629000;556923000;633618000;6734409000;1697520000;2509613000;4345928000;;198865000;4544793000;3034755000;;-844147000;2189616000;6734409000
PHM;404717;USD;2011;Q4;2011-12-31;2012-02-09;380158000;380158000;1083071000;;4771775000;6214781000;24905000;35988000;609946000;670839000;6885620000;1655348000;3088344000;4743692000;;203313000;4947005000;2990066000;;-1050145000;1938615000;6885620000
PHM;404717;USD;2010;Q4;2010-12-31;2011-02-10;379133000;377339000;1483390000;;4852868000;6618330000;50781000;46313000;983952000;1081046000;7699376000;1878133000;3391668000;5269801000;;294408000;5564209000;2976739000;;-840053000;2135167000;7699376000
PHM;404717;USD;2009;Q4;2009-12-31;2010-08-05;1199893019;1199893019;1858234000;2153000;4999003000;8013769000;174132000;73815000;1789506000;2037453000;10051222000;2195935000;4299926000;6495861000;;360921000;6856782000;2939544000;;257145000;3194440000;10051222000
VLO;410846;USD;2017;Q4;2017-12-31;2018-02-28;437000000;438000000;5850000000;6922000000;6384000000;19312000000;27480000000;;3366000000;30846000000;50158000000;10949000000;122000000;11071000000;8750000000;16187000000;27258000000;7046000000;-13315000000;29200000000;22900000000;50158000000
VLO;410846;USD;2018;Q4;2018-12-31;2019-02-28;419000000;422000000;2982000000;7345000000;6532000000;17675000000;28848000000;;3632000000;32480000000;50155000000;10486000000;238000000;10724000000;8871000000;16700000000;27424000000;7055000000;-14925000000;31044000000;22731000000;50155000000
CELG;410976;USD;2015;Q4;2015-12-31;2016-02-11;785800000;849100000;6551900000;1420900000;443400000;9400900000;814100000;;16749400000;17563500000;26964400000;1908300000;0;1968900000;14161400000;19076500000;21045400000;11128700000;-14051800000;8074400000;5919000000;26964400000
CELG;410976;USD;2014;Q4;2014-12-31;2015-02-20;800100000;835100000;7546700000;1166700000;393100000;9712600000;642600000;;6984900000;7627500000;17340100000;1202000000;605900000;2112200000;6265700000;8703100000;10815300000;9836400000;-10698800000;6472400000;6524800000;17340100000
CELG;410976;USD;2013;Q4;2013-12-31;2014-02-13;822300000;861800000;5687000000;1061400000;340400000;7550500000;593400000;;5234300000;5827700000;13378200000;1173300000;544800000;1945500000;4196500000;5842800000;7788300000;8685500000;-7662100000;4472500000;5589900000;13378200000
CELG;410976;USD;2012;Q4;2012-12-31;2013-02-15;843200000;865800000;3900300000;960500000;259500000;5533700000;578400000;;5622200000;6200600000;11734300000;933100000;308500000;1690200000;2771300000;4349600000;6039800000;7544800000;-4823200000;3022600000;5694500000;11734300000
CELG;410976;USD;2011;Q4;2011-12-31;2012-02-22;881126000;898146000;2648154000;945531000;189573000;4353225000;506042000;;5146643000;5652685000;10005910000;853274000;526684000;1539972000;1275585000;2953211000;4493183000;6769353000;-2760705000;1566416000;5512727000;10005910000
CELG;410976;USD;2010;Q4;2010-12-31;2011-03-01;938632000;953312000;2601301000;706429000;260130000;4343199000;509919000;23073000;5300971000;5833963000;10177162000;698224000;;1070382000;1247584000;3111308000;4181690000;6355062000;-545588000;248266000;5995472000;10177162000
CELG;410976;USD;2009;Q4;2009-12-31;2010-02-18;918426000;934344000;2996752000;438617000;100683000;3844804000;297792000;;1246715000;1544507000;5389311000;399111000;;494705000;0;500000000;994705000;5478798000;-362521000;-632246000;4394606000;5389311000
CELG;410976;USD;2008;Q4;2008-12-31;2009-07-31;917724000;917724000;2222091000;312243000;100176000;2841366000;248971000;;1354933000;1603904000;4445270000;411141000;;527248000;;426694000;953942000;5185030000;-157165000;-1408993000;3491328000;4445270000
CELG;410976;USD;2016;Q4;2016-12-31;2017-02-10;776800000;802500000;7970000000;1621000000;498000000;10868000000;930000000;;16288000000;17218000000;28086000000;2403000000;501000000;2959000000;13789000000;18527000000;21486000000;12388000000;-16281000000;10074000000;6600000000;28086000000
CELG;410976;USD;2017;Q4;2017-12-31;2018-02-07;773300000;796700000;12042000000;1921000000;541000000;14892000000;1070000000;;14179000000;15249000000;30141000000;2912000000;0;2987000000;15838000000;20233000000;23220000000;13816000000;-20243000000;13061000000;6921000000;30141000000
CELG;410976;USD;2018;Q4;2018-12-31;2019-02-26;698800000;714600000;6042000000;2066000000;458000000;9067000000;1367000000;;25046000000;26413000000;35480000000;3483000000;501000000;4057000000;19769000000;25262000000;29319000000;14988000000;-26336000000;17559000000;6161000000;35480000000
PNRA;412883;USD;2016;Q4;2016-12-31;2017-02-22;22826000;22953000;105529000;53519000;23775000;311421000;802759000;;187431000;990190000;1301611000;431092000;17229000;448321000;410594000;560900000;1009221000;257594000;-1488779000;1524093000;292387000;1301608000
PNRA;412883;USD;2015;Q4;2015-12-31;2016-02-18;24710000;24807000;241886000;38211000;22482000;468310000;776248000;;196281000;972529000;1440839000;379269000;17229000;399443000;388971000;540115000;939558000;235393000;-1111586000;1378519000;501278000;1440836000
PNRA;412883;USD;2014;Q4;2014-12-31;2015-02-23;26589000;26692000;196493000;36584000;22811000;406166000;787294000;;197226000;984520000;1390686000;352712000;0;352712000;99784000;301790000;654502000;214437000;-706073000;1229177000;736181000;1390683000
PNRA;412883;USD;2013;Q4;2013-12-31;2014-02-20;27530000;27664000;125245000;32965000;21916000;302716000;669409000;;208737000;878146000;1180862000;303325000;;303325000;0;177645000;480970000;196908000;-546570000;1049884000;699889000;1180859000
PNRA;412883;USD;2012;Q4;2012-12-31;2013-02-15;29242000;29441000;297141000;43843000;19714000;478842000;571754000;;217567000;789321000;1268163000;277540000;;277540000;;168704000;446244000;174690000;-207161000;853715000;821916000;1268160000
PNRA;412883;USD;2011;Q4;2011-12-31;2012-02-21;29144000;29425000;222640000;30700000;17016000;353119000;492022000;;182181000;674203000;1027322000;238334000;;238334000;;133912000;372246000;150093000;-175595000;680267000;655073000;1027319000
PNRA;412883;USD;2010;Q4;2010-12-31;2011-02-22;29818000;30121000;229299000;20378000;14345000;330685000;444094000;;149802000;593896000;924581000;211516000;;211516000;;117457000;328973000;130005000;-78990000;544315000;595605000;924578000
PNRA;412883;USD;2009;Q4;2009-12-31;2010-08-06;30937000;31141000;246400000;17317000;12295000;322084000;403784000;;111297000;515081000;837165000;142259000;;142259000;;97870000;240129000;168288000;-3928000;432449000;597033000;837162000
ATW;412984;USD;2016;Q4;2016-09-30;2016-11-15;64815000;64763000;145427000;113091000;109925000;393042000;4127696000;11831000;7223000;4146750000;4539792000;48557000;;49356000;1227919000;1260050000;1309406000;302341000;;2929839000;3230386000;4539792000
ATW;412984;USD;2015;Q4;2015-09-30;2015-11-12;64650000;64927000;113983000;311514000;137998000;605935000;4172132000;11831000;11435000;4195398000;4801333000;131507000;;135448000;1678268000;1718715000;1854163000;277750000;;2670148000;2947170000;4801333000
ATW;412984;USD;2014;Q4;2014-09-30;2014-11-13;64301000;65179000;80080000;242684000;132368000;497807000;3967028000;11831000;30562000;4009421000;4507228000;151896000;11885000;167377000;1742122000;1784327000;1951704000;265826000;;2286137000;2555524000;4507228000
ATW;412984;USD;2013;Q4;2013-09-30;2013-11-14;63969000;64841000;88770000;199689000;121833000;453760000;3164724000;11831000;26951000;3203506000;3657266000;137979000;8071000;156872000;1263232000;1293023000;1449895000;247447000;;1961405000;2207371000;3657266000
ATW;412984;USD;2012;Q4;2012-09-30;2012-11-19;65406000;65979000;77871000;167186000;80290000;370534000;2537340000;11875000;24013000;2573228000;2943762000;118761000;5148000;137647000;830000000;866693000;1004340000;225992000;;1716441000;1939422000;2943762000
ATW;412984;USD;2011;Q4;2011-09-30;2011-11-22;64948000;65549000;295002000;87173000;58263000;460931000;1887321000;11875000;15264000;1914460000;2375391000;152162000;5461000;159323000;520000000;563281000;722604000;210044000;;1444270000;1652787000;2375391000
ATW;412984;USD;2010;Q4;2010-09-30;2010-11-23;193008301;194944874;180523000;96463000;52749000;359994000;1343961000;15799000;4686000;1364446000;1724440000;88927000;;93460000;230000000;260846000;354306000;197538000;;1172596000;1370134000;1724440000
ATW;412984;USD;2009;Q4;2009-09-30;2010-08-06;256475544;257778815;100259000;124053000;50136000;304604000;1184300000;14331000;6167000;1204798000;1509402000;77093000;;112918000;275000000;294191000;407109000;186693000;;915600000;1102293000;1509402000
W;417451;USD;2017;Q4;2017-12-31;2018-02-26;87899000;87899000;619992000;37948000;28042000;816820000;361141000;21561000;13881000;396583000;1213403000;560613000;;739755000;415485000;521977000;1261732000;537300000;;-583266000;-48329000;1213403000
W;417451;USD;2016;Q4;2016-12-31;2016-11-08;85572000;85572000;348583000;19113000;18550000;477091000;239354000;30967000;14271000;284592000;761683000;447300000;;557220000;28900000;125079000;682299000;409311000;;-329940000;79384000;761683000
W;417451;USD;2015;Q4;2015-12-31;2015-11-12;84205000;84205000;386071000;9906000;19900000;492323000;112325000;79883000;10050000;202258000;694581000;322473000;;397026000;0;55010000;452036000;378246000;;-135565000;242545000;694581000
W;417451;USD;2014;Q4;2014-12-31;2014-11-14;80396000;80396000;415859000;5949000;19798000;486868000;60639000;0;8016000;68655000;555523000;190208000;;232592000;;17392000;249984000;364027000;;-58122000;305539000;555523000
W;417451;USD;2013;Q4;2013-12-31;2014-11-14;41415856;41415856;115308000;7689000;14963000;163132000;22088000;;11085000;33173000;196305000;123528000;;145267000;;1030000;146297000;;;-190850000;50008000;196305000
W;417451;USD;2018;Q4;2018-12-31;2019-02-25;90471000;90471000;963739000;50603000;46164000;1255936000;606977000;6526000;21411000;634914000;1890850000;863171000;;1139223000;921960000;1082348000;2221571000;753748000;;-1082689000;-330721000;1890850000
SANM;418072;USD;2016;Q4;2016-09-30;2016-11-18;73358000;78426000;398288000;973680000;946239000;2375652000;617524000;;632046000;1249570000;3625222000;1248461000;28416000;1401263000;434059000;614156000;2015419000;;;;1609803000;3625222000
SANM;418072;USD;2015;Q4;2015-09-30;2015-11-19;80047000;83492000;412253000;936952000;918728000;2322980000;590844000;;579440000;1170284000;3493264000;1155725000;113416000;1380557000;423949000;592236000;1972793000;6075579000;-314550000;-4307129000;1520471000;3493264000
SANM;418072;USD;2014;Q4;2014-09-30;2014-11-13;82527000;87286000;466607000;979475000;893178000;2450974000;563016000;;299099000;862115000;3313089000;1266386000;157394000;1534137000;386681000;532197000;2066334000;6065086000;-216857000;-4684390000;1246755000;3313089000
SANM;418072;USD;2013;Q4;2013-09-30;2013-11-27;83791000;87316000;402875000;944816000;781560000;2204588000;540151000;;251109000;791260000;2995848000;1075060000;22301000;1206724000;562512000;697560000;1904284000;6104476000;-215658000;-4881555000;1091564000;2995848000
SANM;418072;USD;2012;Q4;2012-09-30;2012-11-21;81559000;86521000;409618000;1001543000;826539000;2326299000;569365000;;272122000;841487000;3167786000;1054811000;59995000;1219547000;837364000;984458000;2204005000;6075341000;-214133000;-4960906000;963781000;3167786000
SANM;418072;USD;2011;Q4;2011-09-30;2011-11-22;80713000;82726000;640288000;1014121000;891325000;2629246000;588097000;;136630000;724727000;3353973000;1096207000;60200000;1265885000;1182308000;1317571000;2583456000;6054747000;-213828000;-5141140000;770517000;3353973000
SANM;418072;USD;2010;Q4;2010-09-30;2011-02-08;79620000;82858000;592812000;1018612000;844347000;2590009000;570258000;;141529000;711787000;3301796000;1045972000;65000000;1251343000;1240666000;1388852000;2640195000;6031971000;-214530000;-5210057000;661601000;3301796000
SANM;418072;USD;2017;Q4;2017-09-30;2017-11-13;74277000;79232000;406661000;1110334000;1051669000;2616250000;640275000;;590838000;1231113000;3847363000;1411045000;88416000;1616043000;391447000;583636000;2199679000;6185088000;-633740000;-3980458000;1647684000;3847363000
SANM;418072;USD;2018;Q4;2018-09-30;2018-11-15;68379000;62092000;419528000;1177219000;1374004000;3014427000;642913000;;427793000;1070706000;4085133000;1672147000;593321000;2401895000;14346000;210394000;2612289000;6222988000;-791366000;-4032722000;1472844000;4085133000
ZNGA;418866;USD;2018;Q4;2018-12-31;2019-02-28;860559000;918668000;581222000;91630000;;747277000;266557000;;1132869000;1399426000;2146703000;31706000;100000000;479834000;;70259000;550093000;3504713000;;-1789664000;1596610000;2146703000
ZNGA;418866;USD;2017;Q4;2017-12-31;2018-02-20;870054000;931273000;681376000;103677000;;830950000;266589000;;881794000;1148383000;1979333000;25615000;;282711000;;55382000;338093000;3426505000;;-1691768000;1641240000;1979333000
ZNGA;418866;USD;2016;Q4;2016-12-31;2016-11-04;888414000;888414000;852467000;77260000;;965476000;269439000;;670934000;940373000;1905849000;25888000;;243640000;;81545000;325185000;3349714000;;-1640356000;1580664000;1905849000
ZNGA;418866;USD;2015;Q4;2015-12-31;2015-11-04;922885000;903969000;987250000;79610000;;1112290000;273221000;;739119000;1012340000;2124630000;29676000;;236206000;;101523000;337729000;3234551000;-98942000;-1296320000;1786901000;2124630000
ZNGA;418866;USD;2014;Q4;2014-12-31;2014-11-07;891083000;891083000;916524000;89611000;;1082939000;297919000;231385000;736550000;1265854000;2348793000;14965000;;369038000;;84063000;453101000;3096982000;;-1172115000;1895692000;2348793000
ZNGA;418866;USD;2013;Q4;2013-12-31;2013-05-01;821557000;773980000;1125496000;65667000;;1241399000;348793000;416474000;272419000;1037686000;2279085000;20973000;;276502000;;125312000;401814000;2823743000;;-945426000;1877271000;2279085000
ZNGA;418866;USD;2012;Q4;2012-12-31;2012-10-26;1501422490;1501422490;1284770000;106327000;;1484370000;466074000;367543000;258333000;1091950000;2576320000;23298000;;509145000;100000000;241672000;750817000;2725605000;-295113000;-603542000;1825503000;2576320000
ZNGA;418866;USD;2011;Q4;2011-12-31;2012-05-08;895693826;795549826;1807508000;135633000;;2023909000;246740000;110098000;135899000;492737000;2516646000;44020000;;668685000;0;98422000;767107000;2426168000;-282897000;-394094000;1749539000;2516646000
TDW;419436;USD;2018;Q4;2018-12-31;2019-02-28;31665862;31665862;371791000;111266000;;683302000;1089857000;1039000;53541000;1144437000;1827739000;93723000;8568000;158355000;430436000;524461000;682816000;1352425000;;-210783000;1144923000;1827739000
FOSL;419656;USD;2017;Q4;2017-12-31;2018-03-02;48554000;48554000;231244000;367013000;573788000;1290988000;219742000;;147642000;367384000;1658372000;222641000;2144000;509088000;443942000;568337000;1077425000;242749000;;409653000;580947000;1658372000
FOSL;419656;USD;2016;Q4;2016-12-31;2017-03-01;48163000;48538000;297330000;375520000;542487000;1347290000;273851000;;565756000;839607000;2186897000;179743000;26368000;414585000;609961000;756874000;1171459000;213835000;;887825000;1015438000;2186897000
FOSL;419656;USD;2015;Q4;2015-12-31;2016-02-29;48119000;48243000;289275000;370761000;625344000;1442670000;326370000;;586621000;912991000;2355661000;216580000;23159000;489529000;785076000;933589000;1423118000;187937000;;813957000;932543000;2355661000
FOSL;419656;USD;2014;Q4;2014-12-31;2015-02-20;51218000;51420000;276261000;430498000;597281000;1454572000;345606000;;377282000;722888000;2177460000;185893000;16646000;446308000;609666000;747351000;1193659000;172177000;;822093000;983801000;2177460000
FOSL;419656;USD;2013;Q4;2013-12-31;2014-02-26;55153000;55327000;320479000;454762000;570719000;1479462000;355666000;;395286000;750952000;2230414000;192180000;13443000;491906000;494711000;663141000;1155047000;154923000;;877063000;1075367000;2230414000
FOSL;419656;USD;2012;Q4;2012-12-31;2013-02-27;59735000;60094000;177236000;363456000;506314000;1144112000;335446000;6965000;355466000;697877000;1841989000;180826000;2794000;406778000;75140000;194747000;601525000;138693000;;1066082000;1240464000;1841989000
FOSL;419656;USD;2011;Q4;2011-12-31;2012-02-29;62512000;63081000;287653000;302467000;488983000;1235402000;282050000;7520000;117950000;407520000;1642922000;174222000;9009000;391278000;6236000;134798000;526076000;149927000;-450700000;1384522000;1116846000;1642922000
FOSL;419656;USD;2010;Q4;2010-12-31;2011-03-02;65248000;66539000;401658000;263218000;371935000;1140817000;217424000;9023000;100309000;326756000;1467573000;150295000;5314000;339488000;4513000;76377000;415865000;117894000;-183014000;1089820000;1051708000;1467573000
FOSL;419656;USD;2009;Q4;2009-12-31;2010-08-12;66816000;67543000;413170000;209784000;245714000;946473000;212367000;13730000;103913000;330010000;1276483000;136999000;3618000;245280000;4538000;62791000;308071000;93706000;0;834615000;968412000;1276483000
FOSL;419656;USD;2018;Q4;2018-12-31;2019-02-21;49463000;48185000;403373000;328022000;377622000;1258569000;183203000;;133426000;316629000;1575198000;198023000;126427000;605803000;269788000;380764000;986567000;268608000;;381626000;588631000;1575198000
HIL;420734;USD;2017;Q4;2017-12-31;2018-08-31;52517000;52517000;21353000;147611000;;198411000;12004000;3639000;79241000;94884000;293295000;99715000;3241000;125874000;34541000;56751000;182625000;197110000;-30041000;-53983000;110670000;293295000
HIL;420734;USD;2016;Q4;2016-12-31;2016-11-15;51785000;51473000;25637000;164844000;;266461000;16389000;3501000;113724000;133614000;400075000;90554000;1983000;139525000;142120000;184198000;323723000;190359000;-30041000;-81349000;76352000;400075000
HIL;420734;USD;2015;Q4;2015-12-31;2015-11-16;51521000;51309000;24089000;187721000;;295723000;18822000;4936000;106974000;130732000;426455000;100014000;4357000;144596000;140626000;177922000;322518000;189204000;-29245000;-47793000;103937000;426455000
HIL;420734;USD;2014;Q4;2014-12-31;2014-11-03;50511000;47681000;30124000;146035000;;257294000;8957000;6651000;123170000;138778000;396072000;83660000;6361000;139968000;115163000;139450000;279418000;179918000;-28304000;-33292000;116654000;396072000
HIL;420734;USD;2013;Q4;2013-12-31;2013-11-08;39551000;40187000;30381000;174685000;;245638000;10613000;5984000;131241000;147838000;393476000;90338000;18974000;139124000;114285000;157496000;296620000;136904000;-27766000;422000;96856000;393476000
HIL;420734;USD;2012;Q4;2012-12-31;2012-11-09;38658000;38318000;16716000;151239000;;202838000;11268000;8275000;141524000;161067000;363905000;85976000;21769000;138082000;87666000;133269000;271351000;129918000;-27766000;-3140000;92554000;363905000
HIL;420734;USD;2011;Q4;2011-12-31;2011-11-09;38504000;38055000;17924000;197906000;;231833000;13110000;12620000;149949000;175679000;407512000;82117000;6025000;108463000;87435000;126655000;235118000;127172000;-27766000;73626000;172394000;407512000
HIL;420734;USD;2010;Q4;2010-12-31;2011-08-10;38226000;38849000;39406000;180856000;;237466000;11926000;10962000;110497000;133385000;370851000;80049000;2278000;104069000;67778000;98686000;202755000;123766000;-27766000;79643000;168096000;370851000
HIL;420734;USD;2018;Q4;2018-12-31;2019-04-01;55706000;55706000;18711000;117469000;;183095000;10787000;3015000;67872000;81674000;264769000;88862000;3364000;109039000;44587000;61285000;170324000;210090000;-28231000;-85444000;94445000;264769000
EQR;421306;USD;2018;Q4;2018-12-31;2019-02-21;368450000;384455000;47442000;;;116313000;19814741000;;463155000;20277896000;20394209000;371694000;2884653000;3614910000;5933286000;6000544000;9615454000;8939147000;;1261763000;10778755000;20394209000
EQR;421306;USD;2017;Q4;2017-12-31;2018-02-22;367451000;382795000;50647000;;;100762000;19986518000;;483319000;20469837000;20570599000;365629000;3918479000;4625960000;5038812000;5103821000;9729781000;8890266000;;1403530000;10840818000;20570599000
EQR;421306;USD;2016;Q4;2016-12-31;2016-11-02;365260000;381287000;77207000;;;219088000;20026036000;;459024000;20485060000;20704148000;400724000;4139179000;4890369000;4848079000;4910703000;9801072000;8762081000;;1543626000;10903076000;20704148000
EQR;421306;USD;2015;Q4;2015-12-31;2015-11-05;363839000;380999000;42276000;;;2279304000;20276946000;;553946000;20830892000;23110196000;481723000;5072410000;5920520000;5848956000;5926538000;11847058000;8576013000;;2009091000;11263138000;23110196000
EQR;421306;USD;2014;Q4;2014-12-31;2014-11-06;362036000;379484000;40080000;;;112383000;22242578000;;595653000;22838231000;22950614000;431696000;5419515000;6241126000;5425346000;5500979000;11742105000;8539969000;;1950639000;11208509000;22950614000
EQR;421306;USD;2013;Q4;2013-12-31;2013-11-07;360224000;360224000;53534000;;;157101000;21993239000;;684205000;22677444000;22834545000;440611000;5289166000;6077525000;5477088000;5548680000;11626205000;8565105000;;2047258000;11208340000;22834545000
EQR;421306;USD;2012;Q4;2012-12-31;2012-11-01;310470000;361293000;612590000;;;863032000;16096208000;;241760000;16337968000;17201000000;374771000;3898369000;4577658000;4630875000;4697863000;9275521000;6545606000;;887355000;7925479000;17201000000
EQR;421306;USD;2011;Q4;2011-12-31;2011-11-04;296035000;261486000;383921000;;;536158000;15868363000;;254782000;16123145000;16659303000;302406000;4111487000;4705182000;5609574000;5674860000;10380042000;5050161000;;615572000;6279261000;16659303000
EQR;421306;USD;2010;Q4;2010-12-31;2010-11-04;285973000;285973000;431408000;;;612395000;15365014000;;206785000;15571799000;16184194000;278988000;4762896000;5346086000;5185180000;5245992000;10592078000;4744423000;;203581000;5592116000;16184194000
UDR;424210;USD;2017;Q4;2017-12-31;2018-02-20;267278000;268711000;2038000;19469000;;41299000;6847040000;;844934000;7691974000;7733273000;246192000;;278108000;3671663000;3671663000;3949771000;4653883000;;;3783502000;7733273000
UDR;424210;USD;2016;Q4;2016-12-31;2016-10-26;266519000;268480000;2112000;19790000;;42967000;6691057000;;945560000;7636617000;7679584000;237416000;;271654000;3401478000;3401478000;3673132000;4638086000;;;4006452000;7679584000
UDR;424210;USD;2015;Q4;2015-12-31;2015-10-27;260879000;272333000;6742000;16694000;;56009000;6531627000;;1076208000;7607835000;7663844000;209672000;;246002000;3570795000;3570795000;3816797000;4450434000;;;3847047000;7663844000
UDR;424210;USD;2014;Q4;2014-12-31;2014-10-29;254025000;256035000;15224000;14369000;;51933000;5948487000;;828308000;6776795000;6828728000;210935000;;244999000;3565299000;3565299000;3810298000;4226298000;;;3018430000;6828728000
UDR;424210;USD;2013;Q4;2013-12-31;2013-10-29;249989000;247099000;30249000;83033000;;146230000;5989031000;;672461000;6661492000;6807722000;226715000;;253918000;3523703000;3523703000;3777621000;4112272000;;;3030101000;6807722000
UDR;424210;USD;2012;Q4;2012-12-31;2012-10-31;250048000;250048000;12115000;64006000;;149301000;6081527000;;628275000;6709802000;6859103000;207495000;;232520000;3409333000;3409333000;3641853000;4101383000;;;3217250000;6859103000
UDR;424210;USD;2011;Q4;2011-12-31;2011-11-03;218350000;218007000;12503000;0;;369395000;5910486000;;441473000;6351959000;6721354000;183109000;;247725000;3918370000;3918370000;4166095000;3342667000;;;2555259000;6721354000
UDR;424210;USD;2010;Q4;2010-12-31;2010-11-09;181008000;181008000;13352000;7800000;;488667000;4790953000;;249920000;5040873000;5529540000;177960000;;232949000;3567504000;3567504000;3800453000;2451966000;;;1729087000;5529540000
UDR;424210;USD;2009;Q4;2009-12-31;2010-08-03;152711000;152711000;43635000;7800000;;76987000;4947081000;;108549000;5055630000;5132617000;147664000;;208288000;3426589000;3426589000;3634877000;1950224000;;;1497740000;5132617000
UDR;424210;USD;2018;Q4;2018-12-31;2019-02-19;270132000;270973000;185216000;42259000;;251150000;6541999000;;918579000;7460578000;7711728000;233364000;;268424000;3547787000;3547787000;3816211000;4923487000;;;3895517000;7711728000
SYMC;427444;USD;2017;Q4;2018-03-31;2018-10-26;621000000;781000000;2162000000;809000000;;3493000000;778000000;;11488000000;12266000000;15759000000;430000000;0;3170000000;5026000000;7566000000;10736000000;4691000000;;328000000;5023000000;15759000000
SYMC;427444;USD;2016;Q4;2017-03-31;2017-05-19;619000000;612000000;4256000000;649000000;;5324000000;937000000;;11913000000;12850000000;18174000000;452000000;1310000000;4622000000;6876000000;10065000000;14687000000;4236000000;;-761000000;3487000000;18174000000
SYMC;427444;USD;2015;Q4;2016-03-31;2016-05-20;651000000;631000000;5983000000;556000000;;6959000000;957000000;;3851000000;4808000000;11767000000;1335000000;0;4033000000;2207000000;4058000000;8091000000;4309000000;;-655000000;3676000000;11767000000
SYMC;427444;USD;2014;Q4;2015-03-31;2015-05-22;685000000;702000000;3860000000;700000000;;5422000000;950000000;;6861000000;7811000000;13233000000;448000000;350000000;4453000000;1746000000;2845000000;7298000000;6101000000;;-270000000;5935000000;13233000000
SYMC;427444;USD;2013;Q4;2014-03-31;2014-05-16;692000000;700000000;4084000000;1007000000;;5652000000;1116000000;;6771000000;7887000000;13539000000;647000000;0;4306000000;2095000000;3436000000;7742000000;6751000000;;-1148000000;5797000000;13539000000
SYMC;427444;USD;2012;Q4;2013-03-31;2013-05-17;693000000;714000000;4747000000;1031000000;24000000;6416000000;1122000000;;6970000000;8092000000;14508000000;756000000;997000000;5567000000;2094000000;3465000000;9032000000;7320000000;;-2046000000;5476000000;14508000000
SYMC;427444;USD;2011;Q4;2012-03-31;2012-05-21;730000000;736000000;3211000000;940000000;28000000;4633000000;1100000000;;7287000000;8387000000;13020000000;740000000;;4505000000;2039000000;3343000000;7848000000;7780000000;;-2859000000;5172000000;13020000000
SYMC;427444;USD;2010;Q4;2011-03-31;2011-05-20;764000000;775000000;2958000000;1013000000;30000000;4486000000;1050000000;;7183000000;8233000000;12719000000;703000000;596000000;4893000000;1987000000;3221000000;8114000000;8369000000;;-4012000000;4605000000;12719000000
SYMC;427444;USD;2009;Q4;2010-03-31;2010-05-24;803000000;811000000;3044000000;856000000;25000000;4351000000;949000000;;5932000000;6881000000;11232000000;598000000;0;3771000000;1871000000;2913000000;6684000000;8998000000;;-4609000000;4548000000;11232000000
SYMC;427444;USD;2008;Q4;2009-03-31;2009-08-05;820000000;791000000;1992000000;837000000;27000000;3297000000;973000000;;6368000000;7341000000;10638000000;608000000;;3513000000;1766000000;2978000000;6491000000;9297000000;;-5336000000;4147000000;10638000000
SYMC;427444;USD;2018;Q4;2019-03-31;2019-05-24;637000000;735000000;2043000000;708000000;;3186000000;790000000;;11962000000;12752000000;15938000000;422000000;491000000;3766000000;3961000000;6434000000;10200000000;4812000000;;933000000;5738000000;15938000000
GRUB;433759;USD;2018;Q4;2018-12-31;2019-02-28;90706000;93144000;225329000;110855000;;363775000;119495000;;1582438000;1701933000;2065708000;45251000;6250000;223168000;335548000;400201000;623369000;1094875000;;349355000;1442339000;2065708000
GRUB;433759;USD;2017;Q4;2017-12-31;2018-02-28;86703000;89365000;257695000;87377000;;360483000;71384000;;1111902000;1183286000;1543769000;23902000;3906000;174548000;169645000;251405000;425953000;849052000;;269992000;1117816000;1543769000
GRUB;433759;USD;2016;Q4;2016-12-31;2016-11-08;85608000;86668000;323619000;60550000;;396337000;46555000;;754615000;801170000;1197507000;15793000;;110490000;;114898000;225388000;805740000;;168457000;972119000;1197507000
GRUB;433759;USD;2015;Q4;2015-12-31;2015-11-12;84822000;86026000;310741000;42051000;;356274000;19082000;;684892000;703974000;1060248000;13456000;;89612000;;93040000;182652000;759300000;;118900000;877596000;1060248000
GRUB;433759;USD;2014;Q4;2014-12-31;2014-11-06;81606000;84312000;313137000;36127000;;352204000;16003000;;610670000;626673000;978877000;10989000;;111005000;;97350000;208355000;689961000;;80823000;770522000;978877000
GRUB;433759;USD;2013;Q4;2013-12-31;2014-05-15;54915000;76754000;86542000;29304000;;122159000;17096000;;623557000;640653000;762812000;6841000;;92591000;;112846000;205437000;500361000;;56880000;557375000;762812000
ELY;434282;USD;2016;Q4;2016-12-31;2017-02-27;94118000;97982000;125975000;127863000;189400000;460425000;54475000;48997000;237385000;340857000;801282000;174888000;;186854000;;5828000;192682000;331148000;-905000;287129000;608600000;801282000
ELY;434282;USD;2015;Q4;2015-12-31;2016-03-04;92441000;65760000;49801000;115607000;208883000;391487000;55808000;53315000;130614000;239737000;631224000;163667000;;178636000;;39643000;218279000;323731000;-20000;101047000;412945000;631224000
ELY;434282;USD;2014;Q4;2014-12-31;2015-03-03;77587000;64162000;37635000;109848000;207229000;384033000;58093000;50677000;132008000;240778000;624811000;168867000;;184128000;108574000;149149000;333277000;210841000;-8443000;89932000;291534000;624811000
ELY;434282;USD;2013;Q4;2013-12-31;2014-02-27;76416000;40041000;36793000;92203000;263492000;421603000;71341000;37605000;133314000;242260000;663863000;200536000;;226196000;107835000;153048000;379244000;206495000;-11091000;77038000;284619000;663863000
ELY;434282;USD;2012;Q4;2012-12-31;2013-03-08;71039000;51040000;52003000;91072000;211734000;386996000;89093000;;161547000;250640000;637636000;160639000;;161566000;107133000;154362000;315928000;205233000;-14848000;113831000;321708000;637636000
ELY;434282;USD;2011;Q4;2011-12-31;2012-03-02;64895000;44479000;43023000;115673000;233070000;419329000;117147000;;190636000;307783000;727112000;163676000;;167784000;0;46514000;214298000;265730000;-17800000;247941000;512814000;727112000
ELY;434282;USD;2010;Q4;2010-12-31;2011-08-01;64115000;62651000;55043000;144643000;268591000;543729000;129601000;;202682000;332283000;876012000;175139000;;175166000;;13967000;189133000;262547000;-24835000;432977000;686879000;876012000
ELY;434282;USD;2017;Q4;2017-12-31;2018-02-27;94583000;97284000;85674000;94725000;262486000;465984000;70227000;70495000;384451000;525173000;991157000;224252000;2367000;314374000;9448000;17408000;331782000;336172000;-4456000;324081000;659375000;991157000
ELY;434282;USD;2018;Q4;2018-12-31;2019-03-01;94497000;97326000;63981000;71374000;338057000;524906000;88472000;72238000;367328000;528038000;1052944000;260526000;2411000;303237000;7218000;15399000;318636000;342197000;-17722000;413799000;734308000;1052944000
CPXX;436095;USD;2015;Q4;2015-12-31;2016-03-21;34522813;;23253328;;414904;24312984;861490;;43998;905488;25218472;3156073;5378134;8579456;9081110;11191296;19770752;175264587;;-168683601;5447720;25218472
CPXX;436095;USD;2014;Q4;2014-12-31;2015-03-17;31495272;;32413777;;458278;33570190;1004412;;544501;1548913;35119103;2459185;284961;3287132;9836256;11010106;14297238;171323384;;-149368253;20821865;35119103
CPXX;436095;USD;2013;Q4;2013-12-31;2014-03-24;26212030;;23589516;;468389;26328426;1138579;;5745;1144324;27472750;2823957;0;3366943;0;1724513;5091456;155979930;;-132465370;22381294;27472750
CPXX;436095;USD;2012;Q4;2012-12-31;2013-05-15;13664240;;9648008;;0;12088114;1245025;;105805;1350830;13438944;1894856;1200000;3710240;1800000;3960117;7670357;118523068;;-111621215;5768587;13438944
AVXL;436223;USD;2018;Q4;2018-09-30;2018-12-12;44982364;44982364;22930638;;;24323740;;;52396;52396;24376136;3884626;;3884626;;;3884626;129423477;;-108931967;20491510;24376136
AVXL;436223;USD;2017;Q4;2017-09-30;2017-12-11;42301290;42301290;27440257;;;27785933;;;52396;52396;27838329;3584334;;3584334;;;3584334;115732553;;-91478558;24253995;27838329
AVXL;436223;USD;2016;Q4;2016-09-30;2016-08-11;35717312;35717312;9186814;;;9446285;;;52396;52396;9498681;3119993;;3190525;;0;3190525;84326309;;-78018153;6308156;9498681
AVXL;436223;USD;2015;Q4;2015-09-30;2015-08-14;28009682;28009682;15290976;;;15468661;1252;;0;1252;15469913;2503726;85238;2660578;332;1997747;4658325;74093043;;-63281455;10811588;15469913
AVXL;436223;USD;2014;Q4;2014-09-30;2014-08-13;10561631;8949390;7262138;;;7351255;2247;;;2247;7353502;1249084;192065;1441149;5719727;6359727;7800876;50725951;;-51173325;-447374;7353502
AVXL;436223;USD;2013;Q4;2013-09-30;2013-08-14;9227926;9227926;345074;;;393449;0;;;0;393449;1741797;210863;1952660;904000;964000;2916660;38681761;;-41204972;-2523211;393449
AVXL;436223;USD;2012;Q4;2012-09-30;2012-08-17;;7559462;11362;;;12577;576;;;576;13153;2589324;299000;2888324;;0;2888324;34629755;;-37504926;-2875171;13153
AVXL;436223;USD;2011;Q4;2011-09-30;2011-08-12;;6487133;134702;;;200605;2434;;;2434;203039;410024;867919;1277943;;67500;1345443;28060817;;-29203221;-1142404;203039
AVXL;436223;USD;2010;Q4;2010-09-30;2011-08-12;;5636755;264669;;;325758;4091;;;4091;329849;797763;2492308;3290071;;0;3290071;18935852;;-21896074;-2960222;329849
UTHR;438343;USD;2018;Q4;2018-12-31;2019-02-27;44000000;44700000;1415900000;175700000;101000000;1768000000;699700000;442600000;490700000;1633000000;3401000000;166100000;;276600000;250000000;335800000;612400000;1940900000;-2579200000;3434800000;2788600000;3401000000
UTHR;438343;USD;2017;Q4;2017-12-31;2018-02-21;43200000;44700000;927400000;297100000;107900000;1447900000;545700000;502700000;383100000;1431500000;2879400000;171100000;;694700000;;82900000;777600000;1855000000;-2579200000;2845600000;2101800000;2879400000
UTHR;438343;USD;2016;Q4;2016-12-31;2016-10-27;42300000;45400000;1050800000;214500000;100000000;1424800000;489300000;2300000;409200000;900800000;2325600000;104200000;;332500000;;141800000;474300000;1814200000;-2379600000;2433500000;1851300000;2325600000
UTHR;438343;USD;2015;Q4;2015-12-31;2015-10-27;45700000;56000000;953800000;192800000;81300000;1275300000;495800000;38000000;375300000;909100000;2184400000;103400000;;440700000;;155100000;595800000;1791300000;-1902100000;1719800000;1588600000;2184400000
UTHR;438343;USD;2014;Q4;2014-12-31;2014-10-28;47484000;59594000;695539000;162287000;66927000;957589000;478421000;122658000;325742000;926821000;1884410000;85382000;126414000;504310000;;137744000;642054000;1376801000;-1185825000;1068114000;1242356000;1884410000
UTHR;438343;USD;2013;Q4;2013-12-31;2013-10-29;50281000;54212000;693903000;126297000;47758000;914382000;464950000;448134000;260101000;1173185000;2087567000;92244000;282459000;687674000;;140619000;828293000;1057854000;-513437000;728040000;1259274000;2087567000
UTHR;438343;USD;2012;Q4;2012-12-31;2012-11-01;50480000;50579000;479205000;116626000;37254000;668470000;453685000;305726000;198714000;958125000;1626595000;83188000;1291000;176755000;275010000;365859000;542614000;1016456000;-470998000;553480000;1083981000;1626595000
UTHR;438343;USD;2011;Q4;2011-12-31;2011-10-27;54398000;50991000;403479000;88680000;45981000;562455000;366046000;343899000;245679000;955624000;1518079000;57227000;47257000;212577000;265632000;357014000;569591000;993333000;-282998000;249038000;948488000;1518079000
UTHR;438343;USD;2010;Q4;2010-12-31;2010-10-28;57216000;57436000;627083000;73707000;35520000;764487000;306044000;132849000;228255000;667148000;1431635000;50280000;252114000;428686000;68929000;119063000;547749000;929290000;-67399000;31170000;883886000;1431635000
UTHR;438343;USD;2009;Q4;2009-12-31;2010-07-28;53932000;58641000;229492000;50626000;26360000;324507000;303859000;148628000;274550000;727037000;1051544000;29764000;239022000;330187000;;68348000;398535000;799464000;-67395000;-74746000;653009000;1051544000
PCP;438657;USD;2015;Q4;2016-01-31;2015-02-05;;;343000000;1502000000;3779000000;5835000000;2660000000;225000000;11777000000;14662000000;20497000000;1442000000;0;1485000000;5184000000;7273000000;8758000000;138000000;;12467000000;11739000000;20497000000
PCP;438657;USD;2014;Q4;2015-01-31;2014-02-06;139900000;140600000;361000000;1568000000;3426000000;5507000000;2300000000;416000000;10363000000;13079000000;18586000000;1593000000;2000000;1608000000;3569000000;5565000000;7173000000;1632000000;;10172000000;11413000000;18586000000
PCP;438657;USD;2013;Q4;2014-01-31;2013-02-08;145400000;146300000;280000000;1507000000;2980000000;5080000000;2077000000;445000000;9294000000;11816000000;16896000000;1492000000;204000000;1712000000;3602000000;5380000000;7092000000;1923000000;;8413000000;9804000000;16896000000
PCP;438657;USD;2012;Q4;2013-01-31;2012-02-10;146300000;147200000;698700000;1186400000;1815300000;3785800000;1322200000;442800000;5008000000;6773000000;10558800000;1048700000;500000;1070900000;207700000;1123100000;2194000000;1798900000;;7003500000;8364800000;10558800000
YELP;440174;USD;2016;Q4;2016-12-31;2017-03-01;78872000;70663000;479533000;68725000;;561179000;92440000;;231587000;324027000;885206000;57085000;;60399000;;17621000;78020000;892983000;;-70221000;807186000;885206000
YELP;440174;USD;2015;Q4;2015-12-31;2016-02-24;75398000;75398000;370827000;52755000;;443282000;80467000;;231678000;312145000;755427000;46846000;;49777000;;12030000;61807000;774022000;;-66883000;693620000;755427000
YELP;440174;USD;2014;Q4;2014-12-31;2015-02-27;72664000;81325000;365810000;35593000;;420758000;62761000;38612000;107519000;208892000;629650000;30979000;;33973000;;7527000;41500000;627742000;;-33983000;588150000;629650000
YELP;440174;USD;2013;Q4;2013-12-31;2014-03-03;132490267;132490267;389764000;21317000;;416833000;30666000;0;68478000;99144000;515977000;22368000;;24989000;;4505000;29494000;553753000;;-70456000;486483000;515977000
YELP;440174;USD;2012;Q4;2012-12-31;2013-02-27;155236850;155236850;95124000;11738000;;111332000;14799000;;61565000;76364000;187696000;17258000;;20114000;;1920000;22034000;225245000;;-60388000;165662000;187696000
YELP;440174;USD;2011;Q4;2011-12-31;2012-05-04;16115000;16115000;21736000;8257000;;31726000;9881000;;2214000;12095000;43821000;10658000;;12730000;;55438000;68168000;16625000;;-41243000;-24347000;43821000
YELP;440174;USD;2017;Q4;2017-12-31;2018-02-28;83310000;96544000;821216000;76173000;;913089000;103651000;25032000;174740000;303423000;1216512000;82698000;;86167000;;30737000;116904000;1038017000;-46000;70081000;1099608000;1216512000
YELP;440174;USD;2018;Q4;2018-12-31;2019-03-01;82730000;93676000;755860000;87305000;;860269000;114800000;0;200494000;315294000;1175563000;61062000;;64905000;;35140000;100045000;1139462000;0;-52923000;1075518000;1175563000
NVCR;440850;USD;2017;Q4;2017-12-31;2018-02-22;89389379;89389379;183311000;29567000;22025000;245134000;9031000;;11133000;20164000;265298000;50202000;;50202000;97342000;101532000;151734000;697165000;;-582258000;113564000;265298000
NVCR;440850;USD;2016;Q4;2016-12-31;2016-11-02;86787071;86787071;219634000;6339000;25549000;261873000;9812000;;10396000;20208000;282081000;36882000;;36882000;96231000;102854000;139736000;664154000;;-519926000;142345000;282081000
NVCR;440850;USD;2015;Q4;2015-12-31;2015-10-27;83607063;83607063;269424000;0;13594000;293904000;6552000;;6880000;13432000;307336000;28627000;;28627000;23097000;27889000;56516000;640406000;;-388081000;250820000;307336000
NVCR;440850;USD;2014;Q4;2014-12-31;2015-10-27;12826572;12826572;102612000;;3446000;111830000;3732000;;2314000;6046000;117876000;17669000;;17669000;0;2332000;20001000;374375000;;-276500000;97875000;117876000
NVCR;440850;USD;2018;Q4;2018-12-31;2019-02-28;93083323;93083323;245878000;36523000;22555000;321369000;8442000;;9982000;18424000;339793000;64560000;;64560000;149268000;162974000;227534000;757314000;;-643655000;112259000;339793000
KATE;441025;USD;2016;Q4;2016-12-31;2017-02-23;128140000;129429000;478536000;77487000;167461000;757508000;167192000;;185619000;352811000;1110319000;220785000;3664000;224449000;389742000;455939000;680388000;428253000;-1276258000;1306096000;429931000;1110319000
KATE;441025;USD;2015;Q4;2015-12-31;2016-03-01;127702000;128850000;297851000;96850000;191879000;620825000;173963000;;180809000;354772000;975597000;262662000;3625000;266287000;393168000;464089000;730376000;401114000;-1281690000;1155838000;245221000;975597000
KATE;441025;USD;2014;Q4;2014-12-31;2015-03-03;123932000;126313000;184044000;90091000;158241000;474500000;174072000;;277766000;451838000;926338000;242336000;10459000;252795000;400284000;473932000;726727000;375537000;-1291583000;1145643000;199611000;926338000
KATE;441025;USD;2013;Q4;2013-12-31;2014-02-25;122787000;122787000;130222000;89554000;184634000;651713000;149071000;;176727000;325798000;977511000;345463000;3407000;445240000;390794000;564753000;1009993000;332421000;-1364657000;1020633000;-32482000;977511000
KATE;441025;USD;2012;Q4;2012-12-31;2013-02-21;114092000;114092000;59402000;121591000;220538000;452256000;219963000;;230304000;450267000;902523000;393101000;22632000;415849000;383662000;613604000;1029453000;323455000;-1511862000;1071551000;-126930000;902523000
KATE;441025;USD;2011;Q4;2011-12-31;2012-02-29;95327000;198599000;179936000;119551000;193343000;551745000;238664000;;159595000;398259000;950004000;362211000;64746000;426973000;381569000;632017000;1058990000;478767000;-1827892000;1246063000;-108986000;950004000
KATE;441025;USD;2010;Q4;2010-12-31;2011-07-28;94300000;94300000;22714000;208081000;289439000;611923000;375529000;;270207000;645736000;1257659000;466494000;101493000;572880000;476319000;706460000;1279340000;508245000;-1883898000;1417785000;-21681000;1257659000
AGN_old;442340;USD;2014;Q4;2014-12-31;2015-02-19;298000000;305200000;4966400000;914500000;296000000;6871200000;1006300000;;4538200000;5544500000;12415700000;1485200000;72100000;1557300000;2085300000;3095400000;4652700000;3356800000;-1090000000;5894800000;7763000000;12415700000
AGN_old;442340;USD;2013;Q4;2013-12-31;2014-02-25;297000000;301600000;3649100000;883300000;285300000;5319700000;923200000;;4331400000;5254600000;10574300000;1188700000;55600000;1244300000;2098300000;2860500000;4104800000;3035900000;-992800000;4646700000;6469500000;10574300000
AGN_old;442340;USD;2012;Q4;2012-12-31;2013-02-26;299600000;305200000;2962400000;739000000;272300000;4934900000;851500000;;3392900000;4244400000;9179300000;1041400000;48800000;1095500000;1512400000;2221200000;3316700000;2903700000;-654100000;3832100000;5862600000;9179300000
AGN_old;442340;USD;2011;Q4;2011-12-31;2012-02-28;304300000;309900000;2586000000;730600000;249700000;4048300000;807000000;;3653300000;4460300000;8508600000;871100000;83900000;955000000;1515400000;2221200000;3176200000;2764900000;-183200000;2969300000;5332400000;8508600000
AGN_old;442340;USD;2010;Q4;2010-12-31;2011-03-01;304000000;314800000;2740300000;647300000;229400000;3993700000;800600000;;3513800000;4314400000;8308100000;857800000;670600000;1528400000;1534200000;1998600000;3527000000;2818600000;-133900000;2225900000;4781100000;8308100000
AGN_old;442340;USD;2009;Q4;2009-12-31;2010-02-26;303300000;307000000;1947100000;576600000;213900000;3106300000;808100000;;3622200000;4430300000;7536600000;793500000;18100000;811600000;1491300000;1881100000;2692700000;2733400000;-164500000;2356700000;4843900000;7536600000
AGN_old;442340;USD;2008;Q4;2008-12-31;2009-08-10;;;1110400000;538400000;262500000;2270600000;775400000;;3745800000;4521200000;6791800000;692600000;4400000;697000000;1570500000;2042300000;2739300000;2599700000;-192400000;1842100000;4052500000;6791800000
ARG;442344;USD;2016;Q4;2017-03-31;2016-02-05;72519000;73659000;55809000;667399000;459521000;1384198000;3090543000;;1660215000;4750758000;6134956000;514469000;633365000;1147834000;1954820000;2941824000;4089658000;915570000;-1229713000;2377843000;2045298000;6134956000
ARG;442344;USD;2015;Q4;2016-03-31;2015-02-06;75208000;76213000;50724000;708227000;474070000;1415684000;2951766000;;1606160000;4557926000;5973610000;553066000;575981000;1129047000;1748662000;2692977000;3822024000;854676000;-919263000;2231026000;2151586000;5973610000
ARG;442344;USD;2014;Q4;2015-03-31;2014-05-29;73987000;75195000;69561000;701060000;478149000;1399087000;2802415000;;1591812000;4394227000;5793314000;542587000;788188000;1330775000;1706774000;2621890000;3952665000;790663000;-998386000;2047843000;1840649000;5793314000
ARG;442344;USD;2013;Q4;2014-03-31;2013-02-08;75276000;76593000;86386000;710740000;474821000;1463830000;2686305000;;1468090000;4154395000;5618225000;558141000;303573000;861714000;2304245000;3219528000;4081242000;730721000;-1059571000;1861395000;1536983000;5618225000
ARG;442344;USD;2012;Q4;2013-03-31;2012-05-29;76428000;78232000;44663000;652439000;408438000;1274206000;2616059000;;1430320000;4046379000;5320585000;531212000;398837000;930049000;1761902000;2640278000;3570327000;650420000;-607026000;1701478000;1750258000;5320585000
ARG;442344;USD;2011;Q4;2012-03-31;2011-02-04;82730000;84311000;57218000;550262000;372375000;1130518000;2455758000;;1359478000;3815236000;4945754000;554635000;9868000;564503000;1842994000;2640339000;3204842000;608459000;-379885000;1504758000;1740912000;4945754000
ARG;442344;USD;2010;Q4;2011-03-31;2010-08-06;83000000;84475000;47001000;186804000;333961000;711335000;2427996000;;1356601000;3784597000;4495932000;465388000;10255000;475643000;1499384000;2224745000;2700388000;569284000;-109941000;1332759000;1795544000;4495932000
ATI;442346;USD;2016;Q4;2016-12-31;2017-02-24;102400000;107300000;229600000;452100000;1037000000;1766500000;2498900000;;904600000;3403500000;5170000000;603600000;105100000;708700000;1771900000;3016500000;3725200000;1199800000;-28000000;1277100000;1444800000;5170000000
ATI;442346;USD;2015;Q4;2015-12-31;2016-02-26;101900000;106600000;149800000;400300000;1271600000;1867600000;2928200000;;955900000;3884100000;5751700000;682600000;3900000;686500000;1491800000;2868700000;3555200000;1172700000;-21300000;1945900000;2196500000;5751700000
ATI;442346;USD;2014;Q4;2014-12-31;2015-02-26;102885713;106300000;269500000;603600000;1472800000;2482100000;2961800000;;1127800000;4089600000;6571700000;879900000;17800000;897700000;1498200000;2952600000;3850300000;1175200000;-44300000;2398900000;2721400000;6571700000
ATI;442346;USD;2013;Q4;2013-12-31;2014-02-27;103603473;106100000;1026800000;528200000;1322100000;2950800000;2874100000;;1073600000;3947700000;6898500000;787600000;419900000;1211000000;1527400000;2692800000;3903800000;1196900000;-79600000;2490100000;2994700000;6898500000
ATI;442346;USD;2012;Q4;2012-12-31;2013-02-28;103342102;116700000;304600000;613300000;1536600000;2510600000;2559900000;;1177300000;3737200000;6247800000;830400000;17100000;871500000;1463000000;2789200000;3660700000;1192700000;-111300000;2427600000;2587100000;6247800000
ATI;442346;USD;2011;Q4;2011-12-31;2012-02-27;101485233;116700000;380600000;709100000;1384300000;2569500000;2368800000;;1108600000;3477400000;6046900000;811000000;27300000;861800000;1482000000;2613500000;3475300000;1218100000;-162700000;2361500000;2571600000;6046900000
ATI;442346;USD;2010;Q4;2010-12-31;2011-02-28;94142790;89100000;432300000;545400000;1024500000;2115100000;1989300000;;389200000;2378500000;4493600000;644000000;141400000;791000000;921900000;1573200000;2364200000;669100000;-188000000;2224800000;2129400000;4493600000
ATI;442346;USD;2009;Q4;2009-12-31;2010-02-25;95095462;100800000;708800000;392000000;825500000;1997600000;1907900000;;440500000;2348400000;4346000000;567400000;33500000;624600000;1037600000;1631800000;2256400000;663800000;-208600000;2230500000;2089600000;4346000000
ATI;442346;USD;2008;Q4;2008-12-31;2009-08-27;;;469900000;530500000;887600000;1929400000;1633600000;;607400000;2241000000;4170400000;600500000;15200000;693900000;494600000;1447500000;2141400000;662000000;-244800000;2286700000;2029000000;4170400000
ATI;442346;USD;2017;Q4;2017-12-31;2018-02-20;117500000;76200000;141600000;545300000;1176100000;1915700000;2495700000;;774000000;3269700000;5185400000;702500000;10100000;712600000;1530600000;2628300000;3340900000;1609000000;-26100000;1184300000;1844500000;5185400000
ATI;442346;USD;2018;Q4;2018-12-31;2019-02-28;125400000;146300000;382000000;527800000;1211100000;2246700000;2475000000;;780100000;3255100000;5501800000;758900000;6600000;836900000;1535500000;2673300000;3510200000;1628100000;-30600000;1422000000;1991600000;5501800000
SUPN;445197;USD;2015;Q4;2015-12-31;2015-11-09;48950730;55875876;62190000;25908000;12587000;105946000;3874000;55009000;23797000;82680000;188626000;56261000;;56934000;7085000;43685000;100619000;264004000;;-175509000;88007000;188626000
SUPN;445197;USD;2014;Q4;2014-12-31;2014-11-12;42957975;42642123;74336000;17270000;13441000;108726000;2448000;19816000;5794000;28058000;136784000;27980000;;28123000;26223000;67962000;96085000;230306000;;-189453000;40699000;136784000
SUPN;445197;USD;2013;Q4;2013-12-31;2013-11-13;34679293;34679293;82191000;5054000;7152000;97161000;2554000;8756000;2524000;13834000;110995000;18314000;;26400000;34393000;51131000;77531000;211992000;;-178528000;33464000;110995000
SUPN;445197;USD;2012;Q4;2012-12-31;2012-11-02;26805076;26805076;88508000;11000;1152000;91462000;1421000;;1106000;2527000;93989000;10666000;11809000;22983000;11088000;13436000;36419000;143882000;;-86255000;57570000;93989000
ABMD;445587;USD;2016;Q4;2017-03-31;2017-05-25;43581000;44104000;229948000;54055000;34931000;326958000;87777000;47143000;88536000;223456000;550414000;58323000;799000;69617000;15539000;28726000;98343000;566399000;-46763000;-46959000;452071000;550414000
ABMD;445587;USD;2015;Q4;2016-03-31;2016-05-26;42465000;45299000;212053000;42821000;26740000;288392000;23184000;1000000;111355000;135539000;423931000;37763000;;46541000;;8615000;55156000;509050000;-26660000;-99075000;368775000;423931000
ABMD;445587;USD;2014;Q4;2015-03-31;2015-05-28;41162000;46247000;131958000;31828000;16774000;185039000;9127000;13996000;130205000;153328000;338367000;32283000;;39319000;;7488000;46807000;465459000;-19347000;-137222000;291560000;338367000
ABMD;445587;USD;2013;Q4;2014-03-31;2014-05-28;39806000;44683000;76579000;24357000;13948000;117966000;6889000;41761000;38791000;87441000;205407000;25645000;;30411000;;6643000;37054000;436547000;-16554000;-250910000;168353000;205407000
ABMD;445587;USD;2012;Q4;2013-03-31;2013-05-28;38460000;40072000;76707000;22946000;14930000;116605000;6549000;11406000;35439000;53394000;169999000;22858000;;27056000;;5863000;32919000;415207000;-16129000;-258261000;137080000;169999000
ABMD;445587;USD;2011;Q4;2012-03-31;2012-06-04;38474000;42784000;77223000;20458000;11142000;110539000;6378000;;36994000;43372000;153911000;19390000;;22415000;;5199000;27614000;402164000;-827000;-273275000;126297000;153911000
ABMD;445587;USD;2010;Q4;2011-03-31;2011-08-05;37230000;37230000;60312000;15376000;7505000;84737000;6273000;;40578000;46851000;131588000;20361000;;22343000;;4502000;26845000;379595000;-827000;-274770000;104743000;131588000
ABMD;445587;USD;2017;Q4;2018-03-31;2018-05-24;44329000;46221000;362249000;70010000;50204000;494271000;117167000;37502000;137435000;292104000;786375000;69712000;;84682000;;12169000;96851000;620349000;-67078000;140457000;689524000;786375000
ABMD;445587;USD;2018;Q4;2019-03-31;2019-05-23;45091000;46146000;491698000;90809000;80942000;677197000;145005000;21718000;210426000;377149000;1054346000;89605000;;105998000;;11458000;117456000;690958000;-138852000;399473000;936890000;1054346000
ABTL;445589;USD;2017;Q4;2017-12-31;2018-03-15;12533262;12151342;25247000;25911000;;52963000;4311000;100000;35539000;39950000;92913000;16746000;0;16746000;9000000;9000000;25746000;356067000;;-288900000;67167000;92913000
ABTL;445589;USD;2016;Q4;2016-12-31;2016-11-03;10739336;18682388;38763000;33634000;;77967000;4430000;680000;82204000;87314000;165281000;22609000;6563000;29172000;16500000;16500000;45672000;350033000;;-230424000;119609000;165281000
ABTL;445589;USD;2015;Q4;2015-12-31;2015-11-05;10449298;20337013;23993000;28091000;;57002000;4296000;680000;91610000;96586000;153588000;18387000;5250000;23637000;21750000;21750000;45387000;342496000;;-234295000;108201000;153588000
ABTL;445589;USD;2014;Q4;2014-12-31;2014-11-05;8962253;17890297;20747000;18311000;;45367000;1904000;3880000;53598000;59382000;104749000;17180000;7250000;24430000;10750000;11061000;35491000;308199000;;-238941000;69258000;104749000
ABTL;445589;USD;2013;Q4;2013-12-31;2013-11-07;8911158;13668891;18930000;14178000;;37131000;1548000;2650000;46864000;51062000;88193000;12915000;0;12915000;9250000;10450000;23365000;307180000;;-242352000;64828000;88193000
ABTL;445589;USD;2012;Q4;2012-12-31;2012-11-08;8852529;7944316;15296000;10081000;;25881000;1593000;0;13293000;14886000;40767000;9214000;;9382000;5000000;5620000;15002000;306261000;;-280496000;25765000;40767000
ABTL;445589;USD;2011;Q4;2011-12-31;2011-11-10;9224417;9360667;11209000;10144000;;22324000;1629000;194000;14647000;16470000;38794000;8075000;;8291000;5000000;5607000;13898000;306779000;;-281883000;24896000;38794000
ABTL;445589;USD;2010;Q4;2010-12-31;2011-08-05;;;8819000;9067000;;19083000;1733000;1000000;16016000;18749000;37832000;8708000;;9272000;5000000;5457000;14729000;305402000;;-282299000;23103000;37832000
ABTL;445589;USD;2018;Q4;2018-12-31;2019-03-07;12894883;12894883;13600000;26898000;;41743000;3181000;;12492000;15673000;57416000;22901000;1000000;23901000;;0;23901000;361231000;;-327716000;33515000;57416000
ACAD;445591;USD;2018;Q4;2018-12-31;2019-02-27;131686000;131686000;473520000;26090000;4070000;526106000;3309000;;10787000;14096000;540202000;59565000;;59565000;;1558000;61123000;1948314000;;-1468863000;479079000;540202000
ACAD;445591;USD;2017;Q4;2017-12-31;2018-02-27;124143000;124143000;341342000;17343000;5248000;373477000;2662000;;8367000;11029000;384506000;49030000;;49030000;;191000;49221000;1559355000;;-1223671000;335285000;384506000
ACAD;445591;USD;2016;Q4;2016-12-31;2017-02-28;121281000;121281000;529036000;5903000;4175000;547897000;3081000;;10175000;13256000;561153000;39941000;;42585000;;157000;42742000;1452284000;;-933979000;518411000;561153000
ACAD;445591;USD;2015;Q4;2015-12-31;2016-02-29;101218000;101218000;215132000;;;218989000;2203000;;704000;2907000;221896000;21902000;;21902000;;232000;22134000;862337000;;-662586000;199762000;221896000
ACAD;445591;USD;2014;Q4;2014-12-31;2015-02-26;97479000;97479000;322486000;;;324618000;553000;;287000;840000;325458000;15834000;;15834000;;135000;15969000;807641000;;-498143000;309489000;325458000
ACAD;445591;USD;2013;Q4;2013-12-31;2014-02-27;91198000;91198000;185790000;;;188360000;579000;;179000;758000;189118000;6924000;;6979000;;8000;6987000;587751000;;-405668000;182131000;189118000
ACAD;445591;USD;2012;Q4;2012-12-31;2013-03-12;60689000;60689000;107967000;;;108548000;42000;;;42000;108590000;5514000;;5948000;;17658000;23606000;452700000;;-367720000;84984000;108590000
ACAD;445591;USD;2011;Q4;2011-12-31;2012-03-06;52843000;52843000;31048000;;;31949000;151000;;14000;165000;32114000;5464000;32000;6165000;;2587000;8752000;370224000;;-346871000;23362000;32114000
ACAD;445591;USD;2010;Q4;2010-12-31;2011-08-10;;;37087000;;;37849000;426000;;119000;545000;38394000;5191000;78000;5959000;;2747000;8706000;353282000;;-324106000;29688000;38394000
ACGL;445596;USD;2016;Q4;2016-12-31;2017-03-01;363606903;375228681;15399565000;58284000;;16344897000;;5145443000;7881769000;13027212000;29372109000;76183000;;11845957000;4506751000;8215027000;20060984000;532269000;-2034570000;7996701000;9311125000;29372109000
ACGL;445596;USD;2015;Q4;2015-12-31;2016-02-26;361945824;374420175;12218988000;45505000;;12741035000;;4172024000;6225872000;10397896000;23138931000;64996000;;10413306000;3032156000;5615070000;16028376000;467916000;-1941904000;7332032000;7110555000;23138931000
ACGL;445596;USD;2014;Q4;2014-12-31;2015-02-27;380447802;391080066;12691880000;78170000;;12888667000;;3121093000;5996321000;9117414000;22006081000;128413000;;10051993000;2419645000;4835442000;14887435000;383645000;-1562019000;6854571000;7118646000;22006081000
ACGL;445596;USD;2013;Q4;2013-12-31;2014-03-03;394923288;407447943;11981024000;50555000;;12199011000;;2069264000;5297819000;7367083000;19566094000;51318000;;9861820000;2160413000;4056778000;13918598000;300082000;-1094704000;6042154000;5647496000;19566094000
ACGL;445596;USD;2012;Q4;2012-12-31;2013-03-01;402700560;414935436;11245899000;19248000;;11379426000;;1824699000;4612637000;6437336000;17816762000;37788000;;9545632000;1454274000;3102252000;12647884000;228339000;-1025839000;5354361000;5168878000;17816762000
ACGL;445596;USD;2011;Q4;2011-12-31;2012-02-29;397786557;412745292;10931106000;462891000;;11513155000;;1429616000;4162586000;5592202000;17105357000;480230000;;9508828000;1592583000;3004455000;12513283000;161968000;-845472000;4796655000;4592074000;17105357000
ACGL;445596;USD;2010;Q4;2010-12-31;2011-02-28;429322563;451131633;10546634000;56145000;;10747276000;;1481069000;4050883000;5531952000;16279228000;200192000;;8877382000;1518768000;2888843000;11766225000;110859000;-549912000;4422553000;4513003000;16279228000
ACGL;445596;USD;2009;Q4;2009-12-31;2010-08-05;516204108;539440596;10334609000;187171000;;10799452000;;990503000;3585835000;4576338000;15375790000;136381000;;8845045000;774065000;2207396000;11052441000;254014000;;3605809000;4323349000;15375790000
ACGL;445596;USD;2017;Q4;2017-12-31;2018-02-28;406332330;431606793;16447048000;205536000;;17242332000;;5987465000;8821861000;14809326000;32051658000;449186000;;13092300000;4850926000;8713423000;21805723000;1231228000;-2077741000;8562889000;10245935000;32051658000
ACGL;445596;USD;2018;Q4;2018-12-31;2019-02-28;402111243;408899691;15345566000;36246000;;16109485000;;6701637000;9407207000;16108844000;32218329000;90034000;;13128956000;4661428000;8651694000;21780650000;1794415000;-2382167000;9426299000;10437679000;32218329000
ACHC;445598;USD;2017;Q4;2017-12-31;2018-02-27;87059000;87080000;67290000;296925000;;471550000;3048130000;;2904822000;5952952000;6424502000;342559000;34830000;377389000;3205058000;3451825000;3829214000;2518416000;;428573000;2595288000;6424502000
ACHC;445598;USD;2016;Q4;2016-12-31;2016-11-02;86690000;86974000;57063000;263327000;;427927000;2703695000;;2893104000;5596799000;6024726000;308060000;34805000;342865000;3253004000;3496383000;3839248000;2497155000;;220139000;2185478000;6024726000
ACHC;445598;USD;2015;Q4;2015-12-31;2015-11-04;70850000;70825000;11215000;216626000;;294736000;1709053000;;2275419000;3984472000;4279208000;244843000;45360000;290203000;2195384000;2297922000;2588125000;1573679000;;213996000;1691083000;4279208000
ACHC;445598;USD;2014;Q4;2014-12-31;2014-10-30;59341000;59594000;94040000;118378000;;274143000;1069700000;;863112000;1932812000;2206955000;138969000;26965000;165934000;1052670000;1160056000;1325990000;847893000;;101442000;880965000;2206955000
ACHC;445598;USD;2013;Q4;2013-12-31;2013-10-30;50056000;50169000;4569000;95885000;;145126000;370109000;;709424000;1079533000;1224659000;99495000;15195000;114690000;601941000;629259000;743949000;462308000;;18402000;480710000;1224659000
ACHC;445598;USD;2012;Q4;2012-12-31;2012-11-08;43524000;43765000;49399000;63870000;;140981000;236942000;;605490000;842432000;983413000;64171000;7680000;71851000;465638000;479012000;550863000;456727000;;-24177000;432550000;983413000
ACHC;445598;USD;2011;Q4;2011-12-31;2011-11-14;22129000;22129000;61118000;35127000;;112605000;82972000;;217419000;300391000;412996000;33918000;6750000;40668000;270709000;275963000;316631000;140945000;;-44580000;96365000;412996000
ACHC;445598;USD;2010;Q4;2010-12-31;2011-11-14;17632652;17632652;8614000;5469000;;16924000;18752000;;9719000;28471000;45395000;8075000;9984000;18059000;;27336000;45395000;;;;0;45395000
ACHC;445598;USD;2018;Q4;2018-12-31;2019-03-01;87384000;86854000;50510000;318087000;;450417000;3107766000;;2614321000;5722087000;6172504000;382265000;34112000;416377000;3159375000;3394014000;3810391000;2542861000;;252823000;2362113000;6172504000
ACM;445606;USD;2018;Q4;2018-09-30;2018-11-13;158605000;164489000;642168000;5468821000;;7127322000;614062000;;6939747000;7553809000;14681131000;5032895000;143051000;6129677000;3483746000;4273080000;10402757000;3847962000;;948148000;4278374000;14681131000
ACM;445606;USD;2017;Q4;2017-09-30;2017-11-14;157412000;161040000;665871000;5127743000;;6682222000;621357000;;7093377000;7714734000;14396956000;4533567000;142000000;5578379000;3702109000;4603891000;10182270000;3735147000;;961640000;4214686000;14396956000
ACM;445606;USD;2016;Q4;2016-09-30;2016-11-16;156288000;159092000;588644000;4531460000;;6000771000;644992000;;7024173000;7669165000;13669936000;4306504000;366324000;5304756000;3702157000;4812691000;10117447000;3606058000;;618445000;3552489000;13669936000
ACM;445606;USD;2015;Q4;2015-09-30;2015-11-25;153720000;152020000;543016000;4841450000;;6246085000;699322000;;7068891000;7768213000;14014298000;4021764000;160411000;4836052000;4446527000;5547303000;10383355000;3520512000;;522336000;3630943000;14014298000
ACM;445606;USD;2014;Q4;2014-09-30;2014-11-17;98104000;99728000;521784000;2654976000;;3434113000;281979000;;2407285000;2689264000;6123377000;2011782000;64413000;2455769000;939565000;1395128000;3850897000;1865938000;;677181000;2272480000;6123377000
ACM;445606;USD;2013;Q4;2013-09-30;2013-11-13;97972000;99668000;450328000;2342262000;;3131602000;270672000;;2263349000;2534021000;5665623000;1646798000;84265000;2053549000;1089060000;1537980000;3591529000;1810587000;;472155000;2074094000;5665623000
ACM;445606;USD;2012;Q4;2012-09-30;2012-11-19;109900000;107800000;456983000;2395881000;;3147293000;325917000;;2191358000;2517275000;5664568000;1595515000;162591000;2078402000;907141000;1361678000;3440080000;1742548000;;606089000;2224488000;5664568000
ACM;445606;USD;2011;Q4;2011-09-30;2011-11-21;116384000;117080000;349868000;2380181000;;2990066000;323826000;;2475436000;2799262000;5789328000;1471801000;17746000;1814446000;1144723000;1579745000;3394191000;1700339000;;826946000;2395137000;5789328000
ACM;445606;USD;2010;Q4;2010-09-30;2010-11-22;115876000;116752000;570521000;2170188000;;2946499000;258784000;;2037626000;2296410000;5242909000;1493860000;16441000;1852260000;914686000;1252180000;3104440000;1586197000;;651105000;2138469000;5242909000
ACM;445606;USD;2009;Q4;2009-09-30;2010-08-06;111147000;112541000;263489000;1732959000;;2214535000;228835000;;1346511000;1575346000;3789881000;1143355000;29107000;1556739000;142102000;478737000;2035476000;1459435000;;414345000;1754405000;3789881000
AGNC;445654;USD;2016;Q4;2016-12-31;2017-02-27;331200000;331200000;1208000000;21000000;;55700000000;;;1180000000;1180000000;56880000000;277000000;;46027000000;460000000;3497000000;49524000000;9935000000;;-2518000000;7356000000;56880000000
AGNC;445654;USD;2015;Q4;2015-12-31;2016-02-23;341700000;341700000;1143000000;0;;56635000000;;;386000000;386000000;57021000000;317000000;;44702000000;595000000;4348000000;49050000000;10051000000;;-2350000000;7971000000;57021000000
AGNC;445654;USD;2017;Q4;2017-12-31;2018-02-26;392300000;392300000;1075000000;0;;69433000000;;;943000000;943000000;70376000000;474000000;;61265000000;357000000;357000000;61622000000;11177000000;;-2562000000;8754000000;70376000000
AGNC;445654;USD;2018;Q4;2018-12-31;2019-02-22;505900000;506200000;921000000;489000000;;108155000000;;;1086000000;1086000000;109241000000;1828000000;;99060000000;275000000;275000000;99335000000;13798000000;;-3433000000;9906000000;109241000000
ALGN;445691;USD;2016;Q4;2016-12-31;2017-02-28;79665000;81869000;640256000;247415000;27131000;952978000;175167000;104844000;163162000;443173000;1396151000;162928000;;354335000;;46427000;400762000;864879000;;131448000;995389000;1396151000
ALGN;445691;USD;2015;Q4;2015-12-31;2016-02-25;79468000;81774000;527295000;158550000;19465000;732010000;136473000;151370000;138780000;426623000;1158633000;142119000;;271672000;;39035000;310707000;821515000;;27391000;847926000;1158633000
ALGN;445691;USD;2014;Q4;2014-12-31;2015-02-26;80240000;81960000;454658000;129751000;15928000;657160000;90125000;147892000;92820000;330837000;987997000;111127000;;201811000;;33415000;235226000;783418000;;-30507000;752771000;987997000
ALGN;445691;USD;2013;Q4;2013-12-31;2014-02-28;80413000;85111000;369993000;113250000;13968000;544676000;75743000;101978000;109750000;287471000;832147000;98063000;;175338000;;22839000;198177000;729586000;;-95910000;633970000;832147000
ALGN;445691;USD;2012;Q4;2012-12-31;2013-03-01;81060000;85913000;334871000;98992000;15122000;485793000;79191000;21252000;170076000;270519000;756312000;93796000;;155771000;;19224000;174995000;670740000;;-89626000;581317000;756312000
ALGN;445691;USD;2011;Q4;2011-12-31;2012-02-29;78765000;81228000;248070000;91537000;9402000;384816000;53965000;0;210483000;264448000;649264000;95865000;;148117000;;10366000;158483000;607248000;;-116513000;490781000;649264000
ALGN;445691;USD;2010;Q4;2010-12-31;2011-02-24;76350000;79007000;303279000;65430000;2544000;388611000;30684000;9089000;48559000;88332000;476943000;59126000;;92974000;;6222000;99196000;555859000;;-178246000;377747000;476943000
ALGN;445691;USD;2009;Q4;2009-12-31;2010-08-05;74542000;74542000;186465000;54537000;2046000;261299000;24971000;0;68970000;93941000;355240000;48944000;;81243000;;961000;82204000;525080000;;-252499000;273036000;355240000
ALGN;445691;USD;2017;Q4;2017-12-31;2018-02-28;80085000;82374000;721542000;324189000;31688000;1158367000;348793000;94554000;182295000;625642000;1784009000;232338000;;500051000;;129670000;629721000;886443000;;267274000;1154288000;1784009000
ALGN;445691;USD;2018;Q4;2018-12-31;2019-02-28;79893000;80970000;735359000;439009000;55641000;1302479000;521329000;55025000;173625000;749979000;2052458000;298935000;;692073000;;107494000;799567000;877522000;;378143000;1252891000;2052458000
ALKS;445699;USD;2018;Q4;2018-12-31;2019-02-15;155520000;155520000;539295000;292223000;90196000;983252000;309987000;80744000;451024000;841755000;1825007000;333762000;2843000;339774000;276465000;313948000;653722000;2468902000;-108969000;-1185368000;1171285000;1825007000
ALKS;445699;USD;2017;Q4;2017-12-31;2018-02-16;153880000;153880000;433504000;233590000;93275000;808844000;284736000;157212000;546435000;988383000;1797227000;286166000;3000000;291122000;278436000;303297000;594419000;2340312000;-89347000;-1044365000;1202808000;1797227000
ALKS;445699;USD;2016;Q4;2016-12-31;2016-11-02;152158000;152158000;497234000;191102000;62998000;790678000;264785000;121931000;549029000;935745000;1726423000;207055000;3000000;211993000;280666000;304949000;516942000;2233336000;-72639000;-947942000;1209481000;1726423000
ALKS;445699;USD;2015;Q4;2015-12-31;2015-10-29;150356000;150356000;534778000;155487000;38411000;754962000;254819000;264071000;581892000;1100782000;1855744000;168735000;65737000;236207000;284207000;305262000;541469000;2116229000;-58661000;-739498000;1314275000;1855744000
ALKS;445699;USD;2014;Q4;2014-12-31;2014-10-29;146929000;137542000;631166000;151551000;51357000;876793000;265740000;170480000;606045000;1042265000;1919058000;121258000;6750000;130582000;349006000;391639000;522221000;1944360000;-32052000;-512335000;1396837000;1919058000
ALKS;445699;USD;2013;Q4;2013-12-31;2013-01-31;137208000;156896000;362231000;134154000;46218000;570138000;274490000;87764000;645196000;1007450000;1577588000;91173000;6750000;100897000;357543000;411505000;512402000;1554719000;-17833000;-482274000;1065186000;1577588000
ALKS;445699;USD;2012;Q4;2012-12-31;2012-02-02;130015000;130015000;190447000;96381000;39759000;339153000;302995000;55691000;737378000;1096064000;1435217000;79154000;3100000;89164000;441360000;492201000;581365000;1382042000;-571000;-524906000;853852000;1435217000
ALKS;445699;USD;2011;Q4;2011-12-31;2011-11-03;95934000;;201322000;22969000;20425000;252960000;95020000;93408000;11060000;199488000;452448000;44934000;;48057000;;12373000;60430000;937354000;-131095000;-411228000;392018000;452448000
ALSN;445706;USD;2017;Q4;2017-12-31;2018-02-15;141100000;142200000;199000000;221000000;154000000;632000000;448000000;;3125000000;3573000000;4205000000;159000000;12000000;417000000;2534000000;3099000000;3516000000;1759000000;;-1055000000;689000000;4205000000
ALSN;445706;USD;2016;Q4;2016-12-31;2017-02-24;164800000;165800000;205000000;197000000;126000000;548000000;464000000;;3207000000;3671000000;4219000000;128000000;12000000;342000000;2147000000;2796000000;3138000000;1730000000;;-586000000;1081000000;4219000000
ALSN;445706;USD;2015;Q4;2015-12-31;2016-02-19;171100000;171800000;251600000;195000000;141400000;616800000;479700000;;3311900000;3791600000;4408400000;126200000;24500000;304600000;2352700000;2915200000;3219800000;1691900000;;-444500000;1188600000;4408400000
ALSN;445706;USD;2014;Q4;2014-12-31;2015-02-20;179400000;180800000;263000000;207400000;143500000;638300000;514600000;;3503300000;4017900000;4656200000;151700000;17900000;345900000;2473300000;2912500000;3258400000;1652800000;;-215500000;1397800000;4656200000
ALSN;445706;USD;2013;Q4;2013-12-31;2014-02-24;183000000;185900000;184700000;175100000;160400000;606900000;563400000;;3642300000;4205700000;4812600000;150400000;17900000;387200000;2660400000;2986600000;3373800000;1633800000;;-173800000;1439000000;4812800000
ALSN;445706;USD;2012;Q4;2012-12-31;2013-02-28;183300000;186700000;80200000;165000000;157100000;490300000;596200000;;3779500000;4375700000;4866000000;133100000;19500000;377800000;2801300000;3131300000;3509100000;1603500000;-200000;-202300000;1357100000;4866200000
ALSN;445706;USD;2011;Q4;2011-12-31;2012-04-26;181400000;189000000;314000000;194700000;155900000;702700000;581800000;;3908100000;4489900000;5192600000;162600000;33600000;449900000;3345000000;3921000000;4370900000;1562800000;-200000;-683700000;821900000;5192800000
ALSN;445706;USD;2018;Q4;2018-12-31;2019-02-26;129000000;130000000;231000000;279000000;170000000;725000000;466000000;;3046000000;3512000000;4237000000;169000000;0;426000000;2523000000;3152000000;3578000000;1789000000;;-1100000000;659000000;4237000000
AMCX;445716;USD;2016;Q4;2016-12-31;2017-02-24;70169000;70926000;481389000;700655000;;1696343000;166636000;;2617616000;2784252000;4480595000;373106000;527429000;954178000;2632545000;3308730000;4262908000;143537000;-275230000;295409000;217687000;4480595000
AMCX;445716;USD;2015;Q4;2015-12-31;2016-02-25;72524000;73440000;316321000;674611000;;1521140000;163860000;;2565609000;2729469000;4250609000;325180000;441458000;830867000;2549587000;3216689000;4047556000;123893000;-51993000;24880000;203053000;4250609000
AMCX;445716;USD;2014;Q4;2014-12-31;2015-02-26;72107000;72965000;201367000;587193000;;1329080000;133844000;;2486902000;2620746000;3949826000;306652000;348152000;731692000;2686191000;3365432000;4097124000;101375000;-51993000;-341889000;-147298000;3949826000
AMCX;445716;USD;2013;Q4;2013-12-31;2014-02-27;71664000;72867000;250000000;378831000;;1304658000;71068000;;1260963000;1332031000;2636689000;179416000;211908000;414753000;2169570000;2793187000;3207940000;65463000;-29801000;-602686000;-571251000;2636689000
AMCX;445716;USD;2012;Q4;2012-12-31;2013-02-26;70640000;72366000;610970000;299792000;;1346527000;70890000;;1178802000;1249692000;2596219000;291539000;159142000;812851000;2167419000;2665720000;3478571000;37184000;-17666000;-893424000;-882352000;2596219000
AMCX;445716;USD;2011;Q4;2011-12-31;2012-03-15;69526000;72334000;215836000;286810000;;869999000;63814000;;1250121000;1313935000;2183934000;130150000;153603000;344196000;2299693000;2876733000;3220929000;6663000;-1677000;-1029954000;-1036995000;2183934000
AMCX;445716;USD;2010;Q4;2010-12-31;2011-09-02;69161000;69161000;79960000;242699000;;566440000;68977000;;1218479000;1287456000;1853896000;114925000;170765000;336491000;1064300000;1492574000;1829065000;181724000;0;-156893000;24831000;1853896000
AMCX;445716;USD;2017;Q4;2017-12-31;2018-03-01;61693000;62500000;558783000;775891000;;1879850000;183514000;;2969621000;3153135000;5032985000;365273000;332396000;744102000;3125534000;3906334000;4650436000;192045000;-709440000;766725000;382549000;5032985000
AMCX;445716;USD;2018;Q4;2018-12-31;2019-03-01;56664000;57903000;554886000;835977000;;1963411000;246262000;;3068890000;3315152000;5278563000;371984000;370013000;797421000;3109648000;3836376000;4633797000;240515000;-992583000;1228942000;644766000;5278563000
AMH;445723;USD;2017;Q4;2017-12-31;2018-02-23;286959735;264573988;46156000;;;212967000;8029177000;35803000;330821000;8395801000;8608768000;271726000;1977308000;2249034000;449720000;483910000;2732944000;5603123000;;-453953000;5875824000;8608768000
AMH;445723;USD;2016;Q4;2016-12-31;2017-02-24;240000194;240000194;118799000;;;267859000;7460426000;87430000;291495000;7839351000;8107210000;227034000;2442863000;2669897000;429883000;499693000;3169590000;4571049000;;-378578000;4937620000;8107210000
AMH;445723;USD;2015;Q4;2015-12-31;2016-02-26;208017185;208017185;57686000;;;182904000;6282506000;7432000;278377000;6568315000;6751219000;205503000;2473643000;2679146000;69957000;136840000;2815986000;3556141000;;-296865000;3935233000;6751219000
AMH;445723;USD;2014;Q4;2014-12-31;2015-03-02;211827406;211827406;108787000;;;196994000;5706853000;3818000;319686000;6030357000;6227351000;201350000;1519390000;1720740000;279057000;337017000;2057757000;3620321000;;-170162000;4169594000;6227351000
AMH;445723;USD;2013;Q4;2013-12-31;2014-03-26;187437506;187437506;148989000;;;182282000;3854853000;6569000;180440000;4041862000;4224144000;103397000;;103397000;441938000;470088000;573485000;2998332000;;-63479000;3650659000;4224144000
AMH;445723;USD;2012;Q4;2012-12-31;2013-09-19;18997047;18997047;397198000;;;403784000;505713000;;11961000;517674000;921458000;11282000;;11282000;0;5012000;16294000;914952000;;-10278000;905164000;921458000
AOS;445771;USD;2017;Q4;2017-12-31;2018-02-16;171845200;173755645;820000000;592700000;297000000;1766900000;528900000;;901600000;1430500000;3197400000;741800000;7500000;793800000;402900000;758700000;1552500000;782200000;-626500000;1788700000;1644900000;3197400000
AOS;445771;USD;2016;Q4;2016-12-31;2017-02-17;-878181961;-888485026;754600000;518700000;251100000;1562000000;461900000;;867100000;1329000000;2891000000;713900000;7200000;765600000;316400000;610100000;1375700000;773600000;-488100000;1593000000;1515300000;2891000000
AOS;445771;USD;2015;Q4;2015-12-31;2016-02-17;1418068472;1429221968;645200000;501400000;222900000;1403300000;442700000;;783200000;1225900000;2629200000;596600000;12900000;653200000;236100000;533700000;1186900000;765500000;-360500000;1350700000;1442300000;2629200000
AOS;445771;USD;2014;Q4;2014-12-31;2015-02-17;357954060;360879464;541900000;475400000;208300000;1319000000;427700000;;768600000;1196300000;2515300000;549200000;13700000;605200000;210100000;528800000;1134000000;748300000;-230500000;1135500000;1381300000;2515300000
AOS;445771;USD;2013;Q4;2013-12-31;2014-02-20;-5344004;-4716276;486000000;458700000;193400000;1205600000;391300000;;794600000;1185900000;2391500000;530000000;14200000;590900000;177700000;471900000;1062800000;738200000;-132600000;982200000;1328700000;2391500000
AOS;445771;USD;2012;Q4;2012-12-31;2013-02-27;739480144;745357360;462900000;425400000;163400000;1114600000;345700000;;818500000;1164200000;2278800000;444500000;18600000;506300000;225100000;578400000;1084700000;729200000;-69600000;855100000;1194200000;2278900000
AOS;445771;USD;2011;Q4;2011-12-31;2012-02-27;1844328240;1862139624;625800000;368400000;168400000;1208700000;315300000;;825000000;1140300000;2349000000;418500000;18600000;512300000;443000000;750900000;1263200000;729200000;-72400000;729900000;1085800000;2349000000
AOS;445771;USD;2010;Q4;2010-12-31;2011-02-24;366521392;370936120;118900000;313300000;146800000;896000000;258400000;;956200000;1214600000;2110600000;359200000;18600000;536800000;242400000;692400000;1229200000;733300000;-74600000;452100000;881400000;2110600000
AOS;445771;USD;2009;Q4;2009-12-31;2010-08-04;;;76300000;275600000;110500000;740000000;249000000;;985500000;1234500000;1974500000;335500000;21100000;491300000;232100000;693400000;1184700000;716100000;-79900000;365400000;789800000;1974500000
AOS;445771;USD;2018;Q4;2018-12-31;2019-02-15;169253885;170610714;645000000;647300000;304700000;1638500000;540000000;;893000000;1433000000;3071500000;743600000;;785300000;221400000;569200000;1354500000;792200000;-827200000;2102800000;1717000000;3071500000
ARE;445788;USD;2016;Q4;2016-12-31;2017-01-31;80858000;80107000;125032000;9744000;;151110000;9077972000;342477000;783329000;10203778000;10354888000;808585000;1011292000;1819877000;3152733000;3152733000;4972610000;4673527000;;;5382278000;10354888000
ARE;445788;USD;2015;Q4;2015-12-31;2016-02-03;71838000;71838000;125098000;10485000;;164455000;7629922000;353465000;733175000;8716562000;8881017000;651361000;809818000;1461179000;3125874000;3125874000;4587053000;3558733000;;;4293964000;8881017000
ARE;445788;USD;2014;Q4;2014-12-31;2015-02-24;71286000;71286000;86011000;10548000;;123443000;7108610000;236389000;667594000;8012593000;8136036000;547899000;652209000;1200108000;3026370000;3026370000;4226478000;3461904000;;;3909558000;8136036000
ARE;445788;USD;2013;Q4;2013-12-31;2014-03-03;71118000;71118000;57696000;9918000;;95323000;6776914000;140288000;517239000;7434441000;7529764000;489762000;708831000;1198593000;2352230000;2352230000;3550823000;3572993000;;;3978941000;7529764000
ARE;445788;USD;2012;Q4;2012-12-31;2013-02-26;124706530;124705369;140971000;8449000;;189367000;6424578000;115048000;421123000;6960749000;7150116000;465109000;716144000;1181253000;2465805000;2465805000;3647058000;3086684000;;;3503058000;7150116000
ARE;445788;USD;2011;Q4;2011-12-31;2012-02-21;-54831828714;-54851260091;78539000;7480000;;109351000;6008440000;95777000;360561000;6464778000;6574129000;361972000;724305000;1086277000;2054959000;2054959000;3141236000;3029174000;;;3432893000;6574129000
ARE;445788;USD;2010;Q4;2010-12-31;2011-03-01;54936972;54959797;91232000;5492000;;125078000;5444814000;83899000;252070000;5780783000;5905861000;335371000;790869000;1126240000;1793293000;1793293000;2919533000;2566788000;;734000;2986328000;5905861000
ARE;445788;USD;2009;Q4;2009-12-31;2010-08-04;;;70628000;3902000;;121821000;5039128000;72882000;223396000;5335406000;5457227000;304202000;937017000;2467219000;583929000;583929000;3051148000;1977500000;;;2406079000;5457227000
ARE;445788;USD;2017;Q4;2017-12-31;2018-01-30;95224000;96011000;254381000;10262000;;287448000;10298019000;523254000;995232000;11816505000;12103953000;855977000;771061000;1627038000;3993746000;3993746000;5620784000;5825256000;;;6483169000;12103953000
ARE;445788;USD;2018;Q4;2018-12-31;2019-02-05;106125000;105538000;234181000;9798000;;281928000;11913693000;892264000;1377071000;14183028000;14464956000;1091987000;630547000;1722534000;4847708000;4847708000;6570242000;7288064000;;;7894714000;14464956000
ARRS;445801;USD;2014;Q4;2014-12-31;2015-02-27;145308000;3844000;692538000;598603000;401165000;1916306000;366431000;77640000;2005268000;2449339000;4365645000;678801000;73956000;1009870000;1467370000;1665014000;2674884000;1741496000;-306330000;266642000;1690761000;4365645000
ARRS;445801;USD;2013;Q4;2013-12-31;2014-03-03;139666000;276017000;509798000;619571000;330129000;1678044000;396152000;71176000;2176635000;2643963000;4322007000;774425000;53254000;1095028000;1691034000;1907992000;3003020000;1690548000;-306330000;-60569000;1318987000;4322007000
ARRS;445801;USD;2012;Q4;2012-12-31;2013-02-27;114018000;-339642000;530117000;188581000;133848000;919892000;54378000;86164000;345460000;486002000;1405894000;79227000;222124000;370721000;;74785000;445506000;1287063000;-306330000;-11809000;960388000;1405894000
ARRS;445801;USD;2011;Q4;2011-12-31;2012-02-29;117248000;354045000;518779000;152437000;115912000;859545000;61375000;71095000;368795000;501265000;1360810000;80785000;;157856000;209766000;286749000;444605000;1246564000;-254409000;-65268000;916205000;1360810000
ARRS;445801;USD;2010;Q4;2010-12-31;2011-02-25;122840000;377575000;620102000;125933000;101763000;921373000;56306000;31015000;415393000;502714000;1424087000;82459000;;132931000;202615000;282087000;415018000;1207566000;-145286000;-47606000;1009069000;1424087000
ARRS;445801;USD;2009;Q4;2009-12-31;2010-08-06;125721000;-370272000;625596000;143708000;95851000;942308000;57195000;20618000;455495000;533308000;1475616000;95180000;124000;188551000;211248000;295696000;484247000;1185260000;-75960000;-111734000;991369000;1475616000
ATO;445830;USD;2015;Q4;2015-09-30;2015-08-05;102241000;102241000;28653000;295160000;;626306000;7430580000;;1018186000;8448766000;9075072000;238942000;457927000;1154823000;2437515000;4725452000;5880275000;2231098000;;1073029000;3194797000;9075072000
ATO;445830;USD;2014;Q4;2014-09-30;2014-08-06;101247000;101250000;42258000;343400000;;775840000;6725906000;;1092958000;7818864000;8594704000;308086000;196695000;910650000;2455986000;4597822000;5508472000;2180653000;;917972000;3086232000;8594704000
ATO;445830;USD;2013;Q4;2013-09-30;2013-08-07;90640000;92493000;66199000;301992000;;677133000;6030655000;;1226480000;7257135000;7934268000;241611000;367984000;978486000;2455671000;4375373000;5353859000;1766264000;;775267000;2580409000;7934268000
ATO;445830;USD;2012;Q4;2012-09-30;2012-08-09;90208000;92827000;64239000;234526000;;827962000;5475604000;;1192109000;6667713000;7495675000;215229000;571060000;1275954000;1956305000;3860478000;5136432000;1745918000;;660932000;2359243000;7495675000
ATO;445830;USD;2011;Q4;2011-09-30;2011-08-04;90349000;91540000;131419000;273303000;;1010953000;5147918000;;1124000000;6271918000;7282871000;291205000;208830000;867598000;2206117000;4159852000;5027450000;1733386000;;570495000;2255421000;7282871000
ATO;445830;USD;2010;Q4;2010-09-30;2011-02-09;182149848;184094491;131952000;273207000;;875192000;4793075000;;1095524000;5888599000;6763791000;266208000;486231000;1166079000;1809551000;3419364000;4585443000;1714815000;;486905000;2178348000;6763791000
ATR;445832;USD;2017;Q4;2017-12-31;2018-02-26;62162000;64501000;712640000;510426000;337216000;1670073000;842077000;;625673000;1467750000;3137823000;461579000;66169000;527748000;1191146000;1298027000;1825775000;610138000;-346245000;1301147000;1312048000;3137823000
ATR;445832;USD;2016;Q4;2016-12-31;2016-11-04;62583000;64858000;466287000;433127000;296914000;1270170000;761228000;;575387000;1336615000;2606785000;369139000;173816000;542955000;772737000;889588000;1432543000;547342000;-250917000;1197234000;1174242000;2606785000
ATR;445832;USD;2015;Q4;2015-12-31;2015-11-05;62465000;64744000;519717000;391571000;294912000;1294994000;744452000;;397599000;1142051000;2437045000;354928000;56967000;411895000;760848000;875444000;1287339000;496129000;-270052000;1185681000;1149706000;2437045000
ATR;445832;USD;2014;Q4;2014-12-31;2014-11-06;64354000;66653000;399762000;406976000;311072000;1213938000;788644000;;434608000;1223252000;2437190000;352762000;251976000;604738000;588892000;728536000;1333274000;499564000;-1026117000;1740005000;1103916000;2437190000
ATR;445832;USD;2013;Q4;2013-12-31;2013-11-04;65693000;68444000;309861000;438221000;353159000;1198411000;840601000;;458750000;1299351000;2497762000;403051000;139770000;542821000;354814000;474633000;1017454000;494800000;-744213000;1619419000;1480308000;2497762000
ATR;445832;USD;2012;Q4;2012-12-31;2012-11-02;66251000;67684000;229755000;396788000;321885000;1038933000;824476000;;461003000;1285479000;2324412000;380669000;74654000;455323000;352860000;488591000;943914000;431050000;-625401000;1513558000;1380498000;2324412000
ATR;445832;USD;2011;Q4;2011-12-31;2011-11-02;65966000;69067000;377616000;389020000;285155000;1143950000;734482000;;280863000;1015345000;2159295000;335181000;183668000;518849000;254910000;349874000;868723000;365682000;-545612000;1409388000;1290572000;2159295000
ATR;445832;USD;2010;Q4;2010-12-31;2010-11-03;66957000;70127000;376427000;357110000;272255000;1063983000;706333000;;262402000;968735000;2032718000;327756000;95566000;423322000;258773000;329622000;752944000;319163000;-443019000;1279013000;1279774000;2032718000
ATR;445832;USD;2009;Q4;2009-12-31;2010-08-04;67499000;69770000;332964000;319787000;230807000;943491000;744867000;;267835000;1012702000;1956193000;288960000;128355000;417315000;209616000;285242000;702557000;273277000;-356548000;1150017000;1253636000;1956193000
ATR;445832;USD;2018;Q4;2018-12-31;2019-02-21;62840000;65439000;261823000;569630000;381110000;1330808000;966094000;;1080833000;2046927000;3377735000;525199000;163971000;689170000;1125993000;1265694000;1954864000;679442000;-318208000;1371826000;1422871000;3377735000
AZPN;445871;USD;2017;Q4;2017-06-30;2017-05-02;74335000;75027000;101954000;27670000;;146186000;13400000;;88356000;101756000;247942000;55219000;140000000;467243000;;41483000;508726000;697736000;-1116499000;156520000;-260784000;247942000
AZPN;445871;USD;2016;Q4;2016-06-30;2016-04-28;81296000;81840000;321342000;20476000;;361323000;15825000;;42590000;58415000;419738000;40103000;140000000;432623000;;62149000;494772000;669490000;-741499000;-5676000;-75034000;419738000
AZPN;445871;USD;2015;Q4;2015-06-30;2015-04-28;85112000;85849000;215446000;30721000;;263630000;18039000;3047000;30645000;51731000;315361000;45498000;0;296466000;;67441000;363907000;652044000;-561433000;-145627000;-48546000;315361000
AZPN;445871;USD;2014;Q4;2014-06-30;2014-04-29;91929000;92957000;267145000;38532000;;329682000;7588000;31270000;39432000;78290000;407972000;37564000;;266504000;;57792000;324296000;601427000;-263089000;-264034000;83676000;407972000
AZPN;445871;USD;2013;Q4;2013-06-30;2013-04-30;93674000;95107000;189447000;36988000;;285351000;7829000;35353000;54215000;97397000;382748000;37120000;;215461000;;65389000;280850000;585765000;-141313000;-349817000;101898000;382748000
AZPN;445871;USD;2012;Q4;2012-06-30;2012-05-01;93570000;91205000;165242000;31450000;;261463000;7037000;0;99835000;106872000;368335000;41153000;10756000;195719000;;59024000;254743000;557212000;-56636000;-395079000;113592000;368335000
AZPN;445871;USD;2011;Q4;2011-06-30;2011-11-01;94149000;103609000;149985000;27866000;;253863000;6730000;9291000;129910000;145931000;399794000;67238000;15756000;173675000;9157000;68316000;241991000;540490000;-10531000;-381271000;157803000;399794000
AZPN;445871;USD;2018;Q4;2018-06-30;2018-08-08;71366000;72516000;96165000;21910000;;131185000;9806000;;123933000;133739000;264924000;45443000;170000000;502288000;;46751000;549039000;725788000;-1316499000;305208000;-284115000;264924000
AZPN;445871;USD;2019;Q4;2019-06-30;2019-09-10;68861000;69825000;71926000;47784000;;429040000;7234000;;466791000;474025000;903065000;75437000;220000000;320755000;;189025000;509780000;749464000;-1616499000;1259984000;393285000;903065000
BG;445920;USD;2016;Q4;2016-12-31;2017-02-28;139467127;164000087;934000000;1676000000;4773000000;11092000000;5099000000;;2997000000;8096000000;19188000000;3485000000;1195000000;7684000000;3069000000;4161000000;11845000000;5144000000;-920000000;8208000000;7343000000;19188000000
BG;445920;USD;2015;Q4;2015-12-31;2016-02-25;142433851;158717003;411000000;1607000000;4466000000;10916000000;4736000000;;2262000000;6998000000;17914000000;2675000000;1517000000;7340000000;2926000000;3885000000;11225000000;5106000000;-720000000;7725000000;6689000000;17914000000
BG;445920;USD;2014;Q4;2014-12-31;2015-03-02;145334780;132196222;362000000;1840000000;5554000000;13081000000;5626000000;;2725000000;8351000000;21432000000;3248000000;1002000000;8704000000;2855000000;4001000000;12705000000;5054000000;-420000000;7180000000;8727000000;21432000000
BG;445920;USD;2013;Q4;2013-12-31;2014-02-28;147689831;149938403;742000000;2144000000;5796000000;17772000000;6075000000;;2934000000;9009000000;26781000000;3522000000;1465000000;12535000000;3179000000;4121000000;16656000000;4968000000;-120000000;6891000000;10125000000;26781000000
BG;445920;USD;2012;Q4;2012-12-31;2013-03-01;146234364;132837836;569000000;2471000000;6590000000;17264000000;5888000000;;4128000000;10016000000;27280000000;3319000000;2317000000;11561000000;3532000000;4426000000;15987000000;4910000000;-120000000;6792000000;11293000000;27280000000
BG;445920;USD;2011;Q4;2011-12-31;2012-02-27;145523625;161380138;835000000;2459000000;5733000000;15074000000;5517000000;;4630000000;10147000000;25221000000;3173000000;733000000;8893000000;3348000000;4253000000;13146000000;4830000000;-120000000;6917000000;12075000000;25221000000
BG;445920;USD;2010;Q4;2010-12-31;2011-12-22;141017623;176370686;578000000;2901000000;6635000000;15815000000;5312000000;;4874000000;10186000000;26001000000;3637000000;2330000000;10004000000;2551000000;3443000000;13447000000;4794000000;;6153000000;12554000000;26001000000
BG;445920;USD;2009;Q4;2009-12-31;2010-03-01;134235271;107833051;553000000;2363000000;4862000000;11783000000;5347000000;;4156000000;9503000000;21286000000;3275000000;197000000;6207000000;3618000000;4714000000;10921000000;3626000000;;3996000000;10365000000;21286000000
BG;445920;USD;2008;Q4;2008-12-31;2009-08-10;;;1004000000;2350000000;5653000000;13176000000;3969000000;;3085000000;7054000000;20230000000;4158000000;551000000;8074000000;3032000000;4028000000;12102000000;2850000000;;3844000000;8128000000;20230000000
BG;445920;USD;2017;Q4;2017-12-31;2018-02-23;140642265;141208049;601000000;1501000000;5074000000;10403000000;5310000000;;3158000000;8468000000;18871000000;3395000000;319000000;6215000000;4160000000;5299000000;11514000000;5227000000;-920000000;8081000000;7357000000;18871000000
BG;445920;USD;2018;Q4;2018-12-31;2019-02-22;141104566;135213630;389000000;1637000000;5871000000;11068000000;5201000000;;3156000000;8357000000;19425000000;3501000000;1169000000;7172000000;4203000000;5451000000;12623000000;5279000000;-920000000;8059000000;6802000000;19425000000
BLKB;445967;USD;2016;Q4;2016-12-31;2017-02-22;46318682;47544038;16902000;88932000;;507919000;50269000;;752022000;802291000;1310210000;77470000;4375000;680116000;338018000;382549000;1062665000;310510000;-215237000;152729000;247545000;1310210000
BLKB;445967;USD;2015;Q4;2015-12-31;2016-02-24;45769571;46827299;15362000;80046000;;399112000;52651000;;771573000;824224000;1223336000;76669000;4375000;566298000;403712000;446450000;1012748000;276397000;-199861000;134877000;210588000;1223336000
BLKB;445967;USD;2014;Q4;2014-12-31;2015-02-25;45380675;46102565;14735000;77523000;;287782000;49896000;;605505000;655401000;943183000;63637000;4375000;421004000;276196000;336263000;757267000;245730000;-190440000;131658000;185916000;943183000
BLKB;445967;USD;2013;Q4;2013-12-31;2014-02-26;44991860;45756406;11889000;66969000;;229769000;49550000;;427291000;476841000;706610000;50687000;17158000;356682000;135750000;188384000;545066000;220819000;-183288000;125398000;161544000;706610000
BLKB;445967;USD;2012;Q4;2012-12-31;2013-02-27;44351940;45323118;13491000;75692000;;213748000;49063000;;442936000;491999000;705747000;59619000;10000000;311695000;205500000;246368000;558063000;203693000;-170898000;116862000;147684000;705747000
BLKB;445967;USD;2011;Q4;2011-12-31;2012-02-29;43742535;44433602;52520000;62656000;;187948000;34397000;;170245000;204642000;392590000;46171000;0;240041000;0;12547000;252588000;175455000;-166226000;131921000;140002000;392590000
BLKB;445967;USD;2010;Q4;2010-12-31;2011-03-01;43137704;43778417;28004000;59296000;;140962000;22963000;;159881000;182844000;323806000;37898000;;198018000;;9319000;207337000;158425000;-161186000;120042000;116469000;323806000
BLKB;445967;USD;2009;Q4;2009-12-31;2010-08-06;42668198;43920106;22769000;50220000;;109746000;22507000;;171976000;194483000;304229000;36657000;1288000;180231000;;7892000;188123000;134778000;-134382000;115911000;116106000;304229000
BLKB;445967;USD;2017;Q4;2017-12-31;2018-02-20;46801809;48081631;29830000;95679000;;799367000;42243000;;956236000;998479000;1797846000;79092000;8576000;974611000;429648000;486946000;1461557000;351101000;-239199000;225029000;336289000;1797846000
BLKB;445967;USD;2018;Q4;2018-12-31;2019-02-20;47304825;47957701;30866000;86595000;;597982000;40031000;;977292000;1017323000;1615305000;81431000;7500000;805655000;379624000;435867000;1241522000;399300000;-266884000;246477000;373783000;1615305000
CAVM;446086;USD;2016;Q4;2016-12-31;2017-02-28;67018000;67018000;221439000;125728000;119692000;489118000;150862000;;1010551000;1161413000;1650531000;130423000;29400000;168235000;703292000;740452000;908687000;1079110000;;-336621000;741844000;1650531000
CAVM;446086;USD;2015;Q4;2015-12-31;2016-02-22;56148000;54510000;134646000;68742000;47009000;260628000;64677000;;108688000;173365000;433993000;36932000;20608000;63856000;9858000;16237000;80093000;543312000;;-189412000;353900000;433993000
CAVM;446086;USD;2014;Q4;2014-12-31;2015-03-02;54271000;50846000;131718000;48199000;51922000;240969000;56963000;;110928000;167891000;408860000;34229000;23002000;63516000;22894000;28661000;92177000;489035000;;-172352000;316683000;408860000
CAVM;446086;USD;2013;Q4;2013-12-31;2014-02-24;52118000;50398000;127763000;43636000;45768000;223658000;28494000;;115833000;144327000;367985000;33303000;30615000;72587000;16292000;20567000;93154000;443641000;;-157057000;274831000;367985000
CAVM;446086;USD;2012;Q4;2012-12-31;2013-02-28;50497000;50497000;76784000;33567000;46508000;164901000;30692000;;135911000;166603000;331504000;24763000;17512000;55219000;28832000;33223000;88442000;398184000;;-154092000;243062000;331504000
CAVM;446086;USD;2011;Q4;2011-12-31;2012-02-27;49033000;51430000;63225000;37839000;41719000;151564000;17027000;;191666000;208693000;360257000;22550000;6385000;40137000;719000;9427000;49564000;352153000;;-41460000;310693000;360257000
CAVM;446086;USD;2010;Q4;2010-12-31;2011-02-28;45843000;52880000;90673000;29912000;31556000;163617000;14162000;;113841000;128003000;291620000;22296000;8088000;45745000;2956000;11265000;57010000;276103000;;-41493000;234610000;291620000
CAVM;446086;USD;2009;Q4;2009-12-31;2010-07-30;41990000;41990000;58918000;21958000;17965000;101009000;14972000;;83814000;98786000;199795000;19228000;3271000;35112000;5741000;8310000;43422000;234990000;;-78617000;156373000;199795000
CAVM;446086;USD;2017;Q4;2017-12-31;2018-03-01;69062000;69062000;140498000;230143000;93674000;487109000;192515000;;909701000;1102216000;1589325000;130071000;34705000;174012000;608333000;636967000;810979000;1183888000;;-406352000;778346000;1589325000
CCK;446122;USD;2016;Q4;2016-12-31;2017-02-24;138820000;139440000;559000000;865000000;1245000000;2841000000;2820000000;;3938000000;6758000000;9599000000;2702000000;194000000;2896000000;4717000000;6035000000;8931000000;;;;668000000;9599000000
CCK;446122;USD;2015;Q4;2015-12-31;2016-02-29;138060000;139160000;717000000;912000000;1213000000;3049000000;2699000000;;4302000000;7001000000;10050000000;2645000000;263000000;2908000000;5255000000;6757000000;9665000000;1355000000;-232000000;2125000000;385000000;10050000000
CCK;446122;USD;2014;Q4;2014-12-31;2015-03-02;137520000;138960000;965000000;1031000000;1324000000;3619000000;2437000000;;3587000000;6024000000;9643000000;2651000000;250000000;2924000000;4944000000;6332000000;9256000000;1336000000;-234000000;1782000000;387000000;9643000000
CCK;446122;USD;2013;Q4;2013-12-31;2014-03-03;136300000;136900000;689000000;1064000000;1213000000;3180000000;2152000000;;2698000000;4850000000;8030000000;2547000000;373000000;2920000000;3469000000;4821000000;7741000000;1360000000;-238000000;1395000000;289000000;8030000000
CCK;446122;USD;2012;Q4;2012-12-31;2013-03-01;143100000;145300000;350000000;1057000000;1166000000;2750000000;2005000000;;2745000000;4750000000;7500000000;2146000000;376000000;2522000000;3289000000;4849000000;7371000000;1597000000;-214000000;1071000000;129000000;7500000000
CCK;446122;USD;2011;Q4;2011-12-31;2012-02-29;149800000;151100000;342000000;948000000;1148000000;2603000000;1751000000;;2514000000;4265000000;6868000000;2090000000;195000000;2285000000;3337000000;4822000000;7107000000;1792000000;-187000000;512000000;-239000000;6868000000
CCK;446122;USD;2010;Q4;2010-12-31;2011-02-28;156700000;161500000;463000000;936000000;1060000000;2649000000;1610000000;;2640000000;4250000000;6899000000;1978000000;399000000;2377000000;2649000000;4293000000;6670000000;2160000000;-153000000;230000000;229000000;6899000000
CCK;446122;USD;2009;Q4;2009-12-31;2010-08-06;159770668;162456242;459000000;714000000;960000000;2242000000;1509000000;;2781000000;4290000000;6532000000;1866000000;59000000;1925000000;2739000000;4224000000;6149000000;2465000000;-122000000;-94000000;383000000;6532000000
CCK;446122;USD;2017;Q4;2017-12-31;2018-02-26;133360000;133340000;424000000;1041000000;1385000000;3074000000;3239000000;;4350000000;7589000000;10663000000;3124000000;126000000;3250000000;5217000000;6490000000;9740000000;;;;923000000;10663000000
CCK;446122;USD;2018;Q4;2018-12-31;2019-02-28;133760000;134120000;607000000;1602000000;1690000000;4079000000;3745000000;;7438000000;11183000000;15262000000;3743000000;170000000;3913000000;8493000000;10063000000;13976000000;;;;1286000000;15262000000
COLM;446285;USD;2016;Q4;2016-12-31;2017-02-23;69836000;71749000;551861000;333678000;487997000;1412023000;279650000;;322221000;601871000;2013894000;362851000;;362851000;;69532000;432383000;53801000;;1529636000;1581511000;2013894000
COLM;446285;USD;2015;Q4;2015-12-31;2016-02-25;69891000;71668000;370399000;371953000;473637000;1249389000;291687000;;305077000;596764000;1846153000;364130000;1940000;366070000;;64270000;430340000;34776000;;1385860000;1415813000;1846153000
COLM;446285;USD;2014;Q4;2014-12-31;2015-02-26;69801000;71600000;440825000;344390000;384650000;1266041000;291563000;;234605000;526168000;1792209000;372951000;0;373120000;;63855000;436975000;72700000;;1255070000;1355234000;1792209000
COLM;446285;USD;2013;Q4;2013-12-31;2014-02-27;69080000;70626000;529244000;306878000;329228000;1250472000;279373000;;75743000;355116000;1605588000;301205000;;301254000;;51470000;352724000;52325000;;1157733000;1252864000;1605588000
COLM;446285;USD;2012;Q4;2012-12-31;2013-02-28;68006000;69280000;335442000;334324000;363325000;1122603000;260524000;;75715000;336239000;1458842000;251836000;156000;252059000;;40616000;292675000;24814000;;1094690000;1166167000;1458842000
COLM;446285;USD;2011;Q4;2011-12-31;2012-02-28;67256000;68790000;243912000;351538000;365199000;1049526000;250910000;;82106000;333016000;1382542000;266048000;0;267002000;;40995000;307997000;3037000;;1024611000;1074545000;1382542000
COLM;446285;USD;2010;Q4;2010-12-31;2011-08-05;67318000;68286000;303069000;300181000;314298000;990880000;221813000;;82061000;303874000;1294754000;249473000;;251626000;;41154000;292780000;5052000;;950207000;1001974000;1294754000
COLM;446285;USD;2017;Q4;2017-12-31;2018-02-22;69943000;71337000;768149000;364862000;457927000;1649497000;281394000;;282011000;563405000;2212902000;453636000;;453636000;;107007000;560643000;45829000;;1585009000;1652259000;2212902000
COMM;446289;USD;2016;Q4;2016-12-31;2017-02-23;193278000;197709000;428228000;952367000;473267000;1993764000;474990000;;4673232000;5148222000;7141986000;845318000;12500000;857818000;4549510000;4890084000;5747902000;2283964000;-15211000;-589556000;1394084000;7141986000
COMM;446289;USD;2015;Q4;2015-12-31;2016-02-19;191073000;182094000;562884000;833041000;441815000;2004640000;528706000;;4969285000;5497991000;7502631000;672572000;12520000;685092000;5231131000;5594819000;6279911000;2218125000;-11333000;-812394000;1222720000;7502631000
COMM;446289;USD;2014;Q4;2014-12-31;2015-02-20;187762000;192267000;729321000;612007000;367185000;1827618000;289371000;;2800069000;3089440000;4917058000;466812000;9001000;475813000;2659897000;3133626000;3609439000;2143321000;-10635000;-741519000;1307619000;4917058000
COMM;446289;USD;2013;Q4;2013-12-31;2014-02-20;177913000;182028000;346320000;607489000;372187000;1453423000;310143000;;2970489000;3280632000;4734055000;583919000;9462000;593381000;2505090000;3052658000;3646039000;2103218000;-10635000;-978291000;1088016000;4734055000
COMM;446289;USD;2012;Q4;2012-12-31;2013-12-03;154729000;157965000;264375000;596050000;311970000;1287257000;355212000;;3150795000;3506007000;4793264000;538843000;10776000;549619000;2459994000;3061363000;3610982000;1656937000;-10322000;-447687000;1182282000;4793264000
COMM;446289;USD;2017;Q4;2017-12-31;2018-02-15;190736000;195071000;453977000;898829000;444941000;1943859000;467289000;;4630518000;5097807000;7041666000;723717000;;723717000;4369401000;4670123000;5393840000;2336043000;-205616000;-395998000;1647826000;7041666000
COMM;446289;USD;2018;Q4;2018-12-31;2019-02-21;192341000;195324000;458200000;810400000;473300000;1877800000;450900000;;4301800000;4752700000;6630500000;690600000;;690600000;3985900000;4183100000;4873700000;2387100000;-221300000;-249800000;1756800000;6630500000
CPT;446323;USD;2016;Q4;2016-12-31;2017-02-13;89748000;89229000;337364000;;;369854000;5043742000;;614556000;5658298000;6028152000;256015000;2480588000;2855562000;;0;2855562000;3679255000;-373339000;;3172590000;6028152000
CPT;446323;USD;2015;Q4;2015-12-31;2016-02-19;89176000;87714000;10617000;;;41688000;5119985000;;875939000;5995924000;6037612000;242851000;2724687000;3065352000;;0;3065352000;3663840000;-386793000;;2972260000;6037612000
CPT;446323;USD;2014;Q4;2014-12-31;2015-02-20;88694000;86723000;153918000;;;212936000;5155058000;;675987000;5831045000;6043981000;256767000;2730613000;3087438000;;0;3087438000;3668424000;-396626000;;2956543000;6043981000
CPT;446323;USD;2013;Q4;2013-12-31;2014-02-21;87473000;89512000;17794000;;;52117000;4955902000;;624122000;5580024000;5632141000;205742000;2530766000;2824780000;;0;2824780000;3597036000;-410227000;;2807361000;5632141000
CPT;446323;USD;2012;Q4;2012-12-31;2013-02-15;86349000;89230000;26669000;;;96802000;4820555000;;467815000;5288370000;5385172000;180317000;2510468000;2758464000;;0;2758464000;3588467000;-425355000;;2626708000;5385172000
CPT;446323;USD;2011;Q4;2011-12-31;2012-02-17;73533000;74448000;55159000;;;102401000;4086871000;;432803000;4519674000;4622075000;154994000;2432112000;2696382000;;0;2696382000;2901869000;-452003000;;1925693000;4622075000
CPT;446323;USD;2010;Q4;2010-12-31;2011-02-24;70767000;69957000;170575000;3194000;;211177000;4147834000;;340726000;4488560000;4699737000;139189000;2563754000;2844439000;;0;2844439000;2776449000;-461255000;;1855298000;4699737000
CPT;446323;USD;2009;Q4;2009-12-31;2010-07-30;66175000;64699000;64156000;45847000;;149773000;4110989000;;347237000;4458226000;4607999000;130686000;2625199000;2901061000;-101000;-101000;2900960000;2526426000;-462188000;;1707039000;4607999000
CPT;446323;USD;2017;Q4;2017-12-31;2018-02-16;94955000;96037000;368492000;;;401843000;5171673000;;600232000;5771905000;6173748000;252639000;2204598000;2611804000;;0;2611804000;4138189000;-364066000;;3561944000;6173748000
CPT;446323;USD;2018;Q4;2018-12-31;2019-02-15;95265000;94664000;34378000;;;66523000;5631348000;;521715000;6153063000;6219586000;276206000;2321603000;2781808000;;0;2781808000;4155794000;-355804000;;3437778000;6219586000
CSL;446361;USD;2017;Q4;2017-12-31;2018-02-16;61761000;62419000;379600000;657700000;507900000;1644600000;780900000;;2874300000;3655200000;5299800000;630800000;;658600000;1586200000;2112900000;2771500000;432400000;-649600000;2820800000;2528300000;5299800000
CSL;446361;USD;2016;Q4;2016-12-31;2017-02-13;64287000;65191000;385300000;511600000;377000000;1355200000;632200000;;1978400000;2610600000;3965800000;490300000;;513500000;596400000;985400000;1498900000;414000000;-382600000;2547400000;2466900000;3965800000
CSL;446361;USD;2015;Q4;2015-12-31;2016-02-08;64520000;65315000;410700000;502500000;356000000;1319500000;585800000;;2045600000;2631400000;3950900000;432000000;149800000;605800000;595600000;997700000;1603500000;372100000;-327400000;2381800000;2347400000;3950900000
CSL;446361;USD;2014;Q4;2014-12-31;2015-02-10;64553000;65239000;730800000;439200000;339100000;1611500000;547300000;;1599900000;2147200000;3758700000;374300000;;392200000;749800000;1161500000;1553700000;326500000;-200100000;2134400000;2205000000;3758700000
CSL;446361;USD;2013;Q4;2013-12-31;2014-02-19;63655000;64920000;754500000;399600000;298800000;1535000000;497200000;;1460800000;1958000000;3493000000;359000000;;376400000;751000000;1130500000;1506900000;279800000;-209500000;1944300000;1986100000;3493000000
CSL;446361;USD;2012;Q4;2012-12-31;2013-02-12;63012000;63468000;112500000;408400000;325000000;1205300000;465200000;;1786800000;2252000000;3457300000;378500000;;470600000;752300000;1198600000;1669200000;250100000;-215400000;1788300000;1788100000;3457300000
CSL;446361;USD;2011;Q4;2011-12-31;2012-02-10;61646000;62695000;74700000;486400000;539000000;1214100000;560300000;;1363500000;1923800000;3137900000;422500000;158100000;596900000;604300000;1040900000;1637800000;198900000;-219900000;1566100000;1500100000;3137900000
CSL;446361;USD;2010;Q4;2010-12-31;2011-02-16;60949000;61451000;89400000;391000000;430500000;1016900000;533400000;;979200000;1512600000;2529500000;370300000;69000000;456400000;405100000;732400000;1188800000;171100000;-221600000;1429300000;1340700000;2529500000
CSL;446361;USD;2009;Q4;2009-12-31;2010-07-27;;;96300000;287100000;338300000;799800000;460900000;;653400000;1114300000;1914100000;276200000;;301100000;156100000;394400000;695500000;152600000;-223600000;1324300000;1218600000;1914100000
CSL;446361;USD;2018;Q4;2018-12-31;2019-02-14;59421000;59592000;803600000;698300000;457500000;2056700000;760100000;;2432400000;3192500000;5249200000;570100000;;595600000;1587800000;2056200000;2651800000;462500000;-1102400000;3351400000;2597400000;5249200000
DRE;446513;USD;2017;Q4;2017-12-31;2018-02-16;356214000;363261000;67562000;19427000;;216874000;6154543000;;1016779000;7171322000;7388196000;85285000;;390927000;2422891000;2422891000;2813818000;5208880000;;;4574378000;7388196000
DRE;446513;USD;2016;Q4;2016-12-31;2017-02-17;354783000;365216000;12639000;15838000;;74738000;4840748000;;1856516000;6697264000;6772002000;82745000;;370232000;2908477000;2908477000;3278709000;5195559000;;;3493293000;6772002000
DRE;446513;USD;2015;Q4;2015-12-31;2016-02-19;345277000;358824000;22533000;18846000;;57838000;5912672000;;925005000;6837677000;6895515000;167891000;;370573000;3320141000;3320141000;3690714000;4965376000;;;3204801000;6895515000
DRE;446513;USD;2014;Q4;2014-12-31;2015-02-20;343084000;347828000;17922000;26168000;;80314000;6203592000;;1470933000;7674525000;7754839000;194050000;;462320000;4412639000;4412639000;4874959000;4948241000;;;2879880000;7754839000
DRE;446513;USD;2013;Q4;2013-12-31;2014-02-21;326212000;335284000;19275000;26173000;;64657000;6791221000;;896736000;7687957000;7752614000;195015000;;453609000;4254376000;4254376000;4707985000;4624228000;;;3044629000;7752614000
DRE;446513;USD;2012;Q4;2012-12-31;2013-02-22;276198000;276198000;33889000;22283000;;95926000;6607953000;;856222000;7464175000;7560101000;238499000;;487813000;4446170000;4446170000;4933983000;3956291000;;;2626118000;7560101000
DRE;446513;USD;2011;Q4;2011-12-31;2012-02-24;252928000;274113000;213809000;22255000;;276311000;5892768000;;835358000;6728126000;7004437000;188350000;;415190000;3809589000;3809589000;4224779000;3597117000;;;2779658000;7004437000
DRE;446513;USD;2010;Q4;2010-12-31;2011-02-25;252579000;247062000;18384000;22588000;;48380000;6326334000;;1269562000;7595896000;7644276000;207470000;;447294000;4207079000;4207079000;4654373000;3576242000;;;2989903000;7644276000
DRE;446513;USD;2009;Q4;2009-12-31;2010-08-06;224264000;224264000;147322000;20604000;;186681000;6343528000;;774070000;7117598000;7304279000;196076000;;482387000;3854032000;3854032000;4336419000;3269436000;;;2967860000;7304279000
DRE;446513;USD;2018;Q4;2018-12-31;2019-02-22;358584000;368637000;17901000;14254000;;73370000;6852943000;;877711000;7730654000;7804024000;89511000;;432280000;2658501000;2658501000;3090781000;5247964000;;;4713243000;7804024000
ELLI;446590;USD;2017;Q4;2017-12-31;2018-03-01;34222070;35918852;241043000;43121000;;302638000;186991000;107363000;234615000;528969000;831607000;24913000;;77388000;;18880000;96268000;649820000;;86399000;735339000;831607000
ELLI;446590;USD;2016;Q4;2016-12-31;2016-11-01;33752674;35447694;422748000;39358000;;477315000;126297000;45931000;101974000;274202000;751517000;15942000;;78877000;;17732000;96609000;612101000;;43026000;654908000;751517000
ELLI;446590;USD;2015;Q4;2015-12-31;2015-11-05;29493494;31115104;83371000;28568000;;121813000;81360000;55473000;106245000;243078000;364891000;9911000;;63082000;685000;10958000;74040000;285345000;;5763000;290851000;364891000
ELLI;446590;USD;2014;Q4;2014-12-31;2014-11-06;28471006;30355223;76108000;20403000;;112532000;28694000;58679000;90215000;177588000;290120000;6726000;;33799000;443000;3437000;37236000;242530000;;10449000;252884000;290120000
ELLI;446590;USD;2013;Q4;2013-12-31;2013-11-07;27110848;29142612;79787000;12024000;;97987000;12869000;56285000;62462000;131616000;229603000;3783000;;19826000;175000;1850000;21676000;212335000;;-4374000;207927000;229603000
ELLI;446590;USD;2012;Q4;2012-12-31;2012-11-08;25875888;28928768;60357000;9753000;;74711000;9494000;43728000;57682000;110904000;185615000;2039000;;15927000;;2826000;18753000;184619000;;-17692000;166862000;185615000
ELLI;446590;USD;2011;Q4;2011-12-31;2011-11-10;20985212;39851804;25665000;6819000;;34865000;5539000;0;59367000;64906000;99771000;2255000;;14900000;;6013000;20913000;116014000;;-37156000;78858000;99771000
ELLI;446590;USD;2010;Q4;2010-12-31;2011-08-10;3592043;58196059;16905000;4243000;;26480000;2710000;;33766000;36476000;62956000;3756000;114000;10692000;;84089000;94781000;8951000;;-40776000;-31825000;62956000
ELLI;446590;USD;2018;Q4;2018-12-31;2019-03-01;34725000;35976000;302595000;43876000;;379376000;233590000;61959000;236685000;532234000;911610000;18539000;;82143000;;25398000;107541000;694611000;;110205000;804069000;911610000
ELS;446592;USD;2017;Q4;2017-12-31;2018-02-28;176280000;188604000;31085000;49477000;;80562000;3399119000;;130351000;3529470000;3610032000;135178000;1971715000;2202421000;228302000;307569000;2509990000;1242992000;;;1100042000;3610032000
EME;446597;USD;2016;Q4;2016-12-31;2017-02-23;60477911;60954280;464617000;1495431000;37426000;2169115000;127951000;8792000;1546580000;1683323000;3852438000;811727000;15030000;1511774000;408296000;802722000;2314496000;52825000;-10302000;1596269000;1537942000;3852438000
EME;446597;USD;2015;Q4;2015-12-31;2016-02-25;62385947;62896301;486831000;1359862000;37545000;2066112000;122018000;8359000;1346168000;1476545000;3542657000;756284000;17541000;1412421000;297559000;650180000;2062601000;130986000;-10302000;1432980000;1480056000;3542657000
EME;446597;USD;2014;Q4;2014-12-31;2015-02-26;64129828;64830923;432056000;1234187000;46854000;1886603000;122178000;9122000;1371064000;1502364000;3388967000;706332000;19041000;1283417000;316399000;676163000;1959580000;228521000;-10302000;1280991000;1429387000;3388967000
EME;446597;USD;2013;Q4;2013-12-31;2014-02-25;66964567;67948965;439813000;1268226000;52123000;1930105000;123414000;6799000;1405597000;1535810000;3465915000;725517000;19332000;1298743000;335331000;687546000;1986289000;408759000;-10590000;1133873000;1479626000;3465915000
EME;446597;USD;2012;Q4;2012-12-31;2013-02-26;66804058;67800184;605303000;1221956000;50512000;2044453000;116631000;4959000;941027000;1062617000;3107070000;715176000;1787000;1294519000;154112000;455372000;1749891000;416784000;-11903000;1022239000;1357179000;3107070000
EME;446597;USD;2011;Q4;2011-12-31;2012-02-27;66507032;67913766;511322000;1187832000;44914000;1936653000;101663000;5618000;970142000;1077423000;3014076000;682586000;1522000;1330913000;153335000;438032000;1768945000;417817000;-14476000;910042000;1245131000;3014076000
EME;446597;USD;2010;Q4;2010-12-31;2011-02-25;66542588;66542588;710836000;1090927000;32778000;1980167000;88615000;6211000;680549000;775375000;2755542000;609122000;489000;1232699000;151184000;359998000;1592697000;428303000;-15525000;782576000;1162845000;2755542000
EME;446597;USD;2009;Q4;2009-12-31;2010-07-29;;;726975000;1057171000;34468000;1977365000;92057000;19287000;893185000;1004529000;2981894000;595731000;45100000;1334605000;150251000;420823000;1755428000;416954000;-15451000;869267000;1226466000;2981894000
EME;446597;USD;2017;Q4;2017-12-31;2018-02-22;58895700;59306013;467430000;1607922000;42724000;2284509000;127156000;2309000;1551930000;1681395000;3965904000;890705000;15364000;1650952000;294786000;640835000;2291787000;8604000;-37693000;1796556000;1674117000;3965904000
EME;446597;USD;2018;Q4;2018-12-31;2019-02-21;57171100;57497799;363907000;1773620000;42321000;2386207000;134351000;2899000;1565350000;1702600000;4088807000;995160000;16013000;1734398000;279764000;612968000;2347366000;21704000;-253937000;2060440000;1741441000;4088807000
ES_old;446632;USD;2013;Q4;2013-12-31;2014-03-31;;;84213000;287438000;;677800000;114476000;;1628267000;1742743000;2420543000;354034000;65000000;666037000;666814000;1486291000;2152328000;535288000;;-244684000;268215000;2420543000
ES_old;446632;USD;2012;Q4;2012-12-31;2013-03-18;448807312;448807312;134191000;259913000;;794535000;117744000;;1743183000;1860927000;2655462000;338195000;16592000;644780000;798577000;1709763000;2354543000;512406000;;-190031000;300919000;2655462000
ES_old;446632;USD;2011;Q4;2011-12-31;2012-03-15;177901768;177833768;77213000;302203000;;834138000;126609000;;2055186000;2181795000;3015933000;371649000;;691281000;812734000;2039395000;2730676000;506928000;;-194013000;285257000;3015933000
ES_old;446632;USD;2010;Q4;2010-12-31;2011-08-09;177275602;177275602;60192000;294972000;;680838000;122649000;;2622012000;2744661000;3425499000;298263000;5600000;531993000;834560000;2414968000;2946961000;498979000;;2168000;478538000;3425499000
ES_old;446632;USD;2009;Q4;2009-12-31;2010-08-05;-529146675808;-529635922920;15913000;260380000;;426805000;122696000;;961674000;1084370000;1511175000;277750000;19071000;309268000;505040000;701745000;1011013000;493425000;;26381000;500162000;1511175000
FICO;446774;USD;2018;Q4;2018-09-30;2018-11-09;29073000;30698000;90023000;208865000;;338512000;48837000;19756000;847974000;916567000;1255079000;135000000;235000000;422215000;528944000;569127000;991342000;1211341000;-2612007000;1740810000;263737000;1255079000
FICO;446774;USD;2017;Q4;2017-09-30;2017-11-09;30528000;31960000;105618000;168586000;;310931000;40703000;25515000;878471000;944689000;1255620000;129224000;142000000;326655000;462801000;502428000;829083000;1195733000;-2301097000;1598395000;426537000;1255620000
FICO;446774;USD;2016;Q4;2016-09-30;2016-07-28;30914000;32221000;75926000;167786000;;267638000;45122000;21936000;885980000;953038000;1220676000;121948000;77000000;246077000;493624000;527771000;773848000;1189222000;-2136760000;1471377000;446828000;1220676000
FICO;446774;USD;2015;Q4;2015-09-30;2015-07-30;31219000;32497000;86120000;158773000;;286602000;38208000;20525000;884828000;943561000;1230163000;105178000;92000000;243875000;516000000;549290000;793165000;1153102000;-2033644000;1368255000;436998000;1230163000
FICO;446774;USD;2014;Q4;2014-09-30;2014-07-28;32071000;33163000;105075000;155295000;;288527000;36677000;19784000;847310000;903771000;1192298000;114885000;170000000;341404000;376000000;396280000;737684000;1129637000;-1936095000;1284261000;454614000;1192298000
FICO;446774;USD;2013;Q4;2013-09-30;2013-04-29;35122000;36140000;83178000;143733000;;249188000;45155000;18140000;849064000;912359000;1161547000;93699000;23000000;165880000;447000000;464990000;630870000;1110546000;-1751057000;1192096000;530677000;1161547000
FICO;446774;USD;2012;Q4;2012-09-30;2012-07-30;34267000;35520000;93617000;142595000;;259325000;41080000;16500000;841706000;899286000;1158611000;112646000;49000000;209605000;455000000;474600000;684205000;1103959000;-1718570000;1104825000;474406000;1158611000
FICO;446774;USD;2011;Q4;2011-09-30;2011-08-08;38052000;38654000;241578000;104974000;;364481000;33017000;15104000;716866000;764987000;1129468000;94640000;8000000;146498000;504000000;517476000;663974000;1098759000;-1627180000;1015624000;465494000;1129468000
FICO;446774;USD;2010;Q4;2010-09-30;2010-08-06;41113000;41562000;214814000;113187000;;347175000;30975000;15441000;730125000;776541000;1123716000;71194000;8000000;122147000;512000000;526655000;648802000;1103643000;-1556253000;947202000;474914000;1123716000
FICO;446774;USD;2009;Q4;2009-09-30;2010-08-06;48511000;48773000;317830000;101742000;;442558000;34340000;72445000;754545000;861330000;1303888000;74915000;0;114588000;570000000;589031000;703619000;1106774000;-1375400000;886324000;600269000;1303888000
G;446906;USD;2016;Q4;2016-12-31;2017-03-01;200341922;203431311;422623000;615265000;;1227037000;193218000;;1465625000;1658843000;2885880000;33927000;199181000;731355000;698152000;863357000;1594712000;1386452000;;358121000;1291168000;2885880000
G;446906;USD;2015;Q4;2015-12-31;2016-02-26;212697002;215675065;450907000;590137000;;1195069000;175396000;;1423024000;1598420000;2793489000;34208000;60634000;594480000;737332000;894653000;1489133000;1344133000;;411508000;1304356000;2793489000
G;446906;USD;2014;Q4;2014-12-31;2015-02-27;217279607;221353612;461788000;525754000;;1188508000;175936000;;1378093000;1554029000;2742537000;29130000;139288000;622114000;649314000;835287000;1457401000;1298914000;;398706000;1285136000;2742537000
G;446906;USD;2013;Q4;2013-12-31;2014-02-28;230871407;237730090;571276000;505117000;;1276144000;173204000;;1240019000;1413223000;2689367000;33419000;5668000;461693000;656258000;903606000;1365299000;1270654000;;511699000;1324068000;2689367000
G;446906;USD;2012;Q4;2012-12-31;2013-03-01;224917746;232580888;459228000;451989000;;1128767000;200362000;;1276798000;1477160000;2605927000;40956000;86283000;517818000;659412000;916328000;1434146000;1204701000;;281982000;1171781000;2605927000
G;446906;USD;2011;Q4;2011-12-31;2012-02-29;222192142;226955635;408020000;402419000;;985119000;180504000;;1237764000;1418268000;2403387000;41069000;282779000;661828000;75631000;305876000;967704000;1148425000;;605386000;1435683000;2403387000
G;446906;USD;2010;Q4;2010-12-31;2011-03-01;220699529;225603633;481019000;305925000;;935780000;197166000;;760515000;957681000;1893461000;20270000;26840000;322548000;2489000;89671000;412219000;1107818000;;421092000;1481242000;1893461000
G;446906;USD;2009;Q4;2009-12-31;2010-08-09;216604044;222578758;421335000;252508000;;845966000;189112000;;712487000;901599000;1747565000;17855000;46848000;395583000;28329000;152235000;547818000;1065478000;;278911000;1199747000;1747565000
G;446906;USD;2017;Q4;2017-12-31;2018-03-01;192795533;196862166;504468000;693085000;;1433895000;207030000;;1808696000;2015726000;3449621000;45076000;209226000;838784000;1006687000;1182043000;2020827000;1423292000;;355982000;1428794000;3449621000
G;446906;USD;2018;Q4;2018-12-31;2019-03-01;189724746;193149840;368396000;774184000;;1355057000;212715000;;1961673000;2174388000;3529445000;76479000;328483000;984392000;975645000;1140871000;2125263000;1473189000;;438453000;1404182000;3529445000
GWR;447280;USD;2016;Q4;2016-12-31;2017-03-01;57818000;58763000;32319000;363923000;43621000;485338000;4503319000;;2646301000;7149620000;7634958000;426572000;52538000;479110000;2306915000;3968727000;4447837000;1652453000;-232348000;1685813000;3187121000;7634958000
GWR;447280;USD;2015;Q4;2015-12-31;2016-02-29;58315000;59282000;35941000;382458000;45790000;507386000;4215063000;;1980633000;6195696000;6703082000;451861000;75966000;527827000;2205785000;3655794000;4183621000;1356050000;-227808000;1544676000;2519461000;6703082000
GWR;447280;USD;2014;Q4;2014-12-31;2015-02-27;55725000;57021000;59727000;357278000;30251000;548426000;3788482000;;1258845000;5047327000;5595753000;396840000;67398000;464238000;1548051000;2773535000;3237773000;1335140000;-224547000;1319639000;2357980000;5595753000
GWR;447280;USD;2013;Q4;2013-12-31;2014-02-27;54760000;56806000;62876000;336271000;31295000;548330000;3440744000;;1330747000;4771491000;5319821000;372142000;84366000;456508000;1540346000;2714243000;3170751000;1303183000;-220361000;1058884000;2149070000;5319821000
GWR;447280;USD;2012;Q4;2012-12-31;2013-03-01;48116000;77348000;64772000;262949000;32389000;465252000;3396295000;;1364568000;4760863000;5226115000;326092000;87569000;416744000;1770566000;2909385000;3326129000;867205000;-209266000;789727000;1899986000;5226115000
GWR;447280;USD;2011;Q4;2011-12-31;2012-02-27;40183000;42965000;27269000;165768000;14445000;240199000;1643589000;;410369000;2053958000;2294157000;203178000;57168000;261271000;569026000;1072252000;1333523000;386022000;-204952000;741669000;960634000;2294157000
GWR;447280;USD;2010;Q4;2010-12-31;2011-02-25;39204000;42521000;27417000;132225000;13259000;208948000;1444177000;;414435000;1858612000;2067560000;201196000;103690000;304886000;475174000;945434000;1250320000;358567000;-203626000;622185000;817240000;2067560000
GWR;447280;USD;2009;Q4;2009-12-31;2010-08-06;38600000;41407000;105707000;109931000;8939000;253243000;1024297000;;419492000;1443789000;1697032000;146922000;27818000;175722000;421616000;832433000;1008155000;331245000;-202776000;540925000;688877000;1697032000
GWR;447280;USD;2017;Q4;2017-12-31;2018-02-28;61723000;62611000;80472000;416705000;57750000;589533000;4656921000;;2788443000;7445364000;8034897000;439928000;27853000;467781000;2303442000;3671024000;4138805000;1700175000;-236951000;2234864000;3896092000;8034897000
GWR;447280;USD;2018;Q4;2018-12-31;2019-02-26;57898000;58615000;90387000;426305000;56716000;627593000;4613014000;;2627854000;7240868000;7868461000;453350000;28303000;481653000;2425235000;3756756000;4238409000;1785762000;-699852000;2482252000;3630052000;7868461000
GXP;447283;USD;2016;Q4;2016-12-31;2017-02-23;214000000;214500000;1293100000;166000000;271000000;3059500000;8956700000;;1553800000;10510500000;13570000000;426600000;716900000;1384800000;3365200000;6023200000;7408000000;4217000000;-3800000;1119200000;6162000000;13570000000
GXP;447283;USD;2015;Q4;2015-12-31;2016-02-24;154500000;155500000;11300000;147700000;274100000;664200000;8662400000;;1412000000;10074400000;10738600000;439000000;235100000;915700000;3745100000;6127400000;7043100000;2646700000;-2600000;1024400000;3695500000;10738600000
GXP;447283;USD;2014;Q4;2014-12-31;2015-02-25;154200000;154100000;13000000;160300000;242800000;718900000;8279600000;;1454900000;9734500000;10453400000;464500000;377400000;1070800000;3465700000;5757500000;6828300000;2639300000;-2300000;967800000;3625100000;10453400000
GXP;447283;USD;2013;Q4;2013-12-31;2014-02-26;153500000;153500000;10600000;162200000;228700000;767000000;7746400000;;1282000000;9028400000;9795400000;420100000;118300000;769800000;3515700000;5512200000;6282000000;2631100000;-2800000;871400000;3513400000;9795400000
GXP;447283;USD;2012;Q4;2012-12-31;2013-02-28;153300000;157500000;9300000;154500000;246400000;723700000;7402100000;;1521500000;8923600000;9647300000;416500000;805200000;1449500000;2756800000;4818800000;6268300000;2624700000;-5100000;758800000;3379000000;9647300000
GXP;447283;USD;2011;Q4;2011-12-31;2012-02-28;135700000;139400000;6200000;231200000;229300000;619100000;7053500000;;1445400000;8498900000;9118000000;393300000;1090400000;1634900000;2742300000;4483200000;6118100000;2330600000;-5600000;684700000;2999900000;9118000000
GXP;447283;USD;2010;Q4;2010-12-31;2011-02-25;135200000;137500000;10800000;241700000;217900000;611600000;6892300000;;1314300000;8206600000;8818200000;398500000;758700000;1339300000;2942700000;4552800000;5892100000;2324400000;-8900000;626500000;2926100000;8818200000
GXP;447283;USD;2017;Q4;2017-12-31;2018-02-21;215600000;215500000;1125400000;151700000;274400000;1863100000;9124700000;;1470100000;10594800000;12457900000;432900000;738900000;1448800000;3312600000;6044300000;7493100000;4233100000;-4000000;737900000;4964800000;12457900000
RLGY;447285;USD;2016;Q4;2016-12-31;2017-02-24;142000000;144900000;274000000;152000000;;818000000;267000000;;6336000000;6603000000;7421000000;575000000;242000000;1050000000;3265000000;3902000000;4952000000;5566000000;;-3062000000;2469000000;7421000000
RLGY;447285;USD;2015;Q4;2015-12-31;2016-02-24;146600000;150000000;415000000;141000000;;961000000;254000000;;6316000000;6570000000;7531000000;587000000;740000000;1605000000;2962000000;3504000000;5109000000;5734000000;;-3280000000;2422000000;7531000000
RLGY;447285;USD;2014;Q4;2014-12-31;2015-02-26;146300000;149200000;313000000;116000000;;846000000;233000000;;6225000000;6458000000;7304000000;539000000;19000000;878000000;3836000000;4243000000;5121000000;5678000000;;-3464000000;2183000000;7304000000
RLGY;447285;USD;2013;Q4;2013-12-31;2014-02-27;145500000;147900000;236000000;121000000;;917000000;205000000;;6204000000;6409000000;7326000000;577000000;19000000;911000000;3886000000;4402000000;5313000000;5636000000;;-3607000000;2013000000;7326000000
RLGY;447285;USD;2012;Q4;2012-12-31;2013-02-25;126764609;126764609;376000000;122000000;;978000000;188000000;;6279000000;6467000000;7445000000;575000000;110000000;1015000000;4256000000;4911000000;5926000000;5592000000;;-4045000000;1519000000;7445000000
RLGY;447285;USD;2011;Q4;2011-12-31;2012-03-02;8000000;8000000;143000000;120000000;;806000000;165000000;;6379000000;6544000000;7350000000;704000000;325000000;1436000000;6825000000;7413000000;8849000000;2033000000;;-3502000000;-1499000000;7350000000
RLGY;447285;USD;2010;Q4;2010-12-31;2011-08-03;-569200000;-569200000;192000000;114000000;;898000000;186000000;;6485000000;6671000000;7569000000;728000000;194000000;1357000000;6698000000;7275000000;8632000000;2026000000;;-3061000000;-1063000000;7569000000
RLGY;447285;USD;2017;Q4;2017-12-31;2018-02-27;133400000;136900000;227000000;153000000;;789000000;289000000;;6259000000;6548000000;7337000000;634000000;127000000;955000000;3221000000;3760000000;4715000000;5286000000;;-2631000000;2622000000;7337000000
RLGY;447285;USD;2018;Q4;2018-12-31;2019-02-26;116500000;119700000;225000000;146000000;;768000000;304000000;;6218000000;6522000000;7290000000;548000000;748000000;1527000000;2800000000;3448000000;4975000000;4870000000;;-2507000000;2315000000;7290000000
IART;447419;USD;2017;Q4;2017-12-31;2018-03-01;78424000;79672000;174935000;251799000;296332000;822146000;269251000;;2119860000;2389111000;3211257000;266118000;60000000;348911000;1781142000;1900040000;2248951000;822571000;-121644000;285186000;962306000;3211257000
IART;447419;USD;2016;Q4;2016-12-31;2017-02-23;74684000;80568000;102055000;148186000;217263000;495170000;222369000;;1090415000;1312784000;1807954000;116789000;0;123601000;665000000;844686000;968287000;799429000;-123051000;220443000;839667000;1807954000
IART;447419;USD;2015;Q4;2015-12-31;2016-02-26;73866000;80296000;48132000;132241000;211429000;438495000;205181000;;1130548000;1335729000;1774224000;119086000;14375000;139127000;700115000;883654000;1022781000;1020587000;-367121000;145879000;751443000;1774224000
IART;447419;USD;2014;Q4;2014-12-31;2015-02-27;58367700;59777184;71734000;110414000;189133000;529321000;193626000;;864472000;1058098000;1587419000;103319000;3750000;126025000;626246000;757072000;883097000;779971000;-367121000;314960000;704322000;1587419000
IART;447419;USD;2013;Q4;2013-12-31;2014-02-27;42482220;45028280;120614000;118145000;206919000;521152000;200310000;;470677000;670987000;1192139000;115185000;0;119382000;392057000;406667000;526049000;751328000;-367121000;280956000;666090000;1192139000
IART;447419;USD;2012;Q4;2012-12-31;2013-02-26;61312216;62356280;96938000;114916000;171806000;453051000;177898000;;532650000;710548000;1163599000;103424000;;106929000;519547000;538895000;645824000;587670000;-367121000;302023000;517775000;1163599000
IART;447419;USD;2011;Q4;2011-12-31;2012-02-27;62172684;63236656;100808000;118129000;171261000;452257000;131383000;;560469000;691852000;1144109000;97325000;;101868000;532264000;549603000;651471000;608033000;-367121000;260819000;492638000;1144109000
IART;447419;USD;2010;Q4;2010-12-31;2011-02-24;64760724;66676316;128763000;106005000;146928000;444849000;99456000;;474828000;574284000;1019133000;88975000;108438000;201857000;294842000;317313000;519170000;552586000;-283658000;232830000;499963000;1019133000
IART;447419;USD;2009;Q4;2009-12-31;2010-07-29;64490860;65192064;71891000;103228000;140240000;365363000;83526000;;491213000;574739000;940102000;75893000;76760000;156730000;308754000;338487000;495217000;521199000;-252380000;167161000;444885000;940102000
IART;447419;USD;2018;Q4;2018-12-31;2019-02-26;85260000;86350000;138838000;265737000;280347000;775082000;300112000;;2032693000;2332805000;3107887000;236288000;22500000;262552000;1331713000;1469539000;1732091000;1193481000;-120615000;348373000;1375796000;3107887000
IGT;447449;USD;2014;Q4;2014-09-30;2014-11-25;247100000;250200000;297000000;329300000;71400000;1221100000;412700000;211300000;2144400000;2768400000;3989500000;427300000;117500000;544800000;2140200000;2247100000;2791900000;1472700000;-486500000;226600000;1197600000;3989500000
IGT;447449;USD;2013;Q4;2013-09-30;2013-11-26;260300000;264100000;786200000;348600000;90100000;1776000000;483900000;234500000;2118400000;2836800000;4612800000;550200000;958300000;1508500000;1659600000;1850200000;3358700000;1433100000;-274900000;87700000;1254100000;4612800000
IGT;447449;USD;2012;Q4;2012-09-30;2012-11-28;268500000;270200000;253200000;346600000;92900000;1263300000;555700000;252300000;2213800000;3021800000;4285100000;477900000;152400000;630300000;2175000000;2457000000;3087300000;1585200000;-1332900000;941000000;1197800000;4285100000
IGT;447449;USD;2011;Q4;2011-09-30;2011-11-30;297600000;299800000;508700000;320100000;73000000;1409900000;552100000;271800000;1920600000;2744500000;4154400000;391700000;143000000;534700000;2011700000;2174900000;2709600000;1542600000;-855200000;763800000;1444800000;4154400000
IGT;447449;USD;2010;Q4;2010-09-30;2010-12-29;297200000;297600000;207900000;290300000;97600000;1202400000;586700000;299100000;1918800000;2804600000;4007000000;397700000;179100000;582300000;2066100000;2190400000;2772700000;1473800000;-802000000;551800000;1234300000;4007000000
IGT;447449;USD;2009;Q4;2009-09-30;2009-12-02;294000000;293900000;235200000;334300000;157800000;1233700000;558800000;396900000;2138700000;3094400000;4328100000;463700000;160800000;624500000;2447300000;2640000000;3264500000;1417900000;-799300000;437300000;1063600000;4328100000
JKHY;447566;USD;2016;Q4;2016-06-30;2016-08-29;78841000;79264000;70310000;253923000;;431929000;298564000;;1085019000;1383583000;1815512000;100007000;200000;443732000;0;375570000;819302000;441152000;-876134000;1431192000;996210000;1815512000
JKHY;447566;USD;2015;Q4;2015-06-30;2015-09-11;80905000;81087000;148313000;245387000;;493499000;296332000;;1047004000;1343336000;1836835000;94438000;2595000;443611000;50102000;401690000;845301000;425563000;-700472000;1266443000;991534000;1836835000
JKHY;447566;USD;2014;Q4;2014-06-30;2014-08-27;83739000;84277000;70377000;224041000;;390506000;291675000;;998522000;1290197000;1680703000;73815000;5407000;446809000;3729000;266507000;713316000;413536000;-577781000;1131632000;967387000;1680703000
JKHY;447566;USD;2013;Q4;2013-06-30;2013-08-27;85847000;86527000;127905000;231263000;;456119000;300511000;;915756000;1216267000;1672386000;80229000;7929000;434202000;7366000;222368000;656570000;401730000;-402082000;1016168000;1015816000;1672386000
JKHY;447566;USD;2012;Q4;2012-06-30;2012-08-27;86597000;87051000;157313000;218305000;;468649000;276730000;;874113000;1150843000;1619492000;74577000;25503000;402243000;106166000;234193000;636436000;382934000;-343956000;944078000;983056000;1619492000
JKHY;447566;USD;2011;Q4;2011-06-30;2011-09-01;86335000;87106000;63125000;207510000;;353950000;270186000;;881661000;1151847000;1505797000;62308000;26092000;380511000;127939000;245510000;626021000;362139000;-309585000;827222000;879776000;1505797000
JKHY;447566;USD;2010;Q4;2010-06-30;2010-11-05;85327000;85997000;125518000;208450000;;393102000;274670000;;892788000;1167458000;1560560000;63754000;105963000;444385000;272732000;365803000;810188000;335815000;-309585000;724142000;750372000;1560560000
JKHY;447566;USD;2017;Q4;2017-06-30;2017-08-25;77600000;78064000;114765000;276923000;;520031000;282934000;;1105980000;1388914000;1908945000;88415000;;471192000;50000000;405702000;876894000;453047000;-1006274000;1585278000;1032051000;1908945000
JKHY;447566;USD;2018;Q4;2018-06-30;2018-08-24;77260000;77583000;31440000;291630000;;468536000;286850000;;1294917000;1581767000;2050303000;132358000;;487896000;0;295579000;783475000;465171000;-1055260000;1856917000;1266828000;2050303000
LAZ;447656;USD;2016;Q4;2016-12-31;2017-02-24;123170331;132980859;1158785000;73991000;;2245765000;209021000;459422000;1642300000;2310743000;4556508000;1055198000;;2064927000;1188600000;1197768000;3262695000;416023000;;1134186000;1293813000;4556508000
LAZ;447656;USD;2015;Q4;2015-12-31;2016-02-25;125671748;133320774;1132083000;73396000;;2054105000;207165000;541911000;1674593000;2423669000;4477774000;1094371000;;2100978000;998386000;1009490000;3110468000;424083000;;1123728000;1367306000;4477774000
LAZ;447656;USD;2014;Q4;2014-12-31;2015-02-27;122307447;134084165;1066580000;73915000;;1875226000;222569000;620352000;614089000;1457010000;3332236000;625867000;;1471885000;1060365000;1090294000;2562179000;442855000;;464655000;770057000;3332236000
LAZ;447656;USD;2013;Q4;2013-12-31;2014-02-27;121748928;135426316;841482000;52220000;;1661082000;248796000;478105000;623154000;1350055000;3011137000;523063000;;1316955000;1064184000;1064184000;2381139000;489977000;;203236000;629998000;3011137000
LAZ;447656;USD;2012;Q4;2012-12-31;2013-02-28;114747744;110691339;850190000;53713000;;1685959000;225033000;414673000;661228000;1300934000;2986893000;467578000;;1240640000;1094713000;1094713000;2335353000;497550000;;182647000;651540000;2986893000
LAZ;447656;USD;2011;Q4;2011-12-31;2012-02-29;-118868908618;-139072863449;1003791000;83111000;;1869789000;168429000;378521000;665197000;1212147000;3081936000;383513000;;1118146000;1096934000;1096934000;2215080000;555861000;;258646000;866856000;3081936000
LAZ;447656;USD;2010;Q4;2010-12-31;2011-02-28;113322790;186104068;1209695000;63490000;;2227849000;150524000;417410000;626749000;1194683000;3422532000;498880000;;1376662000;1249753000;1249753000;2626415000;532088000;;166468000;796117000;3422532000
LAZ;447656;USD;2009;Q4;2009-12-31;2010-07-30;87411073;87411073;917329000;73750000;;1607021000;166913000;807693000;566135000;1540741000;3147762000;515033000;;1363187000;1261478000;1261478000;2624665000;359713000;;52726000;523097000;3147762000
LAZ;447656;USD;2017;Q4;2017-12-31;2018-02-27;119866857;132696257;1483836000;83816000;;3026422000;205301000;427186000;1269768000;1902255000;4928677000;904056000;;2469982000;1190383000;1199790000;3669772000;351908000;;1080413000;1258905000;4928677000
LAZ;447656;USD;2018;Q4;2018-12-31;2019-02-26;116333245;126819192;1246537000;184137000;;2977419000;212946000;575148000;1231728000;2019822000;4997241000;856124000;;2587317000;1434260000;1439831000;4027148000;-4894000;;1195563000;970093000;4997241000
LSI_old;447735;USD;2012;Q4;2012-12-31;2013-02-26;552244000;578270000;675985000;264112000;206323000;1226792000;269747000;;859626000;1129373000;2356165000;516894000;;516894000;;679647000;1196541000;5578757000;;-3840803000;1159624000;2356165000
LSI_old;447735;USD;2011;Q4;2011-12-31;2012-02-29;564619000;581263000;935455000;246539000;180035000;1422688000;180589000;;628771000;809360000;2232048000;460871000;;460871000;;712237000;1173108000;5629199000;;-4037031000;1058940000;2232048000
LSI_old;447735;USD;2010;Q4;2010-12-31;2011-02-28;617834000;625710000;676666000;326604000;186772000;1263820000;223181000;;937911000;1161092000;2424912000;484628000;;484628000;;622782000;1107410000;6004289000;;-4368522000;1317502000;2424912000
LSI_old;447735;USD;2009;Q4;2009-12-31;2010-08-12;654403000;654403000;962072000;338961000;169335000;1585452000;218972000;;1163506000;1382478000;2967930000;504385000;350000000;854385000;;652441000;1506826000;6149239000;;-4408494000;1461104000;2967930000
MKSI;447843;USD;2016;Q4;2016-12-31;2017-03-01;53618000;54520000;418086000;248757000;275869000;998769000;174559000;9858000;1029056000;1213473000;2212242000;159859000;10993000;237300000;601229000;733150000;970450000;777595000;;494744000;1241792000;2212242000
MKSI;447843;USD;2015;Q4;2015-12-31;2016-02-26;53216000;53554000;658237000;101883000;152631000;939511000;68856000;;264980000;333836000;1273347000;55625000;;90984000;;21482000;112466000;744838000;;427214000;1160881000;1273347000
MKSI;447843;USD;2014;Q4;2014-12-31;2015-02-25;53102000;53437000;592232000;106362000;155169000;895292000;72776000;;255976000;328752000;1224044000;67838000;;103627000;;38595000;142222000;734845000;;349061000;1081822000;1224044000
MKSI;447843;USD;2013;Q4;2013-12-31;2014-02-26;53252000;53694000;589617000;116744000;142727000;879231000;77536000;60405000;195846000;333787000;1213018000;94180000;;128422000;;63073000;191495000;730684000;;278966000;1021523000;1213018000
MKSI;447843;USD;2012;Q4;2012-12-31;2013-02-26;52707000;53218000;615241000;82060000;134639000;868182000;80516000;12158000;191706000;284380000;1152562000;41906000;;79311000;;61095000;140406000;718118000;;278583000;1012156000;1152562000
MKSI;447843;USD;2011;Q4;2011-12-31;2012-02-24;52467000;53104000;565519000;120894000;153632000;884901000;72487000;7873000;153393000;233753000;1118654000;54175000;1932000;96431000;;32211000;128642000;707532000;;268870000;990012000;1118654000
MKSI;447843;USD;2010;Q4;2010-12-31;2011-02-25;50414000;51244000;431933000;138181000;156429000;752895000;68976000;0;160542000;229518000;982413000;71718000;0;109686000;;25688000;135374000;663905000;;171356000;847039000;982413000
MKSI;447843;USD;2009;Q4;2009-12-31;2010-08-05;49510000;49510000;271795000;94215000;118004000;532881000;67196000;4853000;169139000;241188000;774069000;36950000;12885000;71300000;;17836000;89136000;645524000;;28769000;684933000;774069000
MKSI;447843;USD;2017;Q4;2017-12-31;2018-02-28;54319000;55236000;543202000;300308000;339081000;1236253000;171782000;10655000;995328000;1177765000;2414018000;200063000;2972000;289822000;389993000;535289000;825111000;789757000;;795698000;1588907000;2414018000
MKSI;447843;USD;2018;Q4;2018-12-31;2019-02-26;54006000;54454000;718171000;295454000;384689000;1464104000;194367000;10290000;945485000;1150142000;2614246000;182533000;3986000;263285000;343842000;477774000;741059000;794045000;;1084797000;1873187000;2614246000
MMS;447855;USD;2017;Q4;2017-09-30;2017-11-20;65638000;66211000;166252000;394338000;;657242000;101651000;;591769000;693420000;1350662000;232453000;;316266000;;88628000;404894000;475592000;;492112000;945768000;1350662000
MMS;447855;USD;2016;Q4;2016-09-30;2016-11-21;65808000;66355000;66199000;444357000;;620980000;131569000;;596270000;727839000;1348819000;255170000;277000;340756000;165338000;254923000;595679000;461679000;;323571000;753140000;1348819000
MMS;447855;USD;2015;Q4;2015-09-30;2015-08-07;69030000;68117000;74672000;396177000;;561907000;137830000;;571821000;709651000;1271558000;266820000;356000;356380000;210618000;299479000;655859000;446132000;;188611000;615699000;1271558000
MMS;447855;USD;2014;Q4;2014-09-30;2014-08-08;66780000;68248000;158112000;263011000;;532460000;80246000;;288290000;368536000;900996000;202011000;157000;265321000;1060000;79490000;344811000;429857000;;125875000;556185000;900996000
MMS;447855;USD;2013;Q4;2013-09-30;2013-08-09;68157000;70044000;125617000;264300000;;489599000;77710000;;290669000;368379000;857978000;200627000;;262040000;;66163000;328203000;415271000;;106250000;529775000;857978000
MMS;447855;USD;2012;Q4;2012-09-30;2012-08-08;68088000;70138000;189312000;172705000;;443217000;58798000;;193278000;252076000;695293000;132333000;178000;184611000;1558000;59576000;244187000;395967000;;34899000;451106000;695293000
MMS;447855;USD;2011;Q4;2011-09-30;2011-08-09;68354000;70654000;172950000;146900000;;391276000;51740000;;122263000;174003000;565279000;108322000;42000;163893000;1654000;26929000;190822000;377579000;-416850000;401248000;374457000;565279000
MMS;447855;USD;2010;Q4;2010-09-30;2011-02-08;68910000;71348000;155321000;136260000;;356149000;48873000;;122719000;171592000;527741000;97127000;;164688000;1411000;24264000;188952000;352696000;-359366000;330929000;338789000;527741000
MMS;447855;USD;2018;Q4;2018-09-30;2018-11-20;64652000;65358000;369509000;357613000;;808632000;77544000;;575824000;653368000;1462000000;214371000;;277449000;;98132000;375581000;487539000;;633281000;1086419000;1462000000
MTZ;447935;USD;2017;Q4;2017-12-31;2018-02-27;81037000;82465000;40326000;1598015000;76992000;1852366000;706506000;;1507704000;2214210000;4066576000;616012000;87866000;963827000;1280706000;1669396000;2633223000;784481000;-147124000;857154000;1433353000;4066576000
MTZ;447935;USD;2016;Q4;2016-12-31;2016-11-03;80519000;82609000;38767000;1156031000;111031000;1402486000;549084000;;1231562000;1780646000;3183132000;543085000;64600000;839990000;961379000;1239508000;2079498000;797977000;-145573000;509941000;1103634000;3183132000
MTZ;447935;USD;2015;Q4;2015-12-31;2015-11-03;79884000;79281000;4984000;911106000;90599000;1129758000;558667000;;1238922000;1797589000;2927347000;464462000;77400000;752535000;932868000;1231421000;1983956000;778816000;-145573000;378678000;943391000;2927347000
MTZ;447935;USD;2014;Q4;2014-12-31;2014-10-30;82387000;85608000;24059000;1303552000;112804000;1531751000;623118000;;1409111000;2032229000;3563980000;635218000;73631000;980848000;1061159000;1435057000;2415905000;765450000;-45573000;457788000;1148075000;3563980000
MTZ;447935;USD;2013;Q4;2013-12-31;2013-10-31;77250000;85488000;22927000;1134693000;70185000;1307026000;488132000;;1128040000;1616172000;2923198000;562820000;51376000;829225000;765425000;1072915000;1902140000;837510000;-150000000;341865000;1021058000;2923198000
MTZ;447935;USD;2012;Q4;2012-12-31;2012-11-01;76042000;82435000;26382000;877214000;83939000;1049641000;348858000;;1017809000;1366667000;2416308000;478511000;52596000;714135000;546323000;840298000;1554433000;811758000;-150000000;200915000;861875000;2416308000
MTZ;447935;USD;2011;Q4;2011-12-31;2011-11-03;82817000;86273000;7406000;658528000;88914000;828804000;263007000;13565000;989329000;1265901000;2094705000;376564000;34050000;592445000;460690000;691053000;1283498000;800612000;-75000000;93489000;811207000;2094705000
MTZ;447935;USD;2010;Q4;2010-12-31;2011-08-03;76336000;91923000;177604000;444363000;57483000;721674000;180786000;30969000;722399000;934154000;1655828000;274656000;18399000;486544000;394151000;516122000;1002666000;671749000;;-12512000;653162000;1655828000
MTZ;447935;USD;2018;Q4;2018-12-31;2019-02-28;76550000;77604000;27422000;1923970000;113709000;2168989000;747808000;;1523156000;2270964000;4439953000;892963000;82655000;1283611000;1324223000;1764318000;3047929000;798142000;-466125000;1118375000;1392024000;4439953000
NFG;448011;USD;2017;Q4;2017-09-30;2017-11-17;85512665;86216477;555530000;112383000;33926000;818280000;4674074000;125265000;485701000;5285040000;6103320000;273832000;335031000;646039000;2083681000;3753546000;4399585000;882189000;;851669000;1703735000;6103320000
NFG;448011;USD;2016;Q4;2016-09-30;2016-11-18;85016093;84463541;129972000;133201000;33866000;413031000;4454482000;110664000;658210000;5223356000;5636387000;236496000;34900000;303737000;2086252000;3805646000;4109383000;856283000;;676361000;1527004000;5636387000
NFG;448011;USD;2015;Q4;2015-09-30;2015-11-20;84571265;82051081;113596000;105004000;30414000;375801000;5331895000;92990000;764253000;6189138000;6564939000;367138000;2120209000;2530149000;;2009350000;4539499000;828868000;;1103200000;2025440000;6564939000
NFG;448011;USD;2014;Q4;2014-09-30;2014-11-21;84127025;85340164;36886000;149735000;27817000;377332000;5743091000;86788000;520829000;6350708000;6728040000;339491000;1753003000;2128019000;;2189338000;4317357000;800301000;;1614361000;2410683000;6728040000
NFG;448011;USD;2018;Q4;2018-09-30;2018-11-16;85952570;86608425;229606000;141498000;35823000;544591000;4977143000;132545000;382207000;5491895000;6036486000;332650000;19062000;440060000;2131365000;3659096000;4099156000;906180000;;1098900000;1937330000;6036486000
NUAN;448077;USD;2016;Q4;2016-09-30;2016-11-22;327243840;327243840;580460000;380004000;;1038590000;185169000;27632000;4410079000;4622880000;5661470000;332258000;0;690899000;2433152000;3039241000;3730140000;2493283000;-16788000;-429031000;1931330000;5661470000
NUAN;448077;USD;2015;Q4;2015-09-30;2015-11-19;358976310;358976310;536686000;373162000;;986625000;186007000;32099000;4307178000;4525284000;5511909000;281190000;4834000;626384000;2103079000;2620273000;3246657000;2815558000;-16788000;-416573000;2265252000;5511909000
NUAN;448077;USD;2014;Q4;2014-09-30;2014-11-28;368125065;368125065;588204000;428266000;;1164500000;191411000;0;4464373000;4655784000;5820284000;303039000;4834000;642009000;2127392000;2596283000;3238292000;3153358000;-16788000;-530563000;2581992000;5820284000
NUAN;448077;USD;2013;Q4;2013-09-30;2013-11-29;359046765;359046765;846846000;382741000;;1409527000;160973000;;4388103000;4549076000;5958603000;305241000;246040000;805234000;2108091000;2515355000;3320589000;3017393000;-16788000;-369404000;2638014000;5958603000
NUAN;448077;USD;2012;Q4;2012-09-30;2012-11-29;357385875;369081405;1129761000;381417000;;1701306000;116134000;;3981600000;4097734000;5799040000;328374000;380094000;964763000;1735811000;2106001000;3070764000;2908618000;-16788000;-161155000;2728276000;5799040000
NUAN;448077;USD;2011;Q4;2011-09-30;2011-11-29;353935890;384209595;478468000;280856000;;854927000;78218000;;3162148000;3240366000;4095293000;258777000;6905000;475070000;853020000;1126852000;1601922000;2746243000;-16788000;-243117000;2493371000;4095293000
NUAN;448077;USD;2010;Q4;2010-09-30;2010-11-29;339542280;339542280;521674000;217587000;;841642000;62083000;28322000;2837652000;2928057000;3769699000;230237000;7764000;382472000;851014000;1090031000;1472503000;2582203000;-16788000;-281355000;2297196000;3769699000
NUAN;448077;USD;2009;Q4;2009-09-30;2010-08-09;308686455;308686455;527038000;199548000;;795827000;53468000;0;2650169000;2703637000;3499464000;176537000;6862000;419225000;848898000;1037238000;1456463000;2309273000;-16214000;-262256000;2043001000;3499464000
NUAN;448077;USD;2017;Q4;2017-09-30;2017-11-29;334444110;334444110;844280000;395392000;;1327941000;176548000;29844000;4397590000;4603982000;5931923000;340505000;376121000;1111528000;2241283000;2889013000;4000541000;2629539000;-16788000;-580027000;1931382000;5931923000
NUAN;448077;USD;2018;Q4;2018-09-30;2018-11-20;331645545;326300205;451542000;378832000;;928631000;155894000;21932000;4195922000;4373748000;5302379000;366160000;0;764164000;2185361000;2820719000;3584883000;2597984000;-16788000;-740837000;1717496000;5302379000
OLN;448155;USD;2016;Q4;2016-12-31;2017-02-28;165300000;164000000;184500000;675000000;630400000;1546200000;3704900000;;3511500000;7216400000;8762600000;842100000;80500000;922600000;3537100000;5567000000;6489600000;2409200000;;373800000;2273000000;8762600000
OLN;448155;USD;2015;Q4;2015-12-31;2016-03-01;181100000;178100000;392000000;783400000;685200000;1933400000;3953400000;;3402100000;7355500000;9288900000;941200000;205000000;1146200000;3643800000;5723900000;6870100000;2401500000;;509800000;2418800000;9288900000
OLN;448155;USD;2014;Q4;2014-12-31;2015-02-25;78000000;78800000;256800000;263100000;210100000;816100000;931000000;;951000000;1882000000;2698100000;361300000;16400000;377700000;658700000;1307100000;1684800000;865700000;;590700000;1013300000;2698100000
OLN;448155;USD;2013;Q4;2013-12-31;2014-02-24;79400000;80400000;307800000;266500000;186500000;839900000;987800000;;975100000;1962900000;2802800000;394900000;12600000;407500000;678400000;1294200000;1701700000;918200000;;548000000;1101100000;2802800000
OLN;448155;USD;2012;Q4;2012-12-31;2013-02-25;80100000;81400000;165200000;279200000;195100000;749100000;1034300000;;994300000;2028600000;2777700000;410400000;23600000;434000000;690100000;1345300000;1779300000;936300000;;433400000;998400000;2777700000
OLN;448155;USD;2011;Q4;2011-12-31;2012-02-24;80200000;80900000;304800000;220600000;176600000;780300000;885400000;;783900000;1669300000;2449600000;386900000;12200000;399100000;524200000;1064700000;1463800000;932100000;;347900000;985800000;2449600000
OLN;448155;USD;2010;Q4;2010-12-31;2011-02-24;237399843;239399842;458600000;167900000;155600000;882800000;675000000;;490900000;1165900000;2048700000;313200000;77800000;391000000;418200000;827400000;1218400000;921900000;;170200000;830300000;2048700000
OLN;448155;USD;2009;Q4;2009-12-31;2010-07-26;312399766;313199766;458500000;155200000;123800000;860300000;695400000;;376300000;1071700000;1932000000;310900000;0;310900000;398400000;798800000;1109700000;901800000;;168700000;822300000;1932000000
OLN;448155;USD;2017;Q4;2017-12-31;2018-02-26;166800000;171500000;218400000;733200000;682600000;1699200000;3575800000;;3943300000;7519100000;9218300000;953600000;700000;954300000;3611300000;5510300000;6464600000;2448000000;;790300000;2753700000;9218300000
OLN;448155;USD;2018;Q4;2018-12-31;2019-02-25;165900000;167000000;178800000;776300000;711400000;1707400000;3482100000;;3807900000;7290000000;8997400000;992400000;125900000;1118300000;3104400000;5046900000;6165200000;2412700000;;1070500000;2832200000;8997400000
PEGA;448267;USD;2016;Q4;2016-12-31;2017-02-24;76401000;80723000;133761000;265028000;;425132000;38281000;;191243000;229524000;654656000;111825000;;287472000;;31295000;318767000;144669000;;198315000;335889000;654656000
PEGA;448267;USD;2015;Q4;2015-12-31;2016-02-25;76467000;79456000;219078000;211846000;;446485000;31319000;;149954000;181273000;627758000;111315000;;267188000;;37711000;304899000;146183000;;180183000;322859000;627758000
PEGA;448267;USD;2014;Q4;2014-12-31;2015-02-26;76373000;78530000;211216000;154844000;;393080000;30156000;;164565000;194721000;587801000;94960000;;229632000;;63464000;293096000;142259000;;153058000;294705000;587801000
PEGA;448267;USD;2013;Q4;2013-12-31;2014-02-25;76082000;78664000;156692000;165641000;;348209000;28957000;;159314000;188271000;536480000;79696000;;190386000;;74306000;264692000;140329000;;127826000;271788000;536480000
PEGA;448267;USD;2012;Q4;2012-12-31;2013-02-20;75820000;81602000;122985000;134066000;;279010000;30827000;;129655000;160482000;439492000;59579000;;155125000;;47888000;203013000;138955000;;94349000;236479000;439492000
PEGA;448267;USD;2011;Q4;2011-12-31;2012-02-29;75430000;82064000;111432000;98293000;;231961000;14458000;;135292000;149750000;381711000;68405000;;142245000;;30710000;172955000;130078000;;77029000;208756000;381711000
PEGA;448267;USD;2010;Q4;2010-12-31;2011-08-09;74200000;74200000;87251000;79896000;;188656000;11010000;;137809000;148819000;337475000;58147000;;115050000;;26755000;141805000;122979000;;71431000;195670000;337475000
PEGA;448267;USD;2017;Q4;2017-12-31;2018-02-26;77959000;88817000;223748000;222735000;;646516000;;;365051000;365051000;1011567000;128918000;;295215000;;62115000;357330000;152878000;;508051000;654237000;1011567000
PEGA;448267;USD;2018;Q4;2018-12-31;2019-02-20;78685000;91819000;207423000;180872000;;610635000;;;371918000;371918000;982553000;146664000;;331809000;;29213000;361022000;123990000;;510863000;621531000;982553000
PINC;448306;USD;2013;Q4;2013-06-30;2013-11-12;5545000;5545000;255619000;60600000;12741000;366041000;115587000;0;117288000;232875000;598916000;102030000;12149000;145148000;22468000;68365000;213513000;29223000;;50599000;385403000;598916000
PKG;448316;USD;2017;Q4;2017-12-31;2018-02-28;93600000;93800000;216900000;830700000;762500000;1915100000;2924900000;;1357500000;4282400000;6197500000;681400000;151300000;832700000;2499400000;3182200000;4014900000;472100000;;1867400000;2182600000;6197500000
PKG;448316;USD;2016;Q4;2016-12-31;2016-11-04;93300000;93700000;239300000;689200000;723600000;1696300000;2895700000;;1185000000;4080700000;5777000000;598300000;27100000;625400000;2640300000;3391800000;4017200000;452300000;;1447100000;1759800000;5777000000
PKG;448316;USD;2015;Q4;2015-12-31;2015-11-06;96000000;96100000;184200000;636500000;676800000;1554500000;2832100000;;885700000;3717800000;5272300000;554200000;7700000;561900000;2312000000;3077100000;3639000000;440900000;;1317300000;1633300000;5272300000
PKG;448316;USD;2014;Q4;2014-12-31;2014-11-07;97200000;97500000;124900000;646100000;664900000;1502900000;2857600000;;912300000;3769900000;5272800000;603400000;7600000;611000000;2371700000;3140400000;3751400000;433100000;;1242200000;1521400000;5272800000
PKG;448316;USD;2013;Q4;2013-12-31;2013-11-08;96795000;97493000;191000000;643100000;594300000;1531000000;2805700000;;907100000;3712800000;5243800000;620600000;40000000;660600000;2532700000;3226400000;3887000000;402700000;;1019100000;1356800000;5243800000
PKG;448316;USD;2012;Q4;2012-12-31;2012-11-06;96376000;97511000;207393000;352142000;268767000;937033000;1366069000;;150666000;1516735000;2453768000;243882000;15964000;259846000;905585000;1224461000;1484307000;379775000;;703728000;969461000;2453768000
PKG;448316;USD;2011;Q4;2011-12-31;2011-11-03;97269000;98437000;156313000;319988000;254675000;812063000;1476654000;;123782000;1600436000;2412499000;360782000;15718000;376500000;916613000;1107089000;1483589000;352787000;-59000;673960000;928910000;2412499000
PKG;448316;USD;2010;Q4;2010-12-31;2010-11-03;100973000;101983000;196556000;294192000;241142000;799677000;1337986000;;88247000;1426233000;2225910000;294940000;109670000;404610000;672982000;812299000;1216909000;363271000;;690111000;1009001000;2225910000
PKG;448316;USD;2009;Q4;2009-12-31;2010-08-04;101760000;102607000;260727000;243403000;213396000;885214000;1182504000;;85122000;1267626000;2152840000;261331000;109626000;370957000;571252000;883038000;1253995000;388526000;;546355000;898845000;2152840000
PKG;448316;USD;2018;Q4;2018-12-31;2019-02-28;93900000;94000000;361500000;901900000;795600000;2115100000;3108600000;;1346000000;4454600000;6569700000;692200000;1400000;693600000;2501300000;3203700000;3897300000;495400000;;2315800000;2672400000;6569700000
POOL;448357;USD;2017;Q4;2017-12-31;2018-02-28;40152000;41727000;29940000;76597000;536474000;782248000;100939000;1127000;216748000;318814000;1101062000;310731000;10835000;321566000;508815000;556350000;877916000;426790000;;-196316000;223146000;1101062000
POOL;448357;USD;2016;Q4;2016-12-31;2016-10-28;41212000;42348000;21956000;61437000;486116000;695557000;83290000;1172000;214076000;298538000;994095000;295115000;1105000;296220000;436937000;490378000;786598000;403203000;;-183915000;207497000;994095000
POOL;448357;USD;2015;Q4;2015-12-31;2015-10-30;42671000;43863000;13237000;54173000;474275000;661744000;69854000;1231000;201532000;272617000;934361000;303145000;1700000;304845000;326345000;371108000;675953000;374181000;;-104709000;258408000;934361000
POOL;448357;USD;2014;Q4;2014-12-31;2014-10-30;43421000;44554000;14830000;51014000;466962000;637213000;56475000;1244000;198005000;255724000;892937000;290379000;1529000;291908000;319309000;353564000;645472000;338664000;;-90650000;247465000;892937000
POOL;448357;USD;2013;Q4;2013-12-31;2013-10-31;45704000;47060000;8006000;45138000;429197000;577749000;52328000;1243000;192441000;246012000;823761000;263897000;9000;263906000;246418000;273673000;537579000;310548000;;-27278000;286182000;823761000
POOL;448357;USD;2012;Q4;2012-12-31;2012-11-01;46513000;47559000;12463000;113859000;400308000;543096000;46566000;1160000;189754000;237480000;780576000;247973000;23000;247996000;230882000;250957000;498953000;276380000;;5377000;281623000;780576000
POOL;448357;USD;2011;Q4;2011-12-31;2011-10-31;47550000;49196000;17487000;109273000;386924000;532066000;41394000;980000;196462000;238836000;770902000;226577000;22000;226599000;247300000;264557000;491156000;243227000;;34299000;279746000;770902000
POOL;448357;USD;2010;Q4;2010-12-31;2010-11-01;49554000;50837000;9721000;101543000;347439000;476592000;30685000;966000;220302000;251953000;728545000;211404000;134000;211538000;198700000;231825000;443363000;218793000;-2344000;67681000;285182000;728545000
POOL;448357;USD;2009;Q4;2009-12-31;2010-08-02;194450371;196049411;15843000;96364000;355528000;491317000;31432000;1006000;219344000;251782000;743099000;212277000;48236000;260513000;200700000;230399000;490912000;202833000;0;47128000;252187000;743099000
POOL;448357;USD;2018;Q4;2018-12-31;2019-02-27;39999000;41299000;16358000;69493000;672579000;915244000;106964000;1213000;217450000;325627000;1240871000;296442000;9168000;305610000;657593000;711671000;1017281000;453233000;;-218646000;223590000;1240871000
RES;448466;USD;2017;Q4;2017-12-31;2018-02-28;213818000;;91050000;377853000;114866000;640135000;443928000;;63161000;507089000;1147224000;145360000;;145360000;;90167000;235527000;21654000;;906745000;911697000;1147224000
RES;448466;USD;2016;Q4;2016-12-31;2016-10-31;214268000;214268000;131835000;169166000;108316000;479057000;497986000;;58409000;556395000;1035452000;101468000;;101468000;;127185000;228653000;21749000;;803152000;806799000;1035452000
RES;448466;USD;2015;Q4;2015-12-31;2015-10-30;212525000;212432000;65196000;232187000;128441000;492208000;688335000;;56551000;744886000;1237094000;107464000;;107464000;;177349000;284813000;21699000;;948551000;952281000;1237094000
RES;448466;USD;2014;Q4;2014-12-31;2014-11-03;414239776;416263762;9772000;634730000;155611000;851628000;849383000;;58347000;907730000;1759358000;239012000;;239012000;;441964000;680976000;21654000;;1074561000;1078382000;1759358000
RES;448466;USD;2013;Q4;2013-12-31;2013-11-01;214871000;216570000;8700000;437132000;126604000;604925000;726307000;;52628000;778935000;1383860000;168052000;;168052000;;247106000;415158000;21899000;;956918000;968702000;1383860000
RES;448466;USD;2012;Q4;2012-12-31;2012-11-01;215300000;217062000;14163000;387530000;140867000;567827000;756326000;;43010000;799336000;1367163000;164511000;;164511000;;303420000;467931000;22014000;;891464000;899232000;1367163000
RES;448466;USD;2011;Q4;2011-12-31;2011-11-03;-652383268;-660224000;7393000;461272000;100438000;626555000;675360000;;36296000;711656000;1338211000;179466000;;179466000;;396153000;575619000;22119000;;753119000;762592000;1338211000
RES;448466;USD;2010;Q4;2010-12-31;2011-08-02;-651405064;-658199780;9035000;294002000;64059000;398678000;453017000;;36176000;489193000;887871000;117504000;;117504000;;231472000;348976000;21278000;;527150000;538895000;887871000
RES;448466;USD;2018;Q4;2018-12-31;2019-02-28;212551000;;116262000;323533000;130083000;618938000;517982000;;62660000;580642000;1199580000;143237000;;143237000;;105924000;249161000;21454000;;947711000;950419000;1199580000
RS;448547;USD;2016;Q4;2016-12-31;2017-02-24;72605302;73381718;122800000;960200000;1532600000;2688500000;1662200000;;3060600000;4722800000;7411300000;573500000;82500000;656000000;1846700000;2576200000;3232200000;590300000;;3663200000;4179100000;7411300000
RS;448547;USD;2015;Q4;2015-12-31;2016-02-26;71633192;72545681;104300000;916600000;1436000000;2554200000;1635500000;;2931900000;4567400000;7121600000;488900000;500800000;989700000;1427900000;2189200000;3178900000;533800000;;3480000000;3942700000;7121600000
RS;448547;USD;2014;Q4;2014-12-31;2015-02-26;77543690;78443991;106200000;1144600000;1752100000;3121100000;1656400000;;3044900000;4701300000;7822400000;568900000;93900000;662800000;2208100000;3031700000;3694500000;819400000;;3328500000;4127900000;7822400000
RS;448547;USD;2013;Q4;2013-12-31;2014-02-27;77336944;78177442;83600000;983500000;1540000000;2738900000;1603900000;;2998200000;4602100000;7341000000;536900000;36500000;573400000;2072500000;2883200000;3456600000;818300000;;3063000000;3884400000;7341000000
RS;448547;USD;2012;Q4;2012-12-31;2013-02-27;75616245;76129007;97600000;807700000;1272300000;2277400000;1240700000;;2339600000;3580300000;5857700000;494600000;83600000;578200000;1123800000;1712100000;2290300000;722200000;;2837700000;3567400000;5857700000
RS;448547;USD;2011;Q4;2011-12-31;2012-02-24;74851465;75029221;84600000;896200000;1212800000;2274700000;1105500000;;2225700000;3331200000;5605900000;564200000;12200000;576400000;1319000000;1877500000;2453900000;657100000;;2495600000;3152000000;5605900000
RS;448547;USD;2010;Q4;2010-12-31;2011-02-25;74542317;74782292;72900000;697000000;860200000;1700900000;1025300000;;1942700000;2968000000;4668900000;412800000;86200000;508600000;855100000;1330200000;1838800000;624700000;;2188700000;2830100000;4668900000
RS;448547;USD;2009;Q4;2009-12-31;2010-08-06;73609203;73936774;43002000;533871000;719915000;1390904000;981259000;;1934614000;2915873000;4306777000;331186000;86383000;417569000;849375000;1281086000;1698655000;587612000;;2020343000;2608122000;4306777000
RS;448547;USD;2017;Q4;2017-12-31;2018-02-28;72761821;73624151;154400000;1087300000;1726000000;3051300000;1656300000;;3043400000;4699700000;7751000000;611700000;92000000;703700000;1809400000;2347400000;3051100000;594600000;;4144100000;4699900000;7751000000
RS;448547;USD;2018;Q4;2018-12-31;2019-02-27;69381989;70344607;128200000;1242300000;1817100000;3285000000;1729900000;;3030000000;4759900000;8044900000;633900000;65200000;699100000;2138500000;2666300000;3365400000;136400000;;4637900000;4679500000;8044900000
RSPP;448551;USD;2016;Q4;2016-12-31;2017-02-27;128813000;128813000;690776000;73671000;;776262000;4129635000;;90530000;4220165000;4996427000;79408000;;108269000;1132275000;1470846000;1579115000;3457335000;;-40023000;3417312000;4996427000
RSPP;448551;USD;2015;Q4;2015-12-31;2016-02-25;98557000;98557000;142741000;36323000;;187540000;2758630000;;21263000;2779893000;2967433000;73408000;;77402000;686512000;1031447000;1108849000;1874340000;;-15756000;1858584000;2967433000
RSPP;448551;USD;2014;Q4;2014-12-31;2015-03-17;77292000;77292000;56292000;40436000;;173742000;2094618000;;21587000;2116205000;2289947000;102932000;;104252000;500000000;859924000;964176000;1323273000;;2498000;1325771000;2289947000
RSPP;448551;USD;2013;Q4;2013-12-31;2014-06-13;;;13234000;30018000;;47135000;516288000;;24232000;540520000;587655000;29304000;;30866000;128155000;169908000;200774000;0;;0;386881000;587655000
RSPP;448551;USD;2017;Q4;2017-12-31;2018-02-27;156874000;159435000;38102000;111157000;;149323000;6080719000;;40144000;6120863000;6270186000;169995000;;206561000;1509128000;1741267000;1947828000;4130245000;;192113000;4322358000;6270186000
SEB;448625;USD;2016;Q4;2016-12-31;2017-02-21;1170550;;1354000000;627000000;762000000;2848000000;1006000000;;901000000;1907000000;4755000000;216000000;138000000;785000000;499000000;795000000;1580000000;1000000;;3465000000;3175000000;4755000000
SEB;448625;USD;2015;Q4;2015-12-31;2016-02-25;1170550;;1304000000;510000000;739000000;2664000000;831000000;;936000000;1767000000;4431000000;391000000;145000000;766000000;518000000;783000000;1549000000;1000000;;3153000000;2882000000;4431000000
SEB;448625;USD;2014;Q4;2014-12-31;2015-02-26;1169900;;527000000;634000000;736000000;2053000000;847000000;;792000000;1639000000;3692000000;383000000;76000000;635000000;;322000000;957000000;1000000;;2982000000;2735000000;3692000000
SEB;448625;USD;2013;Q4;2013-12-31;2014-02-26;1190129;;345704000;651404000;698998000;1853949000;863573000;;700526000;1564099000;3418048000;392549000;79396000;615327000;80480000;322751000;938078000;1189000;;2655857000;2479970000;3418048000
SEB;448625;USD;2012;Q4;2012-12-31;2013-02-27;1199076;;361030000;521892000;756864000;1782763000;843879000;;721139000;1565018000;3347781000;426446000;53924000;676575000;120825000;363017000;1039592000;1198000;;2474896000;2308189000;3347781000
SEB;448625;USD;2011;Q4;2011-12-31;2012-02-28;1212115;;394766000;477209000;644930000;1632042000;796822000;;577864000;1374686000;3006728000;366948000;57104000;561409000;116367000;365852000;927261000;1211000;;2233778000;2079467000;3006728000
SEB;448625;USD;2010;Q4;2010-12-31;2011-08-09;1216028;;373329000;359944000;533761000;1485412000;701131000;;547543000;1248674000;2734086000;321882000;80426000;638195000;91407000;317642000;955837000;1216000;;1897897000;1778249000;2734086000
SEB;448625;USD;2017;Q4;2017-12-31;2018-02-21;1170550;;1692000000;482000000;780000000;3128000000;1077000000;;956000000;2033000000;5161000000;272000000;215000000;818000000;482000000;935000000;1753000000;1000000;;3750000000;3408000000;5161000000
SEB;448625;USD;2018;Q4;2018-12-31;2019-02-20;1170354;;1530000000;551000000;815000000;3027000000;1160000000;;1120000000;2280000000;5307000000;399000000;187000000;784000000;739000000;1194000000;1978000000;1000000;;3727000000;3329000000;5307000000
SNH;448715;USD;2016;Q4;2016-12-31;2017-02-27;237393000;237440000;31749000;;;35578000;6402512000;;789664000;7192176000;7227754000;18471000;2840407000;3048253000;980096000;980096000;4028349000;1545971000;;1618885000;3199405000;7227754000
SNH;448715;USD;2015;Q4;2015-12-31;2016-02-24;237537000;237570000;37656000;;;43811000;6309400000;51472000;755407000;7116279000;7160090000;16974000;2157831000;2348654000;1436668000;1451676000;3800330000;1914707000;;1477590000;3359760000;7160090000
SNH;448715;USD;2014;Q4;2014-12-31;2015-02-27;203969000;203989000;27594000;;;38138000;5249155000;23993000;656983000;5930131000;5968269000;20046000;2370704000;2451361000;552826000;564501000;3015862000;1595456000;;1353622000;2952407000;5968269000
SNH;448715;USD;2013;Q4;2013-12-31;2014-03-03;188296000;;39233000;;;51747000;4422865000;29078000;260976000;4712919000;4764666000;15839000;1792764000;1863273000;112528000;124404000;1987677000;1573592000;;1194985000;2776989000;4764666000
SNH;448715;USD;2012;Q4;2012-12-31;2013-02-19;178025000;;42382000;;;51814000;4304928000;25177000;366083000;4696188000;4748002000;15757000;1816530000;1886425000;203482000;215009000;2101434000;1598185000;;1043821000;2646568000;4748002000
SNH;448715;USD;2011;Q4;2011-12-31;2012-02-17;161199000;;23560000;38000000;;68688000;4091330000;16865000;206165000;4314360000;4383048000;22281000;1827385000;1889111000;17778000;21331000;1910442000;1568441000;;907937000;2472606000;4383048000
SNH;448715;USD;2010;Q4;2010-12-31;2011-02-24;130157000;;10866000;;;15860000;3222840000;29249000;124707000;3376796000;3392656000;14993000;1076890000;1116139000;146239000;148540000;1264679000;1357923000;;756518000;2127977000;3392656000
SNH;448715;USD;2009;Q4;2009-12-31;2010-08-02;127437000;;10494000;;;14716000;2863666000;17695000;91849000;2973210000;2987926000;13693000;982219000;1015054000;69687000;72222000;1087276000;1258636000;;640033000;1900650000;2987926000
SNH;448715;USD;2017;Q4;2017-12-31;2018-02-27;237469000;237487000;31238000;;;47321000;6370286000;;876412000;7246698000;7294019000;17987000;2531066000;2777353000;1239478000;1239478000;4016831000;1251224000;;1766495000;3277188000;7294019000
STAY;448789;USD;2016;Q4;2016-12-31;2017-02-28;195822000;196189000;84158000;20837000;;126609000;3905304000;;148391000;4053695000;4180304000;1458821000;;1458821000;1319756000;1344244000;2803065000;776768000;;23679000;1377239000;4180304000
STAY;448789;USD;2015;Q4;2015-12-31;2016-02-23;204329000;204651000;373239000;18164000;;475819000;3921341000;;131740000;4053081000;4528900000;2644834000;;2644834000;361523000;395709000;3040543000;786243000;;102184000;1488357000;4528900000
STAY;448789;USD;2014;Q4;2014-12-31;2015-02-26;203842000;204755000;121324000;26552000;;221258000;4087448000;;140436000;4227884000;4449142000;2663190000;;2663190000;368641000;396635000;3059825000;781495000;;13833000;1389317000;4449142000
STAY;448789;USD;2013;Q4;2013-12-31;2014-03-20;188370000;189268000;60457000;21566000;;129362000;4127317000;;193008000;4320325000;4449687000;2694965000;365000000;3059965000;20000000;48514000;3108479000;774407000;;-25763000;1341208000;4449687000
STAY;448789;USD;2012;Q4;2012-12-31;2013-12-18;170341000;172318000;103582000;18549000;;183744000;4110622000;;197368000;4307990000;4491734000;2650070000;1080000000;3730070000;;8849000;3738919000;744524000;;5010000;752815000;4491734000
STAY;448789;USD;2017;Q4;2017-12-31;2018-02-27;191541000;192019000;113343000;21578000;;172552000;3753134000;;150319000;3903453000;4076005000;1457913000;;1457913000;1265112000;1272245000;2730158000;770600000;;6917000;1345847000;4076005000
STAY;448789;USD;2018;Q4;2018-12-31;2019-02-27;186907000;187282000;287458000;19769000;;323105000;3453632000;;147473000;3601105000;3924210000;1481368000;;1484728000;1121713000;1128843000;2613571000;751101000;;32432000;1310639000;3924210000
SWX;448826;USD;2016;Q4;2016-12-31;2017-02-28;47485000;47852000;28066000;285145000;;533307000;4131971000;;915848000;5047819000;5581126000;245529000;50101000;628375000;1549983000;3268888000;3897263000;952235000;;759263000;1683863000;5581126000
SWX;448826;USD;2015;Q4;2015-12-31;2016-02-25;47385000;47749000;35997000;314512000;;558174000;3891085000;;909426000;4800511000;5358685000;228367000;37475000;535045000;1551204000;3215207000;3750252000;945455000;;699221000;1608433000;5358685000
SWX;448826;USD;2014;Q4;2014-12-31;2015-02-26;46521000;46991000;39566000;281824000;;607432000;3658383000;;942482000;4600865000;5208297000;228795000;24192000;470117000;1631374000;3231872000;3701989000;899534000;;639164000;1506308000;5208297000
SWX;448826;USD;2013;Q4;2013-12-31;2014-02-27;46353000;46836000;41077000;219469000;;494672000;3486108000;;584394000;4070502000;4565174000;241112000;11105000;434164000;1381327000;2718615000;3152779000;888507000;;567714000;1412395000;4565174000
SWX;448826;USD;2012;Q4;2012-12-31;2013-02-27;46144000;46618000;25530000;196913000;;458417000;3343794000;;685846000;4029640000;4488057000;209391000;50137000;535129000;1268373000;2644430000;3179559000;876555000;;484369000;1308498000;4488057000
SWX;448826;USD;2011;Q4;2011-12-31;2012-02-28;45924000;46372000;21937000;209246000;;474417000;3218944000;;582646000;3801590000;4276007000;245556000;322618000;847568000;930858000;2203408000;3050976000;869226000;;406125000;1225031000;4276007000
SWX;448826;USD;2010;Q4;2010-12-31;2011-02-28;45561000;46024000;116096000;147605000;;483675000;3072436000;;428082000;3500518000;3984193000;226136000;75080000;596961000;1124681000;2220236000;2817197000;855114000;;343131000;1166996000;3984193000
SWX;448826;USD;2009;Q4;2009-12-31;2010-08-09;44995000;45368000;65315000;157722000;;467401000;3034503000;;404388000;3438891000;3906292000;219368000;101327000;574230000;1169357000;2229976000;2804206000;839061000;;285316000;1102086000;3906292000
SWX;448826;USD;2017;Q4;2017-12-31;2018-02-28;49131000;48230000;43622000;347375000;;657032000;4523650000;;1056384000;5580034000;6237066000;290064000;239846000;815881000;1798576000;3608782000;4424663000;1005052000;;857398000;1812403000;6237066000
SWX;448826;USD;2018;Q4;2018-12-31;2019-02-28;50941000;51012000;85361000;413926000;;839769000;5093238000;;1424722000;6517960000;7357729000;313922000;185060000;568005000;2107258000;4456303000;5024308000;1360425000;;944285000;2333421000;7357729000
TFX;448874;USD;2018;Q4;2018-12-31;2019-02-21;45995000;48113000;357161000;366286000;427778000;1236169000;432766000;;4609056000;5041822000;6277991000;320904000;86625000;582456000;2072200000;3155557000;3738013000;;;;2539978000;6277991000
TFX;448874;USD;2017;Q4;2017-12-31;2018-02-22;45092000;46636000;333558000;345875000;395744000;1128807000;382999000;;4669686000;5052685000;6181492000;313974000;86625000;483876000;2162927000;3267085000;3750961000;638592000;-228856000;2285886000;2430531000;6181492000
TFX;448874;USD;2016;Q4;2016-12-31;2016-10-27;44059000;47110000;543789000;271993000;316171000;1183393000;302899000;;2404921000;2707820000;3891213000;235586000;183071000;427646000;850252000;1324226000;1751872000;552614000;-170973000;2194593000;2139341000;3891213000
TFX;448874;USD;2015;Q4;2015-12-31;2015-10-29;41606000;48324000;338366000;262416000;330275000;1003839000;316123000;;2551812000;2867935000;3871774000;230519000;417350000;664120000;641850000;1196561000;1860681000;483644000;-119424000;2016176000;2011093000;3871774000
TFX;448874;USD;2014;Q4;2014-12-31;2014-10-29;41423000;47111000;303236000;273704000;335593000;995908000;317435000;;2609444000;2926879000;3922787000;244862000;368401000;632769000;700000000;1376319000;2009088000;465814000;-121455000;1827845000;1913699000;3922787000
TFX;448874;USD;2013;Q4;2013-12-31;2013-10-30;41159000;45032000;431984000;295290000;333621000;1200554000;325900000;;2682553000;3008453000;4209007000;252471000;356287000;635120000;930000000;1657871000;2292991000;452581000;-124623000;1696424000;1916016000;4209007000
TFX;448874;USD;2012;Q4;2012-12-31;2012-10-31;40943000;40080000;337039000;297976000;323347000;1073222000;297945000;;2362520000;2660465000;3733687000;241128000;4700000;275300000;965280000;1676850000;1952150000;437486000;-127948000;1601460000;1781537000;3733687000
TFX;448874;USD;2011;Q4;2011-12-31;2011-10-25;40727000;40965000;584088000;286226000;298775000;1280256000;251912000;;2391935000;2643847000;3924103000;237729000;4986000;271007000;954809000;1670313000;1941320000;423888000;-131053000;1847106000;1982783000;3924103000
TFX;448874;USD;2010;Q4;2010-12-31;2010-10-27;39987000;40311000;208452000;294196000;338598000;921233000;287705000;;2434217000;2721922000;3643155000;268473000;103711000;420763000;813409000;1435114000;1855877000;391401000;-135058000;1578913000;1787278000;3643155000
TFX;448874;USD;2009;Q4;2009-12-31;2010-07-23;39739000;40014000;188305000;265305000;360843000;1003934000;317499000;;2517572000;2835071000;3839005000;316390000;4008000;337107000;1192491000;1916824000;2253931000;319083000;-136600000;1431878000;1585074000;3839005000
UHAL;449042;USD;2017;Q4;2018-03-31;2018-05-30;19589876;19589876;759388000;;89877000;1048233000;6816741000;2318924000;563087000;9698752000;10746985000;510678000;;3157053000;3513076000;4181224000;7338277000;463243000;-677650000;3635561000;3408708000;10746985000
UHAL;449042;USD;2016;Q4;2017-03-31;2017-05-24;19587250;19587250;697806000;;82439000;991141000;5977282000;2031598000;405819000;8414699000;9405840000;450541000;;2678057000;3262880000;4108039000;6786096000;462669000;-677650000;2892893000;2619744000;9405840000
UHAL;449042;USD;2015;Q4;2016-03-31;2016-05-25;19591242;19591242;600646000;;79756000;900436000;5017511000;1802610000;388731000;7208852000;8109288000;502538000;;2548224000;2647396000;3309658000;5857882000;462126000;-677650000;2533641000;2251406000;8109288000
UHAL;449042;USD;2014;Q4;2015-03-31;2015-05-27;19593981;19593981;441850000;;69472000;779408000;4107637000;1573682000;411448000;6092767000;6872175000;496370000;;2262384000;2190869000;2725432000;4987816000;460165000;-677650000;2142600000;1884359000;6872175000
UHAL;449042;USD;2013;Q4;2014-03-31;2014-05-28;19571118;19571118;495112000;;67020000;787025000;3409211000;1387125000;415617000;5211953000;5998978000;357954000;;2088667000;1942359000;2382943000;4471610000;454707000;-677650000;1805453000;1527368000;5998978000
UHAL;449042;USD;2012;Q4;2013-03-31;2013-06-07;19536403;19536403;463744000;;56396000;759626000;2755054000;1337103000;454818000;4546975000;5306601000;358491000;;2014545000;1661845000;2062797000;4077342000;448665000;-677650000;1482630000;1229259000;5306601000
UHAL;449042;USD;2011;Q4;2012-03-31;2012-06-06;19492060;19492090;357180000;;58735000;773930000;2372365000;1025343000;482413000;3880121000;4654051000;335326000;;1753755000;1486211000;1864476000;3618231000;444240000;-677650000;1317064000;1035820000;4654051000
UHAL;449042;USD;2010;Q4;2011-03-31;2011-08-03;19449092;;375496000;;59942000;795030000;2094573000;861677000;440153000;3396403000;4191433000;304006000;;1520583000;1397842000;1677830000;3198413000;435709000;-532842000;1140002000;993020000;4191433000
USG;449068;USD;2015;Q4;2015-12-31;2015-10-22;145624186;147098846;636000000;184000000;219000000;1400000000;1771000000;718000000;847000000;3336000000;4736000000;403000000;500000000;992000000;1675000000;2308000000;3300000000;3042000000;;-1292000000;1436000000;4736000000
USG;449068;USD;2014;Q4;2014-12-31;2014-10-23;139977804;138608701;324000000;404000000;329000000;1109000000;1908000000;793000000;126000000;2827000000;3936000000;511000000;4000000;563000000;2191000000;2965000000;3528000000;3028000000;;-2283000000;408000000;3936000000
USG;449068;USD;2013;Q4;2013-12-31;2013-10-24;110056456;112349179;892000000;369000000;332000000;1700000000;2103000000;133000000;185000000;2421000000;4121000000;505000000;63000000;568000000;2292000000;2891000000;3459000000;2934000000;;-2320000000;662000000;4121000000
USG;449068;USD;2012;Q4;2012-12-31;2012-10-26;106343650;106343650;652000000;326000000;304000000;1327000000;2100000000;25000000;271000000;2396000000;3723000000;525000000;4000000;551000000;2305000000;3153000000;3704000000;2606000000;0;-2367000000;19000000;3723000000
VMI;449113;USD;2016;Q4;2016-12-31;2017-03-01;22441000;22612000;399948000;439342000;350028000;1253216000;518335000;;620180000;1138515000;2391731000;348251000;1597000;349848000;754795000;1059297000;1409145000;27900000;-612781000;1874722000;982586000;2391731000
VMI;449113;USD;2015;Q4;2015-12-31;2016-02-24;22891000;23018000;349074000;466443000;340672000;1226852000;532489000;;633041000;1165530000;2392382000;364501000;2053000;366554000;756918000;1060617000;1427171000;27900000;-571920000;1729679000;965211000;2392382000
VMI;449113;USD;2014;Q4;2014-12-31;2015-02-25;24251000;24409000;371579000;536918000;359522000;1392941000;606453000;;730274000;1336727000;2729668000;382081000;15133000;397214000;766654000;1082049000;1479263000;27900000;-410296000;1718662000;1250405000;2729668000
VMI;449113;USD;2013;Q4;2013-12-31;2014-02-25;26668000;26908000;613706000;515440000;380000000;1597840000;534210000;;644444000;1178654000;2776494000;417354000;19226000;436580000;470907000;795068000;1231648000;27900000;-20860000;1562670000;1544846000;2776494000
VMI;449113;USD;2012;Q4;2012-12-31;2013-02-26;26519000;26814000;414129000;515902000;412384000;1425940000;512612000;;629999000;1142611000;2568551000;398834000;13599000;412433000;472593000;749108000;1161541000;27900000;-22455000;1300529000;1407010000;2568551000
VMI;449113;USD;2011;Q4;2011-12-31;2012-02-28;26361000;26499000;362894000;426683000;393782000;1252943000;454877000;;598256000;1053133000;2306076000;396432000;11638000;408070000;474415000;700095000;1108165000;27900000;-24688000;1079698000;1197911000;2306076000
VMI;449113;USD;2010;Q4;2010-12-31;2011-02-23;26149000;26417000;346904000;410566000;280223000;1094226000;439609000;;556908000;996517000;2090743000;337852000;9062000;346914000;468596000;733702000;1080616000;27900000;-25922000;850269000;1010127000;2090743000
VMI;449113;USD;2009;Q4;2009-12-31;2010-08-03;25996000;26385000;180786000;259521000;210611000;715422000;283088000;;303659000;586747000;1302169000;244686000;12131000;256817000;160251000;237045000;493862000;27900000;-25990000;767398000;808307000;1302169000
VMI;449113;USD;2017;Q4;2017-12-31;2018-02-28;22564000;22801000;492805000;503677000;420948000;1472565000;518928000;;610757000;1129685000;2602250000;401871000;1127000;402998000;753888000;1047457000;1450455000;27900000;-590386000;1954344000;1151795000;2602250000
VMI;449113;USD;2018;Q4;2018-12-31;2019-02-27;21962000;22063000;313210000;483963000;383566000;1340640000;513992000;;675642000;1189634000;2530274000;397578000;11457000;409035000;741822000;985716000;1394751000;27900000;-692549000;2027596000;1135523000;2530274000
WFT_old;449193;USD;2013;Q4;2013-12-31;2014-02-25;776000000;766000000;435000000;3594000000;3371000000;8774000000;8368000000;296000000;4539000000;13203000000;21977000000;2746000000;1666000000;5699000000;7061000000;8075000000;13774000000;5375000000;-37000000;3011000000;8203000000;21977000000
WFT_old;449193;USD;2012;Q4;2012-12-31;2013-03-04;768000000;758000000;300000000;3885000000;3675000000;9029000000;8299000000;646000000;4821000000;13766000000;22795000000;2765000000;1585000000;5710000000;7049000000;8267000000;13977000000;5449000000;-182000000;3356000000;8818000000;22795000000
WFT_old;449193;USD;2011;Q4;2011-12-31;2012-03-15;760000000;764000000;371000000;3233000000;3158000000;7731000000;7287000000;616000000;5417000000;13320000000;21051000000;2151000000;1320000000;4283000000;6286000000;7423000000;11706000000;5444000000;-334000000;4134000000;9345000000;21051000000
WFT_old;449193;USD;2010;Q4;2010-12-31;2011-03-11;745000000;740000000;416000000;2629000000;2590000000;6495000000;6945000000;540000000;5219000000;12704000000;19199000000;1768000000;235000000;2701000000;6530000000;7380000000;10081000000;5378000000;-478000000;3949000000;9118000000;19199000000
WFT_old;449193;USD;2009;Q4;2009-12-31;2010-03-01;1434763673;1446776364;253000000;2511000000;2238000000;6045000000;6995000000;533000000;5209000000;12737000000;18782000000;1564000000;870000000;3056000000;5847000000;6551000000;9607000000;5396000000;-608000000;4166000000;9175000000;18782000000
WFT_old;449193;USD;2008;Q4;2008-12-31;2009-09-01;686223000;692415000;238398000;2442848000;2084160000;5565400000;5922172000;509525000;4473090000;10904787000;16470187000;1489491000;1255947000;3287090000;4564255000;5054504000;8341594000;4787801000;-759477000;4286629000;8128593000;16470187000
WGL;449198;USD;2017;Q4;2017-09-30;2017-11-22;51212000;51486000;8524000;775591000;20172000;985889000;4630051000;0;1010069000;5640120000;6626009000;476178000;809844000;1488988000;1430861000;3599307000;5088295000;;;;1537714000;6626009000
WGL;449198;USD;2016;Q4;2016-09-30;2016-11-22;51038000;51039000;5573000;682858000;18414000;843474000;4127237000;29780000;1048959000;5205976000;6049450000;456187000;331385000;1026926000;1435045000;3618381000;4645307000;;;;1404143000;6049450000
WGL;449198;USD;2015;Q4;2015-09-30;2015-11-19;49781000;50437000;6733000;564137000;21402000;748541000;3672728000;35234000;804856000;4512818000;5261359000;377449000;357000000;982914000;944201000;3007025000;3989939000;;;;1271420000;5261359000
WGL;449198;USD;2014;Q4;2014-09-30;2014-11-21;51424000;51433000;8811000;628828000;23647000;835515000;3314445000;18159000;688380000;4020984000;4856499000;359153000;473500000;1020285000;679228000;2561465000;3581750000;;;;1274749000;4856499000
WGL;449198;USD;2018;Q4;2018-09-30;2018-11-20;;;57969000;710477000;20696000;981808000;4885429000;;1380850000;6266279000;7248087000;568057000;769697000;1558184000;1879875000;3857520000;5415704000;;;;1832383000;7248087000
WOOF;449230;USD;2016;Q4;2016-12-31;2017-02-28;81169000;81836000;81409000;85593000;57590000;281049000;613224000;;2479055000;3092279000;3373328000;258176000;38320000;296496000;1309397000;1496492000;1792988000;32238000;;1484391000;1580340000;3373328000
WOOF;449230;USD;2015;Q4;2015-12-31;2016-02-26;80654000;81404000;98888000;76634000;51523000;282164000;507753000;;1711215000;2218968000;2501132000;198684000;33623000;232307000;832718000;1000280000;1232587000;19789000;;1275207000;1268545000;2501132000
WOOF;449230;USD;2014;Q4;2014-12-31;2015-02-27;83971000;85328000;81383000;60482000;56050000;253116000;468041000;;1580532000;2048573000;2301689000;177862000;19356000;197218000;775412000;881773000;1078991000;155885000;;1064158000;1222698000;2301689000
WOOF;449230;USD;2013;Q4;2013-12-31;2014-02-28;88741000;89775000;125029000;59900000;55067000;309865000;448366000;;1469978000;1918344000;2228209000;153061000;51087000;204148000;568558000;695767000;899915000;384886000;;928720000;1328294000;2228209000
WOOF;449230;USD;2012;Q4;2012-12-31;2013-03-01;88378000;89252000;68435000;55912000;51456000;243529000;403444000;;1444607000;1848051000;2091580000;146440000;39002000;185442000;591641000;704754000;890196000;390447000;;791209000;1201384000;2091580000
WOOF;449230;USD;2011;Q4;2011-12-31;2012-02-29;86837000;87774000;63651000;58279000;48661000;237157000;370646000;;1387565000;1758211000;1995368000;124423000;32571000;156994000;586282000;713458000;870452000;361802000;;745658000;1124916000;1995368000
WOOF;449230;USD;2010;Q4;2010-12-31;2011-02-28;86245000;87192000;97126000;49224000;40760000;246314000;331687000;;1188421000;1520108000;1766422000;113493000;28101000;141594000;498935000;609544000;751138000;347934000;;650253000;1015284000;1766422000
WOOF;449230;USD;2009;Q4;2009-12-31;2010-08-10;85581000;86709000;145181000;49186000;32031000;278210000;289415000;;1059779000;1349194000;1627404000;105163000;17195000;122358000;527860000;613708000;736066000;335200000;;540010000;891338000;1627404000
WPX;449237;USD;2016;Q4;2016-12-31;2017-02-23;334900000;334900000;496000000;168000000;36000000;754000000;6474000000;;36000000;6510000000;7264000000;523000000;;677000000;2575000000;3121000000;3798000000;6806000000;;-3572000000;3466000000;7264000000
WPX;449237;USD;2015;Q4;2015-12-31;2016-02-25;276500000;272900000;38000000;300000000;46000000;893000000;6522000000;;978000000;7500000000;8393000000;580000000;;733000000;3189000000;4125000000;4858000000;6167000000;;-2971000000;3535000000;8393000000
WPX;449237;USD;2014;Q4;2014-12-31;2015-02-26;203300000;209800000;41000000;459000000;45000000;1869000000;6842000000;;67000000;6909000000;8778000000;889000000;;1209000000;2260000000;3141000000;4350000000;5564000000;;-1244000000;4428000000;8778000000
WPX;449237;USD;2013;Q4;2013-12-31;2014-02-27;201000000;197600000;47000000;518000000;66000000;922000000;6760000000;;747000000;7507000000;8429000000;801000000;;1007000000;1911000000;3212000000;4219000000;5518000000;;-1408000000;4210000000;8429000000
WPX;449237;USD;2012;Q4;2012-12-31;2013-02-28;199100000;199100000;153000000;443000000;66000000;772000000;8416000000;145000000;123000000;8684000000;9456000000;710000000;;726000000;1508000000;3359000000;4085000000;5489000000;;-223000000;5371000000;9456000000
WPX;449237;USD;2011;Q4;2011-12-31;2012-05-04;197100000;197100000;526000000;509000000;73000000;1674000000;8222000000;125000000;411000000;8758000000;10432000000;888000000;;1156000000;1503000000;3517000000;4673000000;5459000000;;;5759000000;10432000000
WPX;449237;USD;2017;Q4;2017-12-31;2018-02-22;398200000;348700000;189000000;307000000;30000000;1401000000;6691000000;70000000;45000000;6806000000;8207000000;655000000;;846000000;2575000000;3234000000;4080000000;7483000000;;-3588000000;4127000000;8207000000
WRI;449242;USD;2017;Q4;2017-12-31;2018-02-28;127821000;131564000;13219000;104357000;;117576000;3387525000;317763000;373775000;4079063000;4196639000;116463000;;305645000;2081152000;2081152000;2386797000;1775963000;;;1809842000;4196639000
WRI;449242;USD;2016;Q4;2016-12-31;2016-11-09;127504000;131373000;16257000;94466000;;110723000;3605078000;289192000;421935000;4316205000;4426928000;116859000;;308746000;2356528000;2401286000;2710032000;1721986000;;;1716896000;4426928000
WRI;449242;USD;2015;Q4;2015-12-31;2015-11-02;123375000;121690000;22168000;84782000;;106950000;3209680000;267041000;318274000;3794995000;3901945000;112205000;;243658000;2113277000;2113277000;2356935000;1619986000;;;1545010000;3901945000
WRI;449242;USD;2014;Q4;2014-12-31;2014-11-06;121710000;127561000;23189000;77781000;;100970000;3051145000;257156000;396644000;3704945000;3805915000;112479000;;236963000;1930009000;1930009000;2166972000;1710580000;;;1638943000;3805915000
WRI;449242;USD;2013;Q4;2013-12-31;2013-11-06;121373000;122512000;91576000;82351000;;187257000;3353850000;266158000;416664000;4036672000;4223929000;108535000;;236107000;2299844000;2299844000;2535951000;1682912000;;;1687978000;4223929000
WRI;449242;USD;2012;Q4;2012-12-31;2012-11-08;120876000;122874000;19604000;79540000;;188920000;3359011000;289049000;347804000;3995864000;4184784000;119699000;;240599000;2204030000;2204030000;2444629000;1937846000;;;1740155000;4184784000
WRI;449242;USD;2011;Q4;2011-12-31;2011-11-09;120424000;119465000;13642000;86530000;;249376000;3702236000;341608000;295006000;4338850000;4588226000;124888000;;232807000;2531837000;2531837000;2764644000;1987619000;;;1823582000;4588226000
WRI;449242;USD;2010;Q4;2010-12-31;2010-11-05;120043000;120990000;23859000;95859000;;304506000;3806545000;347526000;349278000;4503349000;4807855000;126767000;;238150000;2589448000;2589448000;2827598000;1973535000;;;1980257000;4807855000
WRI;449242;USD;2009;Q4;2009-12-31;2010-08-09;;;153584000;96372000;;567794000;3802115000;315248000;205228000;4322591000;4890385000;137727000;;251882000;2531847000;2531847000;2783729000;1962590000;;;2106656000;4890385000
WRI;449242;USD;2018;Q4;2018-12-31;2019-02-28;127648000;125558000;65865000;97924000;;163789000;2996880000;353828000;312464000;3663172000;3826961000;113175000;;281578000;1794684000;1794684000;2076262000;1770886000;;;1750699000;3826961000
WTR;449267;USD;2018;Q4;2018-12-31;2019-02-26;177991000;178728000;3627000;101225000;15844000;147172000;5930326000;;886998000;6817324000;6964496000;194653000;144545000;398977000;2398464000;4556155000;4955132000;910954000;-75835000;1174245000;2009364000;6964496000
WTR;449267;USD;2017;Q4;2017-12-31;2018-02-28;177700000;178562000;4204000;98596000;14361000;131246000;5399860000;;801357000;6201217000;6332463000;170719000;113769000;284488000;2007753000;4090354000;4374842000;897485000;-73280000;1132556000;1957621000;6332463000
WTR;449267;USD;2016;Q4;2016-12-31;2017-02-24;177364000;177664000;3763000;97394000;12961000;128650000;5001615000;;1028726000;6030341000;6158991000;150865000;150671000;301536000;1737605000;4007387000;4308923000;887668000;-71113000;1032844000;1850068000;6158991000
WTR;449267;USD;2015;Q4;2015-12-31;2016-02-26;176476000;176868000;3229000;99146000;12414000;128370000;4688925000;;900578000;5589503000;5717873000;157606000;35593000;193199000;1720447000;3798744000;3991943000;863267000;-68085000;930061000;1725930000;5717873000
WTR;449267;USD;2014;Q4;2014-12-31;2015-02-27;176659000;177322000;4138000;96999000;12788000;152522000;4401990000;;852240000;5254230000;5406752000;166720000;58615000;225335000;1560655000;3526034000;3751369000;847441000;-42838000;849952000;1655383000;5406752000
WTR;449267;USD;2013;Q4;2013-12-31;2014-03-03;176679000;176104000;5058000;94704000;11353000;200854000;4138568000;;712395000;4850963000;5051817000;163942000;86288000;279879000;1468583000;3236895000;3516774000;832299000;-27082000;729272000;1535043000;5051817000
WTR;449267;USD;2012;Q4;2012-12-31;2013-02-28;174870500;174940250;5521000;92921000;11757000;260894000;3936163000;;661460000;4597623000;4858517000;205489000;45038000;274164000;1543954000;3198461000;3472625000;788954000;-14668000;611303000;1385892000;4858517000
WTR;449267;USD;2011;Q4;2011-12-31;2012-02-27;173113000;173299000;8204000;75546000;11014000;405358000;3530942000;;412120000;3943062000;4348420000;229218000;80429000;446818000;1395457000;2649785000;3096603000;755868000;-13145000;508334000;1251817000;4348420000
WTR;449267;USD;2010;Q4;2010-12-31;2011-02-25;171753750;172472500;5934000;78170000;9912000;301518000;3357357000;;413591000;3770948000;4072466000;191589000;28087000;323275000;1491370000;2574365000;2897640000;733592000;-12307000;452470000;1174826000;4072466000
WTR;449267;USD;2009;Q4;2009-12-31;2010-08-06;170306250;170622500;21869000;78742000;9519000;121571000;3214559000;;413732000;3628291000;3749862000;141430000;59577000;201007000;1386557000;2439391000;2640398000;711360000;-12138000;409402000;1109464000;3749862000
WWD;449272;USD;2017;Q4;2017-09-30;2017-11-13;61307000;63486000;87552000;402182000;473505000;1021189000;922043000;;813877000;1735920000;2757109000;394634000;32600000;427234000;580286000;958492000;1385726000;163942000;-559641000;1820268000;1371383000;2757109000
WWD;449272;USD;2016;Q4;2016-09-30;2016-07-21;61538000;63599000;81090000;343768000;461683000;944424000;876350000;;821588000;1697938000;2642362000;330613000;150000000;480613000;577153000;949154000;1429767000;141676000;-512882000;1649506000;1212595000;2642362000
WWD;449272;USD;2015;Q4;2015-09-30;2015-07-21;63474000;64718000;82202000;322215000;447664000;917419000;756100000;;838885000;1594985000;2512404000;335778000;2430000;338208000;848488000;1021092000;1359300000;131337000;-422049000;1495274000;1153104000;2512404000
WWD;449272;USD;2014;Q4;2014-09-30;2014-07-22;65526000;67031000;115287000;346858000;451944000;1008644000;513279000;;875279000;1388558000;2397202000;339544000;0;340016000;710000000;896242000;1236258000;112597000;-286588000;1338468000;1160944000;2397202000
WWD;449272;USD;2013;Q4;2013-09-30;2013-07-26;68047000;69330000;48556000;381065000;431744000;957113000;350048000;;911357000;1261405000;2218518000;315130000;100000000;415930000;450000000;660043000;1075973000;101253000;-167710000;1193887000;1142545000;2218518000
WWD;449272;USD;2012;Q4;2012-09-30;2012-07-24;68602000;69892000;61829000;354386000;398229000;903477000;234505000;;721982000;956487000;1859964000;271239000;7829000;279868000;384375000;571981000;851849000;97932000;-147905000;1069811000;1008115000;1859964000
WWD;449272;USD;2011;Q4;2011-09-30;2011-07-26;68832000;70106000;74539000;297614000;381555000;817793000;206725000;;756916000;963641000;1781434000;262409000;18374000;280857000;406875000;581480000;862337000;81559000;-115661000;949573000;919097000;1781434000
WWD;449272;USD;2010;Q4;2010-09-30;2010-07-29;68602000;69883000;105579000;248513000;295034000;719142000;193524000;;750567000;944091000;1663233000;221973000;40592000;262565000;425250000;597474000;860039000;74021000;-113088000;835919000;803194000;1663233000
WWD;449272;USD;2009;Q4;2009-09-30;2010-07-29;68071000;69262000;100863000;209626000;302339000;696244000;208885000;;791293000;1000178000;1696422000;216509000;45569000;262078000;526771000;722829000;984907000;73303000;-115478000;741505000;711515000;1696422000
WWD;449272;USD;2018;Q4;2018-09-30;2018-11-13;61717000;64164000;83594000;431820000;549596000;1114797000;1060005000;;1615847000;2675852000;3790649000;437543000;153635000;591178000;1092397000;1661367000;2252545000;185811000;-539408000;1966643000;1538104000;3790649000
Y;449291;USD;2017;Q4;2017-12-31;2018-02-21;15391390;15342310;4937842000;;;5872150000;125337000;14701175000;4685655000;19512167000;25384317000;156376000;;13096533000;1484897000;3667191000;16763724000;3629569000;-824906000;5091282000;8620593000;25384317000
Y;449291;USD;2016;Q4;2016-12-31;2017-02-22;15415695;15428849;3703614000;;;4587019000;112920000;15001746000;4054906000;19169572000;23756591000;90659000;;12089939000;1476489000;3651987000;15741926000;3629453000;-812840000;5014048000;8014665000;23756591000
Y;449291;USD;2015;Q4;2015-12-31;2016-02-23;15574269;15598399;3481175000;;;4360720000;101306000;14826531000;3550522000;18478359000;22839079000;69297000;;11763229000;1419363000;3495424000;15258653000;3629091000;-747784000;4557127000;7580426000;22839079000
Y;449291;USD;2014;Q4;2014-12-31;2015-02-24;16151228;16151228;3420743000;;;4332304000;88910000;16019859000;3048363000;19157132000;23489436000;79100000;;12406083000;1767125000;3601309000;16007392000;3628177000;-507699000;3999366000;7482044000;23489436000
Y;449291;USD;2013;Q4;2013-12-31;2014-02-25;16776723;16776723;2727768000;;;3562453000;58974000;16762709000;2976952000;19798635000;23361088000;90562000;;12853610000;1794407000;3559957000;16413567000;3630611000;-213911000;3320127000;6947521000;23361088000
Y;449291;USD;2012;Q4;2012-12-31;2013-02-21;16958684;16910735;2073538000;;;2904523000;34118000;16902932000;2966394000;19903444000;22807967000;67654000;;12887355000;1811483000;3516825000;16404180000;3637391000;-175818000;2691706000;6403787000;22807967000
Y;449291;USD;2011;Q4;2011-12-31;2012-02-24;8572714;8566080;955699000;;;1131584000;17906000;3955860000;1372739000;5346505000;6478089000;61709000;;2703637000;299035000;848775000;3552412000;947155000;-167319000;1990309000;2925677000;6478089000
Y;449291;USD;2010;Q4;2010-12-31;2011-02-25;8979646;8945188;1577427000;;;1705502000;19504000;3304516000;1402177000;4726197000;6431699000;44720000;;2699981000;298923000;822850000;3522831000;937934000;-99686000;1900358000;2908868000;6431699000
Y;449291;USD;2009;Q4;2009-12-31;2010-08-05;;;657072000;;;803064000;20097000;3790143000;1579466000;5389706000;6192770000;55622000;;2901343000;0;573906000;3475249000;930343000;-66325000;1759458000;2717521000;6192770000
Y;449291;USD;2018;Q4;2018-12-31;2019-02-20;14743775;14714394;4611553000;;;5662745000;195243000;13950248000;5536660000;19682151000;25344896000;168667000;;13546307000;1669039000;3936117000;17482424000;3630290000;-1312939000;5577362000;7862472000;25344896000
SNAP;449958;USD;2017;Q4;2017-12-31;2018-02-22;1252901000;1252901000;2043039000;279473000;;2366794000;166762000;;888010000;1054772000;3421566000;346256000;;346256000;;82983000;429239000;7634837000;;-4656667000;2992327000;3421566000
SNAP;449958;USD;2016;Q4;2016-12-31;2017-05-11;835874000;835874000;987368000;162659000;;1179985000;100585000;;442222000;542807000;1722792000;156744000;;156744000;;47134000;203878000;2728833000;;-1207862000;1518914000;1722792000
SNAP;449958;USD;2018;Q4;2018-12-31;2019-02-06;1326510000;1326510000;1279063000;354965000;;1675928000;212560000;;825618000;1038178000;2714106000;292691000;;292691000;;110416000;403107000;8220430000;;-5912578000;2310999000;2714106000
AR;466098;USD;2015;Q4;2015-12-31;2016-02-24;277187206;277253920;23473000;79404000;;1248236000;10732242000;;2135015000;12867257000;14115493000;558236000;;707270000;4668782000;6121545000;6828815000;4125581000;;1808811000;7286678000;14115493000
AR;466098;USD;2014;Q4;2014-12-31;2015-02-25;262066734;262102804;245979000;116203000;;1252160000;9352452000;;968883000;10321335000;11573495000;700178000;;894732000;4362550000;5204933000;6099665000;3516346000;;867447000;5473830000;11573495000
AR;466098;USD;2013;Q4;2013-12-31;2014-02-27;262049659;262049659;17487000;30610000;;333564000;5559656000;;720361000;6280017000;6613581000;447766000;;622229000;2078999000;2392692000;3014921000;3404800000;;193860000;3598660000;6613581000
AR;466098;USD;2012;Q4;2012-12-31;2013-11-06;;;18989000;21296000;;274606000;2937473000;;406714000;3344187000;3618793000;240307000;25000000;376296000;1444058000;1568760000;1945056000;1460947000;;212790000;1673737000;3618793000
ETSY;469839;USD;2016;Q4;2016-12-31;2017-02-28;112079286;112079286;282086000;26426000;;371032000;126407000;;83754000;210161000;581193000;64974000;6829000;84008000;5296000;152428000;236436000;442626000;;-116341000;344757000;581193000
ETSY;469839;USD;2015;Q4;2015-12-31;2016-03-01;112952590;112952590;292864000;20275000;;359054000;105021000;;88986000;194007000;553061000;64897000;5610000;80122000;7571000;142441000;222563000;406133000;;-86440000;330498000;553061000
ETSY;469839;USD;2014;Q4;2014-12-31;2015-05-22;43303452;43303452;88843000;15404000;;127061000;75538000;;43604000;119142000;246203000;31656000;1755000;41453000;3148000;137662000;179115000;103399000;;-32377000;67088000;246203000
ETSY;469839;USD;2017;Q4;2017-12-31;2018-03-01;114510227;129426171;340550000;33677000;;439264000;117617000;;48702000;166319000;605583000;87023000;5798000;102477000;4115000;106212000;208689000;499563000;;-96290000;396894000;605583000
ETSY;469839;USD;2018;Q4;2018-12-31;2019-02-28;119996307;127928929;624287000;12244000;;680289000;120179000;0;101383000;221562000;901851000;96775000;3884000;112062000;278581000;388891000;500953000;562153000;;-153442000;400898000;901851000
EPD;469948;USD;2016;Q4;2016-12-31;2017-02-24;;2117200000;63100000;3329500000;1770500000;6528200000;33292500000;;12373300000;45665800000;52194000000;4457300000;2576800000;8250500000;21120900000;21677500000;29928000000;22327000000;;;22266000000;52194000000
EPD;469948;USD;2015;Q4;2015-12-31;2016-02-26;;2015100000;19000000;2569900000;1038100000;4298300000;32034700000;;12469200000;44503900000;48802200000;4773900000;1863900000;7166600000;20676900000;21134500000;28301100000;20514300000;;;20501100000;48802200000
EPD;469948;USD;2014;Q4;2014-12-31;2015-03-02;;1941100000;74400000;3823000000;1014200000;5490700000;29881600000;;11828700000;41710300000;47201000000;5081500000;2206400000;7873700000;19157400000;19635100000;27508800000;18304800000;;;19692200000;47201000000
EPD;469948;USD;2013;Q4;2013-12-31;2014-03-03;;1865400000;56900000;5475500000;1093100000;7023400000;26946600000;;6168700000;33115300000;40138700000;6787200000;1125000000;8238700000;16226500000;16459600000;24698300000;15573800000;;;15440400000;40138700000
EPD;469948;USD;2012;Q4;2012-12-31;2013-03-01;;1805600000;16100000;4350900000;1088400000;5843100000;24846400000;;5244900000;30091300000;35934400000;5668600000;1546600000;7755700000;14655200000;14882700000;22638400000;13558100000;;;13296000000;35934400000
EPD;469948;USD;2011;Q4;2011-12-31;2012-02-29;4968996728;1759400000;19800000;4501800000;1111700000;6068700000;22191600000;;5864800000;28056400000;34125100000;6319800000;500000000;7432400000;14029400000;14473400000;21905800000;12464800000;;;12219300000;34125100000
EPD;469948;USD;2010;Q4;2010-12-31;2011-03-01;2195998752;2227998752;65500000;3800100000;1134000000;5507100000;19332900000;;6520800000;25853700000;31360800000;5092800000;282300000;5880200000;13281200000;13579800000;19460000000;11406700000;;;11900800000;31360800000
EPD;469948;USD;2009;Q4;2009-12-31;2010-03-01;;;55300000;3099000000;711900000;4249600000;17689200000;;5747500000;23436700000;27686300000;4106100000;0;4553900000;12427900000;12659300000;17213200000;1972400000;;;10473100000;27686300000
EPD;469948;USD;2008;Q4;2008-12-31;2009-08-06;;;61700000;2028500000;405000000;3102700000;16732800000;;4376100000;21108900000;24211600000;2506000000;;3101200000;11637900000;11814500000;14915700000;6186700000;;;9295900000;24211600000
EPD;469948;USD;2017;Q4;2017-12-31;2018-02-28;;2167400000;5100000;4358400000;1609800000;6506400000;35620400000;;12291300000;47911700000;54418100000;5853300000;2855000000;9295100000;21713700000;22350600000;31645700000;22718900000;;;22772400000;54418100000
EPD;469948;USD;2018;Q4;2018-12-31;2019-03-01;;2194900000;344800000;3659100000;1522100000;6060700000;38737600000;;12171500000;50909100000;56969800000;5114400000;1500100000;7167500000;24678100000;25510100000;32677600000;23802600000;;;24292200000;56969800000
XCO;470616;USD;2016;Q4;2016-12-31;2017-03-16;19609450;19527410;9068000;52674000;;110617000;334758000;;216039000;550797000;661414000;59463000;50344000;258363000;1258538000;1274957000;1533320000;3538099000;-7632000;-4402373000;-871906000;661414000
XCO;470616;USD;2015;Q4;2015-12-31;2016-03-02;19464550;19464550;12247000;37236000;;149801000;558044000;;246281000;804325000;954126000;95895000;50845000;252919000;1320279000;1363530000;1616449000;3522429000;-7632000;-4177120000;-662323000;954126000
XCO;470616;USD;2014;Q4;2014-12-31;2015-02-25;18983510;18864720;46305000;81720000;;330766000;1713637000;;260539000;1974176000;2304942000;136476000;1769000;329436000;1430516000;1465502000;1794938000;3502479000;-7615000;-2984860000;510004000;2304942000
XCO;470616;USD;2013;Q4;2013-12-31;2014-02-26;15079120;19439560;50483000;128352000;;305854000;1819188000;;283586000;2102774000;2408628000;127361000;32057000;349170000;1858912000;1911608000;2260778000;3219963000;-7479000;-3064634000;147850000;2408628000
XCO;470616;USD;2012;Q4;2012-12-31;2013-02-21;15027180;15027180;45644000;84348000;5705000;361866000;1336711000;;625155000;1961866000;2323732000;100269000;1200000;237931000;1848972000;1936408000;2174339000;3200282000;-7479000;-3043410000;149393000;2323732000
XCO;470616;USD;2011;Q4;2011-12-31;2012-02-27;14990150;15111810;31997000;88518000;8345000;678008000;2509422000;;604157000;3113579000;3791587000;135941000;732000;287399000;1887828000;1945856000;2233255000;3181278000;-7479000;-1615467000;1558332000;3791587000
XCO;470616;USD;2010;Q4;2010-12-31;2011-02-24;14895790;15179780;44229000;80740000;7876000;520460000;1791312000;;1165648000;2956960000;3477420000;172193000;900000;285698000;1588269000;1651170000;1936868000;3151727000;-7479000;-1603696000;1540552000;3477420000
XCO;470616;USD;2009;Q4;2009-12-31;2010-08-04;14819700;14819700;68407000;56485000;15830000;402088000;1393692000;;563114000;1956806000;2358894000;129394000;900000;212914000;1196277000;1286392000;1499306000;3105450000;0;-2245862000;859588000;2358894000
XCO;470616;USD;2017;Q4;2017-12-31;2018-03-15;22480110;22271540;39597000;55692000;;167830000;473907000;;198610000;672517000;840347000;95914000;1363100000;1666970000;;19576000;1686546000;3539444000;-7632000;-4378011000;-846199000;840347000
XCO;470616;USD;2018;Q4;2018-12-31;2019-03-18;21611000;21611000;46541000;61947000;;170143000;657132000;;205418000;862550000;1032693000;72013000;473964000;591293000;;1467896000;2059189000;3541844000;-7632000;-4560708000;-1026496000;1032693000
BERY;470977;USD;2017;Q4;2017-09-30;2017-11-21;130800000;134200000;306000000;847000000;762000000;2004000000;2366000000;;4106000000;6472000000;8476000000;1101000000;33000000;1134000000;5608000000;6327000000;7461000000;824000000;;256000000;1015000000;8476000000
BERY;470977;USD;2016;Q4;2016-09-30;2016-11-30;121500000;124800000;323000000;704000000;660000000;1792000000;2224000000;;3637000000;5861000000;7653000000;988000000;43000000;1031000000;5712000000;6401000000;7432000000;450000000;;-84000000;221000000;7653000000
BERY;470977;USD;2018;Q4;2018-09-30;2018-11-16;131600000;133600000;381000000;941000000;887000000;2285000000;2488000000;;4358000000;6846000000;9131000000;1199000000;38000000;1237000000;5806000000;6460000000;7697000000;868000000;;719000000;1434000000;9131000000
EEFT;484269;USD;2016;Q4;2017-02-28;2017-03-01;52226381;53169911;734414000;502989000;78115000;1584988000;202145000;;925739000;1127884000;2712872000;1099446000;35454000;1179100000;568632000;633215000;1812315000;1046831000;-215462000;278842000;900557000;2712872000
EEFT;484269;USD;2015;Q4;2016-02-29;2015-11-02;52872130;54477796;457518000;423299000;72108000;1131010000;157368000;;904336000;1061704000;2192714000;853994000;14051000;903932000;409619000;462854000;1366786000;1024413000;-138750000;104427000;825928000;2192714000
EEFT;484269;USD;2014;Q4;2015-02-28;2014-10-28;52055000;54446958;468010000;375579000;85675000;1105916000;125307000;;807224000;932531000;2038447000;801593000;13372000;848881000;399404000;456754000;1305635000;956844000;-133788000;5619000;732812000;2038447000
EEFT;484269;USD;2013;Q4;2014-02-28;2013-10-31;50371138;53591931;209826000;394059000;92757000;840450000;116230000;;641510000;757740000;1598190000;686289000;13264000;732086000;191382000;227649000;959735000;810726000;-68122000;-96029000;638455000;1598190000
EEFT;484269;USD;2012;Q4;2013-02-28;2012-02-29;50002239;51023830;201435000;370836000;101168000;813179000;115475000;;622882000;738357000;1551536000;652649000;9948000;696706000;291292000;328290000;1024996000;784568000;-67327000;-184015000;526540000;1551536000
EEFT;484269;USD;2011;Q4;2012-02-29;2011-11-04;50372577;51895684;170663000;349543000;98819000;753970000;102900000;;649459000;752359000;1506329000;573382000;172832000;774486000;165943000;206099000;980585000;767261000;-21869000;-204550000;525744000;1506329000
EEFT;484269;USD;2010;Q4;2011-02-28;2010-11-04;50843074;49054523;187235000;288765000;97225000;728014000;91527000;;589831000;681358000;1409372000;555649000;4936000;571360000;288468000;320109000;891469000;753238000;-5212000;-241511000;517903000;1409372000
EEFT;484269;USD;2009;Q4;2010-02-28;2010-08-06;50668481;52311803;183528000;282905000;87661000;658586000;96592000;;657501000;754093000;1412679000;472621000;5637000;491578000;322280000;355611000;847189000;742012000;-1483000;-203139000;565490000;1412679000
EEFT;484269;USD;2017;Q4;2018-02-28;2018-03-01;52702555;54548051;819144000;744879000;;1890186000;268303000;;981540000;1249843000;3140029000;1309067000;46657000;1407720000;413765000;532831000;1940551000;1073183000;-217161000;436954000;1199478000;3140029000
EEFT;484269;USD;2018;Q4;2019-02-28;2019-02-28;51641546;56801015;1054357000;693616000;;2087587000;291869000;;941699000;1233568000;3321155000;1275626000;43475000;1378394000;597981000;709919000;2088313000;1105462000;-391551000;669805000;1232842000;3321155000
MNKD;486138;USD;2017;Q4;2017-12-31;2018-02-27;116669000;116669000;43946000;2789000;2657000;57216000;26922000;;437000;27359000;84575000;19433000;52745000;87597000;121996000;211710000;299307000;2640184000;;-2854898000;-214732000;84575000
MNKD;486138;USD;2016;Q4;2016-12-31;2017-03-16;95753000;94960000;22895000;30859000;2331000;77488000;28927000;;648000;29575000;107063000;11200000;71339000;92051000;123577000;198605000;290656000;2553996000;;-2737565000;-183593000;107063000
MNKD;486138;USD;2015;Q4;2015-12-31;2015-11-09;83907000;83907000;59074000;23000;;76654000;48749000;;1009000;49758000;126412000;23528000;74582000;268319000;81305000;208422000;476741000;2512920000;;-2863229000;-350329000;126412000
MNKD;486138;USD;2014;Q4;2014-12-31;2014-11-10;79436600;79436600;120841000;50436000;9670000;201153000;192127000;;1159000;193286000;394439000;33600000;172350000;403353000;;64856000;468209000;2421028000;;-2494784000;-73770000;394439000
MNKD;486138;USD;2013;Q4;2013-12-31;2013-11-12;67575200;67575200;70790000;;;76275000;176557000;;5814000;182371000;258646000;25494000;102300000;127794000;98439000;161565000;289359000;2265693000;;-2296402000;-30713000;258646000
MNKD;486138;USD;2012;Q4;2012-12-31;2012-11-09;;;61840000;450000;;66810000;183961000;;543000;184504000;251314000;30332000;114443000;144775000;97583000;-1887694000;-1742919000;1994239000;;;1994233000;251314000
MNKD;486138;USD;2011;Q4;2011-12-31;2011-11-04;;;2681000;;;5821000;193029000;;703000;193732000;199553000;25360000;;25360000;210642000;-1447701000;-1422341000;1621850000;;;1621894000;199553000
MNKD;486138;USD;2010;Q4;2010-12-31;2011-08-04;;;70431000;674000;;73954000;202356000;;946000;203302000;277256000;18134000;;18134000;209335000;-1330088000;-1311954000;1589136000;;;1589210000;277256000
MNKD;486138;USD;2018;Q4;2018-12-31;2019-02-26;161982000;161982000;71157000;4017000;3597000;81854000;25602000;;249000;25851000;107705000;20401000;11298000;75241000;110741000;207546000;282787000;2764937000;;-2940000000;-175082000;107705000
CSGP;486790;USD;2017;Q4;2017-12-31;2018-02-23;35674000;36120000;1211463000;60900000;;1287935000;84496000;10070000;1490940000;1585506000;2873441000;93725000;;146666000;;75525000;222191000;;;;2651250000;2873441000
CSGP;486790;USD;2016;Q4;2016-12-31;2016-10-27;32211000;32474000;567223000;48537000;;627491000;87568000;9952000;1460052000;1557572000;2185063000;80187000;31866000;154946000;306473000;375904000;530850000;1471453000;;195799000;1654213000;2185063000
CSGP;486790;USD;2015;Q4;2015-12-31;2015-10-29;31998000;31998000;421818000;40276000;;472733000;88311000;15507000;1503020000;1606838000;2079571000;72187000;16746000;135281000;338366000;400510000;535791000;1440646000;;110728000;1543780000;2079571000
CSGP;486790;USD;2014;Q4;2014-12-31;2014-10-30;31784000;32163000;527012000;38694000;;596476000;73753000;17151000;1383103000;1474007000;2070483000;58764000;16665000;113432000;355136000;443505000;556937000;1405737000;;114193000;1513546000;2070483000
CSGP;486790;USD;2013;Q4;2013-12-31;2013-10-24;27858000;28903000;255953000;20761000;;308466000;57719000;21990000;868807000;948516000;1256982000;50605000;24063000;109030000;129062000;220090000;329120000;864068000;;69324000;927862000;1256982000
CSGP;486790;USD;2012;Q4;2012-12-31;2012-10-25;27296000;28130000;156064000;16392000;;199563000;46308000;21662000;897606000;965576000;1165139000;49067000;17500000;99115000;153125000;239681000;338796000;793271000;;39590000;826343000;1165139000
CSGP;486790;USD;2011;Q4;2011-12-31;2011-10-27;25009000;25400000;548795000;16589000;;583183000;37571000;24584000;125697000;187852000;771035000;36444000;0;59259000;0;52599000;111858000;638070000;;29675000;659177000;771035000
CSGP;486790;USD;2010;Q4;2010-12-31;2011-07-28;20393000;20797000;210127000;13094000;;239173000;69921000;29189000;101365000;200475000;439648000;33999000;;50894000;;7252000;58146000;375189000;;15019000;381502000;439648000
CSGP;486790;USD;2018;Q4;2018-12-31;2019-02-28;36137000;36474000;1100416000;89192000;;1213298000;83303000;10070000;2006286000;2099659000;3312957000;96024000;;154159000;;136856000;291015000;;;;3021942000;3312957000
ASPN;491354;USD;2016;Q4;2016-12-31;2017-03-02;23216379;23216379;18086000;17535000;12868000;50186000;84394000;;89000;84483000;134669000;17052000;35000;18130000;4000;975000;19105000;533088000;;-417524000;115564000;134669000
ASPN;491354;USD;2015;Q4;2015-12-31;2016-03-04;22895007;22895007;32804000;20624000;6532000;61647000;78322000;;105000;78427000;140074000;16252000;67000;17409000;40000;191000;17600000;527975000;;-405501000;122474000;140074000
ASPN;491354;USD;2014;Q4;2014-12-31;2015-03-13;23361907;23361907;49719000;17924000;4897000;73376000;71492000;;175000;71667000;145043000;19790000;76000;20208000;89000;1119000;21327000;522800000;;-399084000;123716000;145043000
ASPN;491354;USD;2013;Q4;2013-12-31;2014-08-08;3137;3262;1574000;18762000;6892000;28019000;62023000;;191000;62214000;90233000;11928000;17816000;31389000;119739000;120810000;152199000;270794000;;-332760000;-61966000;90233000
ASPN;491354;USD;2017;Q4;2017-12-31;2018-03-01;23491979;23491979;10694000;26764000;8915000;47662000;76067000;;86000;76153000;123815000;16515000;;21569000;;1303000;22872000;538088000;;-437145000;100943000;123815000
ASPN;491354;USD;2018;Q4;2018-12-31;2019-03-08;23836328;23836328;3327000;25565000;7318000;37251000;61699000;;73000;61772000;99023000;16256000;;23066000;;5703000;28769000;541839000;;-471585000;70254000;99023000
PRSC;492538;USD;2016;Q4;2016-12-31;2017-03-10;14192983;13828241;72262000;162115000;;288103000;46220000;161363000;189593000;397176000;685279000;205553000;1721000;227796000;1890000;82243000;310039000;302027000;-125201000;156718000;375240000;685279000
PRSC;492538;USD;2015;Q4;2015-12-31;2016-03-11;15639951;15327125;79756000;156932000;;319724000;46158000;9324000;674996000;730478000;1050202000;219381000;31375000;295272000;268696000;387222000;682494000;293029000;-54823000;69209000;367708000;1050202000
PRSC;492538;USD;2014;Q4;2014-12-31;2015-03-16;16132970;15186618;135258000;107565000;;374646000;42648000;;751640000;794288000;1168934000;212399000;90088000;339458000;484525000;608062000;947520000;261172000;-17686000;-13366000;221414000;1168934000
PRSC;492538;USD;2013;Q4;2013-12-31;2014-03-14;13772371;13001889;98995000;88315000;;211672000;32709000;;180377000;213086000;424758000;122128000;48250000;174065000;75250000;100056000;274121000;194377000;-15641000;-33641000;150637000;424758000
PRSC;492538;USD;2012;Q4;2012-12-31;2013-03-15;13069870;13253039;55863000;98628000;;176199000;30380000;;185158000;215538000;391737000;111574000;14000000;132629000;116000000;140421000;273050000;180792000;-15094000;-53079000;118687000;391737000
PRSC;492538;USD;2011;Q4;2011-12-31;2012-03-15;13257038;11837521;43183878;87163323;;158093398;28563149;;192396280;220959429;379052827;94692806;10000000;106886803;140493000;163143484;270030287;176185987;-11435033;-61561392;109022540;379052827
PRSC;492538;USD;2010;Q4;2010-12-31;2011-08-09;13213471;14996322;61260661;76111608;;171568270;16401107;;198964118;215365225;386933495;90205860;18113512;113693114;164190260;184491719;298184833;172554492;-11383967;-78501586;88748662;386933495
PRSC;492538;USD;2017;Q4;2017-12-31;2018-03-09;13568922;13661602;95310000;158926000;;296329000;50377000;169912000;187472000;407761000;704090000;207149000;2400000;226930000;584000;63597000;290527000;313972000;-154803000;204818000;413563000;704090000
PRSC;492538;USD;2018;Q4;2018-12-31;2019-03-01;12863500;12998320;5678000;147756000;;210980000;22965000;161503000;174197000;358665000;569645000;138346000;718000;165932000;353000;15323000;181255000;334762000;-210891000;187127000;388390000;569645000
RGC;493690;USD;2016;Q4;2016-12-31;2017-02-27;155915000;156857000;246500000;155100000;20900000;446900000;1390100000;;808700000;2198800000;2645700000;291800000;25500000;510000000;2204000000;2974600000;3484600000;-934400000;;96500000;-839000000;2645600000
RGC;493690;USD;2015;Q4;2015-12-31;2016-02-29;155687000;156566000;219600000;149600000;22400000;438200000;1404200000;;759200000;2163400000;2601600000;320500000;27400000;551300000;2206500000;2927900000;3479200000;-940000000;;64200000;-877700000;2601500000
RGC;493690;USD;2014;Q4;2014-12-31;2015-03-02;155290000;157378000;147100000;126000000;17800000;341400000;1458900000;;739200000;2198100000;2539500000;262200000;26600000;477000000;2249800000;2959800000;3436800000;-941800000;;48400000;-897400000;2539400000
RGC;493690;USD;2013;Q4;2013-12-31;2014-02-24;154905000;155938000;280900000;122800000;19000000;465100000;1509600000;;730000000;2239600000;2704700000;294800000;29800000;506400000;2200700000;2913600000;3420000000;-782900000;;71800000;-715400000;2704600000
RGC;493690;USD;2012;Q4;2012-12-31;2013-02-25;154318000;155354000;109500000;102700000;17800000;264200000;1463200000;;494700000;1957900000;2222100000;263300000;22000000;451900000;1921000000;2520600000;2972500000;-745500000;;1100000;-750500000;2222000000
RGC;493690;USD;2011;Q4;2011-12-31;2012-02-27;153618000;155740000;253000000;75200000;14800000;403500000;1548200000;;389600000;1937800000;2341300000;290500000;20600000;400700000;1936100000;2513100000;2913800000;-577600000;;15700000;-572600000;2341200000
RGC;493690;USD;2010;Q4;2010-12-31;2011-05-10;153419000;154530000;205300000;77300000;14700000;346500000;1690500000;;455600000;2146100000;2492600000;274700000;95800000;469000000;1911000000;2515300000;2984300000;-487600000;;9400000;-491800000;2492500000
RGC;493690;USD;2009;Q4;2009-12-31;2010-08-06;153098000;154185000;328100000;69000000;12300000;428900000;1818700000;;390100000;2208800000;2637700000;285500000;17100000;396500000;1908000000;2488100000;2884600000;-282900000;;47000000;-247000000;2637600000
RGC;493690;USD;2017;Q4;2017-12-31;2018-03-01;156352000;157082000;228800000;184000000;22900000;463300000;1513200000;;866400000;2379600000;2842900000;308700000;26600000;561400000;2346100000;3137300000;3698700000;-929400000;;70900000;-855900000;2842800000
AAXN;493957;USD;2016;Q4;2016-12-31;2017-03-06;52289000;52925000;89066000;39466000;34841000;177231000;24004000;234000;76694000;100932000;278163000;28984000;;78039000;2289000;49236000;127275000;187657000;-155947000;118275000;150888000;278163000
AAXN;493957;USD;2015;Q4;2015-12-31;2016-03-07;53672000;54548000;109780000;27701000;15763000;161409000;21848000;8525000;38099000;68472000;229881000;15976000;;38140000;;34737000;72877000;178144000;-122201000;100978000;157004000;229881000
AAXN;493957;USD;2014;Q4;2014-12-31;2015-03-12;52744000;54300000;81141000;30735000;18323000;134642000;17523000;9296000;23907000;50726000;185368000;16927000;;31973000;29000;24289000;56262000;162642000;-114645000;81045000;129106000;185368000
AAXN;493957;USD;2013;Q4;2013-12-31;2014-03-10;52323000;55834000;51372000;22488000;11109000;97467000;19043000;12023000;19849000;50915000;148382000;15061000;;23129000;67000;16906000;40035000;139425000;-92203000;61127000;108347000;148382000
AAXN;493957;USD;2012;Q4;2012-12-31;2013-03-08;52577648;54260965;37808000;18101000;10993000;79053000;21952000;;15231000;37183000;116236000;13288000;;18109000;103000;10842000;28951000;111662000;-67203000;42883000;87285000;116236000
AAXN;493957;USD;2011;Q4;2011-12-31;2012-03-13;55942319;53851198;26408922;11780135;11484761;61732423;26845220;;16385108;43230328;104962751;12156942;;15887897;;6619300;22507197;101598278;-47207093;28145325;82455554;104962751
AAXN;493957;USD;2010;Q4;2010-12-31;2011-08-08;62609913;62609913;42684241;13542535;17815405;82326195;35905765;;17954975;53860740;136186935;8310589;;11947994;;6674700;18622694;97122732;-14708237;35185191;117564241;136186935
AAXN;493957;USD;2017;Q4;2017-12-31;2018-03-01;52919000;54302000;81967000;56064000;45465000;205192000;31172000;;101748000;132920000;338112000;32094000;;107950000;1224000;62718000;170668000;201673000;-155947000;123185000;167444000;338112000
AAXN;493957;USD;2018;Q4;2018-12-31;2019-02-27;58582000;60297000;349462000;130579000;33763000;558155000;37893000;;123492000;161385000;719540000;56256000;;166011000;5704000;86205000;252216000;453401000;-155947000;171383000;467324000;719540000
BCO;494050;USD;2017;Q4;2017-12-31;2018-03-01;50900000;52200000;614300000;642300000;;1488200000;640900000;;930500000;1571400000;3059600000;663100000;97100000;834900000;1139600000;1886500000;2721400000;679100000;;564900000;338200000;3059600000
BCO;494050;USD;2016;Q4;2016-12-31;2017-02-24;50500000;51900000;183500000;501100000;;843700000;531000000;;620100000;1151100000;1994800000;525000000;195600000;753800000;247600000;886200000;1640000000;668100000;;576000000;354800000;1994800000
BCO;494050;USD;2015;Q4;2015-12-31;2016-02-29;49400000;48900000;181900000;478100000;;777700000;549000000;;620000000;1169000000;1946700000;556500000;72400000;641800000;358100000;974300000;1616100000;648500000;;561300000;330600000;1946700000
BCO;494050;USD;2014;Q4;2014-12-31;2014-07-28;49000000;48300000;176200000;530500000;;907600000;669500000;;614900000;1284400000;2192000000;634900000;93500000;728400000;373100000;989800000;1718200000;633100000;;592900000;473800000;2192000000
BCO;494050;USD;2013;Q4;2013-12-31;2013-07-26;48900000;49200000;255500000;622200000;;1102700000;758700000;;636600000;1395300000;2498000000;693100000;105500000;798600000;330500000;919900000;1718500000;614800000;;696400000;779500000;2498000000
BCO;494050;USD;2012;Q4;2012-12-31;2012-07-26;48500000;48900000;201700000;612300000;;995500000;793800000;;764600000;1558400000;2553900000;689300000;53700000;743000000;335600000;1234100000;1977100000;616100000;;659100000;576800000;2553900000
BCO;494050;USD;2011;Q4;2011-12-31;2012-02-28;47800000;48100000;182900000;550500000;;933900000;749200000;;723100000;1472300000;2406200000;648000000;54100000;702100000;335300000;1221700000;1923800000;606400000;;589500000;482400000;2406200000
BCO;494050;USD;2010;Q4;2010-12-31;2011-02-28;47400000;47800000;183000000;525100000;;877400000;698900000;;694200000;1393100000;2270500000;610500000;65500000;676000000;323700000;1011400000;1687400000;589000000;;537500000;583100000;2270500000
BCO;494050;USD;2009;Q4;2009-12-31;2010-08-03;48400000;49000000;143000000;427600000;;690100000;549500000;;640200000;1189700000;1879800000;497000000;23300000;520300000;172300000;763700000;1284000000;598100000;;514800000;595800000;1879800000
BCO;494050;USD;2018;Q4;2018-12-31;2019-02-26;50400000;48300000;343400000;599500000;;1206500000;699400000;;1330100000;2029500000;3236000000;676700000;82400000;849400000;1471600000;2220000000;3069400000;677900000;;429100000;166600000;3236000000
CSLT;494803;USD;2016;Q4;2016-12-31;2017-03-01;104026000;104026000;114604000;14806000;;141010000;5285000;;10871000;16156000;157166000;18100000;;48723000;0;6481000;55204000;457606000;;-355644000;101962000;157166000
CSLT;494803;USD;2015;Q4;2015-12-31;2016-03-10;95013000;95013000;120424000;12751000;;142385000;6896000;13335000;10658000;30889000;173274000;19411000;;46001000;;8919000;54920000;415529000;;-297096000;118354000;173274000
CSLT;494803;USD;2014;Q4;2014-12-31;2015-03-12;91336000;91336000;192482000;11097000;;210730000;3630000;6220000;2694000;12544000;223274000;19463000;;40171000;;6913000;47084000;393403000;;-217176000;176187000;223271000
CSLT;494803;USD;2013;Q4;2013-12-31;2014-05-12;10538000;10538000;67171000;5065000;;77467000;2631000;0;3419000;6050000;83517000;15598000;;22523000;;4921000;27444000;6886000;;-131236000;56073000;83517000
CSLT;494803;USD;2017;Q4;2017-12-31;2018-03-01;134413000;134413000;93344000;21933000;;119268000;5263000;;155352000;160615000;279883000;31026000;;57011000;4958000;11315000;68326000;586913000;;-375334000;211557000;279883000
CSLT;494803;USD;2018;Q4;2018-12-31;2019-03-01;140578000;140578000;77332000;26816000;;107828000;3963000;;141723000;145686000;253514000;30985000;;51178000;3254000;7665000;58843000;609711000;;-415040000;194671000;253514000
STRM;494891;USD;2017;Q4;2017-09-30;2017-04-10;19680749;19680749;5654093;4489789;;11944731;1903509;;27790258;29693767;41638498;2097622;747141;12761217;4883286;17038407;29799624;80864725;;-69025851;11838874;41638498
STRM;494891;USD;2016;Q4;2016-09-30;2017-04-10;18783539;18783539;9882136;4199315;;16203437;2454075;;31218359;33672434;49875871;2400654;1266449;14114383;7684194;19737360;33851743;79888413;;-63864285;16024128;49875871
STRM;494891;USD;2015;Q4;2015-09-30;2015-04-16;18426200;18417098;6522600;6935270;;16505723;3136815;;36136577;39273392;55779115;3728554;1281961;14299591;10082911;22477736;36777327;78575958;;-59574170;19001788;55779115
STRM;494891;USD;2014;Q4;2014-09-30;2014-06-13;16336800;16336668;17924886;7999571;;29688229;919044;;34971601;35890645;65578874;4133894;1619853;15411979;7692856;20675848;36087827;77164846;;-47562713;29491047;65578874
STRM;494891;USD;2013;Q4;2013-09-30;2013-04-26;12522160;9550160;7500256;8685017;;19877778;1198805;;34189995;35388800;55266578;4909802;1250000;17325422;12437501;24481854;41807276;49304825;;-35845523;13459302;55266578
STRM;494891;USD;2012;Q4;2012-09-30;2012-04-25;10140364;10079957;2243054;4484605;;8408243;1215669;;15517146;16732815;25141058;2245683;0;8742621;7120000;8399913;17142534;38465318;;-30466794;7998524;25141058
STRM;494891;USD;2011;Q4;2011-09-30;2011-09-13;-207645107;-213122239;1403949;2620756;;5938415;1525825;;8551182;10077007;16015422;2209517;183637;8159949;1200000;1261034;9420983;37073807;;-30479368;6594439;16015422
STRM;494891;USD;2018;Q4;2018-09-30;2019-04-22;18744366;18744366;2376000;2933000;;7918000;237000;;23585000;23822000;31740000;3094000;597000;12123000;3351000;13415000;25538000;82752000;;-76550000;6202000;31740000
TRHC;494892;USD;2017;Q4;2017-12-31;2018-03-14;17477224;23706119;10430000;17087000;2795000;35451000;9243000;;143138000;152381000;187832000;25206000;921000;27767000;784000;36177000;63944000;144076000;-959000;-19229000;123888000;187832000
TRHC;494892;USD;2016;Q4;2016-12-31;2017-03-14;15493784;18742235;4345000;6646000;2911000;15664000;6409000;;50666000;57075000;72739000;8274000;674000;11009000;1072000;5624000;16633000;91029000;;-34923000;56106000;72739000
TRHC;494892;USD;2015;Q4;2015-12-31;2016-11-10;4578066;4578066;2026000;6013000;2304000;12129000;1962000;;44511000;46473000;58602000;25672000;13776000;51569000;29403000;38661000;90230000;0;;-31628000;-31628000;58602000
TRHC;494892;USD;2018;Q4;2018-12-31;2019-03-01;19429882;16358632;20278000;27950000;3594000;63311000;11865000;;195781000;207646000;270957000;31386000;945000;120728000;7952000;11220000;131948000;209332000;-3825000;-66498000;139009000;270957000
OMCL;495083;USD;2016;Q4;2016-12-31;2017-02-28;36565000;38650000;54488000;150303000;69297000;315408000;42011000;20585000;557099000;619695000;935103000;84986000;8410000;180912000;245731000;322584000;503496000;525804000;-185074000;100396000;431607000;935103000
OMCL;495083;USD;2015;Q4;2015-12-31;2016-02-26;35478000;36315000;82217000;107957000;46594000;264128000;32309000;14484000;267826000;314619000;578747000;70974000;0;124630000;0;51729000;176359000;490399000;-185074000;99793000;402388000;578747000
OMCL;495083;USD;2014;Q4;2014-12-31;2015-03-30;35720000;36733000;125888000;82763000;31554000;283384000;36178000;10848000;229804000;276830000;560214000;58605000;;112330000;;57786000;170116000;457479000;-135053000;69033000;390098000;560214000
OMCL;495083;USD;2013;Q4;2013-12-31;2014-03-17;35461000;36724000;104531000;58597000;31457000;233778000;35254000;11485000;211984000;258723000;492501000;49821000;;92404000;;51100000;143504000;421273000;-110962000;38515000;348997000;492501000
OMCL;495083;USD;2012;Q4;2012-12-31;2013-03-11;33280000;34127000;62313000;55116000;26903000;180756000;34107000;13228000;213728000;261063000;441819000;41856000;;83077000;;51192000;134269000;382883000;-90000000;14536000;307550000;441819000
OMCL;495083;USD;2011;Q4;2011-12-31;2012-03-08;33096000;34114000;199869000;38661000;18107000;283591000;17306000;8785000;54167000;80258000;363849000;27229000;;60630000;;20305000;80935000;362192000;-77637000;-1642000;282914000;363849000
OMCL;495083;USD;2010;Q4;2010-12-31;2011-08-05;33002000;33903000;183709000;42732000;9785000;264625000;14351000;9224000;55024000;78599000;343224000;29657000;;58164000;;19846000;78010000;342309000;-65064000;-12031000;265214000;343224000
OMCL;495083;USD;2017;Q4;2017-12-31;2018-02-27;38144000;40665000;32424000;189227000;96137000;367121000;42595000;15435000;555153000;613183000;980304000;111224000;15208000;212536000;194917000;250569000;463105000;585803000;-185074000;122583000;517199000;980304000
OMCL;495083;USD;2018;Q4;2018-12-31;2019-02-27;39931000;41685000;67192000;196238000;100868000;397134000;51500000;17082000;615526000;684108000;1081242000;122745000;0;204580000;135417000;197045000;401625000;678091000;-185074000;197454000;679617000;1081242000
CATS;495603;USD;2016;Q4;2016-12-31;2017-02-28;9756840;;851000;1052000;;2323000;410000;;371000;781000;3104000;3534000;9796000;22977000;31000;5455000;28432000;254391000;;-279719000;-25328000;3104000
CATS;495603;USD;2015;Q4;2015-12-31;2016-03-30;9042130;;916000;590000;;2081000;412000;;387000;799000;2880000;3138000;0;4821000;3728000;6783000;11604000;253059000;;-261783000;-8724000;2880000
CATS;495603;USD;2014;Q4;2014-12-31;2015-03-31;4207160;;708000;489000;;1510000;354000;;488000;842000;2352000;2347000;;2960000;23000;40616000;43576000;213336000;;-254560000;-41224000;2352000
CATS;495603;USD;2013;Q4;2013-12-31;2014-03-31;3086350;1457240;1136000;288000;;1699000;366000;;558000;924000;2623000;3599000;;4172000;26000;16494000;20666000;209171000;;-227214000;-18043000;2623000
CATS;495603;USD;2012;Q4;2012-12-31;2013-04-01;1483420;1483420;3153000;242000;;3622000;59000;;1253000;1312000;4934000;3720000;;18656000;18000;36000;18692000;208777000;;-222535000;-13758000;4934000
CATS;495603;USD;2011;Q4;2011-12-31;2012-03-30;;344964;771000;180000;;1359000;89000;;2132000;2221000;3580000;3471000;;8058000;;18000;8076000;206396000;;-210892000;-4496000;3580000
CATS;495603;USD;2010;Q4;2010-12-31;2011-08-12;;;4605000;73000;;4861000;194000;;2889000;3083000;7944000;3407000;;12297000;5824000;5824000;18121000;192596000;;-202773000;-10177000;7944000
CATS;495603;USD;2017;Q4;2017-12-31;2018-03-07;15984000;;4779000;511000;;5656000;612000;;336000;948000;6604000;2735000;;5649000;2000;57000;5706000;294222000;;-293324000;898000;6604000
CATS;495603;USD;2018;Q4;2018-12-31;2019-03-22;16092000;;3162000;1382000;;5894000;263000;;166000;429000;6323000;3535000;0;7730000;7472000;7558000;15288000;296690000;;-305655000;-8965000;6323000
ATHN;495675;USD;2016;Q4;2016-12-31;2017-02-02;39500000;42100000;147400000;161600000;;343200000;347700000;17500000;480800000;846000000;1189200000;150900000;18300000;197900000;272800000;358000000;555900000;591900000;-1200000;43500000;633300000;1189200000
ATHN;495675;USD;2015;Q4;2015-12-31;2016-02-04;38800000;41300000;141900000;148200000;;320300000;321500000;14000000;462900000;798400000;1118700000;150300000;10800000;193700000;287400000;381700000;575400000;522800000;-1200000;22500000;543300000;1118700000
ATHN;495675;USD;2014;Q4;2014-12-31;2015-02-09;38257000;38257000;114737000;121710000;;258624000;271552000;6399000;394045000;671996000;930620000;118211000;14550000;205159000;157822000;250338000;455497000;443654000;-1200000;8481000;475123000;930620000
ATHN;495675;USD;2013;Q4;2013-12-31;2014-02-07;37285000;40181000;65002000;87343000;;172539000;213018000;8321000;402518000;623857000;796396000;72754000;15000000;149756000;173750000;255332000;405088000;381354000;-1200000;11600000;391308000;796396000
ATHN;495675;USD;2012;Q4;2012-12-31;2013-02-11;36772000;37418000;193080000;61916000;;267277000;54035000;2773000;104367000;161175000;428452000;57809000;799000;66817000;0;49987000;116804000;303923000;-1200000;9006000;311648000;428452000
ATHN;495675;USD;2011;Q4;2011-12-31;2012-02-16;140079250;144092293;119865000;49038000;;177891000;52275000;21503000;97117000;170895000;348786000;52268000;960000;59573000;;52742000;112315000;247498000;-1200000;-9726000;236471000;348786000
ATHN;495675;USD;2010;Q4;2010-12-31;2011-02-18;-102157276;-105235184;116175000;36870000;;159794000;31899000;7228000;62249000;101376000;261170000;30718000;4406000;40592000;6307000;49825000;90417000;200697000;-1200000;-28772000;170753000;261170000
ATHN;495675;USD;2009;Q4;2009-12-31;2010-07-23;33776000;35547000;82849000;33323000;;120835000;24871000;1393000;63978000;90242000;211077000;28435000;4725000;37489000;8951000;46270000;83759000;170067000;-1200000;-41476000;127318000;211077000
ATHN;495675;USD;2017;Q4;2017-12-31;2018-02-01;40200000;42000000;165100000;169500000;;381400000;355100000;31300000;564500000;950900000;1332300000;156800000;20200000;207700000;252600000;333100000;540800000;647100000;;144800000;791500000;1332300000
MDRX;495816;USD;2015;Q4;2015-12-31;2016-02-29;189245000;189245000;116873000;327851000;;538346000;125617000;0;2017985000;2143602000;2681948000;184423000;12609000;512957000;613022000;749918000;1262875000;1792114000;-189753000;-190235000;1419073000;2681948000
MDRX;495816;USD;2014;Q4;2014-12-31;2015-03-02;180334000;180334000;53173000;331625000;;487190000;145830000;1305000;1830005000;1977140000;2464330000;200853000;27498000;521373000;539193000;658737000;1180110000;1752244000;-278036000;-188009000;1284220000;2464330000
MDRX;495816;USD;2013;Q4;2013-12-31;2014-03-03;178603000;178603000;62954000;313486000;;539819000;174013000;1329000;1904502000;2079844000;2619663000;249651000;16350000;517039000;545133000;784479000;1301518000;1719482000;-278036000;-121556000;1318145000;2619663000
MDRX;495816;USD;2012;Q4;2012-12-31;2013-03-01;171216000;164582000;103956000;302097000;;572575000;155494000;1706000;1619762000;1776962000;2349537000;183098000;79305000;518129000;362697000;547067000;1065196000;1579831000;-278036000;-17530000;1284341000;2349537000
QSII;497184;USD;2016;Q4;2017-03-31;2016-05-25;62342000;62219000;37673000;83407000;158000;146802000;27426000;;298993000;326419000;473221000;29536000;;128694000;15000000;39484000;168178000;229174000;;76227000;305043000;473221000
QSII;497184;USD;2015;Q4;2016-03-31;2016-05-25;60900000;61395000;36473000;94024000;555000;183991000;25790000;;321009000;346799000;530790000;29887000;;138060000;105000000;123353000;261413000;211872000;;57986000;269377000;530790000
QSII;497184;USD;2014;Q4;2015-03-31;2015-05-26;60287000;60983000;130585000;107669000;622000;255977000;20807000;;183737000;204544000;460521000;54817000;;155084000;0;21897000;176981000;199253000;;84479000;283540000;460521000
QSII;497184;USD;2013;Q4;2014-03-31;2014-05-29;60206000;61040000;113801000;113268000;834000;251755000;22801000;;176795000;199596000;451351000;34527000;;126973000;;29288000;156261000;195341000;;99931000;295090000;451351000
QSII;497184;USD;2012;Q4;2013-03-31;2013-05-30;58102000;58352000;118011000;148257000;710000;285186000;21887000;;135982000;157869000;443055000;35314000;;127029000;;8977000;136006000;180338000;;126722000;307049000;443055000
QSII;497184;USD;2011;Q4;2012-03-31;2012-05-25;56888000;58017000;139431000;145756000;1242000;302582000;17841000;;119929000;137770000;440352000;26756000;;129432000;;15743000;145175000;169625000;;125597000;295177000;440352000
QSII;497184;USD;2010;Q4;2011-03-31;2011-05-27;57958000;58394000;117737000;139772000;1933000;271997000;12599000;;94090000;106689000;378686000;30625000;;136636000;;17380000;154016000;133549000;;91121000;224670000;378686000
QSII;497184;USD;2009;Q4;2010-03-31;2010-08-03;57568000;57948000;91769000;107458000;1340000;214543000;8432000;;87205000;95637000;310180000;20957000;;101286000;;20605000;121891000;122560000;;65729000;188289000;310180000
QSII;497184;USD;2017;Q4;2018-03-31;2018-05-25;63885000;63879000;28845000;84962000;180000;141662000;26795000;;347298000;374093000;515755000;32196000;;134592000;37000000;57753000;192345000;245102000;;78708000;323410000;515755000
QSII;497184;USD;2018;Q4;2019-03-31;2019-05-29;64747000;64713000;33079000;87459000;120000;159851000;21404000;;351640000;373044000;532895000;31159000;;128232000;11000000;28717000;156949000;265556000;;111621000;375946000;532895000
BABY;497305;USD;2017;Q4;2017-12-31;2018-03-01;32649000;32094000;88950000;126809000;71529000;305628000;22071000;;382220000;404291000;709919000;76980000;;92137000;154283000;195685000;287822000;316577000;;129115000;422097000;709919000
BABY;497305;USD;2016;Q4;2016-12-31;2017-02-24;32408000;33038000;247570000;86638000;49587000;405799000;17333000;;225880000;243213000;649012000;56595000;;79941000;140000000;151697000;231638000;312986000;;149408000;417374000;649012000
BABY;497305;USD;2015;Q4;2015-12-31;2016-02-29;32560000;33410000;82469000;99080000;48572000;241356000;16967000;;221173000;238140000;479496000;65797000;;77108000;0;11678000;88786000;323745000;;106814000;390710000;479496000
BABY;497305;USD;2014;Q4;2014-12-31;2015-03-16;31926000;33028000;66558000;82277000;40051000;217805000;17923000;;199093000;217016000;434821000;57395000;;69140000;;12966000;82106000;315296000;;68890000;352715000;434821000
BABY;497305;USD;2013;Q4;2013-12-31;2014-03-17;30640000;31707000;56106000;82110000;40563000;199780000;23295000;;206382000;229677000;429457000;57731000;10517000;81194000;27500000;40049000;121243000;292055000;;36412000;308214000;429457000
BABY;497305;USD;2012;Q4;2012-12-31;2013-04-10;87004223;90226770;23057000;89960000;40756000;168871000;26512000;;196470000;222982000;391853000;65475000;19826000;98606000;13034000;24495000;123101000;275395000;;11638000;268752000;391853000
BABY;497305;USD;2011;Q4;2011-12-31;2012-03-14;85856918;84687874;32816000;55421000;32810000;130815000;26092000;;157939000;184031000;314846000;33526000;188000;41318000;710000;15215000;56533000;267499000;;7755000;258313000;314846000
BABY;497305;USD;2010;Q4;2010-12-31;2011-08-05;-83950632;-87393132;29388000;54782000;37627000;128943000;23408000;;178696000;202104000;331047000;39311000;156000;44211000;737000;22771000;66982000;258872000;;18867000;264065000;331047000
BABY;497305;USD;2018;Q4;2018-12-31;2019-03-01;33504000;33504000;56373000;127041000;79736000;285775000;22913000;;329452000;352365000;638140000;81373000;35000000;133446000;69474000;106250000;239696000;334215000;;102261000;398444000;638140000
MDSO;497390;USD;2017;Q4;2017-12-31;2018-02-28;56733000;60528000;484292000;110685000;;641017000;88091000;179041000;153084000;420216000;1061233000;73587000;278094000;429056000;92841000;119567000;548623000;486775000;-132705000;161917000;512610000;1061233000
MDSO;497390;USD;2016;Q4;2016-12-31;2017-02-28;55787000;57794000;374804000;115216000;;518780000;58461000;140418000;100226000;299105000;817885000;56420000;0;132331000;263401000;283564000;415895000;419111000;-114204000;102359000;401990000;817885000
MDSO;497390;USD;2015;Q4;2015-12-31;2016-02-29;54031000;57624000;269688000;90590000;;383201000;51043000;209041000;40895000;300979000;684180000;45496000;;121078000;249487000;278946000;400024000;365567000;-100806000;22799000;284156000;684180000
MDSO;497390;USD;2014;Q4;2014-12-31;2015-03-02;52906000;58982000;272801000;68475000;;357852000;38579000;183842000;41944000;264365000;622217000;31950000;;94840000;240886000;262678000;357518000;302028000;-45049000;9632000;264699000;622217000
MDSO;497390;USD;2013;Q4;2013-12-31;2014-02-25;51702000;56462000;241220000;45534000;;304545000;41229000;195105000;32474000;268808000;573353000;47562000;;100190000;229705000;247350000;347540000;248886000;-26414000;3540000;225813000;573353000
MDSO;497390;USD;2012;Q4;2012-12-31;2013-03-08;49976000;52150000;122554000;42359000;;182701000;10474000;0;31456000;41930000;224631000;23867000;;74215000;0;8325000;82540000;160901000;-5626000;-13121000;142091000;224631000
MDSO;497390;USD;2011;Q4;2011-12-31;2012-03-13;94475178;98644402;107677000;22970000;;147666000;9825000;;32344000;42169000;189835000;19601000;114000;70940000;136000;14778000;85718000;137806000;-2186000;-31141000;104117000;189835000
MDSO;497390;USD;2010;Q4;2010-12-31;2011-08-09;183526732;192353572;85498000;34268000;;132881000;10993000;;14071000;25064000;157945000;18375000;712000;82315000;68000;24504000;106819000;122256000;-474000;-70539000;51126000;157945000
MDSO;497390;USD;2018;Q4;2018-12-31;2019-03-01;59317000;61964000;240545000;170744000;;462485000;98983000;0;351744000;450727000;913212000;96239000;0;170702000;88366000;111062000;281764000;575328000;-152849000;213838000;631448000;913212000
HSTM;497494;USD;2018;Q4;2018-12-31;2019-02-25;32325000;32415000;168818000;38124000;;241434000;15866000;;184648000;200514000;441948000;40793000;;106854000;;16147000;123001000;286597000;;32373000;318947000;441948000
HSTM;497494;USD;2017;Q4;2017-12-31;2018-02-26;31901000;32234000;131118000;36691000;;199728000;8092000;;203299000;211391000;411119000;29356000;;101066000;;9883000;110949000;282666000;;17542000;300170000;411119000
HSTM;497494;USD;2016;Q4;2016-12-31;2017-02-27;31743000;32124000;103174000;44805000;;177437000;10245000;;208318000;218563000;396000000;26428000;;94970000;;14922000;109892000;280813000;;5346000;286108000;396000000
HSTM;497494;USD;2015;Q4;2015-12-31;2016-02-26;31648000;32030000;148986000;36348000;;209537000;12471000;;157561000;170032000;379569000;23980000;;89078000;;10171000;99249000;278799000;;1591000;280320000;379569000
HSTM;497494;USD;2014;Q4;2014-12-31;2015-02-27;27655000;28096000;120968000;33167000;;174611000;9442000;;73209000;82651000;257262000;23543000;;77259000;;12144000;89403000;174926000;;-7030000;167859000;257262000
HSTM;497494;USD;2013;Q4;2013-12-31;2014-03-04;27265000;27859000;108196000;25314000;;147124000;9038000;;56432000;65470000;212594000;18044000;;56212000;;6949000;63161000;166888000;;-17424000;149433000;212594000
HSTM;497494;USD;2012;Q4;2012-12-31;2013-03-01;26213000;27601000;93317000;15348000;;118291000;7820000;;48417000;56237000;174528000;11886000;;35032000;;7300000;42332000;158020000;;-25842000;132196000;174528000
HSTM;497494;USD;2011;Q4;2011-12-31;2012-02-28;23777000;25177000;83456000;16014000;;111079000;6087000;5996000;31075000;43158000;154237000;9689000;;32448000;;874000;33322000;154409000;;-33487000;120915000;154237000
HSTM;497494;USD;2010;Q4;2010-12-31;2011-08-01;21791000;22878000;23571000;11069000;;44271000;3825000;0;33915000;37740000;82011000;8006000;;24746000;;474000;25220000;97227000;;-40431000;56791000;82011000
MTBC;497698;USD;2016;Q4;2016-12-31;2017-03-31;10054039;10054039;3476880;4330901;;8439482;1588937;;18295287;19884224;28323706;5370856;7848126;15857562;4199852;5399313;21256875;26048856;-662000;-17944230;7066831;28323706
MTBC;497698;USD;2015;Q4;2015-12-31;2016-03-24;9793541;9793541;8039562;2211979;;10886233;1372283;;14418382;15790665;26676898;1818048;1082023;5758138;4902923;6026810;11784948;24560235;-122031;-9147507;14891950;26676898
MTBC;497698;USD;2014;Q4;2014-12-31;2015-03-31;9776262;9776262;1048660;3007314;;4584700;1444334;;17078226;18522560;23107260;3185906;1066705;8144125;48564;642538;8786663;18989688;0;-4460129;14320597;23107260
MTBC;497698;USD;2013;Q4;2013-12-31;2014-08-28;5101770;5101770;497944;1009416;;1787707;505344;;3479563;3984907;5772614;1409086;1651784;4144223;936158;1509894;5654117;256730;;49121;118497;5772614
MTBC;497698;USD;2017;Q4;2017-12-31;2018-03-07;11550734;11550734;4362232;3879463;;8929720;1385743;;15210200;16595943;25525663;3503810;168718;4322015;120899;953228;5275243;45141789;-662000;-23509386;20250420;25525663
MTBC;497698;USD;2018;Q4;2018-12-31;2019-03-20;11832638;11832638;14472483;7331474;444437;26073673;1832187;;19717501;21549688;47623361;7237726;277776;8176895;;576112;8753007;65155031;-662000;-24203745;38870354;47623361
INOV;497806;USD;2017;Q4;2017-12-31;2018-02-21;140313000;141012000;476232000;90054000;;588714000;125768000;;280596000;406364000;995078000;52701000;336000;122086000;203359000;230220000;352306000;534159000;-199817000;308905000;642771000;995077000
INOV;497806;USD;2016;Q4;2016-12-31;2017-02-23;146466000;147197000;572998000;85591000;;685854000;76420000;;291070000;367490000;1053344000;31685000;115000;84134000;236465000;285633000;369767000;516300000;-106231000;274087000;683576000;1053343000
INOV;497806;USD;2015;Q4;2015-12-31;2016-02-26;151130000;151064000;728164000;81305000;;844008000;65031000;;203838000;268869000;1112877000;34674000;109000;67531000;266546000;306190000;373721000;493197000;;247540000;739155000;1112876000
INOV;497806;USD;2014;Q4;2014-12-31;2015-05-08;122133000;125028000;162567000;43938000;;219808000;50962000;;71799000;122761000;342569000;26279000;99000;51591000;281418000;299200000;350791000;110317000;-300017000;181477000;-8223000;342568000
INOV;497806;USD;2018;Q4;2018-12-31;2019-02-20;147658000;147658000;122591000;104405000;;272127000;141758000;;1507530000;1649288000;1921415000;56593000;;141310000;939514000;1097516000;1238826000;618674000;-199817000;270471000;682588000;1921414000
CPSI;497906;USD;2018;Q4;2018-12-31;2019-03-18;13604000;13632000;5732000;40474000;1498000;69938000;10875000;;246933000;257808000;327746000;21816000;6486000;38503000;124583000;129460000;167963000;;;;159783000;327746000
CPSI;497906;USD;2017;Q4;2017-12-31;2018-03-14;13451000;13451000;520000;38061000;1417000;57877000;11692000;;248647000;260339000;318216000;26322000;5820000;40849000;136614000;141281000;182130000;155092000;;-19006000;136086000;318216000
CPSI;497906;USD;2016;Q4;2016-12-31;2017-03-15;13351000;13303000;2220000;31812000;1697000;44549000;13439000;;281162000;294601000;339150000;19288000;5817000;30945000;146989000;150235000;181180000;147924000;;10046000;157970000;339150000
CPSI;497906;USD;2015;Q4;2015-12-31;2016-03-14;11110000;11110000;35775000;22594000;1495000;74557000;14351000;;3880000;18231000;92788000;13601000;0;17422000;0;0;17422000;44198000;;31206000;75366000;92788000
CPSI;497906;USD;2014;Q4;2014-12-31;2015-03-13;11048733;11048733;34494874;23101575;1431560;81516032;17038619;;770169;17808788;99324820;12270353;;18160784;;383050;18543834;38994559;;41805764;80780986;99324820
CPSI;497906;USD;2013;Q4;2013-12-31;2014-03-12;10747927;10747927;22431811;20076592;1588673;72752310;19231372;;550956;19782328;92534638;11869657;;21451014;;2001077;23452091;34655059;;34416120;69082547;92534638
CPSI;497906;USD;2012;Q4;2012-12-31;2013-03-11;10715799;10715799;19587066;19704767;1682008;50201475;19029974;;7862833;26892807;77094282;10263348;;17715960;;2176130;19892090;32859179;;24315320;57202192;77094282
CPSI;497906;USD;2011;Q4;2011-12-31;2012-03-12;11064648;11064648;23151170;21521260;1838937;54168534;17419231;;4056748;21475979;75644513;11080846;;16670638;;1589838;18260476;31593171;;25783486;57384037;75644513
CPSI;497906;USD;2010;Q4;2010-12-31;2011-08-08;10962874;10962874;16341762;25472529;1782743;49619994;8683058;;4432277;13115335;62735329;10015945;;14485452;;1785854;16271306;30560112;;15845008;46464023;62735329
BX;498254;USD;2016;Q4;2016-12-31;2017-02-24;655151999;1195901432;1837253000;772695000;;5175982000;;17694975000;3532380000;21227355000;26403337000;12275910000;;13888404000;;0;13888404000;6523929000;;;12514933000;26403337000
BX;498254;USD;2015;Q4;2015-12-31;2016-02-26;641357743;2848084155;1837324000;613153000;;4483299000;;14324097000;3718684000;18042781000;22526080000;8795327000;;10295623000;;0;10295623000;6322307000;;;12230457000;22526080000
BX;498254;USD;2014;Q4;2014-12-31;2015-02-27;615310192;622159757;1412472000;559321000;;4908293000;;22765589000;3823215000;26588804000;31497097000;12557677000;;14163550000;;0;14163550000;6999830000;;;17333547000;31497097000
BX;498254;USD;2013;Q4;2013-12-31;2014-02-28;592266191;596802813;831998000;888356000;;4107264000;;21729523000;3841819000;25571342000;29678606000;13471529000;;15300935000;;0;15300935000;6002592000;;;14377671000;29678606000
BX;498254;USD;2012;Q4;2012-12-31;2013-03-01;554333519;561584142;709502000;638164000;;4120162000;;20847270000;3964120000;24811390000;28931552000;15345270000;;17716605000;;0;17716605000;4955649000;;;11214947000;28931552000
BX;498254;USD;2011;Q4;2011-12-31;2012-02-28;491109179;473844653;754744000;406140000;;2885645000;;15128299000;3895185000;19023484000;21909129000;10599701000;;12656843000;;0;12656843000;4281841000;;;9252286000;21909129000
BX;498254;USD;2010;Q4;2010-12-31;2011-02-25;;397702321;588621000;495893000;;2851733000;;11974472000;4018400000;15992872000;18844605000;8649601000;;10591248000;;0;10591248000;3888211000;;;8253357000;18844605000
BX;498254;USD;2009;Q4;2009-12-31;2010-08-06;;;952096000;306307000;;2104394000;;3565483000;3739147000;7304630000;9409024000;1455068000;;2865491000;;;2865491000;3376707000;;;6543533000;9409024000
BX;498254;USD;2017;Q4;2017-12-31;2018-03-01;668807058;-935028230;1992497000;875018000;;6825183000;;24434049000;3156687000;27590736000;34415919000;19482450000;;20692828000;;0;20692828000;6668511000;;;13723091000;34415919000
BX;498254;USD;2018;Q4;2018-12-31;2019-03-01;676692171;1729388937;2207841000;636238000;;5175522000;;20377031000;3372097000;23749128000;28924650000;13769969000;;15170564000;;0;15170564000;6415700000;;;13754086000;28924650000
AMDA;498391;USD;2017;Q4;2017-12-31;2018-03-29;91350;91350;539000;1240000;775000;4346000;284000;;10011000;10295000;14641000;4414000;605000;8271000;;928000;9199000;226071000;;-220629000;5442000;14641000
AMDA;498391;USD;2016;Q4;2016-12-31;2017-09-20;72439;72439;6915000;1620000;7213000;15987000;889000;;9385000;10274000;26261000;3841000;7012000;13990000;;1036000;15026000;222535000;;-211300000;11235000;26261000
AMDA;498391;USD;2015;Q4;2015-12-31;2016-03-23;17721;17721;11485000;2660000;9131000;23505000;2472000;;9885000;12357000;35862000;4064000;16365000;20429000;;1201000;21630000;210769000;;-196537000;14232000;35862000
AMDA;498391;USD;2014;Q4;2014-12-31;2015-03-24;2613;2613;18247000;2513000;11675000;33682000;3515000;;10386000;13901000;47583000;3924000;19070000;22994000;3061000;17682000;40676000;179412000;;-172505000;6907000;47583000
AMDA;498391;USD;2013;Q4;2013-12-31;2014-05-15;103;103;2279000;2817000;10084000;19910000;3531000;;10886000;14417000;34327000;7088000;17925000;25013000;;919000;25932000;-13138000;;-139923000;8395000;34327000
AMDA;498391;USD;2018;Q4;2018-12-31;2019-03-11;658015;727326;5447000;263000;676000;7641000;124000;;3750000;3874000;11515000;1139000;;2380000;;736000;3116000;237680000;;-229281000;8399000;11515000
UBNT;503387;USD;2018;Q4;2018-06-30;2018-08-24;74145000;75969000;666681000;174521000;102220000;1001352000;14328000;0;6897000;21225000;1022577000;19878000;24425000;112916000;460352000;593913000;706829000;467000;;315281000;315748000;1022577000
UBNT;503387;USD;2017;Q4;2017-06-30;2017-08-25;80279000;81949000;604198000;140561000;142048000;952334000;12916000;;7461000;20377000;972711000;50715000;14743000;98488000;241821000;272459000;370947000;605000;;601159000;601764000;972711000
UBNT;503387;USD;2016;Q4;2016-06-30;2016-08-22;82473000;83895000;551031000;82790000;57113000;728384000;12953000;;5771000;18724000;747108000;52998000;10993000;90663000;191564000;216069000;306732000;82000;;440294000;440376000;747108000
UBNT;503387;USD;2015;Q4;2015-06-30;2015-08-21;87692000;89226000;446401000;66104000;37031000;581346000;15602000;;3624000;19226000;600572000;44964000;10000000;70134000;87500000;108284000;178418000;87000;;422067000;422154000;600572000
UBNT;503387;USD;2014;Q4;2014-06-30;2014-08-22;88115000;89959000;347097000;54871000;46349000;465724000;7260000;;3167000;10427000;476151000;36432000;0;52315000;72254000;88572000;140887000;145960000;-123864000;313168000;335264000;476151000
UBNT;503387;USD;2013;Q4;2013-06-30;2013-09-13;87188000;89102000;227826000;35884000;15880000;283474000;5976000;;2890000;8866000;292340000;37444000;5013000;59421000;71116000;85483000;144904000;135069000;-123864000;136231000;147436000;292340000
UBNT;503387;USD;2012;Q4;2012-06-30;2012-09-28;91775000;86890000;122060000;75644000;7734000;207897000;4471000;;1368000;5839000;213736000;27396000;6968000;52435000;22623000;30350000;82785000;129073000;-69515000;71393000;130951000;213736000
UBNT;503387;USD;2011;Q4;2011-06-30;2011-11-14;62662000;66805000;76361000;39811000;5663000;128102000;1022000;;2554000;3576000;131678000;19186000;;37801000;145847000;147749000;185550000;608000;-69515000;15035000;-53872000;131678000
UBNT;503387;USD;2019;Q4;2019-06-30;2019-08-21;70201000;70347000;308013000;156043000;264281000;753811000;13618000;31585000;76851000;122054000;875865000;64278000;30675000;179186000;464700000;597402000;776588000;69000;;98815000;99277000;875865000
SMSI;504067;USD;2018;Q4;2018-12-31;2019-03-27;27081000;27081000;12159000;7130000;;20084000;865000;;4254000;5119000;25203000;3355000;;3383000;;1257000;4640000;256654000;;-236091000;20563000;25203000
SMSI;504067;USD;2017;Q4;2017-12-31;2018-03-30;14317000;14317000;2205000;5145000;;7926000;1229000;;4722000;5951000;13877000;3743000;;4816000;1558000;4494000;9310000;237500000;;-232933000;4567000;13877000
SMSI;504067;USD;2016;Q4;2016-12-31;2017-03-10;12330000;12330000;2229000;4962000;;7917000;1811000;;4580000;6391000;14308000;5410000;;5508000;1295000;5741000;11249000;229287000;;-226228000;3059000;14308000
SMSI;504067;USD;2015;Q4;2015-12-31;2016-03-09;11465000;11465000;12897000;8145000;39000;21786000;2492000;;195000;2687000;24473000;6772000;;7212000;;3235000;10447000;224913000;;-210887000;14026000;24473000
SMSI;504067;USD;2014;Q4;2014-12-31;2015-02-27;11283750;11283750;13045000;8216000;97000;22829000;4273000;;288000;4561000;27390000;7273000;;8771000;;3717000;12488000;223186000;;-208284000;14902000;27390000
SMSI;504067;USD;2013;Q4;2013-12-31;2014-03-07;9257750;9257750;14841000;7563000;167000;24293000;7023000;;222000;7245000;31538000;9366000;;9830000;;3537000;13367000;214656000;;-196485000;18171000;31538000
SMSI;504067;USD;2012;Q4;2012-12-31;2013-02-20;8970500;8970500;32201000;8953000;176000;43003000;11211000;;181000;11392000;54395000;6807000;;8243000;;3490000;11733000;211201000;;-168539000;42662000;54395000
SMSI;504067;USD;2011;Q4;2011-12-31;2012-02-27;8925500;8925500;45972000;8525000;309000;64245000;15482000;;214000;15696000;79941000;10822000;;11525000;;3556000;15081000;207963000;;-143103000;64860000;79941000
SMSI;504067;USD;2010;Q4;2010-12-31;2011-08-03;8635750;8695000;72550000;29812000;370000;109336000;11623000;;113933000;125556000;234892000;13036000;;14703000;;1924000;16627000;201737000;;16538000;218265000;234892000
QEP;504259;USD;2016;Q4;2016-12-31;2017-02-22;239800000;239800000;443800000;155700000;10400000;640100000;6539000000;;66300000;6605300000;7245400000;302600000;12300000;514800000;2020900000;3227900000;3742700000;1369000000;-22900000;2173300000;3502700000;7245400000
QEP;504259;USD;2015;Q4;2015-12-31;2016-02-24;176800000;176800000;376100000;278200000;13300000;931800000;7384600000;;81800000;7466400000;8398200000;388100000;206600000;641600000;2014700000;3808700000;4450300000;556600000;-14600000;3418300000;3947900000;8398200000
QEP;504259;USD;2014;Q4;2014-12-31;2015-02-25;179300000;178500000;1160100000;441900000;13700000;2001500000;7231200000;;54100000;7285300000;9286800000;1143900000;54700000;1344800000;2218100000;3866700000;5211500000;537100000;-25400000;3587900000;4075300000;9286800000
QEP;504259;USD;2013;Q4;2013-12-31;2014-02-25;181200000;182000000;11900000;330300000;13400000;551100000;7592500000;;1265300000;8857800000;9408900000;407800000;109100000;673600000;2997500000;4858500000;5532100000;500200000;-14900000;2917800000;3876800000;9408900000
QEP;504259;USD;2012;Q4;2012-12-31;2013-02-22;178200000;180700000;0;387500000;13100000;657300000;8299500000;;151700000;8451200000;9108500000;680300000;39700000;769400000;3206900000;5025400000;5794800000;463900000;-3700000;2773000000;3313700000;9108500000
QEP;504259;USD;2011;Q4;2011-12-31;2012-02-24;176600000;178200000;0;397400000;16200000;731000000;6448900000;;262800000;6711700000;7442700000;481700000;29400000;637800000;1679400000;3452800000;4090600000;433200000;-13100000;2673500000;3352100000;7442700000
QEP;504259;USD;2010;Q4;2010-12-31;2011-07-29;175600000;176400000;0;269900000;81800000;654200000;5890000000;;241100000;6131100000;6785300000;360300000;78000000;624300000;1472300000;3097900000;3722200000;399800000;-3800000;2420000000;3063100000;6785300000
QEP;504259;USD;2017;Q4;2017-12-31;2018-02-28;241000000;240800000;0;141800000;;164500000;6544400000;;685900000;7230300000;7394800000;389800000;44000000;572500000;2160800000;3024400000;3596900000;1400600000;-34200000;2442600000;3797900000;7394800000
QEP;504259;USD;2018;Q4;2018-12-31;2019-02-20;236800000;236700000;0;104300000;;280600000;5059500000;;777700000;5837200000;6117800000;290500000;14600000;334300000;2507100000;3032600000;3366900000;1434300000;-45600000;1376500000;2750900000;6117800000
HUBS;504719;USD;2016;Q4;2016-12-31;2017-02-16;35680000;35680000;114350000;38984000;;176253000;30201000;35718000;17583000;83502000;259755000;31002000;796000;127383000;275000;13672000;141055000;365480000;;-245916000;118700000;259755000
HUBS;504719;USD;2015;Q4;2015-12-31;2016-02-24;34225000;34225000;104552000;25142000;;145754000;18161000;40566000;15898000;74625000;220379000;26272000;542000;91307000;277000;7364000;98671000;322867000;;-200354000;121708000;220379000
HUBS;504719;USD;2014;Q4;2014-12-31;2015-03-05;29111000;29111000;123721000;14270000;;149509000;11381000;;13968000;25349000;174858000;18413000;100000;59428000;78000;4731000;64159000;265145000;;-154301000;110699000;174858000
HUBS;504719;USD;2013;Q4;2013-12-31;2014-11-13;5191000;5191000;12643000;7220000;;28685000;7243000;;14631000;21874000;50559000;14786000;96000;39544000;101496000;104263000;143807000;12903000;;-106072000;-93248000;50559000
HUBS;504719;USD;2017;Q4;2017-12-31;2018-02-13;37402000;37402000;504343000;60676000;;602501000;43294000;31394000;34986000;109674000;712175000;41416000;;178296000;298447000;323519000;501815000;496499000;;-286082000;210360000;712175000
HUBS;504719;USD;2018;Q4;2018-12-31;2019-02-12;39172000;39172000;592250000;77100000;;712418000;52468000;11450000;57617000;121535000;833953000;53704000;;237009000;318782000;352303000;589312000;589748000;;-344384000;244641000;833953000
GWW;504823;USD;2017;Q4;2017-12-31;2018-02-26;56650579;56921126;326876000;1325186000;1429199000;3205989000;1391967000;;1206298000;2598265000;5804254000;1412349000;94312000;1506661000;2248036000;2469860000;3976521000;1095323000;-6675709000;7405192000;1827733000;5804254000
GWW;504823;USD;2016;Q4;2016-12-31;2017-02-28;59147038;59542223;274146000;1223096000;1406470000;3020229000;1420891000;;1253187000;2674078000;5694307000;1222831000;406106000;1628937000;1840946000;2159602000;3788539000;1085086000;-6128416000;7113559000;1905768000;5694307000
GWW;504823;USD;2015;Q4;2015-12-31;2016-02-29;62025636;62471847;290136000;1209641000;1414177000;3048642000;1431241000;;1377872000;2809113000;5857755000;1188116000;600418000;1788534000;1388414000;1716507000;3505041000;1055306000;-5369711000;6802130000;2352714000;5857755000
GWW;504823;USD;2014;Q4;2014-12-31;2015-02-27;67888107;68691708;226644000;1172924000;1356396000;2967549000;1324346000;;991154000;2315500000;5283049000;1181416000;80300000;1261716000;403333000;737232000;1998948000;1003170000;-4032615000;6335990000;3284101000;5283049000
GWW;504823;USD;2013;Q4;2013-12-31;2014-02-27;69133884;70182993;430644000;1101656000;1305520000;3044285000;1208562000;;1013481000;2222043000;5266328000;1098504000;97286000;1195790000;445513000;743702000;1939492000;947885000;-3548973000;5822612000;3326836000;5266328000
GWW;504823;USD;2012;Q4;2012-12-31;2013-02-28;69552581;70802986;452063000;940020000;1301935000;2900640000;1144573000;;969385000;2113958000;5014598000;982407000;97596000;1080003000;467048000;817229000;1897232000;867403000;-3175646000;5278577000;3117366000;5014598000
GWW;504823;USD;2011;Q4;2011-12-31;2012-02-28;69905188;71394586;335491000;888697000;1268647000;2694900000;1060295000;;960867000;2021162000;4716062000;1046416000;341509000;1387925000;175055000;603858000;1991783000;755656000;-2904243000;4806110000;2724279000;4716062000
GWW;504823;USD;2010;Q4;2010-12-31;2011-02-28;69155322;70601264;313454000;762895000;991577000;2238071000;963672000;;702634000;1666306000;3904377000;795475000;73828000;869303000;420446000;747404000;1616707000;692516000;-2857012000;4326761000;2287670000;3904377000
GWW;504823;USD;2009;Q4;2009-12-31;2010-02-25;73393650;74663467;459871000;624910000;889679000;2131515000;953271000;;641546000;1594817000;3726332000;688891000;87908000;776799000;437500000;722334000;1499133000;651188000;-2466350000;3966508000;2227199000;3726332000
GWW;504823;USD;2008;Q4;2008-12-31;2009-07-31;75878297;76870386;396290000;589416000;1009932000;2144109000;930311000;;440997000;1371308000;3515417000;720517000;41217000;761734000;488228000;719878000;1481612000;619558000;-2217954000;3670726000;2033805000;3515417000
GWW;504823;USD;2007;Q4;2007-12-31;2009-07-31;;;133511000;602650000;946327000;1800817000;878345000;;414866000;1293211000;3094028000;719753000;106650000;826403000;4895000;169517000;995920000;530180000;-1821118000;3316875000;2098108000;3094028000
GWW;504823;USD;2018;Q4;2018-12-31;2019-02-28;55887954;56376993;538000000;1385000000;1541000000;3557000000;1352000000;;964000000;2316000000;5873000000;1371000000;130000000;1501000000;2090000000;2279000000;3780000000;1189000000;-6966000000;7869000000;2093000000;5873000000
RYN;504942;USD;2016;Q4;2016-12-31;2017-02-24;122618781;122900856;85909000;20664000;21379000;164804000;14034000;2361389000;145533000;2520956000;2685760000;36954000;31676000;91966000;1030205000;1097042000;1189008000;709867000;;700887000;1496752000;2685760000
RYN;504942;USD;2015;Q4;2015-12-31;2016-02-29;123146590;123931681;51777000;20222000;15351000;105685000;6742000;2132230000;71281000;2210253000;2315938000;34669000;0;59457000;830554000;894741000;954198000;708827000;;612760000;1361740000;2315938000
RYN;504942;USD;2014;Q4;2014-12-31;2015-03-02;126553640;133638381;161558000;24018000;8383000;213704000;6706000;2165934000;66771000;2239411000;2453115000;35034000;129706000;202002000;621849000;675962000;877964000;702598000;;790697000;1575151000;2453115000
RYN;504942;USD;2013;Q4;2013-12-31;2014-11-10;126239931;128302863;199644000;94956000;138818000;519094000;860821000;2049378000;256208000;3166407000;3685501000;113352000;112500000;276112000;1461724000;1654146000;1930258000;692100000;;1015209000;1755243000;3685501000
RYN;504942;USD;2012;Q4;2012-12-31;2013-02-26;-1444985;-1110921;280596000;100359000;127966000;566274000;707038000;1573309000;276330000;2556677000;3122951000;117254000;150000000;307823000;1120052000;1377124000;1684947000;670749000;;876634000;1438004000;3122951000
RYN;504942;USD;2011;Q4;2011-12-31;2012-02-28;-1952866;-2002649;78603000;95008000;121998000;344502000;461552000;1503711000;259583000;2224846000;2569348000;117132000;28110000;178251000;819229000;1068024000;1246275000;630286000;;806235000;1323073000;2569348000
RYN;504942;USD;2010;Q4;2010-12-31;2011-02-23;161737751;163547661;349463000;82640000;110035000;609186000;385304000;1137931000;231232000;1754467000;2363653000;99416000;93057000;244948000;675103000;867123000;1112071000;602882000;;717058000;1251582000;2363653000
RYN;504942;USD;2009;Q4;2009-12-31;2010-07-30;;;74964000;103740000;88504000;509696000;344939000;1188559000;209737000;1743235000;2252931000;124987000;4650000;175111000;694999000;931614000;1106725000;561962000;;663986000;1146206000;2252931000
RYN;504942;USD;2017;Q4;2017-12-31;2018-02-23;128723617;129262971;112653000;27693000;24141000;183527000;23378000;2542863000;108713000;2674954000;2858481000;39864000;3375000;68548000;1022004000;1096993000;1165541000;872228000;;707378000;1692940000;2858481000
RYN;504942;USD;2018;Q4;2018-12-31;2019-02-22;129163042;129741366;148374000;26151000;15703000;207853000;22751000;2486936000;63126000;2572813000;2780666000;33442000;0;63541000;972567000;1062575000;1126116000;884263000;;672371000;1654550000;2780666000
SNDK;505727;USD;2015;Q4;2015-12-31;2016-02-12;200489000;209052000;4006193000;618191000;809395000;5659786000;817130000;1127131000;1626714000;3570975000;9230761000;500790000;913178000;2003480000;1237776000;1407869000;3411349000;5203926000;;733937000;5819412000;9230761000
SNDK;505727;USD;2014;Q4;2014-12-31;2015-02-10;217266000;236481000;2264512000;842476000;698011000;4195198000;724357000;3721292000;1632978000;6078627000;10273825000;540288000;864718000;2185956000;1188491000;1434045000;3620001000;5236982000;;1499149000;6653824000;10273825000
SNDK;505727;USD;2013;Q4;2013-12-31;2014-02-21;225253000;234520000;2905857000;682809000;756975000;4650718000;655794000;4314091000;868114000;5837999000;10488717000;429546000;0;1230580000;1985363000;2292446000;3523026000;5040242000;;2004089000;6965691000;10488717000
SNDK;505727;USD;2012;Q4;2012-12-31;2013-02-19;241451000;245119000;2875504000;626025000;750075000;4606360000;665542000;4296043000;771182000;5732767000;10339127000;469265000;906708000;1881667000;789913000;1197860000;3079527000;5027512000;;2071268000;7259600000;10339127000
SNDK;505727;USD;2011;Q4;2011-12-31;2012-02-23;241776000;247266000;2848988000;521763000;678382000;4355961000;344897000;4709558000;764232000;5818687000;10174648000;534858000;0;1093374000;1604911000;2020435000;3113809000;4934808000;;1796849000;7060839000;10174648000
SNDK;505727;USD;2010;Q4;2010-12-31;2011-02-23;235233000;238202000;2847714000;367784000;509585000;4032692000;266721000;4228463000;248834000;4744018000;8776710000;415003000;;960107000;1711032000;2037208000;2997315000;4709743000;;812653000;5779395000;8776710000
SNDK;505727;USD;2009;Q4;2009-12-31;2010-08-12;228464000;235028000;1919366000;234407000;596493000;2914774000;300997000;2604645000;181303000;3086945000;6001719000;316518000;75000000;871110000;934722000;1222200000;2093310000;4269074000;;-487489000;3908409000;6001719000
FORR;506742;USD;2016;Q4;2016-12-31;2017-03-10;18249000;18571000;138105000;58812000;;223436000;23894000;;88455000;112349000;335785000;43209000;;177474000;;8275000;185749000;157786000;-121976000;121799000;150036000;335785000
FORR;506742;USD;2015;Q4;2015-12-31;2016-03-11;17751000;18181000;101106000;67355000;;197727000;27569000;;93695000;121264000;318991000;41777000;;182453000;;9236000;191689000;135178000;-120185000;117135000;127302000;318991000
FORR;506742;USD;2014;Q4;2014-12-31;2015-03-11;18195000;18822000;104535000;67429000;;207995000;32174000;;92538000;124712000;332707000;37129000;;181697000;;9408000;191105000;125151000;-99254000;117318000;141602000;332707000
FORR;506742;USD;2013;Q4;2013-12-31;2014-03-13;19765000;20342000;155145000;77543000;;266389000;39868000;;95945000;135813000;402202000;34495000;;187398000;;10142000;197540000;109881000;-26088000;118415000;204662000;402202000
FORR;506742;USD;2012;Q4;2012-12-31;2013-03-18;22281000;22662000;233686000;74623000;;336623000;46300000;8970000;96122000;151392000;488015000;30850000;;181345000;;9463000;190808000;389677000;-210843000;117785000;297207000;488015000
FORR;506742;USD;2011;Q4;2011-12-31;2012-03-09;22647000;23119000;218038000;81378000;;337361000;50448000;9565000;90204000;150217000;487578000;31376000;;179263000;;17580000;196843000;373901000;-181000000;104662000;290735000;487578000
FORR;506742;USD;2010;Q4;2010-12-31;2011-08-04;22544000;23132000;206917000;73574000;;317790000;19838000;9117000;103732000;132687000;450477000;40129000;;171650000;;6920000;178570000;358322000;-162595000;81652000;271907000;450477000
FORR;506742;USD;2017;Q4;2017-12-31;2018-03-09;17984000;18323000;134123000;70023000;;236819000;25249000;;83132000;108381000;345200000;49846000;;195053000;;8958000;204011000;182134000;-161943000;123010000;141189000;345200000
HRB;506954;USD;2017;Q4;2017-04-30;2018-06-15;209216000;214772000;1544944000;146774000;;1891713000;231888000;;1017348000;1249236000;3140949000;656524000;1026000;843651000;1494609000;1903587000;2747238000;762712000;-717678000;362980000;393711000;3140949000
HRB;506954;USD;2016;Q4;2016-04-30;2017-06-16;207355000;212499000;1011331000;162775000;;1346039000;263827000;;1084242000;1348069000;2694108000;749083000;981000;939280000;1493017000;1815711000;2754991000;757374000;-754752000;-48206000;-60883000;2694108000
HRB;506954;USD;2015;Q4;2015-04-30;2016-06-17;222100000;229336000;896801000;153116000;;1220601000;293565000;;1333059000;1626624000;2847225000;795126000;826000;1039605000;1491375000;1784517000;2824122000;760832000;-766843000;40347000;23103000;2847225000
HRB;506954;USD;2014;Q4;2014-04-30;2015-06-17;275261000;283673000;2446815000;167964000;;2951301000;311387000;;1252732000;1564119000;4515420000;810750000;790000;1878289000;505298000;804182000;2682471000;786959000;-792192000;1836442000;1832949000;4515420000
HRB;506954;USD;2013;Q4;2013-04-30;2014-06-19;274223000;283011000;2608802000;191618000;;3114006000;304911000;;1274612000;1579523000;4693529000;796176000;400637000;2313116000;505837000;823864000;3136980000;769820000;-807745000;1589297000;1556549000;4693529000
HRB;506954;USD;2012;Q4;2012-04-30;2013-06-26;272386000;277594000;1747584000;206835000;;2462343000;267880000;486876000;1320680000;2075436000;4537779000;1075019000;722000;2012205000;905958000;1262027000;3274232000;755649000;-836097000;1333445000;1263547000;4537779000
HRB;506954;USD;2011;Q4;2011-04-30;2012-06-26;293103000;296055000;1944334000;193858000;;2500994000;240772000;371315000;1536486000;2148573000;4649567000;1067445000;631434000;2526428000;409115000;797247000;3323675000;800763000;-2011013000;2523997000;1325892000;4649567000
HRB;506954;USD;2010;Q4;2010-04-30;2011-06-23;305282000;307470000;2578172000;230172000;;3048087000;255298000;163836000;1822232000;2241366000;5289453000;1218641000;557000;2337980000;1039527000;1501899000;3839879000;816790000;-2036552000;2658103000;1449574000;5289453000
HRB;506954;USD;2009;Q4;2009-04-30;2010-06-29;326254000;328768000;1804045000;517986000;;2649036000;345470000;;2239812000;2585282000;5234318000;1415248000;3688000;2321491000;1060144000;1472197000;3793688000;836918000;-2056552000;2658586000;1440630000;5234318000
HRB;506954;USD;2008;Q4;2008-04-30;2009-09-04;336861000;343869000;1654663000;512814000;;2571080000;368289000;;2420353000;2788642000;5359722000;1509610000;8782000;2398280000;1107122000;1555583000;3953863000;840919000;-2094858000;2671437000;1405859000;5359722000
HRB;506954;USD;2018;Q4;2018-04-30;2019-06-14;202763000;208171000;1572150000;138965000;;2135338000;212092000;;952515000;1164607000;3299945000;718025000;;923001000;1492629000;1835417000;2758418000;770019000;-707462000;499386000;541527000;3299945000
MWW;507294;USD;2015;Q4;2015-12-31;2016-02-11;90224000;101088000;167915000;260518000;;481032000;110143000;21566000;542191000;673900000;1154932000;137069000;9773000;426657000;184499000;246869000;673526000;2026415000;-766387000;-780548000;481406000;1154932000
KND;510383;USD;2016;Q4;2016-12-31;2017-02-28;86905000;85582000;137061000;1172078000;22438000;1803753000;618620000;;3690351000;4308971000;6112724000;871147000;27977000;1005728000;3215062000;4065475000;5071203000;1731522000;;-920544000;1041521000;6112724000
KND;510383;USD;2015;Q4;2015-12-31;2016-02-29;86428000;86071000;98758000;1194868000;27791000;1500899000;971996000;;3995364000;4967360000;6468259000;986232000;24630000;1111212000;3086348000;3651000000;4762212000;1758695000;;-256209000;1706047000;6468259000
KND;510383;USD;2014;Q4;2014-12-31;2015-03-02;65318000;65209000;164188000;944219000;25702000;1311146000;902104000;;3439714000;4341818000;5652964000;724562000;24607000;857263000;2852531000;3309729000;4166992000;1604186000;;-159768000;1485972000;5652964000
KND;510383;USD;2013;Q4;2013-12-31;2014-02-28;52346000;52306000;35972000;916529000;25780000;1217706000;926575000;;1801588000;2728163000;3945869000;689459000;8222000;792421000;1579391000;2032232000;2824653000;1159734000;;-76825000;1121216000;3945869000
KND;510383;USD;2012;Q4;2012-12-31;2013-02-28;51693000;51614000;50007000;1038605000;32021000;1273766000;1143126000;;1821054000;2964180000;4237946000;736881000;8942000;835331000;1648706000;2109771000;2945102000;1159242000;;98799000;1292844000;4237946000
KND;510383;USD;2011;Q4;2011-12-31;2012-02-29;51525000;50940000;41561000;994700000;31060000;1233282000;1059041000;;1846170000;2905211000;4138493000;754987000;10620000;848923000;1531882000;1959325000;2808248000;1151218000;;139172000;1330245000;4138493000
KND;510383;USD;2010;Q4;2010-12-31;2011-08-09;38792000;39205000;17168000;631877000;24327000;836038000;896547000;;604830000;1501377000;2337415000;552623000;91000;621384000;365556000;684272000;1305656000;838467000;;193157000;1031759000;2337415000
KND;510383;USD;2017;Q4;2017-12-31;2018-03-01;87912000;87912000;160254000;1122532000;21716000;1409539000;735979000;;3087199000;3823178000;5232717000;815593000;14638000;926319000;3146972000;3958636000;4884955000;1736043000;;-1618896000;347762000;5232717000
NJR;511242;USD;2016;Q4;2016-09-30;2016-11-22;86067000;87430000;37546000;;217029000;607264000;2407652000;55789000;647865000;3111306000;3718570000;269691000;183152000;571608000;1055038000;1980371000;2551979000;437234000;-81044000;825556000;1166591000;3718570000
NJR;511242;USD;2015;Q4;2015-09-30;2015-11-24;85415000;87667000;4928000;;171043000;488215000;2128261000;59475000;608406000;2796142000;3284357000;272880000;77488000;436100000;843595000;1741301000;2177401000;430769000;-92164000;777745000;1106956000;3284357000
NJR;511242;USD;2014;Q4;2014-09-30;2014-11-25;84358000;86062000;2151000;;285681000;682731000;1884110000;10672000;581291000;2476073000;3158804000;331628000;335505000;791086000;598209000;1401552000;2192638000;417962000;-121031000;674829000;966166000;3158804000
NJR;511242;USD;2013;Q4;2013-09-30;2013-11-26;83080000;83588000;2969000;;328811000;745898000;1643116000;;615769000;2258885000;3004783000;335435000;434243000;851833000;512886000;1265566000;2117399000;412759000;-128638000;604884000;887384000;3004783000
NJR;511242;USD;2012;Q4;2012-09-30;2012-11-29;83210000;83212000;4509000;;273056000;647344000;1484877000;;637784000;2122661000;2770005000;267899000;287560000;653139000;525169000;1303001000;1956140000;383522000;-116551000;557665000;813865000;2770005000
NJR;511242;USD;2011;Q4;2011-09-30;2011-11-23;82846000;83224000;7440000;;301870000;732367000;1295927000;;621150000;1917077000;2649444000;334341000;166925000;703384000;426797000;1169803000;1873187000;375782000;-117683000;528762000;776257000;2649444000
NJR;511242;USD;2010;Q4;2010-09-30;2010-11-24;82368000;83108000;943000;;342233000;785008000;1135719000;;642406000;1778125000;2563133000;315434000;178857000;705798000;428925000;1131852000;1837650000;360860000;-110385000;487015000;725483000;2563133000
NJR;511242;USD;2009;Q4;2009-09-30;2010-08-04;83902000;84438000;36186000;;303490000;684189000;1064439000;;572402000;1636841000;2321030000;198791000;149910000;563895000;455492000;1067409000;1631304000;358605000;-84598000;425771000;689726000;2321030000
NJR;511242;USD;2017;Q4;2017-09-30;2017-11-21;86517000;87353000;2226000;;214007000;579444000;2609741000;65752000;673570000;3349063000;3928507000;282610000;431375000;802918000;997080000;1888946000;2691864000;441954000;-70039000;867984000;1236643000;3928507000
NJR;511242;USD;2018;Q4;2018-09-30;2018-11-20;88277000;90036000;1458000;;198543000;770080000;2651049000;32917000;689618000;3373584000;4143664000;373935000;275495000;750976000;1180619000;1973710000;2724686000;500944000;-76473000;1007117000;1418978000;4143664000
SSNT;511627;USD;2017;Q4;2017-12-31;2018-03-26;4490093;4478093;2235347;2336481;;5403947;567532;;4440769;5008301;10412248;3279192;352289;5845632;297240;339495;6185127;11919362;;-7692242;4227120;10412247
SSNT;511627;USD;2016;Q4;2016-12-31;2017-03-24;4426764;4461403;1621049;2501621;;4917327;466202;;5275900;5742102;10659429;2838661;401391;5110228;546600;578285;5688513;12176688;;-7205773;4970915;10659428
SSNT;511627;USD;2015;Q4;2015-12-31;2016-03-30;4415943;4473590;1193313;2477301;;4893776;425347;;3164426;3589773;8483549;2680787;390200;5569420;1085595;1357808;6927228;12198493;;-10642172;1556321;8483549
SSNT;511627;USD;2014;Q4;2014-12-31;2015-03-31;3955657;3954206;1308337;2097454;;3869570;295054;;892206;1187260;5056830;2278414;239847;4733375;309848;309848;5043223;11030083;;-11016477;13606;5056829
SSNT;511627;USD;2013;Q4;2013-12-31;2014-03-31;3909490;3902861;762892;1574996;;2537164;241895;;790716;1032611;3569775;1869520;228726;3816473;153141;153141;3969614;10809538;;-11209378;-399840;3569774
SSNT;511627;USD;2012;Q4;2012-12-31;2013-03-29;3895599;3418255;4483;1509532;;1645535;250233;;906509;1156742;2802277;1985604;88829;3616808;0;0;3616808;10717394;;-11531926;-814531;2802277
SSNT;511627;USD;2011;Q4;2011-12-31;2012-03-29;147212;10238864;233722;881217;;1229963;137948;;153366;291314;1521277;1287720;111117;2420922;;0;2420922;9327018;;-10296756;-899645;1521277
SSNT;511627;USD;2010;Q4;2010-12-31;2011-08-04;139225;-69578;104344;489280;15285;798627;156621;;65866;222487;1021114;1801702;1374565;6133472;;0;6133472;7846123;;-12913304;-5112358;1021114
SSNT;511627;USD;2018;Q4;2018-12-31;2019-03-28;4501109;4857032;1900857;2378144;;4885755;688122;;6170508;6858630;11744385;3848152;513705;6233226;1176999;1176999;7410225;11763969;;-7429810;4334159;11744384
NHTC;511953;USD;2018;Q4;2018-12-31;2019-04-26;11323000;11357000;132653000;;12165000;150187000;934000;;6800000;7734000;157921000;20254000;;43084000;;24976000;68060000;86428000;-39748000;44431000;89861000;157921000
NHTC;511953;USD;2017;Q4;2017-12-31;2018-03-27;11274000;11267000;135311000;;8398000;151243000;1149000;;7162000;8311000;159554000;20835000;;41921000;;27012000;68933000;86696000;-40570000;44908000;90621000;159554000
NHTC;511953;USD;2016;Q4;2016-12-31;2017-03-10;11213000;11220000;125921000;;11257000;141244000;1388000;;5419000;6807000;148051000;31408000;;57154000;;8458000;65612000;86587000;-41889000;38548000;82439000;148051000
NHTC;511953;USD;2015;Q4;2015-12-31;2016-03-04;12113000;12195000;104914000;;10455000;117712000;894000;;5546000;6440000;124152000;39578000;;61513000;;5830000;67343000;85976000;-19419000;-9647000;56809000;124152000
NHTC;511953;USD;2014;Q4;2014-12-31;2015-03-06;12887000;13648000;44816000;107000;3760000;49613000;476000;;2451000;2927000;52540000;18096000;;24360000;;1730000;26090000;85763000;-4576000;-54799000;26450000;52540000
NHTC;511953;USD;2013;Q4;2013-12-31;2014-03-07;11235000;11495000;14550000;134000;1828000;17170000;265000;;2392000;2657000;19827000;10191000;;13642000;;108000;13750000;80701000;-35000;-74619000;6077000;19827000
NHTC;511953;USD;2012;Q4;2012-12-31;2013-03-12;11024000;11304000;4207000;122000;867000;5837000;121000;;2261000;2382000;8219000;4391000;;6218000;;92000;6310000;80595000;;-78708000;1909000;8219000
NHTC;511953;USD;2011;Q4;2011-12-31;2012-03-27;10774000;11061000;1617000;93000;1089000;3830000;68000;;2225000;2293000;6123000;4867000;;6784000;;148000;6932000;80504000;;-81338000;-809000;6123000
NHTC;511953;USD;2010;Q4;2010-12-31;2011-11-14;10588000;10588000;648000;105000;751000;2565000;203000;;2595000;2798000;5363000;5960000;;8006000;;178000;8184000;80425000;;-83643000;-2821000;5363000
CLCT;512060;USD;2018;Q4;2018-06-30;2018-08-30;8673000;8678000;10581000;2608000;2579000;17733000;8378000;;6103000;14481000;32214000;8198000;562000;11973000;2438000;5973000;17946000;86378000;;-72110000;14268000;32214000
CLCT;512060;USD;2017;Q4;2017-06-30;2017-08-31;8486000;8812000;9826000;3615000;2722000;17824000;3163000;;7622000;10785000;28609000;9349000;0;12416000;0;276000;12692000;84957000;;-69040000;15917000;28609000
CLCT;512060;USD;2016;Q4;2016-06-30;2016-08-30;8458000;8548000;11967000;3883000;1835000;18958000;2839000;;6393000;9232000;28190000;9415000;;12597000;;598000;13195000;80651000;;-65656000;14995000;28190000
CLCT;512060;USD;2015;Q4;2015-06-30;2015-08-27;8362000;8520000;17254000;2460000;1619000;22273000;2326000;;7603000;9929000;32202000;9270000;;12669000;;1064000;13733000;79857000;;-61388000;18469000;32202000
CLCT;512060;USD;2014;Q4;2014-06-30;2014-08-28;8221000;8332000;19909000;2118000;1888000;27001000;2466000;;6121000;8587000;35588000;9869000;;13363000;;1585000;14948000;78020000;;-57380000;20640000;35588000
CLCT;512060;USD;2013;Q4;2013-06-30;2013-08-28;8061000;8105000;18711000;2067000;1656000;24726000;2153000;;6139000;8292000;33018000;7169000;;10316000;;2140000;12456000;74587000;;-54025000;20562000;33018000
CLCT;512060;USD;2012;Q4;2012-06-30;2012-08-30;7940000;7964000;21214000;1794000;2273000;27446000;1795000;;7204000;8999000;36445000;6196000;;9322000;;2592000;11914000;73691000;;-49160000;24531000;36445000
CLCT;512060;USD;2011;Q4;2011-06-30;2011-11-07;7767000;7806000;21926000;1534000;1442000;27767000;1301000;;7443000;8744000;36511000;5313000;;8473000;;2968000;11441000;70410000;;-45340000;25070000;36511000
AWRE;512152;USD;2017;Q4;2017-12-31;2018-02-28;21548000;21510000;51608000;2389000;;55642000;4304000;;5089000;9393000;65035000;1569000;;4374000;;127000;4501000;96461000;;-35927000;60534000;65035000
AWRE;512152;USD;2016;Q4;2016-12-31;2017-02-10;22512000;22524000;51913000;3016000;;55197000;4634000;951000;1202000;6787000;61984000;1210000;;3932000;;211000;4143000;100709000;;-42849000;57841000;61984000
AWRE;512152;USD;2015;Q4;2015-12-31;2016-02-12;22933000;22933000;51232000;4743000;;56458000;4977000;869000;1315000;7161000;63619000;1422000;;7307000;;131000;7438000;103197000;;-46952000;56181000;63619000
AWRE;512152;USD;2014;Q4;2014-12-31;2015-02-13;22752000;22719000;43985000;3619000;;48175000;5289000;1428000;1001000;7718000;55893000;1078000;;3430000;;74000;3504000;103984000;;-51566000;52389000;55893000
AWRE;512152;USD;2013;Q4;2013-12-31;2014-02-18;22573000;22742000;72660000;4582000;1601000;79921000;5582000;2754000;1072000;9408000;89329000;2313000;;4161000;;18000;4179000;101519000;;-16244000;85150000;89329000
AWRE;512152;USD;2012;Q4;2012-12-31;2013-02-19;22436000;22756000;71074000;3457000;0;76997000;5904000;2010000;943000;8857000;85854000;1435000;;3639000;;319000;3958000;100786000;;-18840000;81896000;85854000
AWRE;512152;USD;2011;Q4;2011-12-31;2012-02-21;20618000;20632000;46577000;3546000;547000;50883000;6232000;727000;9000;6968000;57851000;1497000;;2814000;;462000;3276000;79718000;;-25123000;54575000;57851000
AWRE;512152;USD;2010;Q4;2010-12-31;2011-04-27;20044000;20534000;39949000;4968000;1863000;47015000;6360000;;25000;6385000;53400000;2253000;;3197000;;320000;3517000;77573000;;-27690000;49883000;53400000
AWRE;512152;USD;2018;Q4;2018-12-31;2019-02-19;21531000;21674000;51612000;2010000;;57185000;4085000;;5171000;9256000;66441000;1445000;;4469000;;75000;4544000;96591000;;-34694000;61897000;66441000
PMD;512201;USD;2016;Q4;2016-12-31;2017-03-07;5462198;5512958;3938000;5837000;;10854000;13358000;;820000;14178000;25032000;3351000;1144000;4495000;2237000;4930000;9425000;30634000;-10082000;-4945000;15607000;25032000
PMD;512201;USD;2015;Q4;2015-12-31;2016-02-26;5423128;5412641;2689000;3539000;;8129000;13133000;;774000;13907000;22036000;1945000;1620000;3565000;4272000;6797000;10362000;30052000;-10082000;-8296000;11674000;22036000
PMD;512201;USD;2014;Q4;2014-12-31;2015-02-27;5374439;5372081;3612153;4078133;;10576553;12740131;;761025;13501156;24077709;2196404;1399925;3596329;4848158;7644824;11241153;29484239;-10081789;-6565894;12836556;24077709
PMD;512201;USD;2013;Q4;2013-12-31;2014-02-28;5306192;5321994;3970512;4368864;;9956268;6050203;;543345;6593548;16549816;2958470;0;2958470;0;1314221;4272691;28918622;-10081789;-6559708;12277125;16549816
PMD;512201;USD;2012;Q4;2012-12-31;2013-03-08;5272968;5289857;3065785;4620768;;9573916;4201409;;345293;4546702;14120618;2083330;;2083330;;814619;2897949;28490467;-10081789;-7186009;11222669;14120618
PMD;512201;USD;2011;Q4;2011-12-31;2012-03-09;5235768;5218837;5564233;4490976;;11500301;2063377;;237174;2300551;13800852;2283700;;2283700;;482523;2766223;28125464;-10081789;-7009046;11034629;13800852
PMD;512201;USD;2010;Q4;2010-12-31;2011-08-16;5212536;5246536;5738940;3905821;;10657571;1066870;;114037;1180907;11838478;2002203;;2018808;;72157;2090965;27794379;-10059398;-7987468;9747513;11838478
PMD;512201;USD;2017;Q4;2017-12-31;2018-03-16;5492000;5522000;8165000;4488000;;13865000;11811000;;832000;12643000;26508000;3268000;957000;4225000;2420000;3663000;7888000;31053000;-10082000;-2113000;18620000;26508000
PMD;512201;USD;2018;Q4;2018-12-31;2019-03-04;5507000;5523000;7974000;4829000;;13870000;10177000;;927000;11104000;24974000;3644000;416000;4060000;1212000;2167000;6227000;31554000;-10082000;-1326000;18747000;24974000
UG;512245;USD;2016;Q4;2016-12-31;2017-03-23;4594319;4594319;10642310;1597997;1255813;13714172;1090591;;61677;1152268;14866440;1045951;;1045951;;0;1045951;459432;;13185423;13820489;14866440
UG;512245;USD;2015;Q4;2015-12-31;2016-03-24;4587959;4587959;11799959;934754;1293642;14517960;1096113;;74118;1170231;15688191;988367;;988367;;118010;1106377;459432;;14050021;14581814;15688191
UG;512245;USD;2014;Q4;2014-12-31;2015-03-26;4596439;4596439;11412884;1593260;1237154;14663071;1207903;;68042;1275945;15939016;974970;;974970;;227108;1202078;459644;;14017425;14736938;15939016
UG;512245;USD;2013;Q4;2013-12-31;2014-03-24;4596439;4596439;10497467;1790747;1610747;14307218;1334501;;9147;1343648;15650866;1245352;;1245352;;169587;1414939;459644;;13644160;14235927;15650866
UG;512245;USD;2012;Q4;2012-12-31;2013-03-21;4596439;4596439;9492328;1017627;1242750;12623403;1235863;;;1235863;13859266;827508;;827508;;193740;1021248;459644;;12199395;12838018;13859266
UG;512245;USD;2011;Q4;2011-12-31;2012-03-26;4596439;4596439;10386729;1653440;1467434;13972796;1245487;;37672;1283159;15255955;1077348;;1077348;;64578;1141926;459644;;13619773;14114029;15255955
UG;512245;USD;2010;Q4;2010-12-31;2011-08-08;;;9828992;1090711;1321389;12790235;1209160;;75344;1284504;14074739;1024240;;1024240;;3626;1027866;459644;;12580394;13046873;14074739
UG;512245;USD;2017;Q4;2017-12-31;2018-03-22;4594319;4594319;8446289;1905415;1340523;11850522;942887;;59471;1002358;12852880;1422383;;1422383;;33855;1456238;459432;;10471185;11396642;12852880
UG;512245;USD;2018;Q4;2018-12-31;2019-03-21;4594319;4594319;8172331;1672567;1482151;11687100;827925;;29647;857572;12544672;1366151;;1366151;;253583;1619734;459432;;10465506;10924938;12544672
FONR;512339;USD;2017;Q4;2017-06-30;2017-09-27;6217396;6343412;10140000;4322000;1624000;53414000;16462000;;28887000;45349000;98763000;1423000;180000;14236000;337000;1617000;15853000;179132000;-675000;-101003000;82910000;98763000
FONR;512339;USD;2016;Q4;2016-06-30;2016-09-28;6052572;6178588;8528309;4370155;2074300;45559573;14512706;;24815327;39328033;84887606;1254485;2447693;20613247;2059236;3498052;24111299;173703011;-675390;-120624010;60776307;84887606
FONR;512339;USD;2015;Q4;2015-06-30;2015-09-29;6051528;6177544;9448798;3790981;2191849;43620813;12901195;;19970069;32871264;76492077;1782442;2490146;18792652;5699302;6915912;25708564;175448262;-675390;-136348635;50783513;76492077
FONR;512339;USD;2014;Q4;2014-06-30;2014-09-29;6033288;12260198;9951736;4450125;2443536;42821790;15029729;;18938324;33968053;76789843;2481997;2890816;20923091;8481830;9960160;30883251;175285113;-675390;-149259286;45906593;76789844
FONR;512339;USD;2013;Q4;2013-06-30;2013-10-15;5969272;12118259;7870727;4443595;2077088;37865756;17524494;;17760400;35284894;73150650;2771980;2885769;21117612;12887005;14233762;35351374;174499687;-675390;-159655416;37799276;73150650
FONR;512339;USD;2012;Q4;2012-06-30;2012-10-26;23097546;17649665;12032015;5094687;2194949;25884955;3173447;;4576600;7750047;33635002;2176846;1853623;21079608;777274;1454329;22533937;174084666;-675390;-168333958;11101065;33635002
FONR;512339;USD;2011;Q4;2011-06-30;2011-12-14;;5678925;9251244;5263903;2400240;22560661;3769424;358769;4891820;9020013;31580674;2262115;2025836;23136289;1746286;2578571;25714860;173476659;-675390;-174110439;5865814;31580674
FONR;512339;USD;2018;Q4;2018-06-30;2018-09-21;6289040;6415056;19633742;3813576;1431380;67064542;16492278;;34754125;51246403;118310945;1300250;38332;14566702;306035;1509772;16076474;179132448;-675390;-79772587;102234471;118310945
TZOO;515536;USD;2016;Q4;2016-12-31;2017-03-15;13658000;13630000;26838000;14415000;;44466000;6158000;;2906000;9064000;53530000;29104000;;29823000;;5643000;35466000;135000;;21716000;18064000;53530000
TZOO;515536;USD;2015;Q4;2015-12-31;2016-03-14;14698000;14698000;35128000;16398000;;57061000;7905000;;3613000;11518000;68579000;39930000;;41015000;;6177000;47192000;7909000;;17386000;21387000;68579000
TZOO;515536;USD;2014;Q4;2014-12-31;2015-02-17;14728000;14701000;55417000;16124000;;79370000;9498000;;4439000;13937000;93307000;40246000;;43111000;;14369000;57480000;30749000;-21517000;29197000;35827000;93307000
TZOO;515536;USD;2013;Q4;2013-12-31;2014-02-12;14990000;14886000;66223000;13986000;;101474000;8245000;;5083000;13328000;114802000;42590000;;70562000;;12905000;83467000;10410000;-15662000;37117000;31335000;114802000
TZOO;515536;USD;2012;Q4;2012-12-31;2013-02-11;15656000;15657000;61169000;13626000;;86320000;4314000;;7199000;11513000;97833000;37688000;;43666000;;10828000;54494000;9026000;-7898000;42948000;43339000;97833000
TZOO;515536;USD;2011;Q4;2011-12-31;2012-02-21;15951000;16116000;38744000;13340000;;59864000;3557000;;4927000;8484000;68348000;28321000;;30603000;;2986000;33589000;7820000;-15123000;43484000;34759000;68348000
TZOO;515536;USD;2010;Q4;2010-12-31;2011-08-04;16444000;16453000;41184000;13290000;;57767000;3425000;;4810000;8235000;66002000;16661000;;18204000;;1909000;20113000;6762000;0;40165000;45889000;66002000
TZOO;515536;USD;2017;Q4;2017-12-31;2018-03-16;12582000;12602000;22553000;11769000;;37239000;4921000;;3512000;8433000;45672000;28768000;;29593000;;3001000;32594000;125000;;16550000;13078000;45672000
TZOO;515536;USD;2018;Q4;2018-12-31;2019-03-11;12054000;12135000;18017000;12646000;;33166000;3790000;2694000;3774000;10258000;43424000;25471000;;26810000;;2555000;29365000;120000;;18153000;14059000;43424000
UTMD;515633;USD;2016;Q4;2016-12-31;2017-03-08;3732000;3740000;26360000;3211000;4542000;34867000;9966000;;31751000;41717000;76584000;3022000;;3022000;;4318000;7340000;415000;;81072000;69244000;76584000
UTMD;515633;USD;2015;Q4;2015-12-31;2016-03-10;3750000;3771000;23333000;4563000;4196000;32873000;7369000;;38933000;46302000;79175000;4066000;;4066000;;5461000;9527000;2748000;;72861000;69648000;79175000
UTMD;515633;USD;2014;Q4;2014-12-31;2015-03-12;3747000;3770000;19332000;4703000;4872000;29675000;8236000;;43165000;51401000;81076000;5077000;3894000;8971000;973000;7549000;16520000;2927000;;64863000;64556000;81076000
UTMD;515633;USD;2013;Q4;2013-12-31;2014-03-12;3741000;3792000;14451000;4335000;4704000;24286000;8329000;;48096000;56425000;80711000;3559000;4052000;7611000;5065000;12519000;20130000;3315000;;57250000;60581000;80711000
UTMD;515633;USD;2012;Q4;2012-12-31;2013-03-07;3692000;3732000;8913000;4341000;4353000;18535000;8428000;;49972000;58400000;76935000;3821000;4001000;7822000;9003000;18139000;25961000;2305000;;49519000;50973000;76934000
UTMD;515633;USD;2011;Q4;2011-12-31;2012-10-25;3642000;3659000;6598000;4734000;5005000;17015000;8805000;;50569000;59374000;76389000;4201000;5430000;9631000;16242000;26001000;35632000;757000;;42904000;40755000;76387000
UTMD;515633;USD;2010;Q4;2010-12-31;2011-08-08;3618000;3643000;18536000;3164000;3097000;25143000;8750000;;7346000;16096000;41239000;1688000;215000;1903000;909000;1543000;3446000;143000;;38924000;37792000;41238000
UTMD;515633;USD;2017;Q4;2017-12-31;2018-03-06;3723000;3750000;39955000;3623000;5244000;49188000;11621000;;31936000;43557000;92745000;5280000;;5280000;;9343000;14623000;846000;;85617000;78122000;92745000
UTMD;515633;USD;2018;Q4;2018-12-31;2019-03-14;3731000;3737000;51112000;3956000;5412000;60903000;10359000;;28506000;38865000;99768000;5260000;;5260000;;5516000;10776000;159000;;100123000;88992000;99768000
RMCF;515680;USD;2013;Q4;2014-02-28;2014-06-11;6112658;6470015;5859729;5347752;4410763;16991743;8488198;;11985598;20473796;37465539;6051391;108023;7958195;6291977;7342466;15300661;10077179;;10344794;22164878;37465539
RMCF;515680;USD;2012;Q4;2013-02-28;2013-05-29;6059506;6184183;5321696;3916320;4221036;14543933;6777143;;2512869;9290012;23833945;5145655;;5563139;;881694;6444833;7741496;;8642093;17389112;23833945
RMCF;515680;USD;2011;Q4;2012-02-29;2012-05-24;6137554;6289919;4125444;4078158;4119073;14099367;8515644;;1547959;10063603;24162970;3386193;;3542193;;1884957;5427150;8897615;;9838205;18735820;24162970
RMCF;515680;USD;2010;Q4;2011-02-28;2011-10-14;6066594;6313746;3344490;4823257;4124188;13506987;6275406;;1656415;7931821;21438808;3414281;;3675691;;1109002;4784693;8242140;;8411975;16654115;21438808
HIBB;515787;USD;2017;Q4;2018-01-31;2017-03-28;24874000;25275000;38958000;8902000;280701000;338264000;111634000;;8956000;120590000;458854000;85314000;595000;96072000;2857000;28742000;124814000;175106000;-538724000;697658000;334040000;458854000
HIBB;515787;USD;2016;Q4;2017-01-31;2016-03-28;27120000;27350000;38958000;;280701000;338264000;111634000;;8956000;120590000;458854000;85314000;595000;112686000;;12128000;124814000;175106000;-538724000;697658000;334040000;458854000
HIBB;515787;USD;2015;Q4;2016-01-31;2015-03-31;24964000;25207000;88397000;7577000;240408000;355498000;92981000;;3918000;96899000;452397000;92688000;436000;102125000;3029000;25491000;127616000;163060000;-404334000;566055000;324781000;452397000
HIBB;515787;USD;2014;Q4;2015-01-31;2014-06-09;25801000;26136000;66227000;8400000;226545000;323649000;86014000;;6682000;92696000;416345000;82996000;322000;91414000;2889000;20908000;112322000;154915000;-343363000;492471000;304023000;416345000
HIBB;515787;USD;2013;Q4;2014-01-31;2014-03-31;;;66227000;8400000;226545000;323649000;86014000;;6682000;92696000;416345000;82996000;322000;91414000;2889000;20908000;112322000;154915000;-343363000;492471000;304023000;416345000
HIBB;515787;USD;2012;Q4;2013-01-31;2012-03-26;29210000;29811000;76911000;5954000;221378000;321614000;49076000;;6641000;55717000;377331000;110133000;714000;118715000;2138000;19489000;138204000;140801000;-323268000;421594000;239127000;377331000
HIBB;515787;USD;2011;Q4;2012-01-31;2011-03-29;26451000;26981000;55138000;6123000;195071000;268773000;39596000;;5327000;44923000;313696000;83610000;173000;91658000;2072000;18288000;109946000;128154000;-273416000;349012000;203750000;313696000
HIBB;515787;USD;2010;Q4;2011-01-31;2010-09-08;27856000;28997000;49691000;4629000;169394000;231520000;41084000;;4100000;45184000;276704000;75420000;117000;83937000;152000;17688000;101625000;98471000;-166944000;243552000;175079000;276704000
HIBB;515787;USD;2018;Q4;2019-01-31;2019-04-18;18288000;18663000;61756000;9470000;280287000;367856000;115394000;;62815000;178209000;546065000;121244000;1017000;192795000;1994000;17221000;210016000;186142000;-609770000;759677000;336049000;546065000
RCII;515845;USD;2016;Q4;2016-12-31;2017-03-01;53152000;52307000;95396000;69785000;3629000;1225753000;316428000;;60560000;376988000;1602741000;440434000;;613578000;724230000;724230000;1337808000;828202000;-1347677000;800640000;264933000;1602741000
RCII;515845;USD;2015;Q4;2015-12-31;2016-02-29;53068000;52129000;60363000;69320000;4668000;1429630000;330939000;;213899000;544838000;1974468000;428908000;;635045000;955833000;955833000;1590878000;819433000;-1347677000;922878000;383590000;1974468000
RCII;515845;USD;2014;Q4;2014-12-31;2015-03-02;52917000;53296000;46126000;65492000;4855000;1560479000;332726000;;1377992000;1710718000;3271197000;493690000;;838989000;1042813000;1042813000;1881802000;814272000;-1347677000;1927445000;1389395000;3271197000
RCII;515845;USD;2013;Q4;2013-12-31;2014-03-03;52946000;53248000;42274000;59178000;4038000;1308159000;336498000;;1373518000;1710016000;3018175000;447528000;;766031000;916275000;916275000;1682306000;803215000;-1347677000;1880320000;1335869000;3018175000
RCII;515845;USD;2012;Q4;2012-12-31;2013-02-26;58358000;58795000;61087000;52819000;3741000;1197129000;309800000;;1352888000;1662688000;2859817000;408632000;;708259000;687500000;687500000;1395759000;785810000;-1130268000;1806488000;1464058000;2859817000
RCII;515845;USD;2017;Q4;2017-12-31;2018-03-01;53313000;55561000;72968000;69823000;4025000;1080384000;282901000;;57496000;340397000;1420781000;388370000;;475451000;672887000;672887000;1148338000;832368000;-1347677000;798743000;272443000;1420781000
RCII;515845;USD;2018;Q4;2018-12-31;2019-03-01;53520000;55555000;155391000;69645000;3834000;1087692000;226323000;;82902000;309225000;1396917000;451297000;;451297000;540042000;659103000;1110400000;839535000;-1347677000;805924000;286517000;1396917000
EPM;516432;USD;2017;Q4;2017-06-30;2017-09-15;33071447;33235915;23028153;2726702;;26142527;61830757;;295384;62126141;88268668;2101055;;2718894;;17079919;19798813;40995044;;27474811;68469855;88268668
EPM;516432;USD;2016;Q4;2016-06-30;2016-09-09;32902709;32988927;34077060;2638188;;37086450;59999112;;365489;60364601;97451051;5809107;;8528908;;12600993;21129901;47204470;;29116363;76321150;97451051
EPM;516432;USD;2015;Q4;2015-06-30;2015-09-11;32900791;32964324;20118757;3122473;;23693048;45463642;;726037;46189679;69882727;8173878;;9329257;;11976893;21306150;36880134;;11696126;48576577;69882727
EPM;516432;USD;2014;Q4;2014-06-30;2014-09-12;32554169;35249278;23940514;1457212;;26304803;38246897;;464052;38710949;65015752;441722;;2999726;;10138504;13138230;34664992;;17212213;51877522;65015752
EPM;516432;USD;2018;Q4;2018-06-30;2018-09-10;33135670;33235042;24929844;3941916;;32147556;61270153;;244835;61514988;93662544;3432568;;4430214;;11942851;16373065;41790725;;35498754;77289479;93662544
AJRD;516551;USD;2016;Q4;2016-12-31;2017-03-01;69300000;69500000;410300000;136400000;185100000;854700000;366000000;;1028800000;1394800000;2249500000;96200000;55600000;583700000;608000000;1631300000;2215000000;463800000;-64500000;-61800000;34500000;2249500000
AJRD;516551;USD;2015;Q4;2015-12-31;2016-02-16;62500000;51400000;208500000;169500000;156200000;633400000;363300000;;1028800000;1392100000;2025500000;64200000;5300000;542100000;633700000;1625600000;2167700000;349100000;-64500000;-79800000;-142200000;2025500000
AJRD;516551;USD;2014;Q4;2014-12-31;2015-01-30;56900000;56900000;265900000;170500000;138000000;660400000;366500000;;891500000;1258000000;1918400000;104000000;5300000;566400000;776900000;1527700000;2094100000;293300000;-64500000;-70600000;-175500000;1918600000
AJRD;516551;USD;2013;Q4;2013-12-31;2014-02-07;59900000;126700000;197600000;214100000;105900000;596000000;374700000;;784600000;1159300000;1755300000;122500000;2900000;479700000;696300000;1226000000;1705700000;286000000;0;-14000000;49600000;1755300000
AJRD;516551;USD;2012;Q4;2012-12-31;2013-02-12;59200000;59098000;162100000;111500000;46900000;368100000;143900000;;407300000;551200000;919300000;56100000;2700000;318600000;246000000;993400000;1312000000;275500000;;-181900000;-392700000;919300000
AJRD;516551;USD;2011;Q4;2011-12-31;2012-02-07;58800000;58800000;188000000;107000000;49500000;400900000;126900000;;411700000;538600000;939500000;33800000;2800000;299800000;323600000;851300000;1151100000;267100000;;-179300000;-211600000;939500000
AJRD;516551;USD;2010;Q4;2010-12-31;2011-09-30;58500000;58600000;208200000;106700000;51100000;432600000;126400000;;432500000;558900000;991500000;27100000;66000000;361200000;326700000;830500000;1191700000;263200000;;-182200000;-200200000;991500000
AJRD;516551;USD;2017;Q4;2017-12-31;2018-02-21;73000000;72600000;555000000;64500000;;1016700000;359000000;;883000000;1242000000;2258700000;100900000;25000000;594800000;591400000;1561500000;2156300000;510500000;-64500000;-71000000;102400000;2258700000
AJRD;516551;USD;2018;Q4;2018-12-31;2019-02-19;76900000;80100000;735300000;141200000;;1234300000;399700000;;856100000;1255800000;2490100000;88700000;273100000;878300000;352300000;1190500000;2068800000;569500000;-12700000;103900000;421300000;2490100000
LL;517434;USD;2016;Q4;2016-12-31;2017-02-21;27741716;27741716;10271000;;301892000;354305000;115004000;;13235000;128239000;482544000;129840000;;186712000;40000000;64940000;251652000;202731000;-139420000;169037000;230892000;482544000
LL;517434;USD;2015;Q4;2015-12-31;2016-02-29;27088191;27088191;26703000;;244402000;322788000;121997000;;11417000;133414000;456202000;61304000;;127744000;20000000;50890000;178634000;180620000;-138987000;237600000;277568000;456202000
LL;517434;USD;2014;Q4;2014-12-31;2015-02-25;27057601;27229332;20287000;;314371000;357277000;124867000;;11318000;136185000;493462000;83996000;;144247000;;17161000;161408000;177509000;-138692000;294033000;332054000;493462000
LL;517434;USD;2013;Q4;2013-12-31;2014-02-19;27598047;27946105;80634000;;252428000;352207000;65947000;;11405000;77352000;429559000;68036000;;107000000;;13230000;120230000;164611000;-85382000;230662000;309329000;429559000
LL;517434;USD;2012;Q4;2012-12-31;2013-02-20;27234404;27839382;64167000;;206704000;288145000;47764000;;11478000;59242000;347387000;63079000;;101027000;;11819000;112846000;131753000;-50552000;153267000;234541000;347387000
LL;517434;USD;2011;Q4;2011-12-31;2012-02-22;27807349;28383125;61675000;;164139000;237969000;44147000;;12738000;56885000;294854000;40670000;;70721000;;9049000;79770000;110191000;-1116000;106203000;215084000;294854000
LL;517434;USD;2010;Q4;2010-12-31;2011-07-26;27445517;28277686;34830000;;155131000;202805000;35314000;;4171000;39485000;242290000;36204000;;56687000;;5098000;61785000;100558000;;79947000;180505000;242290000
LL;517434;USD;2017;Q4;2017-12-31;2018-02-27;28488342;28185342;19938000;;262280000;297996000;100491000;;12308000;112799000;410795000;79777000;;178161000;15000000;34787000;212948000;208660000;-140875000;131214000;197847000;410795000
LL;517434;USD;2018;Q4;2018-12-31;2019-03-18;-85541716;-85696716;11565000;;318272000;366303000;93689000;;15525000;109214000;475517000;82677000;;242124000;65000000;85995000;328119000;213776000;-141828000;76835000;147398000;475517000
IIN;519102;USD;2016;Q4;2016-12-31;2017-03-15;6841000;6594000;667000;7289000;12343000;21974000;6606000;;15178000;21784000;43758000;11049000;2346000;13518000;9284000;11229000;24747000;28203000;;-8633000;19011000;43758000
IIN;519102;USD;2015;Q4;2015-12-31;2016-03-11;5980000;6224000;367000;8335000;13635000;24889000;6709000;;10288000;16997000;41886000;11508000;1908000;13587000;7929000;9402000;22989000;23702000;;-4046000;18897000;41886000
IIN;519102;USD;2014;Q4;2014-12-31;2015-03-06;5835000;6064000;328000;7673000;9983000;19637000;4245000;;10079000;14324000;33961000;9837000;1886000;11833000;4627000;6021000;17854000;22783000;;-6274000;16107000;33961000
IIN;519102;USD;2013;Q4;2013-12-31;2014-03-12;5713000;5713000;217000;5433000;9400000;17337000;4739000;;10644000;15383000;32720000;8885000;2210000;11359000;6271000;8053000;19412000;22161000;;-8522000;13308000;32720000
IIN;519102;USD;2012;Q4;2012-12-31;2013-03-13;5678000;6095000;225000;6877000;10431000;20560000;5999000;;12573000;18572000;39132000;8439000;2945000;11667000;7222000;8743000;20410000;21484000;;-2360000;18722000;39132000
IIN;519102;USD;2011;Q4;2011-12-31;2012-03-14;5668000;5668000;119000;8545000;11720000;21658000;7006000;;12066000;19072000;40730000;10218000;2883000;13451000;8217000;9833000;23284000;20905000;;-3069000;17446000;40730000
IIN;519102;USD;2010;Q4;2010-12-31;2011-08-15;5505000;5520000;281000;8228000;8331000;17764000;6426000;;12077000;18503000;36267000;6684000;2095000;9149000;6465000;8547000;17696000;21717000;-1265000;-1644000;18571000;36267000
IIN;519102;USD;2017;Q4;2017-12-31;2018-03-13;6884000;7964000;373000;9052000;13708000;28300000;7175000;;18999000;26174000;54474000;17275000;2040000;19315000;9321000;13720000;33035000;28481000;;-6056000;21439000;54474000
IIN;519102;USD;2018;Q4;2018-12-31;2019-03-14;8651000;9737000;46140000;11266000;18163000;84544000;11422000;;19282000;30704000;115248000;21311000;;21647000;;1627000;23274000;93663000;;-509000;91974000;115248000
SFM;520294;USD;2016;Q4;2017-01-31;2017-02-23;141608000;143946000;12465000;25228000;204464000;264026000;604660000;;571207000;1175867000;1439893000;246785000;12370000;259155000;372366000;507829000;766984000;597409000;;75500000;672909000;1439893000
SFM;520294;USD;2015;Q4;2016-01-31;2016-02-25;153183000;156125000;136069000;20424000;165434000;345215000;494067000;;587082000;1081149000;1426364000;215450000;14972000;230422000;275500000;372950000;603372000;577546000;;245446000;822992000;1426364000
SFM;520294;USD;2014;Q4;2015-01-31;2015-02-26;151323000;155673000;130513000;14091000;142793000;334129000;454889000;;580055000;1034944000;1369073000;183958000;36882000;220840000;370173000;462844000;683684000;543200000;;142189000;685389000;1369073000
SFM;520294;USD;2013;Q4;2014-01-31;2014-02-27;146874000;155450000;77652000;9524000;118256000;231627000;348830000;;591947000;940777000;1172404000;166404000;9217000;175621000;421595000;483012000;658633000;479274000;;34497000;513771000;1172404000
SFM;520294;USD;2012;Q4;2013-01-31;2013-08-23;127335000;131801000;67211000;8415000;98382000;203121000;303166000;;596949000;900115000;1103236000;131679000;5167000;136846000;529016000;579635000;716481000;395606000;;-8851000;386755000;1103236000
SFM;520294;USD;2017;Q4;2018-01-31;2018-02-22;132491000;135126000;19479000;25893000;229542000;299507000;713031000;;569065000;1282096000;1581603000;290476000;9238000;299714000;473489000;631195000;930909000;620920000;;30558000;650694000;1581603000
SFM;520294;USD;2018;Q4;2019-01-31;2019-02-21;126607000;127713000;1588000;40564000;264366000;333841000;766429000;;575344000;1341773000;1675614000;302572000;7428000;310000000;572642000;776418000;1086418000;657264000;;-69202000;589196000;1675614000
FDC;520475;USD;2017;Q4;2017-12-31;2018-02-21;921000000;947000000;498000000;2176000000;;23372000000;951000000;;23946000000;24897000000;48269000000;1659000000;1271000000;23293000000;17927000000;18890000000;42183000000;13504000000;-149000000;-9059000000;6086000000;48269000000
FDC;520475;USD;2016;Q4;2016-12-31;2017-02-24;905949313;951189223;385000000;1877000000;;17417000000;883000000;;21992000000;22875000000;40292000000;1564000000;358000000;16717000000;18131000000;19371000000;36088000000;13219000000;-61000000;-10524000000;4204000000;40292000000
FDC;520475;USD;2015;Q4;2015-12-31;2016-02-25;769052172;769052172;429000000;1826000000;;10786000000;951000000;;22625000000;23576000000;34362000000;1639000000;856000000;10645000000;18737000000;19980000000;30625000000;12919000000;;-11032000000;3737000000;34362000000
FDC;520475;USD;2014;Q4;2014-12-31;2015-02-27;1000;1000;358000000;1741000000;;9857000000;930000000;;23247000000;24177000000;34034000000;1796000000;161000000;9514000000;20697000000;21920000000;31434000000;9906000000;;-9547000000;2600000000;34034000000
FDC;520475;USD;2013;Q4;2013-12-31;2014-03-10;;;425300000;1763900000;;10076100000;849400000;;24314300000;25163700000;35239800000;287800000;146300000;9618000000;22556800000;23859900000;33477900000;7384000000;;-8284900000;1761900000;35239800000
FDC;520475;USD;2012;Q4;2012-12-31;2013-03-19;;;608300000;1847700000;;11883400000;855800000;;25159800000;26015600000;37899000000;260900000;257100000;11344900000;22528900000;23860300000;35205200000;7341500000;;-7387800000;2693800000;37899000000
FDC;520475;USD;2011;Q4;2011-12-31;2012-03-05;;;485700000;1848600000;;13315500000;935900000;;26024900000;26960800000;40276300000;205900000;133400000;12820200000;22521700000;23980700000;36800900000;7375200000;;-6680200000;3475400000;40276300000
FDC;520475;USD;2010;Q4;2010-12-31;2011-08-12;;;509500000;2169600000;;9786500000;952000000;;26805600000;27757600000;37544100000;180900000;270500000;8864000000;22438800000;24592100000;33456100000;7395100000;;-6163900000;4088000000;37544100000
FDC;520475;USD;2018;Q4;2018-12-31;2019-02-27;933000000;963000000;555000000;2217000000;;14514000000;905000000;;22908000000;23813000000;38327000000;1636000000;1170000000;14229000000;16429000000;17054000000;31283000000;13801000000;-251000000;-8067000000;7044000000;38327000000
CNVR;521210;USD;2013;Q4;2013-12-31;2014-03-03;66676000;68186000;81319000;148738000;;281369000;28006000;;508400000;536406000;817775000;126472000;;138175000;140000000;174703000;312878000;461889000;;45730000;504897000;817775000
CNVR;521210;USD;2012;Q4;2012-12-31;2013-02-27;75179000;76637000;136638000;147487000;;311261000;29014000;;559421000;588435000;899696000;128383000;10000000;142401000;132500000;166590000;308991000;538100000;;58311000;590705000;899696000
CNVR;521210;USD;2011;Q4;2011-12-31;2012-02-29;81512000;82976000;116676000;129076000;;270933000;19952000;;589826000;609778000;880711000;122293000;10000000;134046000;157500000;183272000;317318000;552688000;;20843000;563393000;880711000
CNVR;521210;USD;2010;Q4;2010-12-31;2011-02-28;163598108;165226504;197317000;86738000;;302525000;12414000;;298628000;311042000;613567000;100974000;0;103258000;0;37668000;140926000;555940000;;-76910000;472641000;613567000
CNVR;521210;USD;2009;Q4;2009-12-31;2010-08-06;85768000;86373000;180523000;68484000;;280961000;11272000;;274329000;285601000;566562000;91703000;;98404000;;61669000;160073000;583766000;;-167420000;406489000;566562000
SJI;525920;USD;2017;Q4;2017-12-31;2018-02-26;79547000;79425000;7819000;207292000;52752000;438993000;2700197000;94204000;631692000;3426093000;3865086000;296910000;410209000;883082000;1122999000;1789595000;2672677000;809094000;-271000;420351000;1192409000;3865086000
SJI;525920;USD;2016;Q4;2016-12-31;2017-02-27;79545000;79551000;18282000;224800000;60610000;473313000;2623770000;42566000;590918000;3257254000;3730567000;251982000;528009000;952624000;808005000;1488703000;2441327000;806290000;-266000;510597000;1289240000;3730567000
SJI;525920;USD;2015;Q4;2015-12-31;2016-02-29;69469000;69846000;3877000;181493000;59299000;431274000;2448105000;80551000;512003000;3040659000;3471933000;196052000;461154000;832476000;997427000;1601918000;2434394000;588167000;-296000;474167000;1037539000;3471933000
SJI;525920;USD;2014;Q4;2014-12-31;2015-02-27;67324000;67622000;4171000;266549000;65371000;566697000;2134103000;142724000;505901000;2782728000;3349425000;282414000;395609000;850185000;859491000;1566808000;2416993000;523802000;-330000;439218000;932432000;3349425000
SJI;525920;USD;2013;Q4;2013-12-31;2014-02-28;-126848000;-126860000;3818000;262474000;60584000;482898000;1859098000;130104000;452755000;2441957000;2924855000;269354000;374900000;764973000;680400000;1332882000;2097855000;441905000;-186000;406041000;827000000;2924855000
SJI;525920;USD;2012;Q4;2012-12-31;2013-02-28;125892000;126224000;4638000;234788000;58135000;394837000;1578021000;101266000;557316000;2236603000;2631440000;202122000;363900000;651844000;601400000;1243382000;1895226000;385374000;-182000;382127000;736214000;2631440000
SJI;525920;USD;2011;Q4;2011-12-31;2012-02-28;120476000;120844000;7538000;138000000;71617000;340609000;1352393000;57150000;497358000;1906901000;2247510000;163242000;323587000;587971000;424213000;1035425000;1623396000;311068000;-193000;341677000;624114000;2247510000
SJI;525920;USD;2010;Q4;2010-12-31;2011-03-01;119488000;120032000;2363000;201956000;73521000;423837000;1193255000;23114000;436409000;1652778000;2076615000;179165000;362087000;640524000;340000000;865994000;1506518000;294615000;-179000;297473000;570097000;2076615000
SJI;525920;USD;2009;Q4;2009-12-31;2010-08-06;119176000;119668000;3823000;141611000;106574000;368355000;1073072000;13656000;326925000;1413653000;1782008000;136650000;231719000;478784000;312793000;758660000;1237444000;291748000;-183000;271505000;544564000;1782008000
SJI;525920;USD;2018;Q4;2018-12-31;2019-02-28;85591000;88574000;30030000;339447000;62168000;663192000;3653473000;77812000;1562100000;5293385000;5956577000;430552000;1004409000;1580838000;2106863000;3108717000;4689555000;950151000;-292000;343258000;1267022000;5956577000
CY;526074;USD;2018;Q4;2018-12-31;2019-02-27;361627000;371887000;285720000;324274000;292093000;1016760000;282986000;65145000;2328324000;2676455000;3693215000;312457000;6943000;620552000;874235000;955624000;1576176000;5641472000;-2370452000;-1157115000;2117039000;3693215000
CY;526074;USD;2017;Q4;2017-12-31;2018-02-26;344107000;316669000;151596000;295991000;272127000;823351000;289554000;122514000;2301631000;2713699000;3537050000;331117000;27303000;675497000;956513000;1043961000;1719458000;5664548000;-2334944000;-1511706000;1817592000;3537050000
CY;526074;USD;2016;Q4;2016-12-31;2017-03-01;322156000;299714000;120172000;333037000;287776000;893943000;297266000;188687000;2491975000;2977928000;3871871000;337482000;30152000;702457000;1194979000;1276662000;1979119000;5664381000;-2335301000;-1428441000;1892752000;3871871000
CY;526074;USD;2015;Q4;2015-12-31;2016-03-02;343040000;320682000;226690000;292736000;243595000;850772000;425003000;41330000;2687156000;3153489000;4004261000;234753000;14606000;528396000;673659000;763180000;1291576000;5628048000;-2148193000;-758780000;2712685000;4004261000
CY;526074;USD;2014;Q4;2014-12-31;2015-02-17;163857000;190975000;118812000;75984000;88227000;312311000;237763000;;193207000;430970000;743281000;98501000;6143000;274832000;237107000;266584000;541416000;2678209000;-2090493000;-379913000;201865000;743281000
CY;526074;USD;2013;Q4;2013-12-31;2014-02-27;151577000;142602000;104462000;81084000;100612000;319713000;258585000;;184586000;443171000;762884000;106749000;;305842000;227000000;281359000;587201000;2668416000;-2090233000;-397849000;175683000;762884000
CY;526074;USD;2012;Q4;2012-12-31;2013-02-28;143604000;118137000;117210000;82920000;127596000;368808000;274427000;;188394000;462821000;831629000;119267000;;348748000;232000000;306020000;654768000;2615447000;-2085570000;-348533000;176861000;831629000
CY;526074;USD;2011;Q4;2011-12-31;2012-02-24;154044000;172079000;166330000;103524000;92304000;405650000;284979000;;119461000;404440000;810090000;112962000;;326460000;;85788000;412248000;2582128000;-1853758000;-326163000;397842000;810090000
CY;526074;USD;2010;Q4;2010-12-31;2011-02-25;165875000;197556000;434261000;117726000;101763000;695658000;260122000;;117021000;377143000;1072801000;114740000;;312289000;;57619000;369908000;2404590000;-1202949000;-494002000;702893000;1072801000
CY;526074;USD;2009;Q4;2009-12-31;2010-08-12;154797000;154797000;299642000;86959000;91198000;518705000;272620000;;121183000;393803000;912508000;106558000;;239062000;;43062000;282124000;2250070000;-1048016000;-569744000;630384000;912508000
NKTR;526216;USD;2016;Q4;2016-12-31;2017-03-01;149147000;149147000;389102000;15678000;11109000;425952000;65601000;0;77318000;142919000;568871000;37963000;2908000;72222000;245687000;408524000;480746000;2111498000;;-2021010000;88125000;568871000
NKTR;526216;USD;2015;Q4;2015-12-31;2016-02-29;134199000;129891000;308944000;19947000;11346000;350051000;71336000;;77255000;148591000;498642000;24935000;4756000;61246000;242772000;430967000;492213000;1876085000;;-1867486000;6429000;498642000
NKTR;526216;USD;2014;Q4;2014-12-31;2015-02-26;129405000;124732000;237824000;3607000;12952000;288200000;70368000;;83053000;153421000;441621000;29495000;4512000;64047000;129139000;341242000;405289000;1824208000;;-1786309000;36332000;441621000
NKTR;526216;USD;2013;Q4;2013-12-31;2014-02-27;116263000;116263000;237026000;2229000;13452000;282882000;66974000;;84671000;151645000;434527000;53434000;3536000;98221000;133049000;426209000;524430000;1643671000;;-1732393000;-89903000;434527000
NKTR;526216;USD;2012;Q4;2012-12-31;2013-03-01;115183000;115183000;277194000;5805000;18269000;339631000;72215000;;85944000;158159000;497790000;44227000;;78537000;136607000;372235000;450772000;1617755000;;-1570380000;47018000;497790000
NKTR;526216;USD;2011;Q4;2011-12-31;2012-02-29;;;241168000;4938000;12656000;276706000;78576000;173768000;77500000;329844000;606550000;36253000;214955000;275532000;14582000;133207000;408739000;1597439000;;-1398525000;197811000;606550000
NKTR;526216;USD;2010;Q4;2010-12-31;2011-04-29;;;315932000;25102000;7266000;353979000;89773000;;77473000;167246000;521225000;37130000;;64108000;231969000;366455000;430563000;1354241000;;-1264547000;90662000;521225000
NKTR;526216;USD;2017;Q4;2017-12-31;2018-03-01;158383000;152153000;296132000;5014000;10726000;326820000;47463000;57088000;77495000;182046000;508866000;36768000;;56163000;245207000;364875000;421038000;2207880000;;-2117941000;87828000;508866000
TR;527072;USD;2016;Q4;2016-12-31;2017-02-27;65677394;;186658000;42964000;57531000;299300000;180905000;164665000;275231000;620801000;920101000;62193000;336000;63561000;7730000;145002000;208563000;689769000;-1992000;43833000;711538000;920101000
TR;527072;USD;2015;Q4;2015-12-31;2016-02-26;66604363;;168300000;51010000;62263000;293806000;184586000;152930000;277661000;615177000;908983000;71361000;231000;72062000;7883000;138373000;210435000;665190000;-1992000;52349000;698548000;908983000
TR;527072;USD;2014;Q4;2014-12-31;2015-02-27;67562801;;139558000;43253000;70379000;266210000;190081000;163579000;290516000;644176000;910386000;64007000;124000;64459000;8194000;154791000;219250000;640972000;-1992000;64927000;691136000;910386000
TR;527072;USD;2013;Q4;2013-12-31;2014-02-28;68629561;;121855000;40721000;61856000;240111000;196916000;148532000;302850000;648298000;888409000;59802000;;60121000;7500000;147983000;208104000;613826000;-1992000;73109000;680305000;888409000
TR;527072;USD;2012;Q4;2012-12-31;2013-03-01;69361461;;82608000;42108000;62383000;197241000;201290000;126812000;321394000;649496000;846737000;60210000;;60765000;7500000;136157000;196922000;588044000;-1992000;80210000;649815000;846737000
TR;527072;USD;2011;Q4;2011-12-31;2012-02-29;62372187;;89507000;41895000;71760000;212201000;212162000;96161000;337332000;645655000;857856000;58355000;;58929000;7500000;132992000;191921000;573611000;-1992000;114269000;665935000;857856000
TR;527072;USD;2010;Q4;2010-12-31;2011-03-01;69454846;;123972000;37394000;56652000;235167000;215492000;64461000;342839000;622792000;857959000;58505000;;58505000;7500000;132046000;190551000;544747000;-1992000;135866000;667408000;857959000
TR;527072;USD;2009;Q4;2009-12-31;2010-08-12;76551887;;99653000;37512000;56387000;211878000;220721000;58136000;347512000;626369000;838247000;56066000;;56066000;7500000;127042000;183108000;520945000;-1992000;148582000;655139000;838247000
TR;527072;USD;2017;Q4;2017-12-31;2018-03-01;64740650;;137920000;47354000;54827000;270920000;178972000;190510000;290544000;660026000;930946000;62745000;440000;63788000;7500000;133354000;197142000;700398000;-1992000;57225000;733804000;930946000
TR;527072;USD;2018;Q4;2018-12-31;2019-03-01;64085000;;186039000;49777000;54524000;304046000;186101000;170409000;286805000;643315000;947361000;60438000;;72889000;7873000;123975000;196864000;741069000;-1992000;33767000;750497000;947361000
NC;528497;USD;2018;Q4;2018-12-31;2019-03-06;6922000;7021000;85257000;20817000;31209000;164174000;124554000;20091000;68172000;212817000;376991000;27599000;654000;42248000;6367000;84039000;126287000;13963000;;250352000;250704000;376991000
NC;528497;USD;2017;Q4;2017-12-31;2018-03-07;-39225657;-39308261;101600000;14611000;30015000;176988000;120068000;16335000;76161000;212564000;389552000;24779000;1125000;53976000;42021000;116128000;170104000;11299000;;216490000;219448000;389552000
NC;528497;USD;2016;Q4;2016-12-31;2017-03-01;52561743;52990689;69308000;13389000;28927000;381732000;115106000;31054000;140129000;286289000;668021000;22477000;1744000;221828000;94295000;225900000;447728000;6779000;;239441000;220293000;668021000
NC;528497;USD;2015;Q4;2015-12-31;2016-03-02;29951811;30188169;52499000;111020000;165016000;361434000;132539000;24643000;136792000;293974000;655408000;141154000;1504000;191746000;160113000;262524000;454270000;6837000;;217745000;201138000;655408000
NC;528497;USD;2014;Q4;2014-12-31;2015-03-09;31886445;31807659;61135000;123466000;190382000;447147000;159644000;;163729000;323373000;770520000;161250000;1467000;254681000;191431000;304365000;559046000;7235000;;224428000;211474000;770520000
NC;528497;USD;2013;Q4;2013-12-31;2014-03-04;34547661;34652709;95390000;120789000;184445000;446838000;219256000;;143862000;363118000;809956000;170923000;7859000;238119000;152431000;274057000;512176000;7871000;;302168000;297780000;809956000
NC;528497;USD;2012;Q4;2012-12-31;2013-03-06;36670506;36998781;139855000;121147000;169440000;471507000;182985000;;121814000;304799000;776306000;153845000;6961000;227169000;135448000;267806000;494975000;32965000;;270227000;281331000;776306000
NC;528497;USD;2011;Q4;2011-12-31;2012-02-29;-113577428;-113898875;153700000;96700000;161300000;1351600000;107200000;;349900000;457100000;1808700000;113300000;6700000;891200000;74500000;340500000;1231700000;31100000;;619700000;577000000;1808700000
NC;528497;USD;2010;Q4;2010-12-31;2011-08-03;-187554769;-187715012;261900000;425900000;447400000;1192300000;270400000;;195600000;466000000;1658300000;475500000;22500000;663500000;355300000;546600000;1210100000;31000000;;475400000;448200000;1658300000
ODP;528624;USD;2017;Q4;2017-12-31;2018-02-28;537000000;545000000;622000000;931000000;1093000000;2871000000;725000000;;2727000000;3452000000;6323000000;897000000;96000000;2046000000;1712000000;2139000000;4185000000;2717000000;-246000000;-273000000;2138000000;6323000000
ODP;528624;USD;2016;Q4;2016-12-31;2017-03-01;522000000;536000000;763000000;687000000;1279000000;2973000000;601000000;;1966000000;2567000000;5540000000;896000000;29000000;2031000000;1156000000;1657000000;3688000000;2624000000;-190000000;-453000000;1852000000;5540000000
ODP;528624;USD;2015;Q4;2015-12-31;2016-02-23;549000000;564000000;860000000;746000000;1406000000;4060000000;665000000;;1717000000;2382000000;6442000000;996000000;51000000;2743000000;1447000000;2096000000;4839000000;2613000000;-58000000;-982000000;1603000000;6442000000
ODP;528624;USD;2014;Q4;2014-12-31;2015-02-24;539000000;530000000;1071000000;1264000000;1638000000;4131000000;963000000;;1663000000;2626000000;6757000000;1344000000;32000000;2890000000;1509000000;2246000000;5136000000;2562000000;-58000000;-990000000;1621000000;6757000000
ODP;528624;USD;2013;Q4;2013-12-31;2014-02-25;425000000;203000000;955000000;1333000000;1812000000;4396000000;1309000000;;1772000000;3081000000;7477000000;1430000000;29000000;2922000000;1555000000;2437000000;5359000000;2485000000;-58000000;-636000000;2118000000;7477000000
ODP;528624;USD;2012;Q4;2012-12-31;2013-02-20;281688000;36780000;671000000;804000000;1051000000;2697000000;856000000;;458000000;1314000000;4011000000;940000000;174000000;2046000000;485000000;917000000;2963000000;1123000000;-58000000;-616000000;1048000000;4011000000
ODP;528624;USD;2011;Q4;2011-12-31;2012-02-28;279119000;437522000;570681000;862831000;1146974000;2744132000;1067040000;;439812000;1506852000;4250984000;1001025000;36401000;2047437000;648313000;1100626000;3148063000;1141406000;-57733000;-539124000;1102921000;4250984000
ODP;528624;USD;2010;Q4;2010-12-31;2011-02-22;276719000;599663000;627478000;963787000;1233657000;3027942000;1157013000;;384482000;1541495000;4569437000;1082844000;72368000;2343445000;659820000;1174038000;3517483000;1164240000;-57733000;-634818000;1051954000;4569437000
ODP;528624;USD;2009;Q4;2009-12-31;2010-07-27;273650000;434666000;659898000;1121160000;1252929000;3206329000;1277655000;;406362000;1684017000;4890346000;1088064000;59845000;2428205000;662740000;1317591000;3745796000;1195964000;-57733000;-590195000;1144550000;4890346000
ODP;528624;USD;2018;Q4;2018-12-31;2019-02-27;549000000;564000000;658000000;885000000;1065000000;2683000000;763000000;;2720000000;3483000000;6166000000;1112000000;95000000;2185000000;1444000000;1855000000;4040000000;2683000000;-285000000;-173000000;2126000000;6166000000
LGL;528980;USD;2016;Q4;2016-12-31;2017-03-29;2664115;2666221;5548000;3504000;3638000;12890000;2711000;;1045000;3756000;16646000;2755000;;2755000;;0;2755000;29200000;-580000;-14726000;13891000;16646000
LGL;528980;USD;2015;Q4;2015-12-31;2016-03-29;2656229;2656229;5609000;2606000;3546000;11952000;3165000;;686000;3851000;15803000;2076000;;2076000;;;2076000;29133000;-572000;-14874000;13727000;15803000
LGL;528980;USD;2014;Q4;2014-12-31;2015-03-31;2599695;2599695;5192000;3266000;4198000;12934000;3547000;;781000;4328000;17262000;2783000;;3025000;;;3025000;28928000;-572000;-14163000;14237000;17262000
LGL;528980;USD;2013;Q4;2013-12-31;2014-03-31;2585590;2585590;7183000;3237000;4629000;16954000;3986000;;323000;4309000;21263000;3305000;;4508000;;0;4508000;28620000;-572000;-11338000;16755000;21263000
LGL;528980;USD;2012;Q4;2012-12-31;2013-04-01;922546;922546;8625000;4350000;5349000;21603000;4707000;;3283000;7990000;29593000;3672000;58000;4979000;0;0;4979000;28110000;-405000;-3119000;24614000;29593000
LGL;528980;USD;2011;Q4;2011-12-31;2012-03-30;4239617;4239617;13709000;4309000;5676000;24946000;4530000;;2945000;7475000;32421000;3402000;400000;6828000;0;0;6828000;27682000;-315000;-1799000;25593000;32421000
LGL;528980;USD;2010;Q4;2010-12-31;2011-08-15;3698076;;4147000;5782000;5947000;17488000;3828000;;2409000;6237000;23725000;4360000;299000;4659000;370000;370000;5029000;20915000;0;-2181000;18696000;23725000
LGL;528980;USD;2017;Q4;2017-12-31;2018-03-22;3692168;4074247;17053000;3393000;3875000;24550000;2179000;;826000;3005000;27555000;2627000;;2627000;;0;2627000;40082000;-580000;-14609000;24928000;27555000
LGL;528980;USD;2018;Q4;2018-12-31;2019-03-21;4826954;5000213;19283000;3394000;4466000;27385000;2086000;;604000;2690000;30075000;2752000;;2752000;;0;2752000;41072000;-580000;-13169000;27323000;30075000
AGX;529078;USD;2017;Q4;2018-01-31;2018-04-11;15562000;15769000;434015000;24756000;;485028000;15299000;;42343000;57642000;542670000;135598000;;183211000;;1293000;184504000;145551000;;211150000;358166000;542670000
AGX;529078;USD;2016;Q4;2017-01-31;2017-04-11;15346000;16566000;522994000;54836000;;587949000;13112000;;43427000;56539000;644488000;141483000;;350724000;;1195000;351919000;137745000;;154649000;292569000;644488000
AGX;529078;USD;2015;Q4;2016-01-31;2016-04-15;14834000;15163000;275007000;64185000;;350612000;12308000;;46871000;59179000;409791000;81849000;;187712000;;224000;187936000;119500000;;99581000;221855000;409791000
AGX;529078;USD;2014;Q4;2015-01-31;2015-04-16;14564000;15159000;333691000;29116000;;364354000;6518000;;20321000;26839000;391193000;53667000;;215432000;;809000;216241000;111858000;;73614000;174952000;391193000
AGX;529078;USD;2013;Q4;2014-01-31;2014-04-15;-42007712;-42563292;272209000;23891000;;298559000;4183000;;20564000;24747000;323306000;30501000;;165237000;;292000;165529000;103006000;-33000;53335000;157777000;323306000
AGX;529078;USD;2012;Q4;2013-01-31;2013-04-12;13954000;14473000;175142000;24879000;;204108000;9468000;;21148000;30616000;234724000;42187000;;115546000;;10000;115556000;97100000;-33000;23850000;119168000;234724000
AGX;529078;USD;2011;Q4;2012-01-31;2012-04-13;13635000;14028000;156524000;16053000;;180577000;2761000;;21914000;24675000;205252000;36275000;;104279000;;600000;104879000;91763000;-33000;8944000;100373000;205252000
AGX;529078;USD;2010;Q4;2011-01-31;2011-09-14;13599000;13694000;83292000;13099000;;106042000;1478000;;23022000;24500000;130542000;21590000;;32868000;;630000;33498000;90601000;-33000;6476000;97044000;130542000
AGX;529078;USD;2018;Q4;2019-01-31;2019-04-10;15571000;15741000;296531000;36174000;;416348000;19778000;;40522000;60300000;476648000;73927000;;82276000;;0;82276000;147298000;;247616000;394372000;476648000
CDE;529633;USD;2016;Q4;2016-12-31;2017-02-10;174152000;179859000;162182000;60431000;106026000;410787000;775251000;35439000;97432000;908122000;1318909000;53335000;12039000;116634000;198857000;433788000;550422000;3316399000;;-2545424000;768487000;1318909000
CDE;529633;USD;2015;Q4;2015-12-31;2016-02-10;145693000;145693000;200714000;85992000;81711000;446688000;785218000;27534000;73049000;885801000;1332489000;52153000;10431000;140080000;479979000;770933000;911013000;3025974000;;-2600776000;421476000;1332489000
CDE;529633;USD;2014;Q4;2014-12-31;2015-02-20;102485000;102394000;270861000;107923000;114931000;557442000;729103000;27668000;122356000;879127000;1436569000;49052000;17498000;165612000;451048000;716629000;882241000;2790729000;;-2233593000;554328000;1436569000
CDE;529633;USD;2013;Q4;2013-12-31;2014-02-26;100897000;100809000;206690000;81074000;132023000;531230000;2237774000;51095000;65879000;2354748000;2885978000;53847000;2505000;144561000;306130000;1010850000;1155411000;2782192000;;-1046719000;1730567000;2885978000
CDE;529633;USD;2012;Q4;2012-12-31;2013-02-21;89097000;89429000;126439000;62438000;170670000;406182000;2675811000;75832000;63576000;2815219000;3221401000;106374000;55983000;238252000;3460000;784869000;1023121000;2602157000;;-396156000;2198280000;3221401000
CDE;529633;USD;2011;Q4;2011-12-31;2012-02-23;89485000;89796000;195266000;83497000;132781000;464883000;2688703000;60158000;50697000;2799558000;3264441000;143192000;32602000;252081000;115861000;875639000;1127720000;2586529000;;-444833000;2136721000;3264441000
CDE;529633;USD;2010;Q4;2010-12-31;2011-03-01;89250000;89250000;66118000;58880000;118340000;266186000;2790317000;42866000;58158000;2891341000;3157527000;135505000;63317000;270717000;130067000;846043000;1116760000;2579099000;;-538332000;2040767000;3157527000
CDE;529633;USD;2009;Q4;2009-12-31;2010-08-09;78771000;78771000;22782000;58981000;67712000;183761000;2779093000;37534000;53647000;2870274000;3054035000;100345000;15403000;188608000;185397000;867381000;1055989000;2445065000;;-447024000;1998046000;3054035000
CDE;529633;USD;2017;Q4;2017-12-31;2018-02-07;182967000;194989000;192032000;19069000;58230000;449557000;1084306000;63587000;103725000;1251618000;1701175000;48592000;30753000;228729000;380569000;657469000;886198000;3359201000;;-2546743000;814977000;1701175000
TSE;530044;USD;2017;Q4;2017-12-31;2018-03-01;43496000;44910000;432800000;685500000;510400000;1646200000;627000000;152500000;346300000;1125800000;2772000000;619600000;7000000;626600000;1165000000;1470600000;2097200000;579300000;-286800000;527900000;674800000;2772000000
TSE;530044;USD;2016;Q4;2016-12-31;2017-03-01;44568000;46008000;465100000;564400000;385300000;1432900000;510000000;191400000;287000000;988400000;2421300000;537200000;5000000;542200000;1160400000;1431400000;1973600000;574200000;-217500000;261200000;447700000;2421300000
TSE;530044;USD;2015;Q4;2015-12-31;2016-03-11;48777000;49133000;431261000;494556000;353097000;1289034000;518751000;182836000;268273000;969860000;2258894000;444269000;5000000;449269000;1177120000;1420611000;1869880000;557020000;;-18289000;389014000;2258894000
TSE;530044;USD;2014;Q4;2014-12-31;2015-03-10;48952000;48952000;220786000;601066000;473861000;1322663000;556697000;167658000;309098000;1033453000;2356116000;565033000;7559000;574005000;1194648000;1461246000;2035251000;548018000;;-151936000;320865000;2356116000
TSE;530044;USD;2013;Q4;2013-12-31;2014-08-11;37270000;37270000;196503000;717482000;530191000;1476746000;606427000;155887000;335721000;1098035000;2574781000;654905000;8754000;666562000;1327667000;1565017000;2231579000;339428000;;-84604000;343202000;2574781000
TSE;530044;USD;2018;Q4;2018-12-31;2019-02-28;42100000;43300000;452300000;648100000;510400000;1631300000;592100000;179100000;324300000;1095500000;2726800000;530000000;7000000;537000000;1160800000;1421100000;1958100000;575900000;-418100000;753200000;768700000;2726800000
LGIH;530141;USD;2016;Q4;2016-12-31;2017-03-07;21298030;23451641;49518000;17055000;717681000;794905000;1960000;;17649000;19609000;814514000;459149000;;459313000;;0;459313000;208569000;-16550000;163182000;355201000;814514000
LGIH;530141;USD;2015;Q4;2015-12-31;2016-03-09;20075797;21588651;37568000;17325000;531228000;593122000;2108000;;23472000;25580000;618702000;368587000;;371313000;;;371313000;175788000;-16550000;88151000;247389000;618702000
LGIH;530141;USD;2014;Q4;2014-12-31;2015-03-13;20376685;22198430;31370000;7365000;367908000;416521000;1610000;;19996000;21606000;438127000;252943000;;255628000;;0;255628000;163728000;-16550000;35321000;182499000;438127000
LGIH;530141;USD;2013;Q4;2013-12-31;2014-03-31;;;54069000;5402000;141983000;205157000;845000;;15008000;15853000;221010000;56636000;;56636000;;0;56636000;157264000;0;7110000;164374000;221010000
LGIH;530141;USD;2012;Q4;2012-12-31;2014-03-31;;;7069471;922897;28489191;38506359;719390;4446302;1884100;7049792;45556151;20345174;;20345174;;0;20345174;;;;25210977;45556151
LGIH;530141;USD;2017;Q4;2017-12-31;2018-02-27;21788715;25651862;67571000;44706000;918933000;1050076000;1674000;;28142000;29816000;1079892000;590046000;;590046000;;0;590046000;229908000;-16550000;276488000;489846000;1079892000
LGIH;530141;USD;2018;Q4;2018-12-31;2019-02-26;22744385;24899853;46624000;42836000;1228256000;1363468000;1432000;;30573000;32005000;1395473000;739530000;;739530000;;;739530000;242225000;-18056000;431774000;655943000;1395473000
CPS;530203;USD;2016;Q4;2016-12-31;2017-02-17;17685043;18822602;480092000;460503000;146449000;1296181000;832269000;;363252000;1195521000;2491702000;725903000;33439000;759342000;729480000;1010569000;1769911000;513951000;;425972000;721791000;2491702000
CPS;530203;USD;2015;Q4;2015-12-31;2016-02-23;17441258;18582044;378243000;455187000;149645000;1189481000;765369000;;349442000;1114811000;2304292000;635926000;45494000;681420000;732418000;1008073000;1689493000;513781000;;306713000;614799000;2304292000
CPS;530203;USD;2014;Q4;2014-12-31;2015-02-24;16139236;16818175;267270000;377032000;166531000;1053998000;716013000;;355619000;1071632000;2125630000;492413000;35631000;528044000;743106000;1044891000;1572935000;492976000;;195233000;552695000;2125630000
CPS;530203;USD;2013;Q4;2013-12-31;2014-02-28;14836192;15575713;184370000;365750000;179766000;995332000;732902000;;374520000;1107422000;2102754000;541842000;28329000;570171000;656095000;911858000;1482029000;489069000;;156775000;620725000;2102754000
CPS;530203;USD;2012;Q4;2012-12-31;2013-02-28;17044180;17989420;270555000;350013000;143253000;990472000;628608000;;406897000;1035505000;2025977000;454360000;32556000;486916000;450809000;773987000;1260903000;471867000;;201907000;765074000;2025977000
CPS;530203;USD;2011;Q4;2011-12-31;2012-03-12;17701034;18830012;361745000;433947000;139726000;1005521000;619717000;;378550000;998267000;2003788000;449890000;33093000;482983000;455559000;779342000;1262325000;485654000;;124674000;741463000;2003788000
CPS;530203;USD;2017;Q4;2017-12-31;2018-02-20;17815231;18587577;515952000;494049000;170196000;1426741000;952178000;;346729000;1298907000;2725648000;792036000;34921000;826957000;723325000;1043602000;1870559000;512833000;;511367000;855089000;2725648000
CPS;530203;USD;2018;Q4;2018-12-31;2019-02-25;17758447;18068752;264980000;418607000;175572000;1249724000;984241000;;389138000;1373379000;2623103000;643831000;101323000;816349000;729805000;947252000;1763601000;501528000;;576025000;859502000;2623103000
ENDP;530918;USD;2017;Q4;2017-12-31;2018-02-27;223321000;223321000;986605000;517436000;391437000;2271077000;523971000;1456000;8839076000;9364503000;11635580000;1098911000;34205000;2220909000;8242032000;8929791000;11150700000;8791192000;;-8096539000;484880000;11635580000
ENDP;530918;USD;2016;Q4;2016-12-31;2017-03-01;222868000;222672000;517250000;992153000;555671000;2589459000;669596000;2267000;11013787000;11685650000;14275109000;1463350000;131125000;2634745000;8141378000;8938775000;11573520000;8743262000;;-5688281000;2701589000;14275109000
ENDP;530918;USD;2015;Q4;2015-12-31;2016-02-29;224145000;216973000;272382000;1014808000;752493000;3452537000;675624000;3855000;15218320000;15897799000;19350336000;1518666000;328705000;3474312000;8251657000;9908048000;13382360000;8693407000;;-2341215000;5967976000;19350336000
ENDP;530918;USD;2014;Q4;2014-12-31;2015-03-02;153772000;176441000;406511000;1118720000;414995000;5112054000;387052000;1506000;5323557000;5712115000;10824169000;1438326000;155937000;3165976000;4100627000;5249980000;8415956000;3093882000;;-595085000;2408213000;10824169000
ENDP;530918;USD;2013;Q4;2013-12-31;2014-05-09;115106000;128645000;526597000;725827000;374439000;2854507000;372077000;2979000;3342293000;3717349000;6571856000;1034528000;414929000;1696672000;3323844000;4289968000;5986640000;1167819000;-763120000;126234000;585216000;6571856000
ENDP;530918;USD;2018;Q4;2018-12-31;2019-02-28;224353000;224353000;1149113000;470570000;322179000;2343150000;498892000;;7290351000;7789243000;10132393000;1010861000;34150000;1950096000;8224269000;8680580000;10630676000;8855832000;;-9124932000;-498283000;10132393000
OHI;531049;USD;2017;Q4;2017-12-31;2018-02-23;198616000;207652000;85937000;950566000;;1134073000;6279132000;641307000;718793000;7639232000;8773305000;295142000;3377488000;3672630000;1194670000;1212417000;4885047000;1745885000;;1839356000;3888258000;8773305000
OHI;531049;USD;2016;Q4;2016-12-31;2017-02-24;195792000;204955000;93687000;879378000;;1039522000;6326022000;858784000;724932000;7909738000;8949260000;360514000;3082511000;3443025000;1284343000;1294249000;4737274000;2173635000;;1738937000;4211986000;8949260000
OHI;531049;USD;2015;Q4;2015-12-31;2016-02-29;554254564;586836335;5424000;883657000;;910287000;5724808000;677000000;677841000;7079649000;7989936000;333706000;2564320000;2898026000;975693000;991045000;3889071000;2374176000;;1372522000;4100865000;7989936000
OHI;531049;USD;2014;Q4;2014-12-31;2015-02-27;127803000;128490000;4489000;816255000;;862612000;2402073000;588184000;68776000;3059033000;3921645000;141815000;2093503000;2235318000;285000000;285000000;2520318000;253329000;;1147998000;1401327000;3921645000
OHI;531049;USD;2013;Q4;2013-12-31;2014-02-11;-346111972;-348533600;2616000;389019000;;424750000;2392137000;582499000;62830000;3037466000;3462216000;137695000;1498418000;1636113000;526000000;526000000;2162113000;373454000;;926649000;1300103000;3462216000
OHI;531049;USD;2012;Q4;2012-12-31;2013-02-28;111758000;112332000;1711000;363801000;;403192000;2458180000;47339000;73294000;2578813000;2982005000;145744000;1566932000;1712676000;258000000;258000000;1970676000;257201000;;754128000;1011329000;2982005000
OHI;531049;USD;2011;Q4;2011-12-31;2012-02-27;103310000;103390000;351000;339339000;;376263000;2066619000;52957000;61473000;2181049000;2557312000;127428000;1278900000;1406328000;272500000;272500000;1678828000;245054000;;633430000;878484000;2557312000
OHI;531049;USD;2010;Q4;2010-12-31;2011-02-28;98655000;98847000;6921000;201376000;;231366000;1985861000;28735000;58045000;2072641000;2304007000;121859000;1176965000;1299941000;;;1299941000;314754000;;580824000;1004066000;2304007000
OHI;531049;USD;2009;Q4;2009-12-31;2010-08-06;85515000;85584000;2170000;181781000;;194314000;1373402000;32800000;54517000;1460719000;1655033000;49895000;644049000;695706000;94100000;94100000;789806000;234351000;;522388000;865227000;1655033000
OHI;531049;USD;2018;Q4;2018-12-31;2019-02-26;201798000;212131000;10300000;1024409000;;1037069000;6183791000;636888000;733129000;7553808000;8590877000;272172000;3328896000;3601068000;1211726000;1225325000;4826393000;1355582000;;2130511000;3764484000;8590877000
FLO;531177;USD;2017;Q4;2017-12-31;2018-02-21;210080000;211590000;5129000;280050000;111045000;507191000;732026000;;1420507000;2152533000;2659724000;381856000;12095000;393951000;820141000;1015096000;1409047000;651071000;-235493000;919658000;1250677000;2659724000
FLO;531177;USD;2016;Q4;2016-12-31;2017-02-23;208769000;210622000;6410000;271913000;110882000;476842000;781026000;;1503200000;2284226000;2761068000;329134000;11490000;340624000;946667000;1210364000;1550988000;644655000;-261812000;910520000;1210080000;2761068000
FLO;531177;USD;2015;Q4;2015-12-31;2016-02-24;212083000;214524000;14378000;269683000;111177000;500308000;804968000;;1538775000;2343743000;2844051000;329053000;74685000;403738000;930022000;1197231000;1600969000;636700000;-174635000;877817000;1243082000;2844051000
FLO;531177;USD;2014;Q4;2014-12-31;2015-02-25;209878000;213489000;7523000;235911000;93100000;460563000;807458000;;1140953000;1948411000;2408974000;281057000;34496000;315553000;728940000;970377000;1285930000;614058000;-202062000;809068000;1123044000;2408974000
FLO;531177;USD;2013;Q4;2013-12-31;2014-02-19;208308000;212537000;8530000;253967000;100851000;487405000;867004000;;1149605000;2016609000;2504014000;296510000;31272000;327782000;892478000;1100043000;1427825000;593554000;-190481000;735631000;1076189000;2504014000
FLO;531177;USD;2012;Q4;2012-12-31;2013-02-20;206026000;208773000;13275000;256235000;91010000;464451000;725836000;;805562000;1531398000;1995849000;282962000;71996000;354958000;535016000;782271000;1137229000;572123000;-196465000;597629000;858620000;1995849000
FLO;531177;USD;2011;Q4;2011-12-31;2012-02-29;202968500;204918500;7783000;185603000;74096000;378570000;685487000;;489941000;1175428000;1553998000;225651000;42768000;268419000;283406000;526611000;795030000;544264000;-221246000;547997000;758968000;1553998000
FLO;531177;USD;2010;Q4;2010-12-31;2011-02-23;204590250;206085000;6755000;166281000;60574000;313714000;604693000;;407082000;1011775000;1325489000;214340000;28432000;242772000;98870000;286927000;529699000;540493000;-214683000;503689000;795790000;1325489000
FLO;531177;USD;2009;Q4;2009-12-31;2010-08-24;206572500;208017750;18948000;178708000;60996000;338955000;602576000;;409911000;1012487000;1351442000;196009000;25763000;221772000;225905000;401644000;623416000;532343000;-189250000;437524000;728026000;1351442000
FLO;531177;USD;2018;Q4;2018-12-31;2019-02-20;211046000;212146000;25306000;287482000;122623000;543724000;743847000;;1557966000;2301813000;2845537000;389443000;10896000;400339000;990640000;1186931000;1587270000;653676000;-231648000;945410000;1258267000;2845537000
BRKS;531292;USD;2017;Q4;2017-09-30;2017-11-17;69808000;71516000;101650000;120828000;106395000;352011000;58462000;31235000;324920000;414617000;766628000;112724000;;146778000;;12206000;158984000;1875751000;-200956000;-1082364000;607644000;766628000
BRKS;531292;USD;2016;Q4;2016-09-30;2016-11-29;68714000;68176000;85125000;106372000;92572000;299334000;54885000;33369000;298317000;386571000;685905000;92564000;;119793000;;12422000;132215000;1856524000;-200956000;-1117044000;553690000;685905000
BRKS;531292;USD;2015;Q4;2015-09-30;2015-11-05;67677000;70085000;150743000;86448000;100619000;355868000;41855000;87595000;273384000;402834000;758702000;86952000;;113000000;;13657000;126657000;1847168000;-200956000;-1020065000;632045000;758702000
BRKS;531292;USD;2014;Q4;2014-09-30;2014-11-13;66840000;68292000;162244000;80106000;93567000;374313000;50183000;112156000;241386000;403725000;778038000;75899000;881000;113841000;7417000;21308000;135149000;1835423000;-200956000;-1007265000;642889000;778038000
BRKS;531292;USD;2013;Q4;2013-09-30;2013-11-22;66151000;65505000;128871000;77483000;94411000;354589000;47506000;70178000;264490000;382174000;736763000;64128000;0;92561000;0;11546000;104107000;1826299000;-200956000;-1015991000;632656000;736763000
BRKS;531292;USD;2012;Q4;2012-09-30;2012-11-21;65398000;65970000;140285000;78855000;102985000;347489000;64478000;91374000;238619000;394471000;741960000;61778000;;81191000;;11468000;92659000;1818504000;-200956000;-992524000;649301000;741960000
BRKS;531292;USD;2011;Q4;2011-09-30;2011-11-28;64753000;65189000;124528000;76701000;107654000;320524000;68596000;116240000;131598000;316434000;636958000;73935000;;95739000;;22283000;118022000;1810084000;-200956000;-1108105000;518936000;636958000
BRKS;531292;USD;2010;Q4;2010-09-30;2011-08-04;64071000;64327000;108834000;92273000;115787000;327331000;63669000;65339000;61885000;190893000;518224000;92086000;;108155000;;20717000;128872000;1803910000;-200956000;-1233649000;389352000;518224000
BRKS;531292;USD;2018;Q4;2018-09-30;2018-11-29;70957000;71293000;243989000;125192000;96986000;564056000;59988000;7237000;463976000;531201000;1095257000;122346000;2000000;164617000;194071000;212808000;377425000;1899275000;-200956000;-994074000;717832000;1095257000
CDI;531420;USD;2016;Q4;2016-12-31;2017-03-08;;18644000;3165000;178365000;;196368000;18189000;;74735000;92924000;289292000;80870000;0;80870000;;19446000;100316000;78959000;-59742000;179302000;188976000;289292000
CDI;531420;USD;2015;Q4;2015-12-31;2016-03-03;;19472000;16932000;205685000;;240320000;18728000;;80049000;98777000;339097000;84952000;18831000;103783000;;14071000;117854000;76990000;-52487000;210875000;221243000;339097000
CDI;531420;USD;2014;Q4;2014-12-31;2015-03-05;;19791000;36324000;219578000;;264957000;20350000;;86913000;107263000;372220000;81593000;1250000;82843000;;15024000;97867000;74231000;-52487000;258113000;274353000;372220000
CDI;531420;USD;2013;Q4;2013-12-31;2014-03-06;;19778000;45479000;230613000;;291227000;20528000;;94052000;114580000;405807000;100424000;2812000;103236000;;17397000;120633000;72300000;-52487000;265207000;285174000;405807000
CDI;531420;USD;2012;Q4;2012-12-31;2013-03-01;;19730000;43652000;223630000;;282345000;22090000;;96270000;118360000;400705000;101457000;2751000;104208000;;16717000;120925000;70045000;-52487000;259912000;279780000;400705000
CDI;531420;USD;2011;Q4;2011-12-31;2012-03-06;;19410000;26644000;222889000;;271730000;25295000;;95491000;120786000;392516000;109961000;0;109961000;;15524000;125485000;66024000;-52487000;253344000;267031000;392516000
CDI;531420;USD;2010;Q4;2010-12-31;2011-08-05;;;28746000;222999000;;270011000;31019000;;97481000;128500000;398511000;110188000;13900000;124088000;;15496000;139584000;62491000;-52487000;248467000;258927000;398511000
THS;532132;USD;2017;Q4;2017-12-31;2018-02-20;57200000;56100000;146900000;329800000;918300000;1484700000;1294400000;;3000200000;4294600000;5779300000;589700000;10100000;599800000;2535700000;2916200000;3516000000;2107600000;-28700000;245900000;2263300000;5779300000
THS;532132;USD;2016;Q4;2016-12-31;2017-02-16;56768000;55068000;72500000;429000000;978000000;1560700000;1359300000;;3625800000;4985100000;6545800000;626800000;66400000;693200000;2724800000;3349300000;4042500000;2072500000;0;532100000;2503300000;6545800000
THS;532132;USD;2015;Q4;2015-12-31;2016-02-18;43193000;43797000;43307000;203198000;584115000;847203000;541528000;;2314065000;2855593000;3702796000;260580000;14893000;275473000;1221741000;1572464000;1847937000;1207598000;;760729000;1854859000;3702796000
THS;532132;USD;2014;Q4;2014-12-31;2015-02-19;42650000;43295000;61129000;233656000;594098000;913872000;543778000;;2400672000;2944450000;3858322000;296860000;12994000;309854000;1437749000;1789211000;2099065000;1177769000;;645819000;1759257000;3858322000
THS;532132;USD;2013;Q4;2013-12-31;2014-02-20;36552000;37539000;55155000;152763000;405698000;649689000;462275000;;1609090000;2071365000;2721054000;238813000;1551000;240364000;938945000;1207572000;1447936000;748942000;;555939000;1273118000;2721054000
THS;532132;USD;2012;Q4;2012-12-31;2013-02-21;36395000;37172000;94407000;124648000;347353000;588411000;425307000;;1512155000;1937462000;2525873000;185086000;1944000;187030000;898100000;1159588000;1346618000;726944000;;468951000;1179255000;2525873000
THS;532132;USD;2011;Q4;2011-12-31;2012-02-21;36119000;37154000;3279000;115168000;329374000;468394000;406558000;;1529577000;1936135000;2404529000;169525000;1954000;171479000;902929000;1159533000;1331012000;715291000;;380588000;1073517000;2404529000
THS;532132;USD;2010;Q4;2010-12-31;2011-02-15;36527691;37707409;6323000;126644000;287395000;440803000;386191000;;1564254000;1950445000;2391248000;202384000;976000;203360000;976452000;1209922000;1413282000;703819000;;286181000;977966000;2391248000
THS;532132;USD;2009;Q4;2009-12-31;2010-08-06;32537000;34031000;4415000;86557000;264933000;370652000;276033000;;737743000;1013776000;1384428000;148819000;906000;149725000;401640000;478474000;628199000;587918000;;195262000;756229000;1384428000
THS;532132;USD;2018;Q4;2018-12-31;2019-02-14;54800000;54400000;164300000;351300000;839700000;1417100000;1274400000;;2907800000;4182200000;5599300000;834000000;1200000;835200000;2297400000;2622200000;3457400000;2136400000;-83300000;185900000;2141900000;5599300000
PDLI;533398;USD;2017;Q4;2017-12-31;2018-03-16;151031000;152325000;532114000;31183000;9147000;640443000;7222000;;595458000;602680000;1243123000;67043000;126066000;193109000;117415000;204124000;397233000;-100905000;;945614000;845890000;1243123000
PDLI;533398;USD;2016;Q4;2016-12-31;2017-03-01;163872000;164619000;167141000;40120000;2884000;398031000;38000;;817318000;817356000;1215387000;42314000;0;130315000;232443000;329649000;459964000;-105973000;;857116000;755423000;1215387000
PDLI;533398;USD;2015;Q4;2015-12-31;2016-02-23;163611000;154678000;220352000;0;0;282710000;31000;;729464000;729495000;1012205000;11775000;24966000;36741000;228862000;279512000;316253000;-116340000;;810036000;695952000;1012205000
PDLI;533398;USD;2014;Q4;2014-12-31;2015-02-23;161174000;183747000;293687000;300000;;355897000;62000;;606391000;606453000;962350000;12487000;175496000;187983000;276228000;313930000;501913000;-118252000;;575740000;460437000;962350000
PDLI;533398;USD;2013;Q4;2013-12-31;2014-03-03;139879000;181454000;99540000;300000;;107697000;41000;;436217000;436258000;543955000;12144000;395280000;407424000;0;23042000;430466000;-231774000;;350151000;113489000;543955000
PDLI;533398;USD;2012;Q4;2012-12-31;2013-03-01;279306320;293632796;148689000;366000;;182985000;59000;;96922000;96981000;279966000;10474000;0;10474000;309952000;337614000;348088000;-232668000;;169634000;-68122000;279966000
PDLI;533398;USD;2011;Q4;2011-12-31;2012-02-23;139682000;166731000;210845000;600000;;233513000;22000;17101000;18835000;35958000;269471000;12137000;93370000;133007000;316615000;340737000;473744000;-160353000;;-42035000;-204273000;269471000
PDLI;533398;USD;2010;Q4;2010-12-31;2011-03-01;-246628213;-345084104;246232000;469000;;286660000;80000;;29926000;30006000;316666000;9744000;119247000;193991000;395451000;446857000;640848000;-85977000;;-241424000;-324182000;316666000
PDLI;533398;USD;2009;Q4;2009-12-31;2010-07-29;119510000;220856000;303227000;1050000;;315836000;171000;;22404000;22575000;338411000;14066000;277850000;293516000;450148000;460848000;754364000;-82655000;;-333298000;-415953000;338411000
PDLI;533398;USD;2018;Q4;2018-12-31;2019-03-15;141109000;138950000;394590000;21648000;18942000;517217000;7387000;;439132000;446519000;963736000;52470000;;52470000;124644000;181487000;233957000;-96665000;-2103000;828547000;729779000;963736000
SPRT;533572;USD;2016;Q4;2016-12-31;2017-03-07;18522000;18522000;53409000;9567000;;64187000;1706000;;1336000;3042000;67229000;6555000;;9314000;;607000;9921000;267402000;-5295000;-202470000;57308000;67229000
SPRT;533572;USD;2015;Q4;2015-12-31;2016-03-07;18295111;18295111;65734000;10019000;;77227000;1989000;;2276000;4265000;81492000;7170000;;9354000;;792000;10146000;265329000;-5167000;-186514000;71346000;81492000
SPRT;533572;USD;2014;Q4;2014-12-31;2015-03-06;18068371;18068371;73793000;14627000;;89823000;417000;;17747000;18164000;107987000;4417000;;10065000;;2201000;12266000;262258000;-5036000;-159473000;95721000;107987000
SPRT;533572;USD;2013;Q4;2013-12-31;2014-03-07;17687898;17002633;72357000;13993000;;87672000;461000;;18766000;19227000;106899000;3017000;;9699000;;1804000;11503000;258296000;-5036000;-155990000;95396000;106899000
SPRT;533572;USD;2012;Q4;2012-12-31;2013-03-08;16492684;15953071;56350000;9689000;;67398000;591000;;20270000;20861000;88259000;2053000;;12640000;;1456000;14096000;242959000;-922000;-166373000;74163000;88259000
SPRT;533572;USD;2011;Q4;2011-12-31;2012-03-09;16115388;16115722;51902000;10284000;;63254000;461000;1111000;20170000;21742000;84996000;2872000;;12086000;;1575000;13661000;233982000;;-160949000;71335000;84996000
SPRT;533572;USD;2010;Q4;2010-12-31;2011-08-08;15846415;15846415;71568000;5133000;;78318000;623000;2667000;12131000;15421000;93739000;1784000;;6933000;;749000;7682000;229697000;;-142309000;86057000;93739000
SPRT;533572;USD;2017;Q4;2017-12-31;2018-03-22;18736000;18714000;49233000;11951000;;61986000;1133000;;1234000;2367000;64353000;4991000;;6997000;;898000;7895000;267859000;-5297000;-203996000;56458000;64353000
SPRT;533572;USD;2018;Q4;2018-12-31;2019-03-08;19005000;18823000;49649000;12292000;;62940000;703000;;957000;1660000;64600000;13791000;0;15904000;;800000;16704000;268796000;-5297000;-213096000;47896000;64600000
LQDT;533622;USD;2017;Q4;2017-09-30;2017-12-07;31503360;31503360;94348000;11598000;20736000;138922000;16793000;;59514000;76307000;215229000;70756000;;70756000;;11837000;82593000;227293000;;-88226000;132636000;215229000
LQDT;533622;USD;2016;Q4;2016-09-30;2016-11-21;30740488;30740488;134513000;10355000;27610000;184912000;14376000;;60821000;75197000;260109000;85488000;;85488000;;12010000;97498000;220221000;;-49039000;162611000;260109000
LQDT;533622;USD;2015;Q4;2015-09-30;2015-11-23;30026222;30026222;95465000;6194000;25510000;188389000;13356000;;86743000;100099000;288488000;69164000;;69164000;;3322000;72486000;210741000;;10887000;216002000;288488000
LQDT;533622;USD;2014;Q4;2014-09-30;2014-11-21;29664259;29664258;62598000;21688000;78478000;184697000;12283000;;234738000;247021000;431718000;106762000;;106762000;;7973000;114735000;204732000;;115702000;316983000;431718000
LQDT;533622;USD;2013;Q4;2013-09-30;2013-11-21;31772378;32702807;95109000;24050000;29261000;164465000;10380000;;246499000;256879000;421344000;85176000;;85176000;;21289000;106465000;206892000;;107469000;314879000;421344000
LQDT;533622;USD;2012;Q4;2012-09-30;2012-11-29;31045292;32788205;104782000;16226000;20669000;162577000;10382000;;227449000;237831000;400408000;84718000;10000000;109383000;32000000;41022000;150405000;182392000;;66365000;250003000;400408000
LQDT;533622;USD;2011;Q4;2011-09-30;2011-12-09;28012433;30527438;128984000;6049000;15065000;171253000;7042000;;49512000;56554000;227807000;51996000;;59566000;;6828000;66394000;124915000;-21884000;58330000;161413000;227807000
LQDT;533622;USD;2010;Q4;2010-09-30;2011-08-09;26846427;27354251;75939000;4386000;14651000;108701000;6287000;;49916000;56203000;164904000;45310000;;48637000;;3893000;52530000;85544000;-18343000;49818000;112374000;164904000
LQDT;533622;USD;2018;Q4;2018-09-30;2018-12-06;32428241;32428241;78448000;4870000;10122000;102983000;16610000;;82239000;98849000;201832000;66329000;;68471000;;3707000;72178000;236148000;;-100045000;129654000;201832000
CRR;534434;USD;2018;Q4;2018-12-31;2019-02-28;27175170;27175170;72752000;35693000;64014000;181257000;273619000;;19490000;293109000;474366000;36590000;15733000;53515000;45650000;84568000;138083000;132357000;;203926000;336283000;474366000
CRR;534434;USD;2017;Q4;2017-12-31;2018-03-08;26693720;26693720;68169000;37705000;78999000;198186000;324186000;;18226000;342412000;540598000;39894000;;42431000;60698000;92402000;134833000;125986000;;279779000;405765000;540598000
CRR;534434;USD;2016;Q4;2016-12-31;2017-03-01;97440414299;97440414299;91680000;23622000;97174000;217223000;494103000;;12131000;506234000;723457000;20205000;13000000;34804000;42404000;72083000;106887000;117461000;;533435000;616570000;723457000
CRR;534434;USD;2015;Q4;2015-12-31;2016-02-29;91928289041;91928289041;78866000;48596000;104558000;285277000;537731000;;13361000;551092000;836369000;31050000;33000000;70290000;55000000;123773000;194063000;65300000;;614708000;642306000;836369000
CRR;534434;USD;2014;Q4;2014-12-31;2015-02-26;91716739094;91716739094;24298000;132573000;144443000;337611000;568716000;;27899000;596615000;934226000;52415000;25000000;77415000;;80754000;158169000;59528000;;739498000;776057000;934226000
CRR;534434;USD;2013;Q4;2013-12-31;2014-02-24;22943757;22943757;94250000;125179000;134260000;371382000;478535000;;29034000;507569000;878951000;56688000;0;56688000;;53676000;110364000;57013000;;714835000;768587000;878951000
CRR;534434;USD;2012;Q4;2012-12-31;2013-02-25;22976350;22976350;90635000;103258000;140686000;349917000;426232000;;32729000;458961000;808878000;50830000;;50830000;;44970000;95800000;57595000;;657423000;713078000;808878000
CRR;534434;USD;2011;Q4;2011-12-31;2012-02-29;22975973;22977302;41270000;112014000;132016000;302565000;392659000;;45641000;438300000;740865000;79066000;;79066000;;31641000;110707000;56770000;;577253000;630158000;740865000
CRR;534434;USD;2010;Q4;2010-12-31;2011-02-25;22971964;22979059;46656000;89531000;91055000;237655000;338483000;;23433000;361916000;599571000;51247000;;51247000;;26345000;77592000;57706000;;468387000;521979000;599571000
CRR;534434;USD;2009;Q4;2009-12-31;2010-08-04;;;69557000;59567000;80149000;218870000;270722000;;23820000;294542000;513412000;32458000;;32458000;;23638000;56096000;54592000;;407933000;457316000;513412000
SLCA;534435;USD;2016;Q4;2016-12-31;2017-02-23;75585000;75585000;711225000;89006000;78709000;892945000;783313000;;396962000;1180275000;2073220000;89202000;7058000;109960000;509134000;689970000;799930000;1129862000;-3869000;163173000;1273290000;2073220000
SLCA;534435;USD;2015;Q4;2015-12-31;2016-02-24;53336000;52936000;298926000;58706000;65004000;439140000;561196000;;108283000;669479000;1108619000;64850000;3330000;83918000;488375000;640534000;724452000;195209000;-15845000;220974000;384167000;1108619000
SLCA;534435;USD;2014;Q4;2014-12-31;2015-02-25;53837000;54475000;338209000;120881000;66712000;558110000;565755000;;102862000;668617000;1226727000;110557000;3329000;140657000;491757000;682254000;822911000;191625000;-542000;232551000;403816000;1226727000
SLCA;534435;USD;2013;Q4;2013-12-31;2014-02-26;53143000;54769000;153236000;75207000;64212000;317532000;442116000;;103813000;545929000;863461000;60645000;3488000;64133000;367963000;490034000;554167000;175333000;0;137978000;309294000;863461000
SLCA;534435;USD;2012;Q4;2012-12-31;2013-02-26;-157041632;-157212436;61022000;59564000;39835000;177267000;414218000;;95325000;509543000;686810000;72802000;2433000;80090000;252992000;375026000;455116000;164108000;-970000;82731000;231694000;686810000
SLCA;534435;USD;2011;Q4;2011-12-31;2012-05-08;-149800000;-149830976;59199000;46600000;29307000;175569000;336788000;;93439000;430227000;605796000;53701000;6364000;70458000;270425000;413404000;483862000;104257000;0;30038000;121934000;605796000
SLCA;534435;USD;2017;Q4;2017-12-31;2018-02-21;81013000;81868000;384567000;212586000;92376000;703244000;1169155000;;434884000;1604039000;2307283000;172607000;6867000;215602000;505075000;695175000;910777000;1147896000;-25456000;287992000;1396506000;2307283000
SLCA;534435;USD;2018;Q4;2018-12-31;2019-02-20;71167000;69164000;202498000;215486000;162087000;600237000;1826303000;;474300000;2300603000;2900840000;216400000;13327000;261339000;1246428000;1587197000;1848536000;1170201000;-178215000;67854000;1052304000;2900840000
TEN;534666;USD;2017;Q4;2017-12-31;2018-02-28;51314965;51682888;315000000;1294000000;869000000;2799000000;1615000000;;428000000;2043000000;4842000000;2051000000;83000000;2266000000;1358000000;1792000000;4058000000;3113000000;-930000000;-946000000;784000000;4842000000
TEN;534666;USD;2016;Q4;2016-12-31;2017-02-24;54087722;54686345;347000000;1272000000;730000000;2602000000;1357000000;;387000000;1744000000;4346000000;1840000000;90000000;1973000000;1294000000;1713000000;3686000000;3099000000;-761000000;-1100000000;660000000;4346000000
TEN;534666;USD;2015;Q4;2015-12-31;2016-02-24;57467358;58024201;287000000;1102000000;682000000;2311000000;1243000000;;416000000;1659000000;3970000000;1667000000;86000000;1794000000;1124000000;1671000000;3465000000;3082000000;-536000000;-1456000000;504000000;3969000000
TEN;534666;USD;2014;Q4;2014-12-31;2015-02-25;60886906;62250983;282000000;1064000000;688000000;2426000000;1218000000;;352000000;1570000000;3996000000;1673000000;60000000;1799000000;1055000000;1624000000;3423000000;3060000000;-323000000;-1695000000;576000000;3999000000
TEN;534666;USD;2013;Q4;2013-12-31;2014-02-28;60442252;61304914;275000000;1041000000;656000000;2290000000;1175000000;;365000000;1540000000;3830000000;1661000000;83000000;1838000000;1019000000;1500000000;3338000000;3015000000;-301000000;-1921000000;492000000;3830000000
TEN;534666;USD;2012;Q4;2012-12-31;2013-02-28;59988128;60387333;223000000;966000000;667000000;2124000000;1122000000;;362000000;1484000000;3608000000;1485000000;113000000;1649000000;1067000000;1653000000;3302000000;3032000000;-274000000;-2104000000;306000000;3608000000
TEN;534666;USD;2011;Q4;2011-12-31;2012-02-27;59912546;60452762;214000000;936000000;592000000;1979000000;1047000000;;311000000;1358000000;3337000000;1454000000;66000000;1570000000;1158000000;1712000000;3282000000;3017000000;-256000000;-2379000000;55000000;3337000000
TEN;534666;USD;2010;Q4;2010-12-31;2011-05-10;59505833;61104781;233000000;796000000;547000000;1790000000;1050000000;;327000000;1377000000;3167000000;1339000000;63000000;1468000000;1160000000;1652000000;3120000000;3009000000;-240000000;-2536000000;47000000;3167000000
TEN;534666;USD;2018;Q4;2018-12-31;2019-03-18;80757419;80524232;697000000;2487000000;2245000000;6109000000;3501000000;544000000;3078000000;7123000000;13232000000;3166000000;153000000;4320000000;5340000000;6858000000;11178000000;4361000000;-930000000;-1013000000;2054000000;13232000000
STOR;534667;USD;2017;Q4;2017-12-31;2018-02-23;191216775;191111403;42937000;;16741000;59678000;5516816000;;323283000;5840099000;5899777000;131934000;;131934000;2596901000;2596901000;2728835000;3383028000;;-214845000;3170942000;5899777000
STOR;534667;USD;2016;Q4;2016-12-31;2017-02-24;156112266;156353191;54200000;;;54200000;4556322000;;331146000;4887468000;4941668000;106742000;;106742000;2351671000;2351671000;2458413000;2633438000;;-151592000;2483255000;4941668000
STOR;534667;USD;2015;Q4;2015-12-31;2016-02-25;130300325;130407745;67115000;;;67115000;3582418000;;261855000;3844273000;3911388000;81648000;;81648000;1769947000;1769947000;1851595000;2163539000;;-103453000;2059793000;3911388000
STOR;534667;USD;2014;Q4;2014-12-31;2015-05-15;97448203;97448203;136313000;;;136313000;2595886000;;150504000;2746390000;2882703000;43609000;;46777000;1253242000;1253242000;1300019000;1637355000;;-54405000;1582684000;2882703000
STOR;534667;USD;2018;Q4;2018-12-31;2019-02-22;215922196;216781586;27511000;;;27511000;6667955000;;418505000;7086460000;7113971000;190158000;;190158000;3060312000;3060312000;3250470000;4131293000;;-267651000;3863501000;7113971000
IDT;535487;USD;2017;Q4;2017-07-31;2017-10-16;24194000;24320000;148616000;64979000;;371117000;88994000;26894000;31958000;147846000;518963000;166348000;;362776000;;1630000;364406000;394751000;-83304000;-163370000;154557000;518963000
IDT;535487;USD;2016;Q4;2016-07-31;2016-10-14;22691000;22812000;156950000;47230000;;339053000;87334000;14024000;29247000;130605000;469658000;147065000;;343820000;;1635000;345455000;396530000;-115316000;-153673000;124203000;469658000
IDT;535487;USD;2015;Q4;2015-07-31;2015-10-14;23005000;23204000;150648000;58543000;;340345000;91316000;12344000;41677000;145337000;485682000;168803000;6353000;348912000;;1830000;350742000;403432000;-110543000;-159829000;134940000;485682000
IDT;535487;USD;2014;Q4;2014-07-31;2014-10-14;22746000;23070000;166696000;69330000;;338865000;81760000;10008000;50298000;142066000;480931000;185395000;13271000;367984000;6353000;11783000;379767000;393137000;-99841000;-196725000;101164000;480931000
IDT;535487;USD;2013;Q4;2013-07-31;2013-10-15;20963000;22727000;161284000;65078000;;294944000;80742000;9605000;50116000;140463000;435407000;187353000;21597000;333669000;6624000;12602000;346271000;388809000;-98836000;-203711000;89136000;435407000
IDT;535487;USD;2012;Q4;2012-07-31;2012-11-09;20970000;23980000;148905000;83017000;;288658000;85567000;7133000;69756000;162456000;451114000;201265000;560000;301365000;29716000;47024000;348389000;396143000;-97757000;-196358000;102725000;451114000
IDT;535487;USD;2011;Q4;2011-07-31;2011-12-23;20524000;22505000;220624000;100146000;;427220000;90471000;8721000;41754000;140946000;568166000;209676000;2312000;321420000;29564000;42956000;364376000;521001000;-94941000;-219992000;203790000;568166000
IDT;535487;USD;2018;Q4;2018-07-31;2018-10-15;24674000;24845000;74061000;69481000;;328881000;36068000;6633000;28015000;70716000;399597000;174942000;;366984000;;1310000;368294000;294336000;-85597000;-173103000;31303000;399597000
IDT;535487;USD;2019;Q4;2019-07-31;2019-10-11;50069169;50124169;88390000;58060000;;368461000;34355000;9319000;31568000;75242000;443703000;164911000;;389070000;;1076000;390146000;273604000;-51739000;-160763000;53557000;443703000
HRI;535488;USD;2017;Q4;2017-12-31;2018-02-28;28300000;29200000;41500000;386300000;23700000;474500000;2660900000;;414300000;3075200000;3549700000;265300000;25400000;290700000;2137100000;2748600000;3039300000;1763400000;-692000000;-462400000;510400000;3549700000
HRI;535488;USD;2016;Q4;2016-12-31;2017-03-15;28300000;28300000;24000000;293300000;24100000;371700000;2662000000;;432300000;3094300000;3466000000;227200000;15700000;242900000;2178600000;2905400000;3148300000;1753600000;-692000000;-625200000;317700000;3466000000
HRI;535488;USD;2015;Q4;2015-12-31;2016-02-29;-91570000;-91570000;15700000;287800000;22300000;361500000;2629100000;;406400000;3035500000;3397000000;272100000;10200000;282300000;53300000;812700000;1095000000;3734900000;-692000000;-605500000;2302000000;3397000000
HRI;535488;USD;2014;Q4;2014-12-31;2015-07-16;-326940000;-327680000;490000000;1597000000;67000000;3642000000;14975000000;;5368000000;20343000000;23985000000;2290000000;;2675000000;15993000000;18846000000;21521000000;3330000000;-87000000;-664000000;2464000000;23985000000
HRI;535488;USD;2013;Q4;2013-12-31;2014-03-19;147180000;153450000;411000000;1397000000;87000000;3471000000;15476000000;;5476000000;20952000000;24423000000;2339000000;;2690000000;16309000000;19166000000;21856000000;3230000000;-87000000;-582000000;2567000000;24423000000
HRI;535488;USD;2012;Q4;2012-12-31;2013-03-04;139036920;158737920;541000000;1787000000;102000000;3464000000;14151000000;;5513000000;19664000000;23128000000;2396000000;;2729000000;15449000000;18068000000;20797000000;3238000000;;-884000000;2331000000;23128000000
HRI;535488;USD;2011;Q4;2011-12-31;2012-02-27;274107219;292399779;931779000;1616382000;83978000;3361936000;11357263000;;2954328000;14311591000;17673527000;2151750000;;2433284000;11317090000;13005568000;15438852000;3210134000;;-947064000;2234675000;17673527000
HRI;535488;USD;2010;Q4;2010-12-31;2011-02-25;136293630;130285650;2374170000;1356553000;87429000;4378510000;10087321000;;2879119000;12966440000;17344950000;1694066000;;1972751000;11306429000;13253748000;15226499000;3187360000;;-1123234000;2118451000;17344950000
HRI;535488;USD;2009;Q4;2009-12-31;2010-08-06;135454440;135454440;985642000;1325332000;93415000;3069673000;10039714000;;2893032000;12932746000;16002419000;1326568000;;1604396000;10364367000;12300582000;13904978000;3145797000;;-1062318000;2097441000;16002419000
HRI;535488;USD;2018;Q4;2018-12-31;2019-02-28;28300000;29900000;27800000;332400000;;400400000;2787200000;;422600000;3209800000;3610200000;269300000;29900000;299200000;2129900000;2738300000;3037500000;1778200000;-692000000;-391100000;572700000;3610200000
Time;535758;USD;2016;Q4;2016-12-31;2017-02-27;94010000;93320000;336000000;543000000;31000000;1020000000;304000000;;2981000000;3285000000;4305000000;598000000;7000000;1008000000;1233000000;1857000000;2865000000;12549000000;;-10732000000;1440000000;4305000000
Time;535758;USD;2015;Q4;2015-12-31;2016-02-19;94450000;94050000;711000000;484000000;35000000;1417000000;267000000;;3200000000;3467000000;4884000000;683000000;7000000;1126000000;1286000000;1949000000;3075000000;12605000000;;-10570000000;1809000000;4884000000
Time;535758;USD;2014;Q4;2014-12-31;2015-02-26;109310000;110990000;519000000;488000000;48000000;1255000000;369000000;;4272000000;4641000000;5896000000;621000000;7000000;1086000000;1364000000;1939000000;3025000000;12666000000;;-9626000000;2871000000;5896000000
Time;535758;USD;2013;Q4;2013-12-31;2014-06-11;108940000;108940000;46000000;489000000;56000000;763000000;534000000;;4377000000;4911000000;5674000000;534000000;0;983000000;38000000;649000000;1632000000;0;;0;4042000000;5674000000
ANET;536189;USD;2016;Q4;2016-12-31;2017-02-17;69996000;74404000;867833000;253119000;236490000;1526126000;76961000;36136000;89784000;202881000;1729007000;170408000;;459553000;;161634000;621187000;674190000;;435105000;1107820000;1729007000
ANET;536189;USD;2015;Q4;2015-12-31;2016-02-25;67068000;71820000;687326000;144263000;92129000;974328000;79706000;36636000;69220000;185562000;1159890000;104937000;;235011000;;136727000;371738000;537911000;;250916000;788152000;1159890000
ANET;536189;USD;2014;Q4;2014-12-31;2015-05-15;63691000;70750000;449457000;96982000;78006000;679479000;71558000;36636000;23350000;131544000;811023000;72797000;;144373000;;110992000;255365000;426178000;;129814000;555658000;811023000
ANET;536189;USD;2013;Q4;2013-12-31;2014-08-08;28499000;32481000;117664000;77999000;67094000;282766000;67204000;0;14550000;81754000;364520000;59101000;74050000;209344000;;77444000;286788000;28740000;;42964000;77732000;364520000
ANET;536189;USD;2017;Q4;2017-12-31;2018-02-20;73338000;80314000;1535555000;247346000;306198000;2266429000;74279000;36136000;84016000;194431000;2460860000;186027000;;529905000;;269041000;798946000;804738000;;859114000;1661914000;2460860000
HYH;536304;USD;2016;Q4;2016-12-31;2017-02-27;46400000;47100000;113700000;190100000;272500000;593500000;260800000;;1217500000;1478300000;2071800000;324400000;;324400000;579000000;644900000;969300000;1533700000;-1900000;-379200000;1102500000;2071800000
HYH;536304;USD;2015;Q4;2015-12-31;2016-02-29;46700000;46300000;129500000;224700000;303200000;676000000;279500000;;1044700000;1324200000;2000200000;315200000;;315200000;578100000;629700000;944900000;1518500000;-1000000;-419000000;1055300000;2000200000
HYH;536304;USD;2014;Q4;2014-12-31;2015-03-13;46500000;46500000;149000000;233900000;283100000;683600000;277800000;;1556500000;1834300000;2517900000;352100000;3900000;356000000;622600000;670700000;1026700000;1503000000;0;7300000;1491200000;2517900000
HYH;536304;USD;2013;Q4;2013-12-31;2014-11-20;;;44100000;203300000;285600000;585100000;324900000;;1574000000;1898900000;2484000000;298500000;2800000;310400000;0;2193200000;2503600000;0;;0;-19600000;2484000000
HYH;536304;USD;2017;Q4;2017-12-31;2018-02-27;47000000;44900000;219700000;203000000;91100000;528200000;109900000;;1557800000;1667700000;2195900000;316100000;39800000;389800000;541100000;590700000;980500000;1551000000;-4400000;-299900000;1215400000;2195900000
HYH;536304;USD;2018;Q4;2018-12-31;2019-02-26;47500000;45100000;384500000;150500000;121400000;713600000;154100000;;965700000;1119800000;1833400000;264300000;0;264300000;247700000;271900000;536200000;1578600000;-5300000;-242400000;1297200000;1833400000
CC;536512;USD;2016;Q4;2016-12-31;2017-02-17;182130689;187156632;902000000;807000000;767000000;2553000000;2784000000;136000000;587000000;3507000000;6060000000;1756000000;15000000;1771000000;3529000000;4185000000;5956000000;791000000;;-114000000;104000000;6060000000
CC;536512;USD;2015;Q4;2015-12-31;2016-02-25;181072777;181072777;366000000;859000000;972000000;2301000000;3177000000;136000000;684000000;3997000000;6298000000;1427000000;39000000;1466000000;3915000000;4702000000;6168000000;777000000;;-115000000;130000000;6298000000
CC;536512;USD;2014;Q4;2014-12-31;2015-08-06;180966833;180966833;0;846000000;1052000000;1941000000;3308000000;124000000;586000000;4018000000;5959000000;1398000000;0;1398000000;0;4538000000;5936000000;0;;0;23000000;5959000000
CC;536512;USD;2017;Q4;2017-12-31;2018-02-16;185467643;192021581;1556000000;919000000;935000000;3493000000;3008000000;173000000;619000000;3800000000;7293000000;1633000000;15000000;1648000000;4097000000;4780000000;6428000000;839000000;-116000000;579000000;865000000;7293000000
CC;536512;USD;2018;Q4;2018-12-31;2019-02-15;171515869;176256521;1201000000;861000000;1147000000;3293000000;3291000000;160000000;618000000;4069000000;7362000000;1696000000;13000000;1709000000;3959000000;4633000000;6342000000;862000000;-750000000;1466000000;1020000000;7362000000
HTZ;536728;USD;2017;Q4;2017-12-31;2018-02-27;95450000;95450000;1072000000;1365000000;;3556000000;12176000000;;4326000000;16502000000;20058000000;2026000000;;3673000000;14865000000;14865000000;18538000000;2244000000;-100000000;-506000000;1520000000;20058000000
HTZ;536728;USD;2016;Q4;2016-12-31;2017-03-06;93150000;93150000;816000000;1283000000;;2955000000;11676000000;;4524000000;16200000000;19155000000;1966000000;;4539000000;13541000000;13541000000;18080000000;2228000000;-100000000;-882000000;1075000000;19155000000
HTZ;536728;USD;2015;Q4;2015-12-31;2016-02-29;;;474000000;1786000000;;6983000000;11723000000;;4808000000;16531000000;23514000000;1929000000;;5725000000;15770000000;15770000000;21495000000;3347000000;-692000000;-391000000;2019000000;23514000000
HTZ;536728;USD;2014;Q4;2014-12-31;2015-07-16;;;490000000;1597000000;67000000;3737000000;14975000000;;5368000000;20343000000;24080000000;2290000000;;5592000000;15993000000;15993000000;21585000000;3566000000;;-956000000;2495000000;24080000000
HTZ;536728;USD;2013;Q4;2013-12-31;2014-03-31;;;411000000;1397000000;87000000;3564000000;15476000000;;5476000000;20952000000;24516000000;2338000000;;5608000000;16228000000;16228000000;21836000000;3552000000;;-878000000;2680000000;24516000000
HTZ;536728;USD;2012;Q4;2012-12-31;2013-03-04;;;541000000;1787000000;102000000;3468000000;14151000000;;5513000000;19664000000;23132000000;2395000000;;5376000000;15015000000;15015000000;20391000000;3510000000;;-746000000;2741000000;23132000000
HTZ;536728;USD;2011;Q4;2011-12-31;2012-02-27;;;931208000;1616382000;83978000;3355741000;11357263000;;2954328000;14311591000;17667332000;2186811000;;4130629000;10907849000;10907849000;15038478000;3473625000;;-816376000;2628854000;17667332000
HTZ;536728;USD;2010;Q4;2010-12-31;2011-02-28;;;2374006000;1356553000;87429000;4370490000;10087321000;;2879119000;12966440000;17336930000;2158660000;;3915156000;10919345000;10919345000;14834501000;3452019000;;-1003915000;2502429000;17336930000
HTZ;536728;USD;2009;Q4;2009-12-31;2010-08-09;;;985467000;1329647000;93415000;3063678000;10039714000;;2893032000;12932746000;15996424000;1807235000;;3525337000;9997014000;9997014000;13522351000;3410518000;;-950407000;2474073000;15996424000
BJRI;537369;USD;2018;Q4;2018-12-31;2019-02-26;21248000;21989000;29224000;31190000;10133000;78487000;582754000;;33866000;616620000;695107000;150425000;;150425000;95000000;235461000;385886000;64342000;;244879000;309221000;695107000
BJRI;537369;USD;2017;Q4;2017-12-31;2018-02-26;20637000;21031000;24335000;13865000;10514000;60329000;589844000;;33377000;623221000;683550000;122541000;;122541000;163500000;302280000;424821000;68904000;;189825000;258729000;683550000
BJRI;537369;USD;2016;Q4;2016-12-31;2017-02-28;22781000;23181000;22761000;14698000;9907000;58690000;601324000;;31298000;632622000;691312000;125698000;;125698000;148000000;290717000;416415000;66200000;;208697000;274897000;691312000
BJRI;537369;USD;2015;Q4;2015-12-31;2016-02-23;25100000;25546000;34604000;25364000;8893000;93003000;561832000;;26830000;588662000;681665000;116894000;;116894000;100500000;248288000;365182000;70657000;;245826000;316483000;681665000
BJRI;537369;USD;2014;Q4;2014-12-31;2015-02-26;26319000;26949000;30683000;18796000;8010000;81318000;541349000;;24416000;565765000;647083000;107025000;;107025000;58000000;191369000;298394000;148188000;;200501000;348689000;647083000
BJRI;537369;USD;2013;Q4;2013-12-31;2014-02-25;28251000;28894000;30983000;12776000;7433000;70836000;516502000;1803000;21738000;540043000;610879000;92139000;;92139000;;117304000;209443000;228332000;;173104000;401436000;610879000
BJRI;537369;USD;2012;Q4;2012-12-31;2013-02-25;28083000;28585000;33390000;18929000;6061000;75365000;457499000;7534000;19123000;484156000;559521000;82484000;;82484000;;105203000;187687000;219752000;;152082000;371834000;559521000
BJRI;537369;USD;2011;Q4;2011-12-31;2012-02-28;27750000;29351000;45396000;14539000;5963000;86999000;390591000;7739000;16750000;415080000;502079000;74168000;;74168000;;95462000;169630000;211776000;;120673000;332449000;502079000
BJRI;537369;USD;2010;Q4;2010-12-31;2011-08-03;27265000;28839000;53192000;10041000;4323000;82721000;330108000;1005000;16251000;347364000;430085000;64085000;;64085000;;78174000;142259000;198723000;;89103000;287826000;430085000
CHRS;540930;USD;2016;Q4;2016-12-31;2017-03-14;44384930;36273618;124947000;1859000;;161486000;10772000;;6227000;16999000;178485000;48605000;;56376000;75192000;102755000;159131000;558479000;;-537322000;19354000;178485000
CHRS;540930;USD;2015;Q4;2015-12-31;2016-02-29;39011252;39011252;158226000;1560000;;197386000;10504000;;4494000;14998000;212384000;53629000;;106018000;;113295000;219313000;404179000;;-409985000;-6929000;212384000
CHRS;540930;USD;2014;Q4;2014-12-31;2015-03-23;19972361;19972361;150392000;2417000;;179136000;4472000;;3613000;8085000;187221000;22029000;;51783000;;68681000;120464000;254051000;;-186725000;66757000;187221000
CHRS;540930;USD;2013;Q4;2013-12-31;2014-12-15;3942940;3942940;39554000;278000;;45677000;1743000;;27000;1770000;47447000;10943000;;49498000;1111000;40331000;89829000;2515000;;-99592000;-42382000;47447000
CHRS;540930;USD;2017;Q4;2017-12-31;2018-03-08;58459863;58459863;126911000;;;145477000;12773000;;4361000;17134000;162611000;24764000;;28395000;76206000;103681000;132076000;808066000;;-775492000;30535000;162611000
CHRS;540930;USD;2018;Q4;2018-12-31;2019-02-28;68207961;68207961;72356000;0;1659000;84433000;6660000;;8374000;15034000;99467000;32842000;;33261000;77319000;104797000;138058000;946522000;;-984831000;-38591000;99467000
VRX;542074;USD;2017;Q4;2017-12-31;2018-02-28;350500000;354300000;720000000;2130000000;1048000000;4746000000;1403000000;;31348000000;32751000000;37497000000;4059000000;209000000;4268000000;25235000000;27285000000;31553000000;10470000000;;-2725000000;5944000000;37497000000
VRX;542074;USD;2016;Q4;2016-12-31;2017-03-01;349800000;1039200000;542000000;2517000000;1061000000;5077000000;1312000000;;37140000000;38452000000;43529000000;3551000000;1000000;3609000000;29845000000;36662000000;40271000000;10389000000;;-5129000000;3258000000;43529000000
VRX;542074;USD;2015;Q4;2015-12-31;2016-04-29;344700000;332000000;597000000;2687000000;1257000000;5507000000;1442000000;;42016000000;43458000000;48965000000;4293000000;823000000;5313000000;30265000000;37623000000;42936000000;10202000000;;-2750000000;6029000000;48965000000
VRX;542074;USD;2014;Q4;2014-12-31;2015-02-25;336000000;348500000;322600000;2075800000;889200000;4131700000;1312300000;;20860700000;22173000000;26304700000;2555000000;900000;2708400000;15228000000;18194600000;20903000000;8593100000;;-2397800000;5401700000;26304700000
VRX;542074;USD;2013;Q4;2013-12-31;2014-02-28;336500000;330200000;600300000;1676400000;883000000;3885900000;1234200000;;22850700000;24084900000;27970800000;2127200000;204800000;2512500000;17162900000;20225000000;22737500000;8530000000;;-3278500000;5233300000;27970800000
VRX;542074;USD;2012;Q4;2012-12-31;2013-02-28;304933000;297265000;916091000;913835000;531256000;2777451000;462724000;;14710204000;15172928000;17950379000;1235608000;480182000;1822752000;10535443000;12410229000;14232981000;6207770000;;-2370976000;3717398000;17950379000
VRX;542074;USD;2011;Q4;2011-12-31;2012-02-29;308743000;317424000;170449000;569268000;355212000;1357506000;414242000;;11336371000;11750613000;13108119000;695538000;111250000;924272000;6539761000;8254017000;9178289000;6239738000;;-2030292000;3929830000;13108119000
VRX;542074;USD;2010;Q4;2010-12-31;2011-02-28;303040000;300531000;400352000;274819000;229582000;1020166000;281752000;2083000;9491116000;9774951000;10795117000;552591000;116900000;692456000;3478377000;5191565000;5884021000;5746771000;;-934511000;4911096000;10795117000
VRX;542074;USD;2009;Q4;2009-12-31;2010-08-06;158269000;158786000;124029000;112165000;82773000;342886000;103848000;11516000;1601040000;1716404000;2059290000;215208000;12110000;249152000;313975000;455766000;704918000;1556772000;;-245974000;1354372000;2059290000
VRX;542074;USD;2018;Q4;2018-12-31;2019-02-20;351700000;351700000;721000000;1865000000;934000000;4211000000;1353000000;;26928000000;28281000000;32492000000;3608000000;228000000;4134000000;24077000000;25543000000;29677000000;10534000000;;-5664000000;2815000000;32492000000
VER;543421;USD;2017;Q4;2017-12-31;2018-02-22;974217615;;75150000;;;2186361000;10669672000;39520000;1810025000;12519217000;14705578000;311775000;2082692000;2410414000;4189303000;4252288000;6662702000;12664000000;;-4776581000;8042876000;14705578000
VER;543421;USD;2016;Q4;2016-12-31;2017-02-23;974278102;949071729;300694000;;;2468356000;11208278000;46077000;1864863000;13119218000;15587574000;297439000;2671106000;2979905000;3920165000;3988136000;6968041000;12649912000;;-4200423000;8619533000;15587574000
VER;543421;USD;2015;Q4;2015-12-31;2016-02-24;903646316;903646316;122407000;;;2531735000;12787746000;56824000;2029561000;14874131000;17405866000;292693000;3111985000;3404908000;5199509000;5286999000;8691907000;11940817000;;-3415233000;8713959000;17405866000
VER;543421;USD;2014;Q4;2014-12-31;2015-03-30;907627425;907627425;475357000;;;3157366000;14823384000;98053000;2348333000;17269770000;20427136000;173020000;3773922000;3947501000;6969694000;7097305000;11044806000;11929308000;;-2778576000;9382330000;20427136000
RAIL;543593;USD;2017;Q4;2017-12-31;2018-03-09;12294965;12294965;130705000;7581000;50842000;199947000;38253000;;57704000;95957000;295904000;33200000;;40317000;;23855000;64172000;90474000;-12555000;161380000;231732000;295904000
RAIL;543593;USD;2016;Q4;2016-12-31;2017-03-03;12268193;12268193;92750000;25207000;97904000;241170000;46347000;;51738000;98085000;339255000;45977000;;54135000;;28206000;82341000;92152000;-14583000;187508000;256914000;339255000
RAIL;543593;USD;2015;Q4;2015-12-31;2016-03-04;12246304;12364504;110019000;39708000;115354000;280681000;42596000;;83627000;126223000;406904000;56431000;;72557000;;99236000;171793000;94066000;-17516000;179639000;235111000;406904000
RAIL;543593;USD;2014;Q4;2014-12-31;2015-03-13;12009101;12225104;161493000;4086000;82259000;273165000;43239000;;68848000;112087000;385252000;49744000;;98325000;;88232000;186557000;100430000;-29971000;152253000;198695000;385252000
RAIL;543593;USD;2013;Q4;2013-12-31;2014-03-14;11965329;11965329;184494000;4034000;83295000;297388000;39396000;;80935000;120331000;417719000;27367000;;147228000;;67956000;215184000;99392000;-30970000;149245000;202535000;417719000
RAIL;543593;USD;2012;Q4;2012-12-31;2013-03-15;11938941;11970282;140487000;12987000;73842000;261225000;39343000;;87997000;127340000;388565000;52604000;;96576000;;80658000;177234000;100529000;-34488000;171429000;211331000;388565000
RAIL;543593;USD;2011;Q4;2011-12-31;2012-03-29;11922465;12026504;101870000;10125000;72877000;200287000;35984000;;109192000;145176000;345463000;46690000;;69698000;;78431000;148129000;100331000;-35904000;155209000;197334000;345463000
RAIL;543593;USD;2010;Q4;2010-12-31;2011-08-08;11906420;11906420;61780000;4106000;64399000;150476000;40503000;;119664000;160167000;310643000;30290000;;38681000;;79382000;118063000;98849000;-36539000;150274000;192580000;310643000
RAIL;543593;USD;2018;Q4;2018-12-31;2019-03-04;12326169;12326169;63089000;18218000;64562000;155833000;45317000;;88587000;133904000;289737000;45697000;;62050000;;34077000;96127000;90720000;-9721000;120799000;193610000;289737000
WMAR;543710;USD;2016;Q4;2016-12-31;2017-02-28;24981000;25207000;76141000;6413000;212106000;315228000;82517000;;8357000;90874000;406102000;78118000;;78118000;;19253000;97371000;214816000;-9461000;103910000;308731000;406102000
WMAR;543710;USD;2015;Q4;2015-12-31;2016-03-09;24719000;25048000;48159000;7141000;222853000;301724000;81561000;;8530000;90091000;391815000;75026000;;75026000;;17330000;92356000;211688000;-9285000;97375000;299459000;391815000
WMAR;543710;USD;2014;Q4;2014-12-31;2015-03-12;24370000;24836000;45675000;6843000;214298000;298192000;79447000;;7862000;87309000;385501000;74166000;;74166000;;20327000;94493000;207888000;-9171000;92855000;291008000;385501000
WMAR;543710;USD;2013;Q4;2013-12-31;2014-03-12;24457000;25228000;48408000;6441000;203036000;282257000;72848000;;9138000;81986000;364243000;59277000;;59277000;;16382000;75659000;202647000;-4405000;90907000;288584000;364243000
WMAR;543710;USD;2012;Q4;2012-12-31;2013-03-07;23604000;24539000;56542000;6723000;189339000;279547000;59532000;;11900000;71432000;350979000;61797000;;61797000;;13876000;75673000;193412000;-385000;83070000;275306000;350979000
WMAR;543710;USD;2011;Q4;2011-12-31;2012-03-07;22910000;23979000;43966000;5771000;193375000;264022000;60746000;;10889000;71635000;335657000;66092000;;66092000;;13922000;80014000;186112000;-385000;70643000;255643000;335657000
WMAR;543710;USD;2010;Q4;2010-12-31;2011-08-03;22603000;23113000;22019000;5605000;201588000;248948000;56483000;;3455000;59938000;308886000;72332000;;72332000;;14793000;87125000;181914000;-385000;40981000;221761000;308886000
ERS;543790;USD;2016;Q4;2016-12-31;2017-03-31;8321000;8343000;4065000;52810000;133031000;198241000;7309000;;;7309000;205550000;150708000;265000;150973000;4704000;4859000;155832000;13154000;-7587000;44824000;49718000;205550000
ERS;543790;USD;2015;Q4;2015-12-31;2016-03-30;8136000;14054000;7315000;60525000;157025000;240567000;7340000;;;7340000;247907000;182740000;11049000;194731000;4969000;4977000;199708000;13154000;-7038000;42749000;48199000;247907000
ERS;543790;USD;2014;Q4;2014-12-31;2015-03-31;8960000;6452000;1130000;89693000;192064000;308680000;4258000;;1345000;5603000;314283000;252490000;0;252490000;10197000;12982000;265472000;13795000;-5455000;40805000;48811000;314283000
ERS;543790;USD;2013;Q4;2013-12-31;2014-03-31;8574000;5850000;2477000;52696000;139752000;207370000;3949000;;4501000;8450000;215820000;157081000;1290000;158371000;10632000;12680000;171051000;12054000;-5514000;38178000;44769000;215820000
ERS;543790;USD;2012;Q4;2012-12-31;2013-03-25;17754779;24482578;3136000;53551000;145547000;212566000;3987000;;8237000;12224000;224790000;167962000;171000;168133000;11357000;13548000;181681000;12054000;-5450000;36641000;43109000;224790000
ERS;543790;USD;2011;Q4;2011-12-31;2012-06-14;-9240497;-10262669;4274000;56504000;184113000;259328000;4040000;;6360000;10400000;269728000;212858000;160000;213018000;10962000;13108000;226126000;12054000;-3509000;35271000;43602000;269728000
CLNT;543877;USD;2017;Q4;2017-12-31;2018-04-11;2196413;2196413;1019437;9092709;4553559;22926343;33181119;9053859;5394296;47629274;70555617;3027822;2744529;9386537;;0;9386537;42596292;;13624729;61169080;70555617
CLNT;543877;USD;2016;Q4;2016-12-31;2017-04-17;1316226;1316226;1481498;13922371;2394179;26592126;29878675;8610759;5283695;43773129;70365255;1360051;2159889;5053219;;0;5053219;37903549;;26531498;65312036;70365255
CLNT;543877;USD;2015;Q4;2015-12-31;2016-03-30;986033;986033;18790370;11671902;1667048;39472724;51753964;;3382071;55136035;94608759;2947988;2388032;14541627;;0;14541627;37362745;;37007776;80067132;94608759
CLNT;543877;USD;2014;Q4;2014-12-31;2015-03-30;966373;966373;7835791;20316037;4241022;34090188;70051137;;3672420;73723557;107813745;6413543;3095219;10492942;;0;10492942;36815916;;50039267;97320803;107813745
CLNT;543877;USD;2013;Q4;2013-12-31;2014-03-28;878287;878287;1114873;15234863;4733558;23986124;75346344;;5008267;80354611;104340735;7611323;3109453;12863869;;;12863869;34280531;;46322329;91476866;104340735
CLNT;543877;USD;2012;Q4;2012-12-31;2013-04-11;686423;686059;1445728;10078623;5897555;19073397;66554655;;4308232;70862887;89936284;7489912;2467971;11809870;132756;132756;11942626;31469760;;38401734;77993658;89936284
CLNT;543877;USD;2011;Q4;2011-12-31;2012-03-28;509664;616440;1152607;7087958;4276090;14726538;64042079;;3820536;67862615;82589153;6360908;2601496;10443579;381235;381235;10824814;29556253;;34618341;71764339;82589153
CLNT;543877;USD;2010;Q4;2010-12-31;2011-08-15;462629;671866;947177;8207797;3371128;15706719;54742993;;3767159;58510152;74216871;9600101;1814937;11651042;0;0;11651042;28256001;;29264152;62565829;74216871
CLNT;543877;USD;2018;Q4;2018-12-31;2019-04-16;9396837;9396837;781740;4327980;6414305;21217009;21563420;;3562513;25125933;46342942;5094611;2893464;9403102;244910;1502415;10905517;60812172;;-27492559;35437425;46342942
GENC;543904;USD;2017;Q4;2017-09-30;2017-12-06;14414000;14835000;110819000;1184000;16687000;137118000;5722000;;53000;5775000;142893000;3746000;;12374000;;1601000;13975000;12619000;;116299000;128918000;142893000
GENC;543904;USD;2016;Q4;2016-09-30;2016-12-02;14376000;14632000;104157000;1110000;11634000;123420000;5239000;;53000;5292000;128712000;3707000;;8191000;;316000;8507000;12324000;;107881000;120205000;128712000
GENC;543904;USD;2015;Q4;2015-09-30;2015-12-09;19054000;18890500;95509000;874000;12770000;112366000;6388000;;1390000;7778000;120144000;2981000;;7399000;;0;7399000;11907000;;100838000;112745000;120144000
GENC;543904;USD;2014;Q4;2014-09-30;2014-12-09;14277000;14409000;94305000;1448000;13673000;110619000;7141000;;68000;7209000;117828000;2636000;;2960000;;693000;3653000;11518000;;102657000;114175000;117828000
GENC;543904;USD;2013;Q4;2013-09-30;2013-12-13;14277000;14289000;92670000;1200000;14126000;108791000;8079000;;78000;8157000;116948000;4093000;;6036000;;484000;6520000;11244000;;99184000;110428000;116948000
GENC;543904;USD;2012;Q4;2012-09-30;2012-12-14;14277000;14277000;84736000;1206000;11918000;102090000;8127000;;95000;8222000;110312000;5398000;;5878000;;974000;6852000;11001000;;92459000;103460000;110312000
GENC;543904;USD;2011;Q4;2011-09-30;2011-12-16;14277000;14277000;74201000;1573000;12878000;94734000;8349000;;1292000;9641000;104375000;4820000;;5576000;;0;5576000;10812000;;87987000;98799000;104375000
GENC;543904;USD;2010;Q4;2010-09-30;2011-08-12;;;76331000;1979000;17341000;98436000;7773000;;1018000;8791000;107227000;4696000;;6174000;;2525000;8699000;11503000;-738000;87763000;98528000;107227000
GENC;543904;USD;2018;Q4;2018-09-30;2018-12-13;14536000;14717000;112070000;993000;18214000;145081000;7889000;;53000;7942000;153023000;3923000;;8486000;;2358000;10844000;13316000;;128863000;142179000;153023000
BSPM;543906;USD;2016;Q4;2016-12-31;2017-04-13;2556605;2556605;173290;6741454;166564;7365124;5866612;;29270702;35137314;42502438;2842142;2325643;5623261;;0;5623261;31385104;;-2540991;36879177;42502438
BSPM;543906;USD;2015;Q4;2015-12-31;2016-04-14;2210913;2210913;38898;15814880;234660;16167309;6810933;;28385338;35196271;51363580;4266040;2773199;7098441;;0;7098441;30318984;;3157394;44265139;51363580
BSPM;543906;USD;2014;Q4;2014-12-31;2015-04-15;2315888;2315020;1685154;36734542;673989;43633047;8483113;;29131071;37614184;81247231;5433971;3094614;8911880;;0;8911880;30318984;;28269956;72335351;81247231
BSPM;543906;USD;2013;Q4;2013-12-31;2014-03-31;1745026;1745026;80072;27781515;830311;35985502;7728700;;23850242;31578942;67564444;4791505;0;4791505;;0;4791505;25761345;;23649725;62772939;67564444
BSPM;543906;USD;2012;Q4;2012-12-31;2013-04-15;1399159;1399159;1759078;21851412;847135;41974131;6980521;;21520648;28501169;70475300;6362001;4755413;12702552;;0;12702552;23276769;;23229743;57772748;70475300
BSPM;543906;USD;2011;Q4;2011-12-31;2012-03-27;1316413;1315957;16971789;35033650;1373459;60508809;7379982;;15173085;22553067;83061876;5873060;787116;6660176;;0;6660176;22455060;;43473834;76401700;83061876
BSPM;543906;USD;2010;Q4;2010-12-31;2011-08-15;1253597;1278011;13211443;28535712;351682;43350234;5958636;;18778073;24736709;68086943;7586946;;7586946;;0;7586946;20734054;;33124540;60499997;68086943
SORL;543973;USD;2017;Q4;2017-12-31;2018-04-02;19304921;19304921;4221940;134384961;114300564;460264609;79828006;;42223327;122051333;582315942;146456018;149646930;344640787;37383224;37383224;382024011;-28544045;;168244329;200291931;582315942
SORL;543973;USD;2016;Q4;2016-12-31;2017-03-31;19304921;19304921;8057155;102129294;65776517;239269647;53737706;;8320771;62058477;301328124;86772540;27416376;138936601;0;0;138936601;-28544045;;146352530;162391523;301328124
SORL;543973;USD;2015;Q4;2015-12-31;2016-03-30;19304921;19304921;91238537;71823328;73661860;267976173;37561905;;15015978;52577883;320554056;49162864;26887156;98129556;;;98129556;42237623;;129055099;222424500;320554056
SORL;543973;USD;2014;Q4;2014-12-31;2015-03-31;19304921;19304921;48848354;68171387;84186766;226929046;43550927;;16426289;59977216;286906262;28529582;13274914;62981195;3735437;3735437;66716632;42237623;;116935053;220189630;286906262
SORL;543973;USD;2013;Q4;2013-12-31;2014-03-31;19304921;19304921;28241983;57912384;76364019;190862231;45469013;;16649040;62118053;252980284;23851909;8163351;46203348;7272975;7272975;53476323;42237623;;104544120;199503961;252980284
SORL;543973;USD;2012;Q4;2012-12-31;2013-04-01;19304921;19304921;41253353;62153509;56775825;178751265;46962599;;17847121;64809720;243560985;22826452;25058105;54797309;0;291995;55089304;42237623;;96114407;188471681;243560985
SORL;543973;USD;2011;Q4;2011-12-31;2012-03-30;19304921;19304921;17116692;65344441;56377556;164868460;52209071;;17450206;69659277;234527737;19854965;24343330;49740677;10469265;10705650;60446327;42237623;;84610260;174081410;234527737
SORL;543973;USD;2010;Q4;2010-12-31;2011-08-15;19733492;19733492;6691078;54168856;31960053;131666715;44894001;;14818045;59712046;191378761;18625320;16736821;43406555;;171981;43578536;42237623;;69672286;147800225;191378761
SORL;543973;USD;2018;Q4;2018-12-31;2019-04-01;19304921;19304921;73588229;150047797;204285427;616567975;96053386;;81750165;177803551;794371526;263901106;239081500;565213779;14429404;23688711;588902490;-28544045;;178535378;205469036;794371526
OCN;544026;USD;2015;Q4;2015-12-31;2016-02-29;125296596;121727816;257272000;;;6736187000;57626000;;586495000;644121000;7380308000;;1107922000;6525670000;;0;6525670000;527396000;;325929000;854638000;7380308000
OCN;544026;USD;2014;Q4;2014-12-31;2015-05-11;125449204;116102691;129473000;;;7656170000;43310000;;567798000;611108000;8267278000;;2083691000;7226113000;;0;7226113000;516446000;;530361000;1041165000;8267278000
NTNX;544815;USD;2017;Q4;2017-07-31;2017-09-18;152757432;152757432;349053000;178876000;;583970000;58072000;;84031000;142103000;726073000;140660000;;374158000;0;303713000;677871000;948138000;;-899830000;48202000;726073000
NTNX;544815;USD;2016;Q4;2016-07-31;2016-12-08;44933812;44933812;185200000;110659000;;329861000;42218000;;27007000;69225000;399086000;82195000;;212764000;73260000;252258000;465022000;65630000;;-441933000;-65936000;399086000
NTNX;544815;USD;2018;Q4;2018-07-31;2018-09-24;171001605;171001605;934303000;258289000;;1263101000;85111000;;251668000;336779000;1599880000;182583000;;458231000;429598000;814870000;1273101000;1355911000;;-1028130000;326779000;1599880000
NTNX;544815;USD;2019;Q4;2019-07-31;2019-09-24;186270318;186270318;908834000;245475000;;1275212000;136962000;;373868000;510830000;1786042000;202648000;;599315000;;999834000;1599149000;1835533000;;-1649309000;186893000;1786042000
ABG;545489;USD;2016;Q4;2016-12-31;2017-02-23;21600000;21700000;3400000;138400000;894900000;1332400000;815400000;;188300000;1003700000;2336100000;417400000;14000000;1104900000;912700000;951500000;2056400000;549800000;-879500000;611500000;279700000;2336100000
ABG;545489;USD;2015;Q4;2015-12-31;2016-02-19;25000000;24800000;2800000;119500000;917200000;1331200000;772800000;;190100000;962900000;2294100000;420500000;13900000;1007800000;940400000;971800000;1979600000;537600000;-663900000;444300000;314500000;2294100000
ABG;545489;USD;2014;Q4;2014-12-31;2015-02-24;29100000;29200000;2900000;107000000;886000000;1275400000;741600000;;165000000;906600000;2182000000;362100000;27400000;1039800000;670000000;697300000;1737100000;523000000;-351700000;275100000;444900000;2182000000
ABG;545489;USD;2013;Q4;2013-12-31;2014-02-25;30400000;31000000;5400000;95700000;767700000;1108600000;651500000;;128500000;780000000;1888600000;288300000;11100000;834200000;543300000;563800000;1398000000;510900000;-184000000;163500000;490600000;1888600000
ABG;545489;USD;2012;Q4;2012-12-31;2013-02-21;31100000;31300000;6200000;94300000;648500000;986400000;565800000;;109200000;675000000;1661400000;264200000;4600000;779800000;461400000;478800000;1258600000;499400000;-149400000;54400000;402800000;1661400000
ABG;545489;USD;2011;Q4;2011-12-31;2012-02-22;31000000;31400000;11400000;79000000;519500000;792500000;510800000;;116100000;626900000;1419400000;248300000;19500000;636300000;439100000;456500000;1092800000;483000000;-124100000;-27800000;326600000;1419400000
ABG;545489;USD;2010;Q4;2010-12-31;2011-07-27;32200000;33200000;21300000;102600000;547400000;876800000;458900000;;150600000;609500000;1486300000;514700000;8900000;635800000;534900000;563400000;1199200000;463800000;-75000000;-95700000;287100000;1486300000
ABG;545489;USD;2017;Q4;2017-12-31;2018-02-27;20800000;21100000;4700000;128500000;826000000;1302100000;834200000;;220400000;1054600000;2356700000;417400000;12900000;1058200000;862600000;904300000;1962500000;563900000;-919100000;750300000;394200000;2356700000
ABG;545489;USD;2018;Q4;2018-12-31;2019-02-28;19500000;19600000;8300000;130300000;1067600000;1553000000;886100000;;256300000;1142400000;2695400000;412400000;38800000;1303300000;866500000;918900000;2222200000;573300000;-1023400000;922700000;473200000;2695400000
DIN;545516;USD;2017;Q4;2017-12-31;2018-02-20;17745000;17756000;117010000;140188000;;387955000;199585000;;1150399000;1349984000;1737939000;102324000;27158000;304924000;1331744000;1648555000;1953479000;276658000;-422153000;-69940000;-215540000;1737939000
DIN;545516;USD;2016;Q4;2016-12-31;2017-03-01;17825000;17898000;140535000;141389000;;366148000;205055000;;1707380000;1912435000;2278583000;102356000;13144000;286312000;1357356000;1739499000;2025811000;293060000;-422263000;382082000;252772000;2278583000
DIN;545516;USD;2015;Q4;2015-12-31;2016-02-24;18342000;18452000;144785000;139206000;;372709000;219580000;;1739561000;1959141000;2331850000;116452000;14320000;298429000;1364254000;1766198000;2064627000;287204000;-371797000;351923000;267223000;2331850000
DIN;545516;USD;2014;Q4;2014-12-31;2015-02-25;18739000;18925000;104004000;153498000;;382024000;241229000;;1770483000;2011712000;2393736000;118437000;14852000;313049000;1374607000;1801614000;2114663000;280198000;-314696000;313644000;279073000;2393736000
DIN;545516;USD;2013;Q4;2013-12-31;2014-02-26;18789000;19064000;106011000;144137000;;331582000;274295000;;1798765000;2073060000;2404642000;95351000;16967000;284273000;1315224000;1805190000;2089463000;274455000;-295690000;336578000;315179000;2404642000
DIN;545516;USD;2012;Q4;2012-12-31;2013-02-27;18390000;19795000;64537000;128610000;;294455000;294375000;;1826570000;2120945000;2415400000;87773000;18298000;267760000;1326438000;1838835000;2106595000;264596000;-277684000;322045000;308805000;2415400000
DIN;545516;USD;2011;Q4;2011-12-31;2012-03-01;17647000;17662000;60691000;115667000;;276947000;474154000;;1863193000;2337347000;2614294000;89789000;20900000;257644000;1545855000;2201430000;2459074000;205910000;-291773000;196869000;155220000;2614294000
DIN;545516;USD;2010;Q4;2010-12-31;2011-08-03;17456000;16403000;102309000;98776000;10757000;351102000;612175000;;1893364000;2505539000;2856641000;114554000;25556000;265082000;1775485000;2507980000;2773062000;192457000;-274901000;124250000;83579000;2856641000
DIN;545516;USD;2018;Q4;2018-12-31;2019-02-21;17446000;17770000;137164000;137504000;;382190000;240264000;;1152226000;1392490000;1774680000;106579000;39031000;316186000;1361849000;1660767000;1976953000;237976000;-450603000;10414000;-202273000;1774680000
TSQ;545597;USD;2018;Q4;2018-12-31;2019-03-12;17860000;36000000;61396000;62459000;;152557000;112377000;;722333000;834710000;987267000;50705000;5000;65770000;555330000;579920000;645690000;366025000;;-25735000;341577000;987267000
TSQ;545597;USD;2017;Q4;2017-12-31;2018-03-13;18459000;-1032000;61205000;61558000;;138404000;104030000;;813924000;917954000;1056358000;44060000;9524000;73305000;555618000;601973000;675278000;367226000;;13265000;381080000;1056358000
TSQ;545597;USD;2016;Q4;2016-12-31;2017-03-13;18397000;36579000;51540000;59580000;;122627000;139408000;;818670000;958078000;1080705000;40972000;6901000;65152000;564315000;625502000;690654000;365618000;;24450000;390051000;1080705000
TSQ;545597;USD;2015;Q4;2015-12-31;2016-02-26;17868000;32145000;33298000;60143000;;103207000;133943000;;823561000;957504000;1060711000;44417000;171000;62084000;588657000;635187000;697271000;361365000;;1391000;363440000;1060711000
TSQ;545597;USD;2014;Q4;2014-12-31;2015-03-16;;;24462000;61151000;;92029000;96247000;;749036000;845283000;937312000;37331000;1293000;52923000;528747000;540227000;593150000;352158000;;-8439000;344162000;937312000
TSQ;545597;USD;2013;Q4;2013-12-31;2014-09-02;;10676000;45647000;56994000;;110939000;96294000;;731970000;828264000;939203000;40871000;2186000;52453000;651286000;652219000;704672000;234039000;;0;234531000;939203000
Joe;546306;USD;2015;Q4;2015-12-31;2016-03-03;74679310;74679310;212773000;;;215048000;323744000;407097000;36853000;767694000;982742000;;;78727000;54474000;230568000;309295000;892387000;-305289000;78851000;673447000;982742000
Joe;546306;USD;2014;Q4;2014-12-31;2015-02-27;92306529;92306529;34515000;;;84455000;332015000;854675000;31990000;1218680000;1303135000;47465000;;82289000;63804000;241145000;323434000;892237000;-285000;80582000;979701000;1303135000
Joe;546306;USD;2013;Q4;2013-12-31;2014-02-28;92290223;92290223;21894000;;;90603000;396419000;146972000;35478000;578869000;669472000;61730000;;61730000;44217000;44217000;105947000;892027000;-285000;-325871000;563525000;669472000
Joe;546306;USD;2012;Q4;2012-12-31;2013-03-01;92182311;92182311;165980000;;;230129000;382796000;0;32596000;415392000;645521000;57125000;;57125000;36062000;36062000;93187000;891798000;-260000;-330861000;552334000;645521000
Joe;546306;USD;2011;Q4;2011-12-31;2012-02-27;92208982;92165334;162391000;;;225447000;402148000;;33696000;435844000;661291000;63941000;;63941000;53458000;53458000;117399000;890314000;;-336873000;543892000;661291000
CIE;546550;USD;2016;Q4;2016-12-31;2017-03-14;32037200;32037200;953952000;;;1147191000;1082787000;;500000;1083287000;2230478000;264372000;;533954000;2479349000;2537858000;3071812000;4224023000;;-5065357000;-841334000;2230478000
CIE;546550;USD;2015;Q4;2015-12-31;2016-02-22;-57106308210;-57106308210;1265506000;;;1669963000;2371342000;;19914000;2391256000;4061219000;376637000;;626637000;1981895000;1988445000;2615082000;4168185000;;-2722048000;1446137000;4061219000
CIE;546550;USD;2014;Q4;2014-12-31;2015-02-23;28509490;28509490;1776910000;;35093000;2003134000;714654000;326047000;1407027000;2447728000;4450862000;98086000;;303600000;1928528000;2032996000;2336596000;4141888000;;-2027622000;2114266000;4450862000
CIE;546550;USD;2013;Q4;2013-12-31;2014-02-27;113829763472;113829763472;1511840000;;74768000;1967443000;1476275000;14661000;175294000;1666230000;3633673000;274887000;;340967000;1035980000;1163560000;1504527000;3646005000;;-1516859000;2129146000;3633673000
CIE;546550;USD;2012;Q4;2012-12-31;2013-02-26;28468986;28468986;2215483000;;65286000;2456742000;1099756000;36267000;418694000;1554717000;4011459000;111937000;;160956000;991191000;1161285000;1322241000;3617053000;;-927835000;2689218000;4011459000
CIE;546550;USD;2011;Q4;2011-12-31;2012-02-21;26740527;26740527;1150839000;;36049000;1335094000;863326000;47232000;282292000;1192850000;2527944000;105604000;;238069000;;210961000;449030000;2723750000;;-644836000;2078914000;2527944000
CIE;546550;USD;2010;Q4;2010-12-31;2011-07-27;24515555;24515555;837653000;;34738000;889632000;463769000;40003000;353039000;856811000;1746443000;21109000;;24559000;;2850000;27409000;2230233000;;-511199000;1719034000;1746443000
CIE;546550;USD;2017;Q4;2017-12-31;2018-03-02;28166560;28166560;431646000;;;657883000;919443000;;19428000;938871000;1596754000;161394000;;161394000;;3229308000;3390702000;4240042000;;-6033990000;-1793948000;1596754000
FRPT;546551;USD;2016;Q4;2016-12-31;2017-03-14;33888313;33434953;3908177;8886790;5402735;19243353;101493080;;5714783;107207863;126451216;11668685;7000000;18668685;;;18668685;299511667;;-191729136;107782531;126451216
FRPT;546551;USD;2015;Q4;2015-12-31;2016-03-14;33527711;33527711;11279413;7030719;6853447;25393210;82793007;;4911357;87704364;113097574;9147514;0;9147514;;;9147514;292518523;;-188568463;103950060;113097574
FRPT;546551;USD;2014;Q4;2014-12-31;2015-03-31;16035429;16035429;36259252;5360400;7314151;50225182;57825961;;4410717;62236678;112461860;9069161;;9069161;;;9069161;288250350;;-184857651;103392699;112461860
FRPT;546551;USD;2013;Q4;2013-12-31;2014-12-10;10419655;10419655;2444754;3497596;5512225;11628361;48764032;;2224831;50988863;62617224;8563765;;8563765;76112312;83919558;92483323;16460596;;-147518634;-29866099;62617224
FRPT;546551;USD;2017;Q4;2017-12-31;2018-03-07;35432637;35432637;2184259;12721521;10118394;26957968;100598639;;6343727;106942366;133900334;16692517;0;16692517;;304839;16997356;312818327;;-195991478;116902978;133900334
FRPT;546551;USD;2018;Q4;2018-12-31;2019-02-28;35541430;35541430;7554388;12326703;9317232;30958105;102094248;;6912505;109006753;139964858;18216963;0;18216963;;273420;18490383;323114993;-256226;-201352682;121474475;139964858
COOL;546690;USD;2017;Q4;2017-12-31;2018-04-17;149498131;149498131;173343;;;183343;45728;;183488;229216;412559;2271406;659312;3338222;97009;97009;3435231;42274608;;-45247740;-3022672;412559
COOL;546690;USD;2018;Q4;2018-12-31;2019-04-16;218356073;218356073;24435;;54474;90909;64446;;205974;270420;361329;2094092;2091014;4734865;36819;36819;4771684;45507810;;-49866128;-4410355;361329
ETEC;546873;USD;2012;Q4;2012-08-31;2012-12-14;17777520;;1769000;24381000;2346000;33888000;3538000;;26278000;29816000;63704000;25519000;785000;42169000;12744000;18709000;60878000;17092000;;-15516000;2825000;63703000
ETEC;546873;USD;2011;Q4;2011-08-31;2012-01-17;16598206;;4039000;31196000;1339000;43379000;4284000;;38944000;43228000;86607000;30979000;245000;52209000;9709000;18322000;70531000;16766000;;-3093000;16076000;86607000
RWC;546874;USD;2017;Q4;2017-12-31;2018-03-06;13010029;12958064;16331000;5524000;14358000;36985000;2201000;0;3615000;5816000;42801000;8767000;;10313000;;481000;10794000;33949000;-810000;-5450000;32007000;42801000
RWC;546874;USD;2016;Q4;2016-12-31;2017-03-01;13733982;13816297;10910000;3448000;13999000;29767000;2486000;6472000;3819000;12777000;42544000;5570000;;6362000;;408000;6770000;33635000;-162000;240000;35774000;42544000
RWC;546874;USD;2015;Q4;2015-12-31;2016-03-02;13726452;13819276;4669000;4122000;16282000;28154000;1840000;3402000;6053000;11295000;39449000;3589000;;4263000;;366000;4629000;33164000;0;1259000;34820000;39449000
RWC;546874;USD;2014;Q4;2014-12-31;2015-03-04;13663767;13795077;11363000;3266000;12112000;28662000;1282000;0;7042000;8324000;36986000;2866000;;3541000;;212000;3753000;33015000;;218000;33233000;36986000
RWC;546874;USD;2013;Q4;2013-12-31;2014-03-05;13584284;13415714;7945000;2844000;11575000;28120000;1045000;;4858000;5903000;34023000;1883000;;2456000;;147000;2603000;32825000;;-1405000;31420000;34023000
RWC;546874;USD;2012;Q4;2012-12-31;2013-03-05;-40569536;-40574060;6581000;2062000;13345000;27332000;1113000;;5515000;6628000;33960000;2783000;18000;3695000;;81000;3776000;32731000;;-2547000;30184000;33960000
RWC;546874;USD;2011;Q4;2011-12-31;2012-03-06;13519488;13513044;2693000;4155000;12148000;22980000;1158000;;7709000;8867000;31847000;2881000;0;3513000;;265000;3778000;32681000;;-4612000;28069000;31847000
RWC;546874;USD;2010;Q4;2010-12-31;2011-08-09;13501783;12437362;5050000;3900000;11942000;23760000;1357000;;9675000;11032000;34792000;3750000;;4016000;2000000;2386000;6402000;32509000;;-4119000;28390000;34792000
RWC;546874;USD;2018;Q4;2018-12-31;2019-02-27;-40712980;-40749244;11268000;5721000;11466000;30856000;2729000;1919000;3687000;8335000;39191000;8157000;0;9883000;;1596000;11479000;34197000;-4092000;-2393000;27712000;39191000
BRRE;547113;USD;2013;Q4;2013-10-31;2014-01-29;6126060;;3416359;109796;16159231;20280459;19264196;;6497345;25761541;46042000;2690672;;3295436;14251685;14251685;17547121;20649206;-2085407;11584359;28494879;46042000
BRRE;547113;USD;2012;Q4;2012-10-31;2013-01-29;6126060;;497409;143382;21198240;22474541;21043068;;7053883;28096951;50571492;4693017;;5870631;16880416;16880416;22751047;20649206;-2085407;12203825;27820445;50571492
BRRE;547113;USD;2011;Q4;2011-10-31;2012-11-28;6126060;;377158;160290;23583935;35607087;22438253;;7060369;29498622;65105709;4166034;;8238652;27113120;27113120;35351772;20649206;-2085407;13462459;29753937;65105709
BRRE;547113;USD;2010;Q4;2010-10-31;2011-09-14;;;389962;409987;25354216;38950840;23795723;;7510827;31306550;70257390;3746439;;10209998;27249809;27249809;37459807;20649206;-2085407;15937224;32797583;70257390
ROCK;548420;USD;2016;Q4;2016-12-31;2017-02-21;31667000;32303000;170177000;124072000;89612000;391197000;108304000;;418744000;527048000;918245000;140336000;400000;152088000;209237000;305277000;457365000;264738000;-7885000;211748000;460880000;918245000
ROCK;548420;USD;2015;Q4;2015-12-31;2016-02-18;31289000;31741000;68858000;164969000;107058000;351422000;118932000;;419418000;538350000;889772000;156809000;400000;185395000;208882000;294291000;479686000;253775000;-6346000;178073000;410086000;889772000
ROCK;548420;USD;2014;Q4;2014-12-31;2015-02-24;31081000;30661000;110610000;101141000;128743000;360431000;129575000;;320465000;450040000;810471000;133685000;400000;134085000;209511000;289157000;423242000;247545000;-5390000;154625000;387229000;810471000
ROCK;548420;USD;2013;Q4;2013-12-31;2014-02-20;30972000;30798000;97039000;90082000;121152000;322400000;131752000;;440010000;571762000;894162000;119504000;409000;119913000;213598000;302500000;422413000;243700000;-4815000;236449000;471749000;894162000
ROCK;548420;USD;2012;Q4;2012-12-31;2013-02-22;30790000;30924000;48028000;89473000;116357000;267238000;151613000;;464823000;616436000;883674000;116492000;1093000;117585000;206710000;289267000;406852000;240416000;-4101000;242082000;476822000;883674000
ROCK;548420;USD;2011;Q4;2011-12-31;2012-02-24;30608000;30741000;54117000;90595000;109270000;268854000;151974000;;451227000;603201000;872055000;128007000;417000;128424000;206746000;283695000;412119000;236980000;-3131000;229437000;459936000;872055000
ROCK;548420;USD;2010;Q4;2010-12-31;2011-02-25;30329000;30050000;60866000;70371000;77848000;242377000;145783000;1345000;421385000;568513000;810890000;93560000;408000;100118000;206789000;269919000;370037000;232304000;-2305000;212914000;440853000;810890000
ROCK;548420;USD;2009;Q4;2009-12-31;2010-08-09;30162000;30162000;23596000;71782000;86296000;252125000;174704000;;548113000;722817000;974942000;86140000;408000;109016000;256874000;337700000;446716000;227665000;-1191000;303982000;528226000;974942000
ROCK;548420;USD;2017;Q4;2017-12-31;2018-02-27;31704000;32353000;222280000;145385000;86372000;462764000;97098000;;431523000;528621000;991385000;157854000;400000;171033000;209621000;288633000;459666000;272280000;-10757000;274562000;531719000;991385000
ROCK;548420;USD;2018;Q4;2018-12-31;2019-02-27;32153000;32568000;297006000;140283000;98913000;544553000;95830000;;421262000;517092000;1061645000;166210000;208805000;392872000;1600000;72080000;464952000;282854000;-17922000;338995000;596693000;1061645000
IDCC;549215;USD;2016;Q4;2016-12-31;2017-02-23;34280000;35481000;952761000;228464000;;1221119000;12626000;;494108000;506734000;1727853000;65288000;;425480000;272021000;548005000;973485000;684252000;-1064795000;1120766000;754368000;1727853000
IDCC;549215;USD;2015;Q4;2015-12-31;2016-02-18;35418000;35876000;933708000;53868000;;1010967000;12148000;;451370000;463518000;1474485000;66570000;227174000;399973000;259595000;552617000;952590000;663774000;-1000110000;847033000;521895000;1474485000
IDCC;549215;USD;2014;Q4;2014-12-31;2015-02-19;37173000;38059000;703928000;51702000;;787857000;12546000;;392559000;405105000;1192962000;80474000;0;205169000;216206000;512116000;717285000;614860000;-903700000;757050000;475677000;1192962000
IDCC;549215;USD;2013;Q4;2013-12-31;2015-02-19;40976000;41654000;698451000;92830000;;857514000;9535000;;246134000;255669000;1113183000;66262000;;126438000;208813000;452925000;579363000;599021000;-751075000;680718000;533820000;1113183000
IDCC;549215;USD;2012;Q4;2012-12-31;2013-02-26;40979000;41146000;577279000;169874000;;814347000;7824000;;234438000;242262000;1056609000;66608000;;172913000;200391000;364991000;537904000;580547000;-721941000;659235000;518705000;1056609000
IDCC;549215;USD;2011;Q4;2011-12-31;2012-02-27;45506000;46060000;677994000;28079000;;768887000;7997000;;220084000;228081000;996968000;38886000;180000;173153000;192529000;352133000;525286000;574641000;-569247000;466727000;471682000;996968000
IDCC;549215;USD;2010;Q4;2010-12-31;2011-03-28;44675000;45396000;541669000;33632000;;619556000;8344000;;246743000;255087000;874643000;43468000;288000;178560000;180000;342967000;521527000;526453000;-569247000;395799000;353116000;874643000
IDCC;549215;USD;2009;Q4;2009-12-31;2010-07-30;43121000;44720000;409806000;212905000;;702322000;10399000;;195764000;206163000;908485000;58567000;584000;252560000;468000;486388000;738948000;491736000;-569247000;246771000;169537000;908485000
IDCC;549215;USD;2017;Q4;2017-12-31;2018-02-22;34655000;35606000;1157995000;216293000;;1395794000;10673000;;447953000;458626000;1854420000;69299000;;376441000;285126000;604831000;981272000;680747000;-1072488000;1249091000;873148000;1854420000
MSCI;549638;USD;2016;Q4;2016-12-31;2017-02-24;93284000;93801000;791834000;221504000;;1055670000;95585000;;1931323000;2026908000;3082578000;202212000;;536570000;2075201000;2228403000;2764973000;1226855000;-2170739000;1322224000;317605000;3082578000
MSCI;549638;USD;2015;Q4;2015-12-31;2016-02-26;103060000;103811000;777706000;208239000;;1063271000;98926000;;1984790000;2083716000;3146987000;180564000;;498116000;1579404000;1747384000;2245500000;1174465000;-1395695000;1158462000;901487000;3146987000
MSCI;549638;USD;2014;Q4;2014-12-31;2015-03-02;112413000;113400000;508799000;178717000;;769458000;94074000;;2019001000;2113075000;2882533000;162137000;;472912000;788358000;976788000;1449700000;1023487000;-588378000;1022695000;1432833000;2882533000
MSCI;549638;USD;2013;Q4;2013-12-31;2014-02-28;118898000;119947000;358434000;169490000;;624270000;85588000;;2426257000;2511845000;3136115000;163534000;19772000;503041000;788010000;1068727000;1571768000;1074413000;-268391000;758975000;1564347000;3136115000
MSCI;549638;USD;2012;Q4;2012-12-31;2013-03-01;122047000;122958000;254207000;153557000;;514835000;67419000;;2437385000;2504804000;3019639000;158830000;43093000;509945000;811623000;1084463000;1594408000;1001254000;-120926000;547699000;1425231000;3019639000
MSCI;549638;USD;2011;Q4;2011-12-31;2012-02-29;121163000;122553000;392701000;180566000;;677943000;37623000;;2377430000;2415053000;3092996000;153249000;10339000;452805000;1066548000;1334759000;1787564000;996892000;-49827000;363461000;1305432000;3092996000
MSCI;549638;USD;2010;Q4;2010-12-31;2011-01-31;119280000;121142000;342240000;137988000;;574962000;35723000;;2446796000;2482519000;3057481000;142345000;54932000;466084000;1207966000;1489227000;1955311000;948207000;-35201000;190007000;1102170000;3057481000
MSCI;549638;USD;2009;Q4;2009-12-31;2010-10-01;101378000;101946000;471328000;77180000;;602484000;29381000;;568404000;597785000;1200269000;97468000;42088000;292500000;337622000;400713000;693213000;449801000;-19168000;84013000;507056000;1200269000
MSCI;549638;USD;2017;Q4;2017-12-31;2018-02-26;90120000;92456000;889502000;327597000;;1267129000;94437000;;1914102000;2008539000;3275668000;233306000;;607671000;2078093000;2266985000;2874656000;1266144000;-2321989000;1505204000;401012000;3275668000
MSCI;549638;USD;2018;Q4;2018-12-31;2019-02-22;80733000;83259000;904176000;473433000;;1435089000;90877000;;1861986000;1952863000;3387952000;271031000;;809008000;2575502000;2745438000;3554446000;1307728000;-3272774000;1856951000;-166494000;3387952000
ETM;550551;USD;2017;Q4;2017-12-31;2017-08-04;88761866;104418859;34167000;341989000;;400503000;346507000;9955000;3782236000;4138698000;4539201000;77163000;13319000;198043000;1859442000;2576798000;2774841000;1738569000;;25791000;1764360000;4539201000
ETM;550551;USD;2016;Q4;2016-12-31;2017-02-28;38599980;36449248;46843000;92172000;;146685000;63375000;255000;865918000;929548000;1076233000;17362000;4817000;67717000;467651000;615142000;682859000;606010000;;-212636000;393374000;1076233000
ETM;550551;USD;2015;Q4;2015-12-31;2016-02-26;38159788;40282492;9169000;87157000;;106065000;57993000;;851587000;909580000;1015645000;16845000;31832000;68601000;448724000;585594000;654195000;612151000;;-250701000;361450000;1015645000
ETM;550551;USD;2014;Q4;2014-12-31;2015-03-02;38013412;39227264;31540000;70249000;;110004000;44662000;;771949000;816611000;926615000;14262000;3000000;30761000;476929000;566833000;597594000;608906000;;-279885000;329021000;926615000
ETM;550551;USD;2013;Q4;2013-12-31;2014-03-03;37803228;39811980;12231000;71818000;;91266000;44439000;;776983000;821422000;912688000;13929000;3000000;29652000;514124000;584643000;614295000;605106000;;-306713000;298393000;912688000
ETM;550551;USD;2012;Q4;2012-12-31;2013-02-27;37721872;40521584;8923000;70955000;;90796000;51677000;;777885000;829562000;920358000;14605000;9808000;49276000;560133000;601588000;650864000;602231000;;-332737000;269494000;920358000
ETM;550551;USD;2011;Q4;2011-12-31;2012-02-29;36704640;37985860;3625000;69053000;;81406000;58368000;0;779495000;837863000;919269000;12913000;3778000;31373000;598446000;638985000;670358000;597709000;;-348798000;248911000;919269000
ETM;550551;USD;2010;Q4;2010-12-31;2011-08-09;35749529;37943434;3768000;70897000;;81496000;62729000;217000;756583000;819529000;901025000;11746000;165026000;190248000;485122000;540110000;730358000;593024000;;-415080000;170667000;901025000
ETM;550551;USD;2018;Q4;2018-12-31;2019-02-27;135960326;134973200;122893000;342766000;;560229000;317030000;11205000;3131894000;3460129000;4020358000;60307000;0;178745000;1872203000;2507353000;2686098000;1694924000;;-360664000;1334260000;4020358000
ICUI;550676;USD;2016;Q4;2016-12-31;2017-03-01;16339000;34416000;445082000;56161000;49264000;569097000;85696000;0;49895000;135591000;704688000;40537000;;40537000;0;3996000;44533000;164461000;-14000;516980000;660155000;704688000
ICUI;550676;USD;2015;Q4;2015-12-31;2016-02-26;16024000;16823000;377397000;57847000;43632000;505007000;74320000;;47498000;121818000;626825000;42618000;;42618000;;4336000;46954000;146733000;0;453896000;579871000;626825000
ICUI;550676;USD;2014;Q4;2014-12-31;2015-02-20;15470000;16343000;346764000;39051000;36933000;432529000;86091000;;22482000;108573000;541102000;28728000;;28728000;;4122000;32850000;108895000;;408911000;508252000;541102000
ICUI;550676;USD;2013;Q4;2013-12-31;2014-02-21;14944000;15503000;296891000;45318000;34451000;394296000;87861000;;17486000;105347000;499643000;26886000;;26886000;;8032000;34918000;80005000;-49000;382576000;464725000;499643000
ICUI;550676;USD;2012;Q4;2012-12-31;2013-02-26;14436000;15136000;226159000;49127000;36333000;325503000;85937000;;17072000;103009000;428512000;29118000;;29118000;;8537000;37655000;65256000;-15128000;342158000;390857000;428512000
ICUI;550676;USD;2011;Q4;2011-12-31;2012-03-23;13864000;14147000;159985000;43571000;40423000;260408000;83048000;;17656000;100704000;361112000;29310000;;29310000;;11225000;40535000;58282000;-35348000;300877000;320577000;361112000
ICUI;550676;USD;2010;Q4;2010-12-31;2011-02-18;13623000;13900000;93357000;50941000;44056000;205251000;83545000;;20848000;104393000;309644000;25508000;;25762000;;12178000;37940000;57988000;-41428000;256208000;271704000;309644000
ICUI;550676;USD;2009;Q4;2009-12-31;2010-02-19;14569000;14850000;108135000;47777000;41327000;207938000;78389000;;22826000;101215000;309153000;31307000;;33696000;;10452000;44148000;55838000;-19881000;227861000;265005000;309153000
ICUI;550676;USD;2008;Q4;2008-12-31;2009-02-24;14530839;14817815;111789000;38423000;17930000;179388000;70837000;11350000;21859000;104046000;283434000;21960000;;21960000;;8443000;30403000;52448000;-1623000;201304000;253031000;283434000
ICUI;550676;USD;2007;Q4;2007-12-31;2008-02-22;13745720;14620513;95643000;26115000;19504000;153257000;72708000;;16629000;89337000;242594000;21475000;;21475000;;7215000;28690000;76280000;-40776000;177004000;213904000;242594000
ICUI;550676;USD;2017;Q4;2017-12-31;2018-03-16;20212000;22956000;300133000;112696000;288657000;864662000;398684000;14579000;219026000;632289000;1496951000;210292000;;210292000;;88405000;298697000;627589000;0;585624000;1198254000;1496951000
ICUI;550676;USD;2018;Q4;2018-12-31;2019-03-01;20495000;21802000;382110000;176298000;311163000;927036000;432641000;2025000;223689000;658355000;1585391000;249289000;;249289000;;72447000;321736000;659948000;-95000;620747000;1263655000;1585391000
WTW;564422;USD;2018;Q4;2018-12-31;2019-02-26;66896000;70474000;236974000;27247000;25851000;366424000;52202000;;995915000;1048117000;1414541000;140637000;77000000;341316000;1669708000;1878255000;2219571000;0;-3175624000;2382438000;-805030000;1414541000
WTW;564422;USD;2017;Q4;2017-12-31;2018-02-28;64606000;70042000;83054000;23913000;31728000;208988000;47978000;;989034000;1037012000;1246000000;111595000;82750000;343027000;1740612000;1914492000;2257519000;0;-3208836000;2203317000;-1011519000;1246000000
WTW;564422;USD;2016;Q4;2016-12-31;2017-03-01;63900000;68267000;108656000;27518000;32629000;235211000;49574000;;986191000;1035765000;1270976000;126896000;21000000;292388000;1981299000;2181462000;2473850000;0;-3237346000;2056893000;-1202874000;1270976000
WTW;564422;USD;2015;Q4;2015-12-31;2016-03-02;62478000;64637000;241526000;29281000;27838000;351457000;58186000;;984573000;1042759000;1394216000;136995000;213323000;503127000;1996296000;2176797000;2679924000;0;-3247406000;1994513000;-1285708000;1394216000
WTW;564422;USD;2014;Q4;2014-12-31;2015-03-04;56701000;56888000;301212000;31960000;32382000;425665000;74650000;;1034325000;1108975000;1534640000;177569000;80728000;431695000;2277272000;2470433000;2902128000;0;-3253597000;1900506000;-1367488000;1534640000
WTW;564422;USD;2013;Q4;2013-12-31;2014-02-26;56409000;56502000;174557000;36248000;40939000;315725000;87052000;;1003149000;1090201000;1405926000;166102000;30000000;345820000;2358000000;2536711000;2882531000;0;-3256406000;1771284000;-1476605000;1405926000
WTW;564422;USD;2012;Q4;2012-12-31;2013-02-27;55693000;56265000;70215000;37363000;46846000;217967000;71768000;;928872000;1000640000;1218607000;190509000;114695000;447855000;2291669000;2436211000;2884066000;0;-3281831000;1603513000;-1665459000;1218607000
WTW;564422;USD;2011;Q4;2011-12-31;2012-02-28;73579000;74199000;53199000;41445000;53437000;214526000;41072000;;866030000;907102000;1121628000;154527000;124933000;494207000;926868000;1037187000;1531394000;0;-1793983000;1378616000;-409766000;1121628000
WTW;564422;USD;2010;Q4;2010-12-31;2011-03-02;73713000;74054000;40534000;43722000;40571000;190442000;30930000;;870615000;901545000;1091987000;125787000;197524000;539135000;1167561000;1243576000;1782711000;0;-1794066000;1103817000;-690724000;1091987000
WTW;564422;USD;2009;Q4;2009-12-31;2010-08-12;77028000;77180000;46137000;39622000;32488000;199951000;36038000;;851520000;887558000;1087509000;84891000;215000000;536055000;1238000000;1284724000;1820779000;0;-1684343000;955514000;-733270000;1087509000
FRX;564852;USD;2013;Q4;2013-09-30;2013-05-23;271380000;279642000;2153050000;576854000;612664000;4123712000;371815000;1170141000;6351863000;7893819000;12017531000;221025000;;1510669000;3000000000;4341298000;5851967000;2104707000;-5171906000;9220654000;6165564000;12017531000
FRX;564852;USD;2012;Q4;2012-09-30;2012-05-25;266318000;265069000;1674873000;478032000;393901000;2947786000;376960000;1349424000;2955412000;4681796000;7629582000;157349000;;997691000;0;886636000;1884327000;1842110000;-5162315000;9055344000;5745255000;7629582000
FRX;564852;USD;2011;Q4;2011-09-30;2011-05-27;267850000;268332000;2427070000;471784000;298118000;3586195000;360020000;723367000;2822173000;3905560000;7491755000;154275000;;899786000;;915152000;1814938000;1743609000;-5151305000;9087447000;5676817000;7491755000
FRX;564852;USD;2010;Q4;2010-09-30;2010-05-26;288177000;288184000;3851141000;535486000;451365000;5259673000;319766000;529917000;813098000;1662781000;6922454000;190767000;;937858000;;485716000;1423574000;1674385000;-4291890000;8108389000;5498880000;6922454000
FRX;564852;USD;2009;Q4;2009-09-30;2010-05-26;606910042;607445607;3322262000;475653000;467769000;4579191000;323284000;742335000;578721000;1644340000;6223531000;130205000;;979646000;;353978000;1333624000;1565585000;-3783401000;7061619000;4889907000;6223531000
FRX;564852;USD;2008;Q4;2008-09-30;2009-05-29;610167507;611446671;2580922000;449444000;393527000;3785954000;345935000;449793000;615126000;1410854000;5196808000;117192000;;817828000;;264389000;1082217000;1533466000;-3750966000;6379236000;4114591000;5196808000
FRX;564852;USD;2007;Q4;2007-09-30;2009-05-29;;;1906169000;445987000;425138000;3036649000;350037000;534480000;604201000;1488718000;4525367000;223720000;;610825000;;199225000;810050000;1476314000;-3407082000;5611493000;3715317000;4525367000
CLAR;569146;USD;2016;Q4;2016-12-31;2017-03-06;30009000;30009000;94738000;23232000;45410000;166945000;11055000;;32457000;43512000;210457000;18709000;21898000;40607000;;9042000;49649000;483928000;-12398000;-309717000;160808000;210457000
CLAR;569146;USD;2015;Q4;2015-12-31;2016-03-15;32197000;32197000;98225000;26774000;51496000;180581000;10790000;;35421000;46211000;226792000;21446000;;21446000;20133000;30914000;52360000;483701000;-7320000;-300739000;174432000;226792000
CLAR;569146;USD;2014;Q4;2014-12-31;2015-03-16;32694000;32694000;39690000;27754000;56789000;158560000;12235000;;144745000;156980000;315540000;24672000;;32540000;18559000;25807000;58347000;482988000;-186000;-223197000;257193000;315540000
CLAR;569146;USD;2013;Q4;2013-12-31;2014-03-04;32405000;32405000;4478000;40316000;54054000;106381000;17401000;;197641000;215042000;321423000;27349000;1910000;29259000;36131000;44914000;74173000;477893000;-2000;-237204000;247250000;321423000
CLAR;569146;USD;2012;Q4;2012-12-31;2013-03-12;31448000;30760000;5111000;30925000;60664000;104542000;17508000;;198736000;216244000;320786000;22178000;4059000;26237000;36429000;46543000;72780000;473631000;-2000;-231334000;248006000;320786000
CLAR;569146;USD;2011;Q4;2011-12-31;2012-03-06;21856000;22294000;2400000;22718000;47137000;76997000;14019000;;136711000;150730000;227727000;16344000;673000;17017000;37397000;38536000;55553000;402718000;-2000;-233286000;172174000;227727000
CLAR;569146;USD;2010;Q4;2010-12-31;2011-08-09;21984000;22071000;2767000;20293000;34942000;62603000;14740000;;135336000;150076000;212679000;19208000;308000;19516000;29456000;30241000;49757000;399477000;-2000;-238178000;162922000;212679000
CLAR;569146;USD;2017;Q4;2017-12-31;2018-03-12;30043000;30043000;1856000;35817000;58138000;99444000;24345000;;83660000;108005000;207449000;19784000;;19784000;20842000;24683000;44467000;485288000;-12415000;-310390000;162982000;207449000
CLAR;569146;USD;2018;Q4;2018-12-31;2019-03-04;29839000;30656000;2486000;35943000;64933000;108501000;23401000;;81226000;104627000;213128000;21699000;41000;21740000;22105000;25183000;46923000;488407000;-18102000;-304577000;166205000;213128000
IPGP;570971;USD;2016;Q4;2016-12-31;2017-02-27;53238000;54018000;830634000;155901000;239010000;1300962000;379375000;;109662000;489037000;1789999000;155087000;3188000;158275000;37635000;74000000;232275000;650979000;-8946000;1094108000;1557724000;1789999000
IPGP;570971;USD;2015;Q4;2015-12-31;2016-02-26;52886000;53607000;689116000;150479000;203738000;1102589000;288604000;;62236000;350840000;1453429000;139790000;2000000;141790000;17667000;50974000;192764000;607654000;0;833356000;1260665000;1453429000
IPGP;570971;USD;2014;Q4;2014-12-31;2015-03-02;52290000;53011000;522150000;143109000;171009000;893838000;275082000;;41967000;317049000;1210887000;102870000;13333000;122075000;19667000;42251000;164326000;567622000;;591202000;1046561000;1210887000
IPGP;570971;USD;2013;Q4;2013-12-31;2014-02-28;51828000;52398000;448776000;103803000;172700000;786343000;252245000;;22628000;274873000;1061216000;93341000;1333000;100079000;11333000;33168000;133247000;538913000;;390757000;927969000;1061216000
IPGP;570971;USD;2012;Q4;2012-12-31;2013-02-28;51383000;52389000;384053000;96630000;139618000;664959000;210563000;;19976000;230539000;895498000;111677000;1505000;125455000;14014000;27116000;152571000;511044000;;234977000;742927000;895498000
IPGP;570971;USD;2011;Q4;2011-12-31;2012-02-27;47568000;48693000;205685000;75755000;116978000;434457000;155202000;;18473000;173675000;608132000;79637000;1613000;93712000;15726000;24687000;118399000;332590000;;122833000;489733000;608132000
IPGP;570971;USD;2010;Q4;2010-12-31;2011-08-08;46839172;48144136;147860000;55399000;72470000;300801000;120683000;;20371000;141054000;441855000;71209000;1333000;82770000;15644000;17379000;100149000;310223000;;5567000;341706000;441855000
IPGP;570971;USD;2017;Q4;2017-12-31;2018-02-28;53792000;55257000;1116157000;237278000;307712000;1754010000;460206000;;153039000;613245000;2367255000;195299000;3604000;198903000;45378000;146030000;344933000;704732000;-48933000;1443867000;2022322000;2367255000
IPGP;570971;USD;2018;Q4;2018-12-31;2019-02-27;53161000;54034000;1044790000;255509000;403579000;1805424000;543068000;;225958000;769026000;2574450000;242103000;3671000;245774000;41707000;122441000;368215000;744942000;-224998000;1848500000;2206235000;2574450000
AEIS;574583;USD;2018;Q4;2018-12-31;2019-02-21;38386000;38615000;351771000;100442000;97987000;568448000;31269000;;216767000;248036000;816484000;74679000;;110309000;;98873000;209182000;97456000;;512783000;607302000;816484000
AEIS;574583;USD;2017;Q4;2017-12-31;2018-02-15;39643000;40103000;410387000;87429000;78450000;595225000;17795000;;120288000;138083000;733308000;71954000;;106119000;;106548000;212667000;184883000;;333225000;520641000;733308000
AEIS;574583;USD;2016;Q4;2016-12-31;2017-02-24;39713000;40088000;286690000;75667000;55770000;438334000;13337000;;119858000;133195000;571529000;61263000;;95046000;;84409000;179455000;203643000;;195364000;392074000;571529000
AEIS;574583;USD;2015;Q4;2015-12-31;2016-02-25;40271000;40607000;170429000;54959000;52573000;322477000;9645000;;130381000;140026000;462503000;50393000;;103970000;;94953000;198923000;195136000;;67910000;263580000;462503000
AEIS;574583;USD;2014;Q4;2014-12-31;2015-02-26;40328000;40649000;124484000;79053000;46092000;376753000;9759000;;298056000;307815000;684568000;38143000;;112568000;;97035000;209603000;237793000;;226396000;474965000;684568000
AEIS;574583;USD;2013;Q4;2013-12-31;2014-03-03;40282000;42343000;149693000;125782000;109771000;416969000;34888000;;201120000;236008000;652977000;81037000;13661000;122357000;;66158000;188515000;251591000;;179414000;464462000;652977000
AEIS;574583;USD;2012;Q4;2012-12-31;2013-03-06;37954000;38583000;172247000;83914000;81482000;371146000;39523000;;126573000;166096000;537242000;68269000;0;85748000;;61883000;147631000;212558000;;147328000;389611000;537242000
AEIS;574583;USD;2011;Q4;2011-12-31;2012-03-02;43314000;43677000;143206000;132485000;80283000;390486000;42338000;;100554000;142892000;533378000;65755000;;91244000;;34795000;126039000;254045000;;124767000;407339000;533378000
AEIS;574583;USD;2010;Q4;2010-12-31;2011-08-11;43315000;43797000;140554000;119893000;77593000;361767000;34569000;;108821000;143390000;505157000;90133000;;102325000;;28864000;131189000;258441000;;88453000;373968000;505157000
ADP;591496;USD;2018;Q4;2018-06-30;2018-08-03;437900000;441100000;2170000000;1984200000;;31823300000;793700000;25500000;6206600000;7025800000;38849100000;2693500000;;30412700000;2002400000;3700500000;34113200000;1078700000;-12209600000;16546600000;4735900000;38849100000
ADP;591496;USD;2017;Q4;2017-06-30;2017-08-04;444500000;446400000;2780400000;1703600000;;32658700000;779900000;28000000;3713400000;4521300000;37180000000;2393600000;;29815900000;2002400000;3387100000;33203000000;931700000;-11303700000;14728200000;3977000000;37180000000
ADP;591496;USD;2016;Q4;2016-06-30;2016-08-05;453600000;453500000;3191100000;1742800000;;39500400000;685000000;27100000;3457500000;4169600000;43670000000;2282400000;;35847400000;2007700000;3341000000;39188400000;832000000;-10138600000;14003300000;4481600000;43670000000
ADP;591496;USD;2015;Q4;2015-06-30;2015-08-07;465100000;467200000;1665900000;1546900000;;28809200000;672700000;61100000;3567500000;4301300000;33110500000;2234600000;;27113700000;9200000;1188300000;28302000000;727200000;-9118400000;13460300000;4808500000;33110500000
ADP;591496;USD;2014;Q4;2014-06-30;2014-08-08;478200000;482300000;3616200000;1498800000;;27493000000;667100000;209500000;3690200000;4566800000;32059800000;2192600000;2173000000;24167600000;11500000;1222000000;25389600000;609100000;-7750000000;13632900000;6670200000;32059800000
ADP;591496;USD;2013;Q4;2013-06-30;2013-08-19;281186300;283523700;1727100000;1595300000;;26214500000;728600000;452700000;4872300000;6053600000;32268100000;2211800000;0;24732800000;14700000;1345400000;26078200000;520800000;-7366600000;13020300000;6189900000;32268100000
ADP;591496;USD;2012;Q4;2012-06-30;2012-08-20;553667900;557996100;1578500000;1391700000;;25272600000;706300000;216700000;4621800000;5544800000;30817400000;2054600000;;23252700000;16800000;1450700000;24703400000;550300000;-7104800000;12438300000;6114000000;30817400000
ADP;591496;USD;2011;Q4;2011-06-30;2011-08-24;563121600;569613900;1425700000;1364800000;;28583500000;716200000;226700000;4711900000;5654800000;34238300000;1844800000;;26786800000;34200000;1441100000;28227900000;553400000;-6714000000;11803900000;6010400000;34238300000
ADP;591496;USD;2010;Q4;2010-06-30;2010-08-25;565171800;568816600;1671200000;1127700000;;22316700000;673800000;233700000;3638000000;4545500000;26862200000;1594000000;;20052200000;39800000;1331100000;21383300000;556900000;-6539500000;11252000000;5478900000;26862200000
ADP;591496;USD;2009;Q4;2009-06-30;2009-11-06;570297300;570866800;2296100000;1050700000;;20705500000;734300000;255000000;3656900000;4646200000;25351700000;1703300000;730000000;18763400000;42700000;1265700000;20029100000;583900000;-6133900000;10716600000;5322600000;25351700000
ADP;591496;USD;2019;Q4;2019-06-30;2019-08-09;433400000;435900000;1959700000;2439300000;;34342300000;764200000;23800000;6757400000;7545400000;41887700000;3000500000;0;32627700000;2002200000;3860100000;36487800000;1247100000;-13090500000;17500600000;5399900000;41887700000
NTGR;591520;USD;2018;Q4;2018-12-31;2019-02-22;-26479636;-24312496;274364000;303667000;243871000;857899000;20177000;;165300000;185477000;1043376000;372906000;;383992000;;31832000;415824000;793617000;;-166050000;627552000;1043376000
NTGR;591520;USD;2017;Q4;2017-12-31;2018-02-16;50597456;52439972;329653000;255118000;162942000;1015664000;17349000;;175551000;192900000;1208564000;272561000;;424436000;;53643000;478079000;603168000;;128168000;730485000;1208564000
NTGR;591520;USD;2016;Q4;2016-12-31;2017-02-24;53133132;55190044;365982000;313839000;247862000;962785000;19473000;;202198000;221671000;1184456000;321352000;;356653000;;30984000;387637000;566340000;;228541000;796819000;1184456000
NTGR;591520;USD;2015;Q4;2015-12-31;2016-02-19;51898340;53557088;278266000;290642000;213118000;821143000;22384000;;207042000;229426000;1050569000;286647000;;315772000;;26087000;341859000;513080000;;195627000;708710000;1050569000
NTGR;591520;USD;2014;Q4;2014-12-31;2015-02-20;55891264;57092204;257129000;275689000;222883000;822965000;29694000;;196028000;225722000;1048687000;274093000;;304116000;;23006000;327122000;454179000;;267348000;721565000;1048687000
NTGR;591520;USD;2013;Q4;2013-12-31;2014-02-25;61004528;62013640;248154000;266484000;224456000;800111000;27194000;;266625000;293819000;1093930000;275587000;;300083000;;20064000;320147000;421938000;;351776000;773783000;1093930000
NTGR;591520;USD;2012;Q4;2012-12-31;2013-02-26;61726704;62892180;376877000;256014000;174903000;864209000;19025000;;151335000;170360000;1034569000;233285000;;260930000;;19028000;279958000;394465000;;360142000;754611000;1034569000
NTGR;591520;USD;2011;Q4;2011-12-31;2012-03-28;60562840;61804080;353695000;261307000;163724000;834229000;15884000;;121257000;137141000;971370000;268868000;;308961000;;23652000;332613000;364281000;;274453000;638757000;971370000
NTGR;591520;USD;2010;Q4;2010-12-31;2011-08-09;57848232;59358676;270737000;226731000;127394000;668044000;17503000;;94774000;112277000;780321000;227185000;;254723000;;25162000;279885000;316144000;;184011000;500436000;780321000
AKER;592461;USD;2017;Q4;2017-12-31;2018-04-03;1717551;1717551;5450039;964671;947612;7775899;235113;;1326878;1561991;9337890;1785037;;1785037;;;1785037;110647169;;-104845847;7552853;9337890
AKER;592461;USD;2016;Q4;2016-12-31;2017-04-11;706459;696796;122701;601271;2036521;3186944;259392;;1638771;1898163;5085107;1697430;;1697430;;;1697430;100891786;;-97479537;3387677;5085107
AKER;592461;USD;2015;Q4;2015-12-31;2016-03-30;669262;669262;4427163;609195;1131654;6481068;251145;;1539696;1790841;8271909;1668731;;1668731;;;1668731;100785408;;-94175999;6603178;8271909
AKER;592461;USD;2014;Q4;2014-12-31;2015-03-23;645466;645466;9720802;1154290;905116;13059733;201483;;3389656;3591139;16650872;1538430;;1843986;;;1843986;99691096;;-84864086;14806886;16650872
AKER;592461;USD;2013;Q4;2013-12-31;2014-05-14;253118;253118;103634;118404;1025104;3369382;267321;;2438919;2706240;6075622;1006999;307500;1647832;;305556;1953388;85843360;;-81721126;4122234;6075622
AKER;592461;USD;2018;Q4;2018-12-31;2019-04-01;10721675;10721675;5454753;176326;585267;6670128;83456;;1053669;1137125;7807253;1973500;;1973500;;0;1973500;121554547;;-115694881;5833753;7807253
MYSZ;592569;USD;2017;Q4;2017-12-31;2018-03-21;18743150;18743150;1802000;;;2253000;67000;98000;;165000;2418000;581000;558000;3570000;;0;3570000;16030000;;-17048000;-1152000;2418000
MYSZ;592569;USD;2016;Q4;2016-12-31;2017-04-14;18170056;17991190;34000;;;1497000;74000;579000;;653000;2150000;545000;0;625000;;-93000;532000;13364000;;-11644000;1618000;2150000
MYSZ;592569;USD;2015;Q4;2015-12-31;2016-03-04;-15283170419;-15283170419;2727000;;;3677000;61000;0;;61000;3738000;193000;3470000;6351000;;-69000;6282000;4870000;;-7310000;-2544000;3738000
MYSZ;592569;USD;2014;Q4;2014-12-31;2015-08-20;15540103;15540103;645000;;;755000;24000;0;;24000;779000;192000;72000;301000;;0;301000;4470000;;-3873000;478000;779000
MYSZ;592569;USD;2018;Q4;2018-12-31;2019-03-27;29883400;;6557000;;;7046000;71000;;0;71000;7117000;571000;;1823000;;0;1823000;29146000;;-23017000;5294000;7117000
DSW;596024;USD;2016;Q4;2017-01-31;2017-03-23;80112000;80643000;209187000;18456000;499995000;759266000;375251000;93734000;200225000;669210000;1428476000;316605000;;316605000;;149390000;465995000;946351000;-316531000;346602000;962481000;1428476000
DSW;596024;USD;2015;Q4;2016-01-31;2016-03-24;85514000;86318000;258522000;15437000;484236000;795668000;374241000;93141000;106059000;573441000;1369109000;323426000;;323426000;;115766000;439192000;930011000;-266531000;287140000;929917000;1369109000
DSW;596024;USD;2014;Q4;2015-01-31;2015-03-26;88271000;89405000;230372000;24400000;450836000;748723000;337903000;242643000;108974000;689520000;1438243000;283790000;;283790000;;118340000;402130000;908679000;-86938000;220826000;1036113000;1438243000
DSW;596024;USD;2013;Q4;2014-01-31;2014-03-27;90749000;92162000;336119000;26593000;397768000;812764000;318620000;243188000;46672000;608480000;1421244000;284402000;;284402000;;113305000;397707000;890698000;-1600000;134439000;1023537000;1421244000
DSW;596024;USD;2012;Q4;2013-01-31;2013-03-28;89790000;91550000;313178000;26756000;393794000;821790000;300313000;96712000;43288000;440313000;1262103000;275311000;;275311000;;106533000;381844000;872026000;0;16991000;880259000;1262103000
DSW;596024;USD;2017;Q4;2018-01-31;2018-03-23;79994000;80655000;300537000;17532000;501903000;870873000;355199000;6096000;189349000;550644000;1421517000;327534000;;327534000;;113739000;441273000;961245000;-325906000;354979000;980244000;1421517000
DSW;596024;USD;2018;Q4;2019-01-31;2019-03-26;79410000;76794000;169087000;68870000;645317000;955219000;409576000;;255789000;665365000;1620584000;463160000;;463160000;160000000;300054000;763214000;978794000;-373436000;254718000;857370000;1620584000
WLB;596565;USD;2017;Q4;2017-12-31;2018-04-02;18762000;18762000;103247000;89311000;106795000;392441000;741835000;27763000;501879000;1271477000;1663918000;186017000;983427000;1245209000;64980000;883487000;2128696000;250682000;;-552263000;-464778000;1663918000
WLB;596565;USD;2016;Q4;2016-12-31;2017-03-29;18572000;18565000;60082000;140731000;125515000;377714000;835521000;26951000;344723000;1207195000;1584909000;209686000;86272000;379274000;1022794000;1895752000;2275026000;248329000;;-757367000;-690117000;1584909000
WLB;596565;USD;2015;Q4;2015-12-31;2016-03-14;18087000;18087000;22936000;134141000;122156000;313120000;746842000;27374000;328643000;1102859000;1415979000;172407000;38852000;309426000;979357000;1769454000;2078880000;240903000;;-730266000;-662901000;1415979000
WLB;596565;USD;2014;Q4;2014-12-31;2015-03-06;17112000;17112000;14258000;143052000;133855000;347688000;927662000;33409000;507736000;1468807000;1816495000;197960000;43136000;373897000;932075000;1792043000;2165940000;228400000;;-468902000;-349445000;1816495000
WLB;596565;USD;2013;Q4;2013-12-31;2014-02-28;14595000;14260000;61110000;66196000;39972000;205039000;490036000;0;251610000;741646000;946685000;110733000;44343000;213028000;295494000;921536000;1134564000;171340000;;-295784000;-187879000;946685000
WLB;596565;USD;2012;Q4;2012-12-31;2013-03-12;14176000;12847000;31610000;60037000;37734000;159312000;512840000;;263963000;776803000;936115000;85321000;23791000;170912000;337198000;1051434000;1222346000;166354000;;-289727000;-286231000;936115000
WLB;596565;USD;2011;Q4;2011-12-31;2012-03-13;13798000;13798000;30783000;46235000;25696000;122453000;396732000;;239987000;636719000;759172000;70931000;20795000;144122000;261474000;864908000;1009030000;160815000;;-281141000;-249858000;759172000
WLB;596565;USD;2010;Q4;2010-12-31;2011-08-05;11136000;10890000;5775000;50578000;23571000;97547000;416955000;;235804000;652759000;750306000;72564000;14973000;133340000;227131000;779321000;912661000;126367000;;-226740000;-162355000;750306000
LCI;600871;USD;2017;Q4;2017-06-30;2017-08-28;36891233;35122155;144828000;204066000;122604000;494793000;243148000;;865371000;1108519000;1603312000;109660000;60117000;192208000;843530000;849982000;1042190000;292817000;-9247000;277774000;561122000;1603312000
LCI;600871;USD;2016;Q4;2016-06-30;2016-08-29;36575972;38258645;238863000;211722000;114904000;612815000;216638000;;934565000;1151203000;1764018000;82303000;178236000;306669000;883612000;902892000;1209561000;283338000;-7349000;278355000;554457000;1764018000
LCI;600871;USD;2015;Q4;2015-06-30;2015-08-27;36159879;37251660;213807000;91103000;46191000;370546000;94556000;;43664000;138220000;508766000;43413000;135000;43548000;874000;1452000;45000000;236215000;-6080000;233573000;463766000;508766000
LCI;600871;USD;2014;Q4;2014-06-30;2014-08-29;35364725;38141348;146280000;61325000;44844000;265547000;61704000;;15522000;77226000;342773000;46870000;129000;46999000;1009000;1009000;48008000;216829000;-5959000;83654000;294765000;342773000
LCI;600871;USD;2013;Q4;2013-06-30;2013-09-12;28754239;29735970;51150000;26413000;32531000;116129000;40141000;;11482000;51623000;167752000;32429000;670000;33099000;5844000;5844000;38943000;104104000;-2034000;26553000;128809000;167752000
LCI;600871;USD;2012;Q4;2012-06-30;2012-09-12;27523887;27453938;29229000;26586000;27064000;90855000;37068000;;14669000;51737000;142592000;24118000;648000;24766000;6513000;6513000;31279000;99544000;-1594000;13236000;111313000;142592000
LCI;600871;USD;2011;Q4;2011-06-30;2011-11-04;28340768;27987633;24659000;33464000;26903000;94142000;29929000;;23673000;53602000;147744000;34231000;629000;34860000;7193000;7195000;42055000;97110000;-872000;9288000;105689000;147744000
LCI;600871;USD;2018;Q4;2018-06-30;2018-08-28;37313313;38342037;98586000;252651000;141635000;526870000;233247000;;815187000;1048434000;1575304000;127366000;66845000;200917000;772425000;775472000;976389000;306855000;-13889000;306464000;598915000;1575304000
LCI;600871;USD;2019;Q4;2019-06-30;2019-08-28;37929521;35089527;140249000;164752000;143971000;472249000;186670000;;528494000;715164000;1187413000;103810000;66845000;176622000;662203000;676750000;853372000;317062000;-14481000;32075000;334041000;1187413000
PDFS;606334;USD;2016;Q4;2016-12-31;2017-03-09;62879724;33293000;116787000;48157000;;170279000;19341000;;32709000;52050000;222329000;10245000;;18522000;;5004000;23526000;281428000;-54882000;-25752000;198803000;222329000
PDFS;606334;USD;2015;Q4;2015-12-31;2016-03-01;31322000;31859000;126158000;33438000;;163251000;11325000;;17193000;28518000;191769000;8487000;;14456000;;3006000;17462000;266013000;-50383000;-39780000;174307000;191769000
PDFS;606334;USD;2014;Q4;2014-12-31;2015-03-03;31029000;31830000;115464000;37725000;;159420000;8832000;;9186000;18018000;177438000;8648000;;12388000;;3227000;15615000;248739000;-34048000;-52187000;161823000;177438000
PDFS;606334;USD;2013;Q4;2013-12-31;2014-03-14;30301000;31980000;89371000;34860000;;133783000;7064000;;10317000;17381000;151164000;10429000;;12868000;;3584000;16452000;233818000;-28905000;-70649000;134712000;151164000
PDFS;606334;USD;2012;Q4;2012-12-31;2013-03-18;29136000;30450000;61637000;33959000;;102598000;3898000;;17764000;21662000;124260000;15659000;;19698000;;3502000;23200000;220365000;-27778000;-91578000;101060000;124260000
PDFS;606334;USD;2011;Q4;2011-12-31;2012-03-15;28300000;29456000;46041000;20863000;;70621000;777000;784000;2202000;3763000;74384000;8335000;;13385000;;4156000;17541000;208830000;-22899000;-128789000;56843000;74384000
PDFS;606334;USD;2010;Q4;2010-12-31;2011-08-30;27566000;28422000;38154000;22121000;;63460000;797000;718000;3417000;4932000;68392000;7680000;108000;12611000;;4949000;17560000;200870000;-19298000;-130669000;50832000;68392000
PDFS;606334;USD;2017;Q4;2017-12-31;2018-03-16;64050889;61555612;101267000;57564000;;163900000;25386000;;34890000;60276000;224176000;11656000;;19637000;;6171000;25808000;297955000;-71793000;-27089000;198368000;224176000
OA;609619;USD;2016;Q4;2016-12-31;2017-04-28;58000000;55860000;200000000;1741000000;215000000;2235000000;816000000;;2367000000;3183000000;5418000000;295000000;40000000;1342000000;1398000000;2259000000;3601000000;2176000000;-872000000;1266000000;1817000000;5418000000
OA;609619;USD;2017;Q4;2017-12-31;2018-02-22;57800000;58220000;346000000;1893000000;221000000;2542000000;934000000;;2190000000;3124000000;5666000000;353000000;40000000;1460000000;1361000000;2161000000;3621000000;2176000000;-864000000;1502000000;2045000000;5666000000
LEA;610198;USD;2017;Q4;2017-12-31;2018-02-06;67545408;68501499;1500400000;3230800000;1205700000;6613000000;2459400000;;2873500000;5332900000;11945900000;3167200000;9000000;4854300000;1951500000;2645600000;7499900000;1216100000;-724100000;4171900000;4446000000;11945900000
LEA;610198;USD;2016;Q4;2016-12-31;2017-02-07;70109646;71108730;1271600000;2746500000;1020600000;5649300000;2019300000;;2232000000;4251300000;9900600000;2640500000;44200000;4182300000;1898000000;2525400000;6707700000;1386100000;-1200200000;3706900000;3192900000;9900600000
LEA;610198;USD;2015;Q4;2015-12-31;2016-02-09;75029228;76496121;1196600000;2590000000;947600000;5286600000;1826500000;;2292700000;4119200000;9405800000;2504400000;23100000;3839600000;1931700000;2548500000;6388100000;1452700000;-623000000;2827800000;3017700000;9405800000
LEA;610198;USD;2014;Q4;2014-12-31;2015-02-10;78778977;80808322;1094100000;2471700000;853700000;5165600000;1624700000;;2322800000;3947500000;9113100000;2525300000;240500000;3945100000;1454000000;2138700000;6083800000;1476000000;-176900000;2161700000;3029300000;9113100000
LEA;610198;USD;2013;Q4;2013-12-31;2014-02-11;80371261;82486903;1137700000;2278300000;818700000;4922500000;1587200000;;1821200000;3408400000;8330900000;2438700000;0;3579100000;1057100000;1602300000;5181400000;1653800000;-362100000;1920300000;3149500000;8330900000
LEA;610198;USD;2012;Q4;2012-12-31;2013-02-12;96626905;97896671;1402200000;2040700000;727100000;4873500000;1403100000;;1917500000;3320600000;8194100000;2233000000;;3216900000;626300000;1365000000;4581900000;2156800000;-517900000;2149000000;3612200000;8194100000
LEA;610198;USD;2011;Q4;2011-12-31;2012-02-17;101916698;103912844;1754300000;1880100000;637800000;4761500000;1072000000;;1177400000;2249400000;7010900000;2014300000;;3063500000;695400000;1386300000;4449800000;2151700000;-305600000;922300000;2561100000;7010900000
LEA;610198;USD;2010;Q4;2010-12-31;2011-04-29;103399546;108183254;1654100000;1758400000;554200000;4385500000;994700000;;1240900000;2235600000;6621100000;1838400000;4100000;2818500000;694900000;1233800000;4052300000;2117100000;-13400000;434500000;2568800000;6621100000
LEA;610198;USD;2018;Q4;2018-12-31;2019-02-05;63909139;64508112;1493200000;2880300000;1196800000;6280500000;2598100000;;2722100000;5320200000;11600700000;2862800000;22800000;4500600000;1941000000;2581400000;7082000000;1018000000;-225100000;4113600000;4518700000;11600700000
INGR;610276;USD;2016;Q4;2016-12-31;2017-02-22;72500000;74500000;516000000;923000000;789000000;2252000000;2116000000;;1414000000;3530000000;5782000000;872000000;106000000;978000000;1850000000;2179000000;3157000000;1150000000;-413000000;2899000000;2625000000;5782000000
INGR;610276;USD;2015;Q4;2015-12-31;2016-02-19;71600000;73700000;440000000;775000000;715000000;1950000000;1989000000;;1135000000;3124000000;5074000000;723000000;19000000;742000000;1819000000;2128000000;2870000000;1161000000;-467000000;2552000000;2204000000;5074000000
INGR;610276;USD;2014;Q4;2014-12-31;2015-02-20;71900000;73500000;614000000;762000000;699000000;2144000000;2073000000;;868000000;2941000000;5085000000;698000000;23000000;721000000;1798000000;2135000000;2856000000;1165000000;-481000000;2275000000;2229000000;5085000000
INGR;610276;USD;2013;Q4;2013-12-31;2014-02-24;75700000;76900000;574000000;832000000;723000000;2214000000;2156000000;11000000;979000000;3146000000;5360000000;727000000;93000000;820000000;1717000000;2087000000;2907000000;1167000000;-225000000;2045000000;2453000000;5360000000
INGR;610276;USD;2012;Q4;2012-12-31;2013-02-28;76500000;79100000;628000000;814000000;834000000;2360000000;2193000000;10000000;1029000000;3232000000;5592000000;855000000;76000000;933000000;1724000000;2181000000;3114000000;1149000000;-6000000;1769000000;2478000000;5592000000
INGR;610276;USD;2011;Q4;2011-12-31;2012-02-27;75900000;78000000;401000000;837000000;769000000;2102000000;2156000000;10000000;1049000000;3215000000;5317000000;778000000;148000000;926000000;1801000000;2243000000;3169000000;1147000000;-42000000;1412000000;2148000000;5317000000
INGR;610276;USD;2010;Q4;2010-12-31;2011-02-28;76000000;77500000;302000000;763000000;645000000;1754000000;2156000000;12000000;1118000000;3286000000;5040000000;780000000;88000000;873000000;1681000000;2157000000;3030000000;1120000000;-1000000;1046000000;2010000000;5040000000
INGR;610276;USD;2009;Q4;2009-12-31;2010-08-06;74900000;77300000;175000000;440000000;394000000;1045000000;1564000000;10000000;333000000;1907000000;2952000000;420000000;136000000;565000000;408000000;675000000;1240000000;1083000000;-13000000;919000000;1712000000;2952000000
INGR;610276;USD;2017;Q4;2017-12-31;2018-02-21;72100000;73800000;604000000;961000000;823000000;2415000000;2217000000;;1448000000;3665000000;6080000000;837000000;120000000;957000000;1744000000;2170000000;3127000000;1139000000;-494000000;3259000000;2953000000;6080000000
INGR;610276;USD;2018;Q4;2018-12-31;2019-02-25;68200000;68900000;334000000;951000000;824000000;2138000000;2198000000;;1392000000;3590000000;5728000000;777000000;169000000;946000000;1931000000;2337000000;3283000000;1097000000;-1091000000;3536000000;2445000000;5728000000
CFMS;613117;USD;2016;Q4;2016-12-31;2017-03-08;42095845;42095845;65499000;14675000;11720000;95848000;15084000;;1878000;16962000;112810000;13966000;;14271000;0;4484000;18755000;476486000;;-382930000;94055000;112810000
CFMS;613117;USD;2015;Q4;2015-12-31;2016-03-24;41400798;41400798;117185000;14867000;11520000;146023000;10966000;;2380000;13346000;159369000;12529000;295000;13129000;183000;5028000;18157000;467075000;;-325342000;141212000;159369000
CFMS;613117;USD;2014;Q4;2014-12-31;2015-08-14;4284894;4284894;37900000;9119000;7691000;55868000;8696000;;6714000;15410000;71278000;10560000;272000;10832000;10348000;10619000;21451000;318420000;;-268096000;49827000;71278000
CFMS;613117;USD;2017;Q4;2017-12-31;2018-03-09;43837469;43837469;45228000;13200000;9184000;69858000;16514000;;7426000;23940000;93798000;12611000;;12916000;29667000;34369000;47285000;486570000;;-436821000;46513000;93798000
CFMS;613117;USD;2018;Q4;2018-12-31;2019-03-13;60814741;60814741;23625000;13244000;9534000;47956000;14439000;;588000;15027000;62983000;11375000;;11375000;14792000;15408000;26783000;513337000;;-475667000;36200000;62983000
TEVA;616649;USD;2018;Q4;2018-12-31;2019-02-19;1031000000;1028000000;1782000000;5822000000;4731000000;13794000000;6868000000;;40021000000;46889000000;60683000000;4591000000;2216000000;14322000000;26700000000;30567000000;44889000000;27266000000;-4142000000;-5958000000;15794000000;60683000000
TEVA;616649;USD;2017;Q4;2017-12-31;2018-02-12;1014000000;1016000000;963000000;7128000000;4924000000;15382000000;7673000000;;47560000000;55233000000;70615000000;5632000000;3646000000;17921000000;28829000000;33949000000;51870000000;23533000000;-4149000000;-3803000000;18745000000;70615000000
TEVA;616649;USD;2016;Q4;2016-12-31;2018-02-12;;;988000000;7523000000;4954000000;17228000000;8073000000;;67756000000;75829000000;93057000000;6421000000;3276000000;18488000000;32524000000;39576000000;58064000000;23463000000;-4194000000;13607000000;34993000000;93057000000
GMED;617302;USD;2016;Q4;2016-12-31;2017-03-16;95866000;96517000;290312000;91983000;112692000;513766000;124229000;60444000;229198000;413871000;927637000;65784000;;79892000;;15667000;95559000;211821000;;628899000;832078000;927637000
GMED;617302;USD;2015;Q4;2015-12-31;2016-02-29;95279000;96219000;281029000;77681000;105260000;544799000;114743000;48762000;125796000;289301000;834100000;70503000;;82691000;;36085000;118776000;192724000;;524558000;715324000;834100000
GMED;617302;USD;2014;Q4;2014-12-31;2015-02-26;94582000;95701000;228704000;75430000;90945000;470025000;69475000;75347000;88700000;233522000;703547000;83331000;;89412000;;28681000;118093000;175337000;;411774000;585454000;703547000
GMED;617302;USD;2013;Q4;2013-12-31;2014-03-14;93340000;94803000;238924000;62414000;70350000;416808000;64150000;36528000;48818000;149496000;566304000;66212000;;67942000;;26002000;93944000;154080000;;319289000;472360000;566304000
GMED;617302;USD;2012;Q4;2012-12-31;2013-06-13;91746000;94004000;212400000;53496000;62310000;360110000;61089000;0;25934000;87023000;447133000;38073000;;39508000;;21123000;60631000;136592000;;250677000;386502000;447133000
GMED;617302;USD;2011;Q4;2011-12-31;2012-09-19;88091000;89553000;142668000;46727000;47369000;258775000;52394000;;18221000;70615000;329390000;28071000;;29271000;;17643000;46914000;106781000;;176846000;282476000;329390000
GMED;617302;USD;2017;Q4;2017-12-31;2018-02-22;96497000;98733000;373707000;116676000;108409000;620342000;143167000;56133000;258860000;458160000;1078502000;80907000;;92318000;;18406000;110724000;238438000;;736247000;967778000;1078502000
GMED;617302;USD;2018;Q4;2018-12-31;2019-02-21;98538000;101454000;199937000;137067000;131254000;630681000;171873000;263117000;234999000;669989000;1300670000;86690000;;93520000;;21634000;115154000;299967000;;892721000;1185516000;1300670000
NOW;617429;USD;2016;Q4;2016-12-31;2017-02-28;166850593;166850593;899362000;322757000;;1342535000;181620000;262658000;246954000;691232000;2033767000;209716000;;1071498000;507812000;575308000;1646806000;1405484000;;-997390000;386961000;2033767000
NOW;617429;USD;2015;Q4;2015-12-31;2016-02-25;159828819;159828819;801250000;203333000;;1085635000;144714000;422667000;154036000;721417000;1807052000;138633000;;731636000;474534000;508602000;1240238000;1140705000;;-557009000;566814000;1807052000
NOW;617429;USD;2014;Q4;2014-12-31;2015-02-27;148569953;148569953;668791000;159171000;;906986000;104237000;266772000;146757000;517766000;1424752000;97326000;;506997000;443437000;489080000;996077000;799371000;;-358583000;428675000;1424752000
NOW;617429;USD;2013;Q4;2013-12-31;2014-02-28;139970591;139970591;634554000;108339000;;797749000;75560000;255356000;39811000;370727000;1168476000;75535000;;328088000;414777000;446129000;774217000;573931000;;-179196000;394259000;1168476000
NOW;617429;USD;2012;Q4;2012-12-31;2013-03-08;125024390;125024390;314691000;78163000;;422089000;42342000;0;13683000;56025000;478114000;57663000;;211627000;0;23082000;234709000;348929000;;-105488000;243405000;478114000
NOW;617429;USD;2017;Q4;2017-12-31;2018-02-28;173657669;173657669;1779298000;437051000;;2421951000;245124000;391442000;491728000;1128294000;3550245000;285366000;543418000;2039479000;630018000;732022000;2771501000;1731541000;;-958564000;778744000;3550245000
NOW;617429;USD;2018;Q4;2018-12-31;2019-02-27;179838389;151600231;1497922000;574810000;;2344693000;347216000;581856000;605375000;1534447000;3879140000;360979000;;2012573000;661707000;755368000;2767941000;2094014000;;-978780000;1111199000;3879140000
ROKU;617783;USD;2017;Q4;2017-12-31;2018-03-01;98240204;98240204;177250000;120553000;32740000;344917000;14736000;;12244000;26980000;371897000;128757000;;163258000;;56360000;219618000;435617000;;-283338000;152279000;371897000
ROKU;617783;USD;2016;Q4;2016-12-31;2017-11-09;4809699;4809699;34562000;79473000;43568000;165220000;9528000;;4330000;13858000;179078000;77553000;15000000;116505000;;33227000;149732000;26005000;;-219829000;29346000;179078000
ROKU;617783;USD;2018;Q4;2018-12-31;2019-03-01;109448000;90402000;197710000;183078000;35585000;432935000;25264000;;6798000;32062000;464997000;148562000;;194004000;;26342000;220346000;498564000;;-253896000;244651000;464997000
WK;618274;USD;2017;Q4;2017-12-31;2018-02-22;42121911;42121911;76697000;28800000;;115292000;40444000;;1979000;42423000;157715000;23272000;1168000;129341000;18425000;45308000;174649000;248331000;;-265337000;-16934000;157715000
WK;618274;USD;2016;Q4;2016-12-31;2017-02-23;40875996;40875996;62716000;22535000;;98042000;42590000;;2511000;45101000;143143000;21544000;1305000;99887000;19796000;46381000;146268000;217495000;;-220911000;-3125000;143143000
WK;618274;USD;2015;Q4;2015-12-31;2016-03-01;40208646;40208646;76170000;15647000;;97878000;44410000;;1607000;46017000;143895000;25532000;1826000;84084000;21156000;34092000;118176000;202412000;;-176934000;25719000;143895000
WK;618274;USD;2014;Q4;2014-12-31;2015-03-11;33116625;33116625;101131000;11120000;;116541000;46265000;;1745000;48010000;164551000;19776000;2025000;66730000;22838000;42002000;108732000;189207000;;-133535000;55819000;164551000
WK;618274;USD;2013;Q4;2013-12-31;2015-03-11;;;17951000;13885000;;35884000;34715000;2368000;977000;38060000;73944000;12932000;3026000;43425000;14765000;37306000;80731000;3797000;;;-6787000;73944000
WK;618274;USD;2018;Q4;2018-12-31;2019-02-20;44494793;44494793;98348000;65107000;;177231000;41468000;;12412000;53880000;231111000;41814000;1222000;191581000;17208000;49270000;240851000;297189000;;-307027000;-9740000;231111000
CBB;618601;USD;2016;Q4;2016-12-31;2017-02-24;42000000;42100000;9700000;178600000;22700000;229900000;1085500000;128000000;97600000;1311100000;1541000000;144300000;7500000;232900000;1199100000;1429800000;1662700000;2571300000;;-2732100000;-121700000;1541000000
CBB;618601;USD;2015;Q4;2015-12-31;2016-02-25;41920000;41240000;7400000;157100000;20600000;200400000;975500000;55500000;215000000;1246000000;1446400000;171300000;13800000;259200000;1223800000;1485400000;1744600000;2578100000;-500000;-2834200000;-298200000;1446400000
CBB;618601;USD;2014;Q4;2014-12-31;2015-02-26;41760000;42180000;57900000;160800000;25000000;268700000;815400000;273600000;463000000;1552000000;1820700000;190700000;11600000;410800000;1689400000;2058400000;2469200000;2585000000;-1100000;-3187900000;-648500000;1820700000
CBB;618601;USD;2013;Q4;2013-12-31;2014-02-27;41380000;41080000;4600000;145600000;23800000;251100000;902800000;471000000;482400000;1856200000;2107300000;159000000;12600000;254300000;2252600000;2529700000;2784000000;2592700000;-2000000;-3263500000;-676700000;2107300000
CBB;618601;USD;2012;Q4;2012-12-31;2013-02-28;40100000;41980000;23600000;199000000;30700000;303500000;1587400000;0;981500000;2568900000;2872400000;229000000;13400000;355400000;2676000000;3215200000;3570600000;2592900000;-2000000;-3208800000;-698200000;2872400000
CBB;618601;USD;2011;Q4;2011-12-31;2012-02-28;38980000;39720000;73700000;179400000;23800000;321000000;1400500000;;993200000;2393700000;2714700000;231600000;13000000;356400000;2520600000;3073500000;3429900000;2586600000;-2300000;-3220000000;-715200000;2714700000
CBB;618601;USD;2010;Q4;2010-12-31;2011-02-28;40200000;40260000;77300000;184200000;20900000;322900000;1264400000;;1066300000;2330700000;2653600000;205800000;16500000;328700000;2507100000;2992700000;3321400000;2603500000;-2100000;-3238600000;-667800000;2653600000
CBB;618601;USD;2009;Q4;2009-12-31;2010-08-09;40340000;41300000;23000000;159900000;23700000;321000000;1123300000;;620000000;1743300000;2064300000;185600000;15800000;323800000;1963300000;2395100000;2718900000;2621700000;-2700000;-3266900000;-654600000;2064300000
CBB;618601;USD;2017;Q4;2017-12-31;2018-02-26;42300000;42900000;17800000;239800000;44300000;710400000;1129000000;;348200000;1477200000;2187600000;244200000;18400000;357300000;1729300000;1948200000;2305500000;2566000000;;-2639600000;-117900000;2187600000
CBB;618601;USD;2018;Q4;2018-12-31;2019-02-22;50400000;50400000;15400000;342800000;46500000;445900000;1844000000;;440300000;2284300000;2730200000;401600000;20200000;541700000;1909600000;2263500000;2805200000;2680500000;;-2709400000;-75000000;2730200000
ADES;619745;USD;2017;Q4;2017-12-31;2018-03-12;20738000;20675000;30693000;1113000;;36888000;410000;4351000;40969000;45730000;82618000;2384000;;6878000;;2285000;9163000;105330000;-16397000;-15478000;73455000;82618000
ADES;619745;USD;2016;Q4;2016-12-31;2017-03-13;22260000;22474000;13208000;8648000;;38908000;735000;3959000;63694000;68388000;107296000;14747000;;23711000;;7420000;31131000;119516000;0;-43351000;76165000;107296000
ADES;619745;USD;2015;Q4;2015-12-31;2016-04-19;21994000;21994000;9265000;8361000;;24715000;2040000;20344000;13676000;36060000;60775000;18476000;14513000;50092000;13512000;35661000;85753000;116051000;;-141029000;-24978000;60775000
ADES;619745;USD;2014;Q4;2014-12-31;2016-02-29;21738000;23280000;25181000;16594000;;54429000;4808000;22696000;11766000;39270000;93699000;16421000;1479000;47157000;14431000;47239000;94396000;110191000;;-110888000;-697000;93699000
ADES;619745;USD;2013;Q4;2013-12-31;2016-02-29;20660000;20124000;38401000;12943000;;55355000;5799000;3366000;9004000;18169000;73524000;14909000;0;42559000;0;37132000;79691000;106108000;;-112275000;-6167000;73524000
ADES;619745;USD;2012;Q4;2012-12-31;2013-08-09;19268000;19268000;11378000;11025000;;25291000;44611000;;5847000;50458000;75749000;14266000;559000;49397000;2305000;6489000;55886000;63724000;;-79765000;19863000;75749000
ADES;619745;USD;2018;Q4;2018-12-31;2019-03-18;19314000;19477000;18577000;9554000;21791000;59776000;42697000;6634000;50557000;99888000;159664000;14514000;24067000;40719000;50058000;50998000;91717000;96773000;-41740000;12914000;67947000;159664000
CIDM;620342;USD;2017;Q4;2018-03-31;2018-06-26;39458872;39458872;17952000;38128000;792000;74168000;21483000;;25531000;47014000;121182000;69225000;5287000;76333000;63005000;67153000;143486000;366258000;-11603000;-379225000;-22304000;121182000
CIDM;620342;USD;2016;Q4;2017-03-31;2017-06-29;9975949;9975949;12566000;53608000;1137000;86450000;33138000;;31746000;64884000;151334000;73679000;25721000;101861000;114444000;120176000;222037000;287405000;0;-360415000;-70703000;151334000
CIDM;620342;USD;2015;Q4;2016-03-31;2016-07-14;-19396682088;-19396682088;25481000;52898000;2024000;101845000;61740000;;45813000;107553000;209398000;68517000;29415000;100833000;174060000;181592000;282425000;269950000;-2839000;-342448000;-73027000;209398000
CIDM;620342;USD;2014;Q4;2015-03-31;2015-06-30;7696211;7696211;18999000;59591000;3210000;106943000;98561000;;67513000;166074000;273017000;77147000;57907000;137814000;144242000;154340000;292154000;278061000;-172000;-300350000;-19137000;273017000
CIDM;620342;USD;2013;Q4;2014-03-31;2014-06-26;6533054;6533054;50215000;56863000;3164000;135725000;134936000;;86588000;221524000;357249000;83855000;53658000;140727000;193776000;206295000;347022000;275595000;-172000;-268686000;10227000;357249000
CIDM;620342;USD;2012;Q4;2013-03-31;2013-06-20;4832886;4832886;13448000;29384000;127000;58965000;170088000;;52406000;222494000;281459000;39777000;34579000;77700000;207848000;221073000;298773000;221858000;-172000;-242466000;-17314000;281459000
CIDM;620342;USD;2011;Q4;2012-03-31;2012-06-18;3766795;3766795;27320000;24502000;;63393000;200974000;;25770000;226744000;290137000;20854000;35830000;60436000;227952000;241174000;301610000;206386000;-172000;-221044000;-11473000;290137000
CIDM;620342;USD;2010;Q4;2011-03-31;2011-08-12;12308536189;;17228000;13103000;;65506000;216562000;;25420000;241982000;307488000;7625000;28496000;51793000;242249000;253908000;305701000;196452000;-172000;-197648000;1787000;307488000
CIDM;620342;USD;2018;Q4;2019-03-31;2019-07-16;38309704;38309704;17872000;41765000;673000;67923000;14047000;;19913000;33960000;101883000;71751000;43319000;116757000;19132000;21694000;138451000;368567000;-11603000;-395814000;-36568000;101883000
SSTK;623203;USD;2017;Q4;2017-12-31;2018-02-22;34687000;35142000;253428000;49932000;;340469000;85698000;;151609000;237307000;577776000;65894000;;245742000;;17449000;263191000;273030000;-100027000;145139000;314585000;577776000
SSTK;623203;USD;2016;Q4;2016-12-31;2017-02-27;35088000;35879000;279162000;38107000;;339838000;56101000;;105839000;161940000;501778000;48411000;;203497000;;11585000;215082000;252259000;-77567000;129065000;286696000;501778000
SSTK;623203;USD;2015;Q4;2015-12-31;2016-02-24;35981000;36473000;288382000;28464000;;328559000;32094000;;108468000;140562000;469121000;37512000;;160784000;;19772000;180556000;214212000;-15635000;96437000;288565000;469121000
SSTK;623203;USD;2014;Q4;2014-12-31;2015-02-27;35460000;36007000;288297000;15251000;;323530000;26744000;;33503000;60247000;383777000;30407000;;120327000;;12017000;132344000;175177000;0;76885000;251433000;383777000
SSTK;623203;USD;2013;Q4;2013-12-31;2014-02-28;34948648;35530567;209784000;6081000;;243188000;20256000;;15044000;35300000;278488000;27802000;;91928000;;3961000;95889000;127794000;;54796000;182599000;278488000
SSTK;623203;USD;2012;Q4;2012-12-31;2013-03-01;32593470;32785166;102096000;1738000;;125975000;5255000;;15884000;21139000;147114000;18212000;6000000;69291000;;889000;70180000;48617000;;28317000;76934000;147114000
SSTK;623203;USD;2011;Q4;2011-12-31;2012-12-19;-62464329032;-62464329032;14097000;647000;;18074000;3844000;;2937000;6781000;24855000;12713000;;46510000;;8247000;54757000;;;-63627000;-29902000;24855000
SSTK;623203;USD;2018;Q4;2018-12-31;2019-02-26;35052000;35879000;230852000;41028000;;306721000;76188000;;148579000;224767000;531488000;58597000;;223303000;;21518000;244821000;292086000;-100027000;101079000;286667000;531488000
FCPT;623532;USD;2017;Q4;2017-12-31;2018-02-27;61148416;61100585;64466000;;;64466000;966109000;;38084000;1004193000;1068659000;16843000;;30852000;515539000;515539000;546391000;473691000;;36318000;522268000;1068659000
FCPT;623532;USD;2016;Q4;2016-12-31;2017-02-27;59899960;59828268;26643000;;;26643000;894258000;;16250000;910508000;937151000;14519000;;27943000;438895000;439091000;467034000;438870000;;25943000;470117000;937151000
FCPT;623532;USD;2015;Q4;2015-12-31;2016-03-22;;;98073000;;;98073000;828691000;;2673000;831364000;929437000;0;;14612000;392302000;473183000;487795000;436701000;;5257000;441642000;929437000
FCPT;623532;USD;2014;Q4;2014-12-31;2016-03-22;;;7000;;;7000;11722000;;220000;11942000;11949000;;;1918000;0;1033000;2951000;0;;0;8998000;11949000
FCPT;623532;USD;2018;Q4;2018-12-31;2019-02-20;67774006;68652064;92041000;;;92041000;1190697000;;60360000;1251057000;1343098000;19580000;;28242000;615892000;615892000;644134000;639123000;;46018000;698964000;1343098000
IPXL;625184;USD;2017;Q4;2017-12-31;2018-03-01;72104816;72104816;181778000;240753000;158471000;695555000;124813000;;530932000;655745000;1351300000;329220000;17848000;354238000;769524000;809861000;1164099000;560374000;-2157000;-372445000;187201000;1351300000
IPXL;625184;USD;2016;Q4;2016-12-31;2017-03-01;71491236;71492824;180133000;257368000;175230000;631141000;233372000;;958505000;1191877000;1823018000;303605000;17719000;321324000;813545000;877720000;1199044000;535795000;-2157000;98192000;623974000;1823018000
IPXL;625184;USD;2015;Q4;2015-12-31;2016-02-22;70432988;77023590;340351000;324451000;125582000;822073000;214156000;;886258000;1100414000;1922487000;326761000;0;326761000;424595000;533317000;860078000;504806000;-2157000;570223000;1062409000;1922487000
IPXL;625184;USD;2014;Q4;2014-12-31;2015-02-26;68690426;71152411;414856000;146490000;80570000;675626000;188169000;;215402000;403571000;1079197000;157792000;;158699000;;32621000;191320000;364817000;-2157000;531226000;887877000;1079197000
IPXL;625184;USD;2013;Q4;2013-12-31;2014-02-25;67397269;71102728;413133000;112993000;70107000;659742000;188191000;;148990000;337181000;996923000;149907000;;153890000;;32830000;186720000;337347000;-2157000;473873000;810203000;996923000
IPXL;625184;USD;2012;Q4;2012-12-31;2013-02-26;66238422;69389519;298918000;92249000;89764000;545543000;180758000;;137669000;318427000;863970000;139018000;;145295000;;27572000;172867000;315402000;-2157000;372614000;691103000;863970000
IPXL;625184;USD;2011;Q4;2011-12-31;2012-02-28;64704997;67594885;346414000;153773000;54177000;599935000;118158000;;75766000;193924000;793859000;133837000;;156861000;;34057000;190918000;286633000;-2157000;316741000;602941000;793859000
IPXL;625184;USD;2010;Q4;2010-12-31;2011-05-05;62831902;67385704;348401000;82054000;44549000;520694000;106280000;;66344000;172624000;693318000;108140000;;126416000;;58753000;185169000;256087000;-2157000;251246000;508149000;693318000
TOWR;625334;USD;2017;Q4;2017-12-31;2018-02-28;20538565;20901759;123688000;239319000;78745000;564483000;535272000;;160342000;695614000;1260097000;437220000;42048000;496604000;344738000;493621000;990225000;344376000;-36408000;29712000;269872000;1260097000
TOWR;625334;USD;2016;Q4;2016-12-31;2017-02-28;20336114;20772852;62788000;178251000;71710000;518024000;465569000;;178930000;644499000;1162523000;372208000;34211000;459729000;356095000;488855000;948584000;340844000;-35645000;-14021000;213939000;1162523000
TOWR;625334;USD;2015;Q4;2015-12-31;2016-02-29;21111106;21446499;121594000;223735000;66648000;593883000;427887000;;193727000;621614000;1215497000;368537000;29492000;442186000;415100000;566592000;1008778000;338084000;-16067000;-44030000;206719000;1215497000
TOWR;625334;USD;2014;Q4;2014-12-31;2015-02-27;20751635;21469601;148561000;230377000;69775000;631994000;451126000;7752000;74301000;533179000;1165173000;361844000;31139000;460690000;453043000;604705000;1065395000;335552000;-9516000;-235971000;99778000;1165173000
TOWR;625334;USD;2013;Q4;2013-12-31;2014-03-07;20474821;19486484;134880000;255674000;81278000;525377000;549605000;8624000;99387000;657616000;1182993000;391592000;39704000;431296000;464086000;614828000;1046124000;328209000;-8594000;-257487000;136869000;1182993000
TOWR;625334;USD;2012;Q4;2012-12-31;2013-03-07;20250784;19087488;113943000;266138000;81336000;568213000;573148000;;96761000;669909000;1238122000;399561000;74605000;474166000;422373000;623082000;1097248000;321240000;-8297000;-237212000;140874000;1238122000
TOWR;625334;USD;2011;Q4;2011-12-31;2012-03-08;19691605;18903110;134984000;327992000;85100000;621258000;667686000;;108434000;776120000;1397378000;521703000;109447000;631150000;474051000;668768000;1299918000;311627000;-5130000;-255244000;97460000;1397378000
TOWR;625334;USD;2010;Q4;2010-12-31;2011-08-04;18058438;18058438;150345000;297086000;73189000;598958000;627497000;;113721000;741218000;1340176000;499375000;109848000;609223000;448330000;619327000;1228550000;296453000;0;-192556000;111626000;1340176000
TOWR;625334;USD;2018;Q4;2018-12-31;2019-02-27;20607433;21010375;68066000;113128000;69434000;709793000;347803000;;112796000;460599000;1170392000;273066000;4148000;445096000;294457000;424382000;869478000;348040000;-36882000;64676000;300914000;1170392000
ENVA;625336;USD;2018;Q4;2018-12-31;2019-02-27;34151000;35096000;52917000;;;52917000;49553000;;1225715000;1275268000;1328185000;89317000;;89317000;857929000;891100000;980417000;48175000;-23017000;336415000;347768000;1328185000
ENVA;625336;USD;2017;Q4;2017-12-31;2018-02-26;33497000;34697000;68684000;;;68684000;48525000;;1042251000;1090776000;1159460000;77123000;;77123000;788542000;800650000;877773000;29781000;-5703000;264695000;281687000;1159460000
ENVA;625336;USD;2016;Q4;2016-12-31;2017-02-24;33240000;33768000;39934000;;;39934000;47100000;;890845000;937945000;977879000;71671000;;71671000;649911000;664509000;736180000;18446000;-624000;235455000;241699000;977879000
ENVA;625336;USD;2015;Q4;2015-12-31;2016-03-07;33024000;33059000;42066000;;;42066000;48055000;;750416000;798471000;840537000;72141000;;72141000;541909000;562428000;634569000;9924000;-187000;200853000;205968000;840537000
ENVA;625336;USD;2014;Q4;2014-12-31;2015-03-20;33000000;33032000;75106000;;;75106000;33985000;;651106000;685091000;760197000;57277000;;57277000;494181000;548936000;606213000;294000;;156861000;153984000;760197000
ENVA;625336;USD;2013;Q4;2013-12-31;2014-12-15;33000000;33000000;47480000;;;47480000;39405000;;605267000;644672000;692152000;49576000;;49627000;424133000;469477000;519104000;0;;169947000;173048000;692152000
AVIR;625536;USD;2016;Q4;2016-06-30;2019-08-26;38640381;38640381;69000000;700000;;72400000;300000;;;300000;72700000;7500000;400000;9200000;500000;17300000;26500000;161500000;;-134300000;46200000;72700000
FRGI;625539;USD;2017;Q4;2017-12-31;2018-02-26;26851198;26851198;3599000;9830000;2880000;41048000;234561000;;147704000;382265000;423313000;37929000;98000;59844000;76425000;131953000;191797000;167091000;;64425000;231516000;423313000
FRGI;625539;USD;2016;Q4;2016-12-31;2017-02-27;26752692;26768207;4196000;8771000;2865000;26942000;270920000;;143703000;414623000;441565000;35364000;89000;46769000;71423000;130621000;177390000;163471000;;100704000;264175000;441565000
FRGI;625539;USD;2015;Q4;2015-12-31;2016-02-24;26576337;26582949;5281000;9217000;2910000;31238000;248992000;;135415000;384407000;415645000;34140000;69000;46305000;74275000;125358000;171663000;159990000;;83992000;243982000;415645000
FRGI;625539;USD;2014;Q4;2014-12-31;2015-02-19;26357891;26363445;5087000;6340000;2719000;25180000;191371000;;141405000;332776000;357956000;31052000;61000;39423000;68924000;118946000;158369000;154131000;;45456000;199587000;357956000
FRGI;625539;USD;2013;Q4;2013-12-31;2014-02-25;24322024;24322024;10978000;6011000;2564000;32925000;144527000;;141333000;285860000;318785000;29721000;61000;38087000;73981000;122392000;160479000;149026000;;9280000;158306000;318785000
FRGI;625539;USD;2012;Q4;2012-12-31;2013-03-01;22748262;22748262;15533000;5935000;2750000;30957000;126516000;;146256000;272772000;303729000;35257000;60000;41278000;203918000;251947000;293225000;10481000;;23000;10504000;303729000
FRGI;625539;USD;2011;Q4;2011-12-31;2012-05-10;23161822;23161822;13670000;4842000;2264000;27609000;195122000;;147435000;342557000;370166000;30018000;59000;36673000;323968000;338165000;374838000;3572000;;-8244000;-4672000;370166000
FRGI;625539;USD;2018;Q4;2018-12-31;2019-02-26;26817712;26817713;5258000;8505000;2842000;44399000;231328000;;142932000;374260000;418659000;32367000;108000;46561000;79636000;132039000;178600000;170560000;-2769000;72268000;240059000;418659000
BGCP;625540;USD;2017;Q4;2017-12-31;2018-02-22;452450575;719965000;634333000;;;3317390000;189347000;349964000;1600429000;2139740000;5457130000;2051636000;6046000;2620465000;1650509000;1650509000;4270974000;1807254000;-303873000;-859009000;1186156000;5457130000
BGCP;625540;USD;2016;Q4;2016-12-31;2017-02-28;435266270;670253205;535613000;;;3275123000;167239000;198259000;1406965000;1772463000;5047586000;2137733000;;2395702000;965767000;965767000;3361469000;1708360000;-288743000;-212858000;1686117000;5047586000
BGCP;625540;USD;2015;Q4;2015-12-31;2016-02-29;395910775;71536220;462134000;;;1819581000;147505000;680159000;1335392000;2163056000;3982637000;2575668000;;2693558000;;0;2693558000;1162002000;-212331000;-290208000;1289079000;3982637000
BGCP;625540;USD;2014;Q4;2014-12-31;2015-03-02;343689210;-150960955;648277000;;;1828115000;112020000;162111000;648881000;923012000;2751127000;2109704000;;2109704000;;0;2109704000;867091000;-200958000;-268920000;641423000;2751127000
BGCP;625540;USD;2013;Q4;2013-12-31;2014-02-28;343062545;16032050;716919000;;;1532540000;127615000;62705000;356503000;546823000;2079363000;1307667000;;1309698000;;0;1309698000;760104000;-121753000;-167923000;769665000;2079363000
BGCP;625540;USD;2012;Q4;2012-12-31;2013-03-12;243122695;680478885;388409000;;;1185544000;141109000;25556000;286730000;453395000;1638939000;1132688000;;1132688000;;0;1132688000;596016000;-110090000;-147452000;506251000;1638939000
BGCP;625540;USD;2011;Q4;2011-12-31;2012-03-15;202583845;-216763890;369713000;;;1001721000;136068000;20367000;247029000;403464000;1405185000;890618000;13600000;904218000;;0;904218000;511002000;-109870000;-80726000;500967000;1405185000
BGCP;625540;USD;2010;Q4;2010-12-31;2011-08-08;156307045;376103185;364104000;;;1142018000;133428000;29707000;165161000;328296000;1470314000;1045272000;;1045272000;;;1045272000;371137000;-109627000;-23616000;425042000;1470314000
TRGP;625570;USD;2017;Q4;2017-12-31;2018-02-16;216500000;215200000;137200000;827600000;204500000;1269900000;10430000000;221600000;2467100000;13118700000;14388600000;1186900000;350000000;1616600000;4703000000;5799500000;7416100000;6303000000;-35600000;-77200000;6972500000;14388600000
TRGP;625570;USD;2016;Q4;2016-12-31;2017-02-21;181400000;181400000;73500000;674600000;137700000;1006800000;9691000000;240800000;1932600000;11864400000;12871200000;843500000;275000000;1167600000;4606000000;5788400000;6956000000;5506400000;-32200000;-187300000;5915200000;12871200000
TRGP;625570;USD;2015;Q4;2015-12-31;2016-02-29;56300000;56300000;140200000;515800000;141000000;920000000;9702700000;258900000;2329400000;12291000000;13211000000;650400000;;874900000;5718800000;6085900000;6960800000;1457500000;-28700000;26900000;6250200000;13211000000
TRGP;625570;USD;2014;Q4;2014-12-31;2015-02-17;42000000;42100000;81000000;567300000;168900000;882500000;4824600000;50200000;696100000;5570900000;6453400000;638500000;;826500000;2885400000;3087400000;3913900000;164900000;-25400000;25500000;2539500000;6453400000
TRGP;625570;USD;2013;Q4;2013-12-31;2014-02-14;41600000;42200000;66700000;658800000;150700000;897200000;4349900000;55900000;745600000;5151400000;6048600000;761800000;;770400000;2989300000;3186900000;3957300000;151600000;-22800000;20500000;2091300000;6048600000
TRGP;625570;USD;2012;Q4;2012-12-31;2013-02-19;41000000;41600000;76300000;514900000;99400000;733300000;3538000000;53100000;780600000;4371700000;5105000000;679000000;;686600000;2475300000;2665000000;3351600000;184400000;-9500000;-32000000;1753400000;5105000000
TRGP;625570;USD;2011;Q4;2011-12-31;2012-03-20;41000000;41400000;145800000;575700000;92200000;866500000;2819500000;36800000;108200000;2964500000;3831000000;700000000;;741100000;1567000000;1759200000;2500300000;229500000;0;-70100000;1330700000;3831000000
TRGP;625570;USD;2010;Q4;2010-12-31;2011-08-19;13100000;13100000;188400000;466600000;50400000;750500000;2509000000;15200000;119100000;2643300000;3393800000;590000000;;624200000;1534700000;1733500000;2357700000;244500000;;-100800000;1036100000;3393800000
TRGP;625570;USD;2018;Q4;2018-12-31;2019-03-01;230500000;228800000;232100000;865500000;164700000;1418900000;12928400000;490500000;2100400000;15519300000;16938200000;1737300000;1027900000;2798800000;5632400000;6422900000;9221700000;6155100000;-39600000;-130400000;7716500000;16938200000
HCHC;625571;USD;2018;Q4;2018-12-31;2019-03-12;44413000;51199000;3917100000;379200000;;5747700000;376300000;;379800000;756100000;6503800000;344900000;;5427100000;743900000;854700000;6281800000;260500000;-2600000;-57200000;222000000;6503800000
HCHC;625571;USD;2017;Q4;2017-12-31;2018-03-14;43644000;43644000;1486000000;322400000;;2608900000;374700000;;234100000;608800000;3217700000;347500000;;2338400000;593200000;663300000;3001700000;254700000;-2100000;-221200000;216000000;3217700000
HCHC;625571;USD;2016;Q4;2016-12-31;2017-03-09;41633000;41508000;1445848000;267598000;;2375918000;286458000;;172900000;459358000;2835276000;251733000;;2214485000;428496000;521367000;2735852000;241527000;-1387000;-174278000;99424000;2835276000
HCHC;625571;USD;2015;Q4;2015-12-31;2016-03-15;30676000;30676000;1440147000;210853000;12120000;2401662000;214466000;;126384000;340850000;2742512000;225389000;;2154422000;371876000;414825000;2569247000;209512000;-378000;-79729000;173265000;2742512000
HCHC;625571;USD;2014;Q4;2014-12-31;2015-03-16;24008000;24008000;113095000;152279000;14975000;416223000;233022000;;62918000;295940000;712163000;147602000;;189561000;335531000;374358000;563919000;141972000;-378000;-44164000;148244000;712163000
JCOM;625587;USD;2017;Q4;2017-12-31;2018-03-01;47724800;48440680;350945000;234195000;;620427000;79773000;57722000;1695171000;1832666000;2453093000;169837000;;265102000;1001944000;1167686000;1432788000;326333000;;723062000;1020305000;2453093000
JCOM;625587;USD;2016;Q4;2016-12-31;2017-03-01;47340916;47854764;123950000;199871000;;347999000;68094000;0;1646235000;1714329000;2062328000;194824000;;454089000;601746000;693703000;1147792000;308803000;;660382000;914536000;2062328000
JCOM;625587;USD;2015;Q4;2015-12-31;2016-02-29;47855195;48777507;335185000;114680000;;482805000;57442000;78563000;1164909000;1300914000;1783719000;119973000;;196654000;592185000;696857000;893511000;292543000;;626789000;890208000;1783719000
JCOM;625587;USD;2014;Q4;2014-12-31;2015-03-02;47155829;47428741;529869000;91699000;;646183000;38217000;60508000;960294000;1059019000;1705202000;95310000;;159367000;593491000;725600000;884967000;273778000;;553584000;820235000;1705202000
JCOM;625587;USD;2013;Q4;2013-12-31;2014-03-03;45877527;46582033;298590000;67245000;;389025000;31200000;47351000;686213000;764764000;1153789000;71139000;;114892000;245670000;332479000;447371000;217333000;;484850000;706418000;1153789000
JCOM;625587;USD;2012;Q4;2012-12-31;2013-03-01;45061912;45422354;323734000;37285000;;377499000;19599000;19841000;578231000;617671000;995170000;42911000;;78927000;245194000;321648000;400575000;169993000;;424790000;594595000;995170000
JCOM;625587;USD;2011;Q4;2011-12-31;2012-02-28;46712065;45801473;177872000;19071000;;212897000;14438000;43077000;380759000;438274000;651171000;25580000;;57798000;0;38998000;96796000;197928000;-112671000;472595000;554375000;651171000
JCOM;625587;USD;2010;Q4;2010-12-31;2011-02-28;44851581;46598847;78787000;17423000;;115502000;13567000;8175000;395379000;417121000;532623000;26910000;;57892000;;42986000;100878000;165306000;-112671000;381145000;431745000;532623000
JCOM;625587;USD;2009;Q4;2009-12-31;2010-08-05;44223852;45596524;228792000;11928000;;256453000;13366000;14887000;129295000;157548000;414001000;17504000;;28915000;;48914000;77829000;148148000;-112671000;301670000;336172000;414001000
JCOM;625587;USD;2018;Q4;2018-12-31;2019-03-01;47968698;48506709;209474000;221615000;;460331000;98813000;83828000;1917858000;2100499000;2560830000;179436000;;366966000;1013129000;1158120000;1525086000;354691000;-42543000;769575000;1035744000;2560830000
TVPT;625611;USD;2017;Q4;2017-12-31;2018-02-20;125212235;126572331;122039000;206524000;;438287000;431741000;;1988471000;2420212000;2858499000;582346000;64291000;646637000;2165722000;2404183000;3050820000;2700450000;-24755000;-2722375000;-192321000;2858499000
TVPT;625611;USD;2016;Q4;2016-12-31;2017-02-21;124021876;129690816;139938000;218224000;;442251000;431046000;;1960632000;2391678000;2833929000;537779000;63558000;601337000;2281210000;2568374000;3169711000;2709148000;-14166000;-2864838000;-335782000;2833929000
TVPT;625611;USD;2015;Q4;2015-12-31;2016-02-18;123185730;123304290;154841000;205686000;;465141000;459848000;;1980440000;2440288000;2905429000;504927000;74163000;579090000;2363035000;2649197000;3228287000;2715849000;-13331000;-2881658000;-322858000;2905429000
TVPT;625611;USD;2014;Q4;2014-12-31;2015-02-27;122152854;126262049;139000000;184000000;;412000000;414000000;;2066000000;2480000000;2892000000;499000000;56000000;555000000;2384000000;2675000000;3230000000;2715000000;;-2898000000;-338000000;2892000000
TVPT;625611;USD;2013;Q4;2013-12-31;2014-11-06;60990236;60990236;154000000;177000000;;466000000;428000000;;2194000000;2622000000;3088000000;612000000;45000000;681000000;3528000000;3718000000;4399000000;1736000000;;-2984000000;-1311000000;3088000000
TVPT;625611;USD;2018;Q4;2018-12-31;2019-02-22;126433803;130194253;213001000;209834000;;536440000;495699000;;1896918000;2392617000;2929057000;572202000;57497000;629699000;2194537000;2451716000;3081415000;2680935000;-27623000;-2648761000;-152358000;2929057000
WIN;625612;USD;2017;Q4;2017-12-31;2018-02-28;178700000;;43400000;643000000;93000000;932500000;5391800000;;4760000000;10151800000;11084300000;546600000;357900000;1543400000;10317900000;10839800000;12383200000;1191900000;;-2512200000;-1298900000;11084300000
WIN;625612;USD;2016;Q4;2016-12-31;2017-03-01;97800000;;59100000;618600000;77500000;866900000;5283500000;;5619600000;10903100000;11770000000;448300000;183600000;1254600000;9680600000;10345400000;11600000000;559700000;;-395600000;170000000;11770000000
WIN;625612;USD;2015;Q4;2015-12-31;2016-02-25;96000000;;31300000;643900000;79500000;875300000;5279800000;549200000;5813800000;11642800000;12518100000;508500000;158600000;1267100000;10165000000;10944600000;12211700000;602900000;;-12100000;306400000;12518100000
WIN;625612;USD;2014;Q4;2014-12-31;2015-02-24;99800000;2089200000;27800000;635500000;63700000;898300000;5412300000;0;6209700000;11622000000;12520300000;658200000;717500000;2043000000;7927500000;10252500000;12295500000;252200000;;-39500000;224800000;12520300000
WIN;625612;USD;2013;Q4;2013-12-31;2014-02-27;-1371900000;593200000;48200000;635300000;67700000;943300000;5702600000;;6798700000;12501300000;13444600000;640500000;85000000;1445600000;8622200000;11158800000;12604400000;811700000;;0;840200000;13444600000
WIN;625612;USD;2012;Q4;2012-12-31;2013-02-20;584900000;589900000;132000000;609000000;75000000;1061100000;5861800000;;7059100000;12920900000;13982000000;626200000;866000000;2167900000;8099800000;10709300000;12877200000;1098400000;;0;1104800000;13982000000
WIN;625612;USD;2011;Q4;2011-12-31;2012-02-22;534900000;;227000000;657400000;76500000;1286300000;5709200000;;7396600000;13105800000;14392100000;605800000;213700000;1463000000;8936700000;11433800000;12896800000;1493400000;;0;1495300000;14392100000
WIN;625612;USD;2010;Q4;2010-12-31;2011-02-22;485500000;;42300000;373900000;52500000;642900000;4764200000;;5896800000;10661000000;11303900000;451700000;139200000;990000000;7186600000;9482900000;10472900000;855100000;;0;831000000;11303900000
WIN;625612;USD;2009;Q4;2009-12-31;2010-02-24;;;1062900000;291700000;26100000;1434300000;3992600000;;3718500000;7711100000;9145400000;385900000;23800000;709300000;6271400000;8175400000;8884700000;83600000;;385400000;260700000;9145400000
WIN;625612;USD;2008;Q4;2008-12-31;2009-08-06;;;296600000;316600000;30800000;677900000;3897100000;;3434300000;7331400000;8009300000;382300000;24300000;665300000;5358200000;7091700000;7757000000;101500000;;487400000;252300000;8009300000
WIN;625612;USD;2018;Q4;2018-12-31;2019-03-15;-107000000;;355700000;653100000;82400000;1256200000;4920900000;;4080800000;9001700000;10257900000;547100000;10298400000;11457700000;72800000;719500000;12177200000;1250400000;;-3205300000;-1919300000;10257900000
POST;625659;USD;2018;Q4;2018-09-30;2018-11-16;66600000;75300000;989700000;462300000;484200000;2200300000;1709700000;;9147500000;10857200000;13057500000;365100000;22100000;792100000;7232100000;9204900000;9997000000;3591700000;-589900000;88000000;3060500000;13057500000
POST;625659;USD;2017;Q4;2017-09-30;2017-11-17;66000000;63600000;1525900000;480600000;573500000;2615900000;1690700000;;7570200000;9260900000;11876800000;336000000;22100000;704400000;7149100000;8382700000;9087100000;3567200000;-371200000;-376000000;2789700000;11876800000
POST;625659;USD;2016;Q4;2016-09-30;2016-11-18;64600000;66700000;1143600000;385000000;503100000;2076900000;1354400000;;5929300000;7283700000;9360600000;264400000;12300000;634000000;4551200000;5718000000;6352000000;3546700000;-53400000;-424300000;3008600000;9360600000
POST;625659;USD;2015;Q4;2015-09-30;2015-11-25;58700000;48600000;841400000;366200000;465300000;1772800000;1333200000;;6057900000;7391100000;9163900000;265200000;16000000;611000000;4454900000;5576900000;6187900000;3539400000;-53400000;-421000000;2976000000;9163900000
POST;625659;USD;2014;Q4;2014-09-30;2014-11-28;43100000;49900000;268400000;413700000;380700000;1219000000;831900000;;5680200000;6512100000;7731100000;225000000;25600000;519900000;3830500000;4928000000;5447900000;2669800000;-53400000;-305700000;2283200000;7731100000
POST;625659;USD;2013;Q4;2013-09-30;2013-11-27;32800000;33200000;402000000;83200000;121900000;668100000;388500000;;2417200000;2805700000;3473800000;77100000;0;146000000;1408600000;1829200000;1975200000;1517500000;-53400000;47600000;1498600000;3473800000
POST;625659;USD;2012;Q4;2012-09-30;2012-12-13;34200000;34600000;58200000;56500000;78600000;209700000;405100000;0;2117500000;2522600000;2732300000;50000000;15300000;126400000;930300000;1374400000;1500800000;1272900000;-53400000;36600000;1231500000;2732300000
POST;625659;USD;2011;Q4;2011-09-30;2012-03-08;34700000;34400000;1700000;17900000;66600000;135300000;412100000;60200000;2115600000;2587900000;2723200000;28800000;68000000;134300000;716500000;1154200000;1288500000;0;0;0;1434700000;2723200000
TAST;625660;USD;2017;Q4;2017-12-31;2018-03-12;35434679;54642373;29412000;9420000;9373000;60015000;274098000;;247401000;521499000;581514000;64821000;1808000;79529000;292826000;332925000;412454000;145004000;-141000;25407000;169060000;581514000
TAST;625660;USD;2016;Q4;2016-12-31;2017-03-07;35257043;44850187;2002000;7623000;7761000;29669000;247847000;;212639000;460486000;490155000;56352000;1616000;68900000;229732000;266599000;335499000;141486000;-141000;14514000;154656000;490155000
TAST;625660;USD;2015;Q4;2015-12-31;2016-03-09;35044411;64033169;22274000;6161000;7126000;44995000;220114000;;162147000;382261000;427256000;55807000;1435000;71254000;215239000;248003000;319257000;139433000;-141000;-30958000;107999000;427256000
TAST;625660;USD;2014;Q4;2014-12-31;2015-03-04;34825563;34825563;21221000;4034000;7785000;41629000;179383000;;143561000;322944000;364573000;43638000;1272000;55183000;168469000;202855000;258038000;137995000;-141000;-30962000;106535000;364573000
TAST;625660;USD;2013;Q4;2013-12-31;2014-03-03;23047337;23047337;8302000;2846000;6494000;25479000;152175000;;151827000;304002000;329481000;39793000;1147000;50649000;167564000;201628000;252277000;69488000;-141000;7155000;77204000;329481000
TAST;625660;USD;2012;Q4;2012-12-31;2013-03-12;22976108;22976108;38290000;6418000;7729000;57826000;135926000;;152504000;288430000;346256000;41477000;1062000;52790000;169475000;203293000;256083000;68283000;-141000;21362000;90173000;346256000
TAST;625660;USD;2011;Q4;2011-12-31;2012-03-08;21714696;20250542;24661000;6673000;5601000;48773000;190310000;;219309000;409619000;458392000;48545000;6553000;63877000;272030000;335358000;399235000;7172000;-141000;51041000;59157000;458392000
TAST;625660;USD;2010;Q4;2010-12-31;2011-08-12;21626328;21882580;3144000;5213000;5203000;23796000;186850000;;215656000;402506000;426302000;45079000;15538000;68051000;247975000;313344000;381395000;3690000;-141000;39823000;44907000;426302000
TAST;625660;USD;2018;Q4;2018-12-31;2019-03-07;35739754;55002251;4014000;11693000;10396000;34678000;289817000;;275756000;565573000;600251000;67590000;1948000;82139000;278019000;332572000;414711000;150816000;-141000;35511000;185540000;600251000
LDOS_old;625661;USD;2015;Q4;2016-01-31;2016-02-26;74000000;74000000;656000000;921000000;;1793000000;142000000;;1435000000;1577000000;3370000000;1037000000;2000000;1040000000;1079000000;1262000000;2302000000;1353000000;;-277000000;1068000000;3370000000
LDOS_old;625661;USD;2014;Q4;2015-01-31;2015-03-25;72000000;70000000;443000000;896000000;;1618000000;308000000;;1355000000;1663000000;3281000000;939000000;2000000;951000000;1164000000;1332000000;2283000000;1433000000;;-424000000;998000000;3281000000
LDOS_old;625661;USD;2013;Q4;2014-01-31;2014-03-27;80000000;80000000;430000000;1082000000;;1807000000;482000000;;1873000000;2355000000;4162000000;1001000000;2000000;1009000000;1331000000;1558000000;2567000000;1576000000;;25000000;1595000000;4162000000
LDOS_old;625661;USD;2012;Q4;2013-01-31;2013-03-27;-19515000;-19515000;735000000;1166000000;;3617000000;286000000;;1972000000;2258000000;5875000000;1135000000;0;1792000000;1295000000;1465000000;3257000000;2110000000;;510000000;2618000000;5875000000
LDOS_old;625661;USD;2011;Q4;2012-01-31;2012-03-27;-74670000;-75480000;1592000000;2164000000;;4231000000;348000000;;2088000000;2436000000;6667000000;2465000000;553000000;3025000000;1299000000;1461000000;4486000000;2028000000;;164000000;2181000000;6667000000
LDOS_old;625661;USD;2010;Q4;2011-01-31;2011-12-08;144990000;145800000;1367000000;2069000000;;3867000000;359000000;;1997000000;2356000000;6223000000;1716000000;3000000;1748000000;1849000000;1984000000;3732000000;2090000000;;408000000;2491000000;6223000000
HGR;626019;USD;2016;Q4;2016-12-31;2018-01-19;143625189;143625189;7157000;144562000;68225000;252281000;100467000;;402356000;502823000;755104000;166323000;30944000;197267000;441706000;492423000;689690000;322553000;-696000;-255003000;65414000;755104000
HGR;626019;USD;2015;Q4;2015-12-31;2018-01-19;142434955;142434813;58753000;174592000;68478000;357628000;113274000;;502182000;615456000;973084000;187419000;30385000;217804000;536048000;590034000;807838000;315888000;-696000;-148532000;165246000;973084000
HGR;626019;USD;2014;Q4;2014-12-31;2017-05-12;35414209;35231883;11699000;174248000;70517000;286035000;112350000;;903920000;1016270000;1302305000;183986000;26852000;210838000;502132000;607931000;818769000;307521000;-656000;178559000;483536000;1302305000
HGR;626019;USD;2013;Q4;2013-12-31;2014-04-04;34932829;35262977;1613000;154739000;82257000;260215000;116289000;;838484000;954773000;1214988000;129577000;17728000;147305000;469818000;576370000;723675000;295464000;-656000;197525000;491313000;1214988000
HGR;626019;USD;2012;Q4;2012-12-31;2013-03-19;34426247;34587180;19211000;165668000;127295000;330967000;114461000;;791899000;906360000;1237327000;96105000;11082000;107187000;509564000;627046000;734233000;280440000;-656000;225229000;503094000;1237327000
HGR;626019;USD;2011;Q4;2011-12-31;2012-02-29;33747177;34034347;42896000;138826000;112305000;311042000;104772000;;710905000;815677000;1126719000;82977000;8065000;91042000;499968000;607095000;698137000;268886000;-656000;161537000;428582000;1126719000
HGR;626019;USD;2010;Q4;2010-12-31;2011-08-02;32662352;33199783;36308000;118622000;98290000;271034000;103304000;;687141000;790445000;1061479000;95687000;7006000;102693000;501678000;594359000;697052000;257763000;-656000;107599000;364427000;1061479000
HGR;626019;USD;2017;Q4;2017-12-31;2018-05-14;144974968;144974711;1508000;146346000;69138000;250959000;93615000;;295849000;389464000;640423000;167957000;4336000;172293000;445928000;496181000;668474000;334103000;-696000;-359772000;-28051000;640423000
HGR;626019;USD;2018;Q4;2018-12-31;2019-03-14;36912440;35598768;95114000;143986000;67690000;325900000;89489000;;287621000;377110000;703010000;162691000;8583000;171274000;502090000;553660000;724934000;344326000;-696000;-361023000;-21924000;703010000
TTMI;626042;USD;2017;Q4;2017-12-31;2018-02-23;101818000;134162000;409326000;483903000;294588000;1221307000;1056845000;;503730000;1560575000;2781882000;715778000;4578000;720356000;975479000;1087654000;1808010000;777127000;;193342000;973872000;2781882000
TTMI;626042;USD;2016;Q4;2016-12-31;2017-02-24;100385000;51737000;256277000;432788000;269212000;1012841000;966638000;;520597000;1487235000;2500076000;578413000;110652000;689065000;909030000;1013735000;1702800000;758540000;;74787000;797276000;2500076000
TTMI;626042;USD;2015;Q4;2015-12-31;2016-02-25;99135000;98273000;259100000;456000000;268923000;1022520000;1103067000;;514546000;1617613000;2640133000;587619000;157375000;744994000;1013411000;1094282000;1839276000;745707000;;45963000;800857000;2640133000
TTMI;626042;USD;2014;Q4;2014-12-31;2015-02-27;83346000;85464000;279042000;312867000;145187000;798123000;754718000;;48448000;803166000;1601289000;367967000;128045000;496012000;374642000;411049000;907061000;586792000;;76421000;694228000;1601289000
TTMI;626042;USD;2013;Q4;2013-12-31;2014-02-21;82649000;84081000;330554000;290382000;138145000;804991000;810672000;;57912000;868584000;1673575000;361799000;96204000;458003000;477539000;528969000;986972000;576727000;;64272000;686603000;1673575000
TTMI;626042;USD;2012;Q4;2012-12-31;2013-03-01;81963000;80776000;285433000;301557000;146012000;765612000;833678000;;77672000;911350000;1676962000;339876000;30004000;369880000;527541000;569418000;939298000;546111000;;45921000;737664000;1676962000
TTMI;626042;USD;2011;Q4;2011-12-31;2012-02-29;81367000;82229000;199618000;316568000;129430000;671534000;766800000;;310735000;1077535000;1749069000;316258000;120882000;437140000;368518000;396280000;833420000;535639000;;228661000;915649000;1749069000
TTMI;626042;USD;2010;Q4;2010-12-31;2011-08-08;;;216078000;287703000;135385000;676499000;740630000;;344823000;1085453000;1761952000;351077000;67123000;418200000;458278000;510894000;929094000;519131000;;193814000;832858000;1761952000
TTMI;626042;USD;2018;Q4;2018-12-31;2019-02-26;103683000;157471000;256360000;523165000;109377000;1206914000;1052024000;;1198565000;2250589000;3457503000;526238000;30000000;673214000;1462425000;1557202000;2230416000;797999000;;433008000;1227087000;3457503000
IDA;627772;USD;2017;Q4;2017-12-31;2018-02-22;50363000;50471000;76649000;75249000;55745000;443601000;4283875000;120005000;1197924000;5601804000;6045405000;170749000;0;200749000;1746123000;3588542000;3789291000;857207000;-1386000;1426528000;2256114000;6045405000
IDA;627772;USD;2016;Q4;2016-12-31;2017-02-23;50295000;50407000;61480000;71557000;57858000;440312000;4171999000;148646000;1528940000;5849585000;6289897000;185706000;22864000;249715000;1744614000;3882316000;4132031000;851833000;-243000;1323198000;2157866000;6289897000
IDA;627772;USD;2015;Q4;2015-12-31;2016-02-18;50219000;50326000;114802000;73505000;56924000;462036000;3992413000;163281000;1405584000;5561278000;6023314000;171541000;21064000;242306000;1725410000;3718964000;3961270000;849112000;-57000;1230105000;2062044000;6023314000
IDA;627772;USD;2014;Q4;2014-12-31;2015-02-19;50131000;50245000;56808000;79083000;55404000;442101000;3833477000;171741000;1253718000;5258936000;5701037000;166095000;32364000;241781000;1598622000;3501691000;3743472000;845402000;-280000;1132237000;1957565000;5701037000
IDA;627772;USD;2013;Q4;2013-12-31;2014-02-20;50057000;50179000;78162000;97873000;53643000;476611000;3665041000;163883000;1059028000;4887952000;5364563000;166095000;55814000;250372000;1615258000;3259451000;3509823000;839750000;-8000;1027461000;1854740000;5364563000
IDA;627772;USD;2012;Q4;2012-12-31;2013-02-21;49967000;50071000;26527000;66111000;51037000;367253000;3536031000;165231000;1222775000;4924037000;5291290000;166527000;140764000;351303000;1466632000;3194008000;3545311000;834922000;-21000;923981000;1745979000;5291290000
IDA;627772;USD;2011;Q4;2011-12-31;2012-02-22;49598000;49738000;27813000;66296000;46490000;310972000;3406590000;205552000;1037495000;4649637000;4960609000;143797000;155264000;368247000;1387550000;2930668000;3298915000;828389000;-29000;840916000;1661694000;4960609000
IDA;627772;USD;2010;Q4;2010-12-31;2011-02-23;49025000;49175000;228677000;62114000;45601000;464038000;3161382000;206909000;843726000;4212017000;4676055000;127037000;189472000;449059000;1488287000;2691012000;3140071000;807842000;-40000;733879000;1535984000;4676055000
IDA;627772;USD;2009;Q4;2009-12-31;2010-08-05;47637000;47731000;52987000;74987000;48054000;310406000;2917008000;199515000;811798000;3928321000;4238727000;107376000;63090000;218229000;1409730000;2618954000;2837183000;756475000;-53000;649180000;1401544000;4238727000
IDA;627772;USD;2018;Q4;2018-12-31;2019-02-21;50434000;50531000;267492000;77178000;54987000;597640000;4395735000;101178000;1288201000;5785114000;6382754000;201576000;;258592000;1834788000;3748351000;4006943000;863593000;-1932000;1531543000;2375811000;6382754000
TROX;627774;USD;2017;Q4;2017-12-31;2018-03-01;122600000;117487000;1116000000;336000000;473000000;2639000000;2000000000;;225000000;2225000000;4864000000;331000000;17000000;348000000;3130000000;3501000000;3849000000;1558000000;;-327000000;1014000000;4863000000
TROX;627774;USD;2016;Q4;2016-12-31;2017-02-24;116321000;116321000;248000000;278000000;499000000;2738000000;1969000000;;257000000;2226000000;4964000000;287000000;166000000;564000000;2888000000;3247000000;3811000000;1524000000;;-19000000;1152000000;4963000000
TROX;627774;USD;2015;Q4;2015-12-31;2016-02-25;115679000;115679000;229000000;391000000;630000000;1301000000;3447000000;;279000000;3726000000;5027000000;382000000;166000000;548000000;2910000000;3369000000;3917000000;1500000000;;93000000;1109000000;5026000000
TROX;627774;USD;2014;Q4;2014-12-31;2015-02-26;115055000;115055000;1276000000;277000000;770000000;2381000000;2285000000;;399000000;2684000000;5065000000;339000000;18000000;366000000;2375000000;2911000000;3277000000;1476000000;;529000000;1787000000;5064000000
TROX;627774;USD;2013;Q4;2013-12-31;2014-02-27;113498000;113498000;1478000000;308000000;759000000;2653000000;2474000000;;572000000;3046000000;5699000000;338000000;18000000;363000000;2395000000;2899000000;3262000000;1448000000;;1073000000;2436000000;5698000000
TROX;627774;USD;2012;Q4;2012-12-31;2013-02-28;113670000;117072000;716000000;391000000;914000000;2173000000;2862000000;;476000000;3338000000;5511000000;422000000;40000000;467000000;1605000000;2162000000;2629000000;1429000000;;1314000000;2881000000;5510000000
TROX;627774;USD;2018;Q4;2018-12-31;2019-02-28;123013000;116179000;1034000000;317000000;479000000;2544000000;1800000000;;298000000;2098000000;4642000000;278000000;22000000;300000000;3139000000;3481000000;3781000000;1579000000;;-357000000;861000000;4642000000
GPRE;627777;USD;2017;Q4;2017-12-31;2018-02-14;37000000;71673000;266651000;151122000;711878000;1206471000;1176707000;;401472000;1578179000;2784650000;279274000;594103000;886261000;767396000;839253000;1725514000;685065000;-55184000;325411000;1059136000;2784650000
GPRE;627777;USD;2016;Q4;2016-12-31;2017-02-22;38368000;38423000;304211000;147495000;422181000;1000576000;1178706000;;327210000;1505916000;2506492000;259748000;326282000;594946000;782610000;932355000;1527301000;659246000;-75816000;283214000;979191000;2506492000
GPRE;627777;USD;2015;Q4;2015-12-31;2016-02-18;37892000;39678000;384867000;96150000;353957000;912577000;922070000;;83273000;1005343000;1917920000;198989000;231435000;438669000;432139000;520342000;959011000;577832000;-69811000;290974000;958909000;1917920000
GPRE;627777;USD;2014;Q4;2014-12-31;2015-02-10;37660000;39768000;425510000;138073000;254967000;903415000;825210000;;92437000;917647000;1821062000;238189000;273351000;511540000;399440000;512073000;1023613000;569476000;-65808000;299101000;797449000;1821062000
GPRE;627777;USD;2013;Q4;2013-12-31;2014-02-10;30435000;48719000;272027000;106808000;158328000;633305000;806046000;;92694000;898740000;1532045000;150646000;254433000;409197000;480746000;577490000;986687000;469000000;-65808000;148505000;545358000;1532045000
GPRE;627777;USD;2012;Q4;2012-12-31;2013-02-15;29677000;30345000;254289000;80537000;172009000;568035000;708110000;;73589000;781699000;1349734000;128039000;300728000;432384000;362549000;426848000;859232000;445235000;-65808000;107540000;490502000;1349734000
GPRE;627777;USD;2011;Q4;2011-12-31;2012-02-17;32866000;39364000;174988000;106198000;229070000;576420000;776789000;;67619000;844408000;1420828000;202153000;143359000;360965000;493407000;554506000;915471000;440505000;-28201000;95761000;505357000;1420828000
GPRE;627777;USD;2010;Q4;2010-12-31;2011-08-03;34821000;39148000;233205000;89170000;184888000;606686000;747421000;;43672000;791093000;1397779000;178854000;141068000;342503000;527900000;557634000;900137000;431325000;;57343000;497642000;1397779000
GPRE;627777;USD;2018;Q4;2018-12-31;2019-02-20;40693000;44429000;251683000;100361000;734883000;1206642000;886576000;;123214000;1009790000;2216432000;215874000;593050000;833700000;298190000;319743000;1153443000;696269000;-58162000;324728000;1062989000;2216432000
TRNC;627811;USD;2017;Q4;2017-12-31;2018-03-16;33611000;34597000;185351000;129480000;7412000;406705000;94490000;;363938000;458428000;865133000;65724000;21487000;260904000;331065000;535067000;795971000;150605000;-51526000;-16390000;69162000;865133000
TRNC;627811;USD;2016;Q4;2016-12-31;2017-03-08;36428000;36963000;198349000;195519000;10950000;423681000;67866000;;397219000;465085000;888766000;70148000;21617000;264887000;349128000;515998000;780885000;139988000;-1368000;-21925000;107881000;888766000
TRNC;627811;USD;2015;Q4;2015-12-31;2016-03-14;26234000;25815000;40832000;240813000;13688000;312157000;77450000;;443359000;520809000;832966000;80881000;21826000;313430000;367847000;533934000;847364000;19515000;-1368000;-28639000;-14398000;832966000
TRNC;627811;USD;2014;Q4;2014-12-31;2015-03-25;25438000;25894000;36675000;234812000;16651000;314731000;162345000;3370000;197257000;362972000;677703000;81567000;17911000;279488000;321822000;392046000;671534000;2624000;0;-6937000;6169000;677703000
TRNC;627811;USD;2018;Q4;2018-12-31;2019-03-18;35574000;35574000;97560000;145463000;9587000;270807000;144963000;;310857000;455820000;726627000;70555000;405000;159413000;6799000;154146000;313559000;167044000;-26160000;232401000;413068000;726627000
TRMB;627855;USD;2017;Q4;2018-01-31;2018-02-27;250800000;255900000;537400000;414800000;271800000;1317100000;174000000;;2807100000;2981100000;4298200000;307400000;128400000;809200000;785500000;1123000000;1932200000;1461300000;;1035900000;2366000000;4298200000
TRMB;627855;USD;2016;Q4;2017-01-31;2017-02-24;250800000;254700000;327200000;354800000;218800000;978700000;144200000;;2550900000;2695100000;3673800000;224500000;130300000;688200000;489600000;679900000;1368100000;1348600000;;1177100000;2305700000;3673800000
TRMB;627855;USD;2015;Q4;2016-01-31;2016-02-24;250600000;253000000;116000000;361900000;261100000;798400000;159200000;;2723100000;2882300000;3680700000;217200000;118300000;660900000;611400000;799200000;1460100000;1238300000;;1148200000;2220600000;3680700000
TRMB;627855;USD;2014;Q4;2015-01-31;2015-02-25;259200000;262800000;148000000;362000000;278100000;902300000;157400000;;2796200000;2953600000;3855900000;223300000;64400000;588300000;671000000;914200000;1502500000;1207300000;;1211000000;2353400000;3855900000
TRMB;627855;USD;2013;Q4;2014-01-31;2014-02-25;257996000;262831000;147227000;337932000;254311000;837017000;142975000;;2720848000;2863823000;3700840000;226169000;106402000;576990000;652056000;889868000;1466858000;1106017000;;1081695000;2233982000;3700840000
TRMB;627855;USD;2012;Q4;2013-01-31;2013-02-25;253314000;258232000;157771000;323477000;240529000;815973000;96890000;;2556241000;2653131000;3469104000;227662000;38092000;468670000;873066000;1086910000;1555580000;1006818000;;868026000;1913524000;3469104000
TRMB;627855;USD;2011;Q4;2012-01-31;2012-02-28;246890000;253180000;154621000;275201000;232063000;733057000;62724000;;1856694000;1919418000;2652475000;190294000;65918000;411323000;498518000;652250000;1063573000;878514000;;685639000;1588902000;2652475000
TRMB;627855;USD;2010;Q4;2011-01-31;2011-03-01;241040000;248790000;220788000;222820000;192852000;714370000;50692000;;1101830000;1152522000;1866892000;146193000;1993000;251815000;151160000;229378000;481193000;781779000;;536350000;1385699000;1866892000
TRMB;627855;USD;2009;Q4;2010-01-31;2010-08-10;240792000;246306000;273848000;202293000;144012000;690078000;44635000;;1018564000;1063199000;1753277000;111791000;445000;223245000;151038000;265477000;488722000;720248000;;491367000;1264555000;1753277000
TRMB;627855;USD;2018;Q4;2019-01-31;2019-02-22;251200000;254600000;172500000;512600000;298000000;1089100000;212900000;;4474400000;4687300000;5776400000;332100000;256200000;1055200000;1712300000;2046400000;3101600000;1592200000;;1268300000;2674800000;5776400000
CRZO;628031;USD;2017;Q4;2017-12-31;2018-02-28;81676000;83148000;9540000;107441000;;122878000;2635810000;;19616000;2655426000;2778304000;222372000;;372822000;1629209000;1820323000;2193145000;1926871000;;-1555974000;585159000;2778304000
CRZO;628031;USD;2016;Q4;2016-12-31;2017-02-27;63617000;63617000;4194000;64208000;;72988000;1545760000;;7579000;1553339000;1626327000;126618000;;211959000;1325418000;1390910000;1602869000;1666542000;;-1643084000;23458000;1626327000
CRZO;628031;USD;2015;Q4;2015-12-31;2016-02-22;56657000;56657000;42918000;54721000;;232182000;1716861000;;58203000;1775064000;2007246000;146859000;;285484000;1236017000;1277708000;1563192000;1411664000;;-967610000;444054000;2007246000
CRZO;628031;USD;2014;Q4;2014-12-31;2015-02-25;46015000;46755000;10838000;92946000;;278621000;2629253000;;73602000;2702855000;2981476000;234117000;;424304000;1351346000;1453731000;1878035000;915897000;;187544000;1103441000;2981476000
CRZO;628031;USD;2013;Q4;2013-12-31;2014-03-03;42882000;43550000;157439000;111195000;;275560000;1794215000;;40985000;1835200000;2110760000;161607000;;322835000;900247000;946321000;1269156000;880403000;;-38799000;841604000;2110760000
CRZO;628031;USD;2012;Q4;2012-12-31;2013-02-28;39689000;40511000;52095000;112821000;;208705000;1487674000;;187617000;1675291000;1883996000;151961000;;298918000;967808000;1000062000;1298980000;667498000;;-82482000;585016000;1883996000
CRZO;628031;USD;2011;Q4;2011-12-31;2012-03-19;39713000;40401000;26397000;21988000;;120397000;1240917000;2523000;163843000;1407283000;1527680000;148618000;;271320000;711486000;746505000;1017825000;647824000;;-137969000;509855000;1527680000
CRZO;628031;USD;2010;Q4;2010-12-31;2011-08-12;35541000;36048000;4128000;16027000;;60332000;983057000;3392000;97353000;1083802000;1144134000;82380000;160000;119004000;558094000;568494000;687498000;631234000;;-174598000;456636000;1144134000
CRZO;628031;USD;2018;Q4;2018-12-31;2019-03-01;91709000;93102000;2282000;99723000;;150369000;3018524000;;16207000;3034731000;3185100000;177192000;;322009000;1633591000;1707765000;2029774000;2132451000;;-1151547000;1155326000;3185100000
HUBB;628038;USD;2017;Q4;2017-12-31;2018-02-15;54600000;54800000;389500000;540300000;634700000;1604100000;458300000;57700000;1600500000;2116500000;3720600000;638000000;68100000;706100000;987100000;1366600000;2072700000;11600000;;1892400000;1647900000;3720600000
HUBB;628038;USD;2016;Q4;2016-12-31;2017-02-16;55100000;55200000;448800000;530000000;532400000;1551300000;439800000;56400000;1477500000;1973700000;3525000000;586400000;3200000;589600000;990500000;1332200000;1921800000;16000000;;1879300000;1603200000;3525000000
HUBB;628038;USD;2015;Q4;2015-12-31;2016-02-18;57400000;57800000;355700000;466600000;540000000;1387800000;419700000;49500000;1351700000;1820900000;3208700000;554900000;48200000;603100000;595900000;856600000;1459700000;78700000;;1886100000;1749000000;3208700000
HUBB;628038;USD;2014;Q4;2014-12-31;2015-02-19;58300000;58500000;661700000;469800000;441800000;1629400000;401200000;44100000;1245400000;1690700000;3320100000;497800000;1400000;499200000;594900000;885200000;1384400000;147300000;;1944100000;1935700000;3320100000
HUBB;628038;USD;2013;Q4;2013-12-31;2014-02-18;59100000;59700000;750800000;440900000;385700000;1632400000;377100000;35800000;1141900000;1554800000;3187200000;466700000;300000;467000000;597200000;805400000;1272400000;237200000;;1740200000;1914800000;3187200000
HUBB;628038;USD;2012;Q4;2012-12-31;2013-02-13;59000000;59900000;653800000;405200000;341700000;1456200000;364700000;36700000;1089400000;1490800000;2947000000;447400000;0;447400000;596700000;831700000;1279100000;64600000;;1715700000;1667900000;2947000000
HUBB;628038;USD;2011;Q4;2011-12-31;2012-02-15;59100000;59700000;582400000;394300000;318300000;1353500000;359600000;42000000;1091400000;1493000000;2846500000;489200000;2900000;492100000;596300000;880900000;1373000000;102400000;;1515800000;1473500000;2846500000
HUBB;628038;USD;2010;Q4;2010-12-31;2011-02-16;60200000;60600000;529500000;341800000;298400000;1226100000;358300000;30200000;1091200000;1479700000;2705800000;443200000;1800000;445000000;595900000;797300000;1242300000;201900000;;1338600000;1463500000;2705800000
HUBB;628038;USD;2009;Q4;2009-12-31;2010-10-22;;;261100000;310100000;263500000;911300000;368800000;25500000;1097200000;1491500000;2402800000;418500000;0;418500000;497200000;682300000;1100800000;159000000;;1208000000;1302000000;2402800000
HUBB;628038;USD;2018;Q4;2018-12-31;2019-02-15;54400000;54700000;198200000;725400000;651000000;1643700000;502100000;56300000;2670000000;3228400000;4872100000;783200000;56100000;839300000;1737100000;2233900000;3073200000;1900000;;2064400000;1798900000;4872100000
LSXMA;629561;USD;2017;Q4;2017-12-31;2018-03-01;;;1029000000;358000000;;1763000000;2541000000;2864000000;34828000000;40233000000;41996000000;1250000000;768000000;3979000000;13186000000;15443000000;19422000000;3897000000;;13081000000;22574000000;41996000000
LSXMA;629561;USD;2016;Q4;2016-12-31;2017-02-28;;;562000000;240000000;;1029000000;2352000000;2426000000;25570000000;30348000000;31377000000;985000000;5000000;2872000000;8013000000;10789000000;13661000000;91000000;;11727000000;17716000000;31377000000
LSXMA;629561;USD;2015;Q4;2015-12-31;2016-02-26;336000000;335000000;201000000;247000000;;691000000;1879000000;1648000000;25580000000;29107000000;29798000000;758000000;255000000;2813000000;6626000000;8854000000;11667000000;;;10981000000;18128000000;29795000000
LSXMA;629561;USD;2014;Q4;2014-12-31;2015-02-26;346000000;344000000;880000000;235000000;;1385000000;1714000000;1667000000;25503000000;28884000000;30269000000;712000000;257000000;2650000000;5588000000;7443000000;10093000000;;;11416000000;20173000000;30266000000
LSXMA;629561;USD;2013;Q4;2013-12-31;2014-02-28;587000000;589000000;1103000000;206000000;;2494000000;1808000000;4623000000;25617000000;32048000000;34542000000;670000000;777000000;3172000000;4778000000;7488000000;10660000000;2215000000;;11859000000;23879000000;34539000000
LSXMA;629561;USD;2012;Q4;2012-12-31;2013-02-28;1085000000;1117000000;603000000;25000000;;2211000000;157000000;4733000000;1224000000;6114000000;8325000000;34000000;0;385000000;0;1508000000;1893000000;3348000000;;3079000000;6431000000;8324000000
LSXMA;629561;USD;2011;Q4;2011-12-31;2013-02-28;;;2369000000;288000000;;3860000000;215000000;2422000000;1222000000;3859000000;7719000000;328000000;754000000;1230000000;541000000;1240000000;2470000000;3564000000;;1665000000;5248000000;7718000000
LSXMA;629561;USD;2018;Q4;2018-12-31;2019-02-28;;;358000000;364000000;;1082000000;2469000000;1641000000;35636000000;39746000000;40828000000;1116000000;17000000;3244000000;13371000000;15886000000;19130000000;2989000000;;13644000000;21698000000;40828000000
TGI;629705;USD;2016;Q4;2017-03-31;2017-05-24;49308000;48927000;69633000;311792000;1340175000;1772919000;805030000;;1836651000;2641681000;4414600000;1155622000;160630000;1334260000;1035670000;2233867000;3568127000;846858000;-183696000;579489000;846473000;4414600000
TGI;629705;USD;2015;Q4;2016-03-31;2016-05-27;49227000;49022000;20984000;444208000;1236190000;1742641000;889734000;;2202718000;3092452000;4835093000;1093433000;42441000;1135874000;1374879000;2764275000;3900149000;851153000;-199415000;630368000;934944000;4835093000
TGI;629705;USD;2014;Q4;2015-03-31;2015-05-21;49835000;50119000;32617000;521601000;1280274000;1906381000;950734000;;3099210000;4049944000;5956325000;840982000;42255000;883237000;1326345000;2937304000;3820541000;851991000;-203514000;1686217000;2135784000;5956325000
TGI;629705;USD;2013;Q4;2014-03-31;2014-05-19;52198000;52716000;28998000;517304000;1111767000;1781940000;931430000;;2840016000;3771446000;5553386000;590624000;49575000;640199000;1500808000;2629276000;3269475000;866333000;-19134000;1455620000;2283911000;5553386000
TGI;629705;USD;2012;Q4;2013-03-31;2013-05-30;49829000;52761000;32037000;448865000;985535000;1640064000;815084000;;2784031000;3599115000;5239179000;610695000;133930000;747246000;1195933000;2446775000;3194021000;848422000;0;1257708000;2045158000;5239179000
TGI;629705;USD;2011;Q4;2012-03-31;2012-05-29;49209000;52579000;29662000;440608000;817956000;1461086000;733380000;;2402758000;3136138000;4597224000;577744000;142237000;719981000;1016625000;2083874000;2803855000;833985000;-1716000;970406000;1793369000;4597224000
TGI;629705;USD;2010;Q4;2011-03-31;2011-05-18;48247000;51503000;39328000;374491000;781714000;1313391000;734879000;;2428964000;3163843000;4477234000;576070000;300252000;876753000;1011752000;1968264000;2845017000;819246000;-5085000;697585000;1632217000;4477234000
TGI;629705;USD;2009;Q4;2010-03-31;2010-08-06;32946000;33456000;157218000;214497000;350865000;771673000;328694000;;592211000;920905000;1692578000;191434000;91929000;284262000;413851000;547630000;831892000;314887000;-7921000;553015000;860686000;1692578000
TGI;629705;USD;2017;Q4;2018-03-31;2018-05-23;49540000;49540000;35819000;376612000;1427169000;1922925000;726003000;;1158136000;1884139000;3807064000;654281000;16527000;992439000;1421757000;2364091000;3356530000;851331000;-179082000;146155000;450534000;3807064000
TGI;629705;USD;2018;Q4;2019-03-31;2019-05-23;49944000;49944000;92807000;373590000;413560000;1241070000;543710000;;1069794000;1613504000;2854574000;673355000;8201000;975275000;1480620000;2452612000;3427887000;867597000;-159154000;-794072000;-573313000;2854574000
MNTM;629989;USD;2016;Q4;2016-12-31;2017-03-31;47447444;47447444;375498;;;379669;;;0;0;379669;602729;17501;620230;553640;553640;1173870;3739505;;-4533706;-794201;379669
MNTM;629989;USD;2015;Q4;2015-12-31;2016-04-14;50709812;50709812;5447;;;5447;;;;;5447;660245;125911;786156;;;786156;1572425;;-2353134;-780709;5447
MNTM;629989;USD;2014;Q4;2014-12-31;2015-06-19;32916250;32916250;881;;;20881;;;;;20881;173801;53209;277010;;;277010;1676;;-257805;-256129;20881
MNTM;629989;USD;2013;Q4;2013-12-31;2014-11-19;38725000;38725000;21491;;5182;26673;;;;;26673;66407;0;66407;;0;66407;770200;;-809934;-39734;26673
MNTM;629989;USD;2017;Q4;2017-12-31;2018-04-17;52965007;52965007;46082;;;49611;;;7046;7046;56657;927285;693910;1621195;;;1621195;5585265;;-7149803;-1564538;56657
MNTM;629989;USD;2018;Q4;2018-12-31;2019-04-15;55488194;55488194;57641;;;62318;;;2046;2046;64364;851624;1332489;2184113;;;2184113;6857845;;-8977593;-2119748;64365
SGH;630523;USD;2017;Q4;2017-08-31;2017-10-13;21414000;19445000;22436000;183303000;127135000;346989000;55182000;;77857000;133039000;480028000;217033000;22841000;239874000;154450000;157758000;397632000;232815000;;-7209000;82396000;480028000
SGH;630523;USD;2016;Q4;2016-08-31;2017-06-29;13863000;13863000;58634000;141036000;103066000;319258000;57600000;;81797000;139397000;458655000;212047000;17116000;229163000;225587000;230729000;459892000;145700000;;586000;-1237000;458655000
SGH;630523;USD;2018;Q4;2018-08-31;2018-10-30;22410000;23417000;31375000;237212000;221419000;522049000;56615000;;94098000;150713000;672762000;268376000;27409000;295785000;184190000;189849000;485634000;250869000;;112254000;187128000;672762000
REN;637543;USD;2017;Q4;2017-12-31;2018-03-12;21960000;19930000;3762000;63420000;;77875000;554138000;;9909000;564047000;641922000;139437000;;160799000;550727000;555532000;716331000;957428000;;-1031837000;-74409000;641922000
REN;637543;USD;2016;Q4;2016-12-31;2017-03-13;17704000;17704000;133089000;55228000;;191784000;373120000;;23469000;396589000;588373000;98925000;122139000;229973000;405975000;434147000;664120000;948382000;;-1024129000;-75747000;588373000
REN;637543;USD;2015;Q4;2015-12-31;2016-03-07;15151000;15151000;9297000;37100000;;140215000;223172000;;27596000;250768000;390983000;58361000;;59252000;514995000;535012000;594264000;659126000;;-862407000;-203281000;390983000
REN;637543;USD;2014;Q4;2014-12-31;2015-03-05;-162229000;-162393000;4352000;57909000;;136872000;1242996000;;59839000;1302835000;1439707000;97319000;1494000;99140000;759942000;813949000;913089000;646746000;;-120128000;526618000;1439707000
REN;637543;USD;2013;Q4;2013-12-31;2014-03-10;73356000;73356000;19000;94358000;;105237000;1332789000;;30783000;1363572000;1468809000;119818000;;133598000;736671000;801659000;935257000;631830000;;-98278000;533552000;1468809000
REN;637543;USD;2012;Q4;2012-12-31;2013-03-07;59460000;58112000;934000;78356000;;100261000;1230723000;;33146000;1263869000;1364130000;101961000;;137225000;563865000;694721000;831946000;516656000;;15528000;532184000;1364130000
REN;637543;USD;2011;Q4;2011-12-31;2012-03-13;59223000;72719000;1135000;61930000;;81758000;839716000;;26086000;865802000;947560000;87585000;;125448000;170000000;306287000;431735000;518273000;;-2448000;515825000;947560000
REN;637543;USD;2010;Q4;2010-12-31;2011-08-08;49885000;49053000;1844000;45154000;;65293000;671561000;;23669000;695230000;760523000;58144000;;92409000;127900000;264248000;356657000;436799000;;-32933000;403866000;760523000
FTI;637893;USD;2017;Q4;2017-12-31;2018-04-02;466300000;468500000;6737400000;1484400000;1378300000;12977100000;3871500000;272500000;11142600000;15286600000;28263700000;4681200000;77100000;9829400000;3777900000;5024900000;14854300000;10943600000;;3448000000;13409400000;28263700000
FTI;637893;USD;2016;Q4;2016-12-31;2017-01-13;118900000;123900000;6269300000;1469500000;1046200000;10937200000;2620100000;235400000;4886600000;7742100000;18679300000;4462900000;683600000;10888900000;1869300000;2746300000;13635200000;2797800000;-44500000;3404100000;5044100000;18679300000
FTI;637893;USD;2015;Q4;2015-12-31;2017-01-13;;;0;;;74100;;;;;74100;0;;0;;0;0;0;;0;74100;74100
FTI;637893;USD;2018;Q4;2018-12-31;2019-03-11;451800000;444000000;5540000000;2469700000;1440900000;11781200000;3259800000;394500000;9349000000;13003300000;24784500000;3076900000;67400000;9134400000;4124300000;5180700000;14315100000;10645100000;;1114200000;10469400000;24784500000
MDR;638112;USD;2018;Q4;2018-12-31;2019-02-25;181123176;179992660;520000000;932000000;101000000;3033000000;2067000000;452000000;3888000000;6407000000;9440000000;2159000000;38000000;4217000000;3459000000;4170000000;8387000000;3722000000;-96000000;-2719000000;1053000000;9440000000
MDR;638112;USD;2017;Q4;2017-12-31;2018-02-21;94947258;96489197;390000000;328000000;;1435000000;1666000000;8000000;114000000;1788000000;3223000000;651000000;24000000;707000000;513000000;727000000;1434000000;1956000000;-96000000;-48000000;1789000000;3223000000
MDR;638112;USD;2016;Q4;2016-12-31;2017-02-21;80345669;109583133;595921000;334384000;;1332383000;1687301000;17023000;185523000;1889847000;3222230000;468732000;48125000;709343000;704395000;917419000;1626762000;1944809000;-94957000;-226767000;1595468000;3222230000
MDR;638112;USD;2015;Q4;2015-12-31;2016-02-22;79502763;48318900;664844000;208474000;;1527278000;1610859000;26551000;222388000;1859798000;3387076000;634551000;24882000;824206000;819001000;1016149000;1840355000;1933900000;-92262000;-260884000;1546721000;3387076000
MDR;638112;USD;2014;Q4;2014-12-31;2015-03-02;79035500;79035500;665309000;143370000;;1487381000;1657348000;38186000;233964000;1929498000;3416879000;614298000;23678000;857594000;840791000;1020171000;1877765000;1922025000;-96441000;-239572000;1539114000;3416879000
MDR;638112;USD;2013;Q4;2013-12-31;2014-03-03;79212009;78125886;118702000;381858000;;1080200000;1478677000;64047000;184447000;1727171000;2807371000;784620000;39543000;1120984000;49019000;246043000;1367027000;1658728000;-97926000;-163578000;1440344000;2807371000
MDR;638112;USD;2012;Q4;2012-12-31;2013-02-28;78607812;79264859;659389000;428800000;;1789789000;1281791000;64185000;197862000;1543838000;3333627000;846411000;14146000;1113011000;88562000;268511000;1381522000;1634713000;-98725000;445756000;1952105000;3333627000
MDR;638112;USD;2011;Q4;2011-12-31;2012-02-29;78339270;78966807;680376000;445808000;;1537185000;1101865000;72143000;281621000;1455629000;2992814000;679210000;8941000;1021776000;84794000;237326000;1259102000;1618392000;-95827000;239103000;1733712000;2992814000
MDR;638112;USD;2010;Q4;2010-12-31;2011-03-01;77776029;79005473;612926000;323497000;;1285638000;915569000;120758000;276723000;1313050000;2598688000;572656000;8547000;865007000;46748000;221414000;1086421000;1598107000;-85735000;100373000;1512267000;2598688000
MDR;638112;USD;2009;Q4;2009-12-31;2010-03-01;4925284;4979261;899282000;642995000;101494000;2357921000;1337605000;315638000;837946000;2491189000;4849110000;1125422000;16270000;2009032000;56714000;1006978000;3016010000;1537917000;-69370000;951647000;1833100000;4849110000
MDR;638112;USD;2008;Q4;2008-12-31;2009-08-27;-138026048;-140552688;718164000;712055000;128383000;2216985000;1078859000;389474000;916375000;2384708000;4601693000;1201449000;9021000;2208345000;6109000;1076835000;3285180000;1487022000;-63026000;564591000;1316513000;4601693000
OII;638114;USD;2018;Q4;2018-12-31;2019-02-28;98537000;98537000;354259000;368885000;194507000;1244889000;964670000;;615439000;1580109000;2824998000;409569000;;494741000;786580000;914959000;1409700000;248130000;-704066000;2204548000;1415298000;2824998000
OII;638114;USD;2017;Q4;2017-12-31;2018-03-01;98281000;99897000;430316000;476903000;215282000;1187402000;1064204000;;772344000;1836548000;3023950000;435797000;;435797000;792312000;923635000;1359432000;252834000;-718946000;2417412000;1664518000;3023950000
OII;638114;USD;2016;Q4;2016-12-31;2017-02-24;98067000;98925000;450193000;489749000;280130000;1262595000;1153258000;;714462000;1867720000;3130315000;508364000;;508364000;793058000;1105308000;1613672000;255275000;-731202000;2295234000;1516643000;3130315000
OII;638114;USD;2015;Q4;2015-12-31;2016-02-19;97822000;98242000;385235000;612785000;328453000;1517493000;1266731000;;645312000;1912043000;3429536000;615956000;;615956000;795836000;1234846000;1850802000;257888000;-743577000;2364786000;1578734000;3429536000
OII;638114;USD;2014;Q4;2014-12-31;2015-02-19;103277000;103812000;430714000;778372000;375588000;1713550000;1305822000;0;485568000;1791390000;3504940000;679137000;;679137000;743469000;1168332000;1847469000;257349000;-656917000;2240229000;1657471000;3504940000
OII;638114;USD;2013;Q4;2013-12-31;2014-02-20;108201000;108816000;91430000;768842000;441789000;1433275000;1189099000;37462000;468664000;1695225000;3128500000;727088000;;727088000;0;357972000;1085060000;250111000;-75736000;1921642000;2043440000;3128500000
OII;638114;USD;2012;Q4;2012-12-31;2012-08-01;107903000;108544000;120549000;666930000;331280000;1202990000;1025132000;42619000;497377000;1565128000;2768118000;617185000;;617185000;94000000;335473000;952658000;240649000;-84062000;1641027000;1815460000;2768118000
OII;638114;USD;2011;Q4;2011-12-31;2012-02-24;108033000;108927000;106142000;549812000;255095000;984122000;893308000;49607000;473507000;1416422000;2400544000;501375000;;501375000;120000000;341207000;842582000;230328000;-71700000;1426525000;1557962000;2400544000
OII;638114;USD;2010;Q4;2010-12-31;2011-02-25;;;245219000;424014000;236517000;983502000;786373000;51820000;208811000;1047004000;2030506000;439856000;;439856000;0;200435000;640291000;220986000;-61385000;1239574000;1390215000;2030506000
OII;638114;USD;2009;Q4;2009-12-31;2010-08-06;;;162351000;435151000;232217000;874139000;766361000;58736000;181051000;1006148000;1880287000;388547000;;388547000;120000000;267417000;655964000;226642000;-27796000;1039043000;1224323000;1880287000
CMP;638470;USD;2017;Q4;2017-12-31;2018-02-27;33826000;33829000;36600000;344500000;289900000;737500000;1138100000;24600000;670800000;1833500000;2571000000;235900000;32100000;268000000;1330400000;1608400000;1876400000;102900000;-2900000;672500000;694600000;2571000000
CMP;638470;USD;2016;Q4;2016-12-31;2017-03-01;33788000;33796000;77400000;320900000;280600000;715000000;1092300000;24900000;634300000;1751500000;2466500000;241800000;130200000;372000000;1194800000;1377400000;1749400000;97500000;-3000000;727500000;717100000;2466500000
CMP;638470;USD;2015;Q4;2015-12-31;2016-02-22;33704000;33710000;58400000;147800000;275300000;512300000;800700000;116400000;195400000;1112500000;1624800000;165900000;4900000;170800000;718000000;814300000;985100000;92100000;-3200000;659100000;639700000;1624800000
CMP;638470;USD;2014;Q4;2014-12-31;2015-02-23;33602000;33654000;266800000;213000000;199000000;702700000;700900000;0;233600000;934500000;1637200000;233800000;3900000;237700000;622500000;745900000;983600000;82900000;-3300000;589500000;653600000;1637200000
CMP;638470;USD;2013;Q4;2013-12-31;2014-02-24;33481000;33476000;159600000;211900000;180700000;577400000;677300000;;150100000;827400000;1404800000;197200000;3900000;257600000;474700000;593000000;850600000;70800000;-3600000;452500000;554200000;1404800000
CMP;638470;USD;2012;Q4;2012-12-31;2013-02-21;33198000;33226000;100100000;143700000;229700000;506900000;645200000;;148500000;793700000;1300600000;158600000;3900000;199300000;478400000;597800000;797100000;54900000;-4000000;395000000;503500000;1300600000
CMP;638470;USD;2011;Q4;2011-12-31;2012-02-22;32994000;33017000;130300000;152500000;207200000;515800000;573400000;;116300000;689700000;1205500000;170800000;156000000;326800000;326700000;432100000;758900000;37800000;-4500000;372500000;446600000;1205500000
CMP;638470;USD;2010;Q4;2010-12-31;2011-02-22;32807000;32835000;91100000;197200000;205000000;521400000;533800000;;59100000;592900000;1114300000;178400000;4200000;182600000;482500000;583900000;766500000;23100000;-4900000;283600000;347800000;1114300000
CMP;638470;USD;2009;Q4;2009-12-31;2010-07-30;130198329;130286251;13500000;167500000;273200000;483400000;463800000;;56600000;520400000;1003800000;180500000;4100000;184600000;486600000;596100000;780700000;12100000;-5200000;185000000;223100000;1003800000
CMP;638470;USD;2018;Q4;2018-12-31;2019-03-01;33855000;33855000;27000000;311600000;266600000;721200000;1052000000;24500000;570200000;1646700000;2367900000;239800000;43500000;283300000;1321200000;1544400000;1827700000;110500000;-2900000;643500000;540200000;2367900000
GRPN;639037;USD;2017;Q4;2017-12-31;2018-02-14;558289837;585047012;880129000;98294000;;1072448000;151145000;135189000;318723000;605057000;1677505000;1133499000;;1133499000;189753000;292161000;1425660000;2174783000;-867450000;-1088204000;251845000;1677505000
GRPN;639037;USD;2016;Q4;2016-12-31;2017-02-15;570546159;570546159;862977000;71272000;;1091936000;169452000;141882000;358107000;669441000;1761377000;1165999000;;1213051000;178995000;283264000;1496315000;2112802000;-807424000;-1099010000;265062000;1761377000
GRPN;639037;USD;2015;Q4;2015-12-31;2016-02-12;607517009;607517009;853362000;68175000;;1075242000;198897000;178236000;343889000;721022000;1796264000;1203525000;;1203525000;0;122152000;1325677000;1964525000;-645041000;-901292000;470587000;1796264000
GRPN;639037;USD;2014;Q4;2014-12-31;2015-02-13;671885966;671885966;1016634000;90597000;;1385058000;176004000;24298000;642237000;842539000;2227597000;1127359000;;1293598000;;169055000;1462653000;1847490000;-198467000;-921960000;764944000;2227597000
GRPN;639037;USD;2013;Q4;2013-12-31;2014-02-21;668046075;668046075;1240472000;83673000;;1562498000;134423000;20652000;324437000;479512000;2042010000;1007502000;;1187778000;;142550000;1330328000;1584278000;-46587000;-848870000;711682000;2042010000
GRPN;639037;USD;2012;Q4;2012-12-31;2013-02-27;656385954;640412782;1209289000;96713000;;1487786000;121072000;84209000;338407000;543688000;2031474000;978094000;;1168441000;;120932000;1289373000;1485071000;0;-753477000;742101000;2031474000
GRPN;639037;USD;2011;Q4;2011-12-31;2012-03-30;530176148;530176148;1122935000;108747000;;1323327000;51800000;50604000;348745000;451149000;1774476000;773648000;;995162000;;78194000;1073356000;1388317000;;-698704000;701120000;1774476000
GRPN;639037;USD;2010;Q4;2010-12-31;2012-03-30;;;118833;42407;;188399;16490;0;176681;193171;381570;318275;;370419;;1621;372040;920840;-503173;-419468;9527;381567
GRPN;639037;USD;2018;Q4;2018-12-31;2019-02-12;570388802;562644369;841021000;69493000;;998629000;143117000;108515000;391881000;643513000;1642142000;957174000;;957174000;201669000;302357000;1259531000;2234636000;-877491000;-1010499000;382611000;1642142000
HABT;639722;USD;2017;Q4;2017-12-31;2018-03-01;20365374;20215601;28277000;8278000;1733000;40133000;139956000;;112035000;251991000;292124000;32159000;;33602000;;113927000;147529000;113735000;;4590000;144595000;292124000
HABT;639722;USD;2016;Q4;2016-12-31;2017-03-03;19501667;19530484;44192000;5145000;1519000;52528000;102857000;;174981000;277838000;330366000;26196000;;27135000;;159344000;186479000;110316000;;7397000;143887000;330366000
HABT;639722;USD;2015;Q4;2015-12-31;2016-03-03;13759756;13770401;46991000;4372000;1123000;53944000;81524000;;121243000;202767000;256711000;23301000;;24145000;;100634000;124779000;73387000;;2737000;131932000;256711000
HABT;639722;USD;2014;Q4;2014-12-31;2015-05-29;;;49469000;3187000;909000;54682000;65668000;;38272000;103940000;158622000;16695000;;17133000;;24532000;41665000;41577000;;-32000;116957000;158622000
HABT;639722;USD;2018;Q4;2018-12-31;2019-03-01;20657714;20944686;24519000;7648000;2019000;37944000;160746000;;113916000;274662000;312606000;37148000;;39262000;;123350000;162612000;117314000;;6921000;149994000;312606000
REV;639819;USD;2017;Q4;2017-12-31;2018-03-15;52148155;52148155;87100000;444800000;497900000;1143200000;372700000;;1541000000;1913700000;3056900000;336900000;182600000;932300000;2653700000;2895000000;3827300000;1040500000;-21700000;-1560800000;-770400000;3056900000
REV;639819;USD;2016;Q4;2016-12-31;2017-03-03;52520256;52276407;186400000;423900000;424600000;1123700000;320500000;;1579300000;1899800000;3023500000;296900000;28900000;708700000;2663100000;2929600000;3638300000;1033700000;-19200000;-1377600000;-614800000;3023500000
REV;639819;USD;2015;Q4;2015-12-31;2016-02-26;52457389;52766441;326900000;244900000;183800000;808900000;215300000;;943100000;1158400000;1967300000;201300000;41300000;515000000;1783700000;2039800000;2554800000;1026800000;-13300000;-1355700000;-587500000;1967300000
DLX;639822;USD;2017;Q4;2017-12-31;2018-02-23;47848000;48137000;59240000;149844000;42249000;392966000;84638000;42607000;1688616000;1815861000;2208827000;381730000;44040000;425770000;665260000;768044000;1193814000;47953000;;1004657000;1015013000;2208827000
DLX;639822;USD;2016;Q4;2016-12-31;2017-02-24;48364000;48737000;76574000;152649000;40182000;398230000;86896000;42240000;1656972000;1786108000;2184338000;379842000;35842000;415684000;722806000;887684000;1303368000;48546000;;882795000;880970000;2184338000
DLX;639822;USD;2015;Q4;2015-12-31;2016-02-19;48915000;49261000;62427000;123654000;41956000;323985000;85732000;41691000;1390745000;1518168000;1842153000;315998000;1045000;317043000;627973000;780041000;1097084000;49019000;;751253000;745069000;1842153000
DLX;639822;USD;2014;Q4;2014-12-31;2015-02-20;49697000;50092000;61541000;113656000;39411000;318890000;87623000;46451000;1235427000;1369501000;1688391000;306337000;160911000;467248000;393401000;573646000;1040894000;54500000;;629335000;647497000;1688391000
DLX;639822;USD;2013;Q4;2013-12-31;2014-02-28;50505000;50992000;121089000;88049000;28966000;319313000;101343000;44451000;1104422000;1250216000;1569529000;234482000;255589000;490071000;385115000;529001000;1019072000;72940000;;510941000;550457000;1569529000
DLX;639822;USD;2012;Q4;2012-12-31;2013-02-22;50785000;51093000;45435000;70387000;23291000;219743000;104189000;46898000;1041610000;1192697000;1412440000;220110000;0;220110000;652581000;759395000;979505000;98582000;;375000000;432935000;1412440000
DLX;639822;USD;2011;Q4;2011-12-31;2012-02-24;50782000;50916000;28687000;69023000;22043000;192575000;113411000;45147000;1037676000;1196234000;1388809000;214792000;85575000;300367000;656131000;785753000;1086120000;106664000;;255426000;302689000;1388809000
DLX;639822;USD;2010;Q4;2010-12-31;2011-02-22;51132000;51349000;17383000;66471000;21660000;171237000;120221000;37410000;979823000;1137454000;1308691000;204512000;7000000;211512000;748122000;870981000;1082493000;114253000;;161957000;226198000;1308691000
DLX;639822;USD;2009;Q4;2009-12-31;2010-08-05;;;12789000;65564000;22122000;159499000;121797000;39200000;890714000;1051711000;1211210000;217048000;26000000;243048000;742753000;850952000;1094000000;109260000;;60768000;117210000;1211210000
DLX;639822;USD;2018;Q4;2018-12-31;2019-02-26;45238000;45367000;59740000;173862000;46441000;450046000;90342000;43773000;1720935000;1855050000;2305096000;391259000;791000;392050000;911073000;997633000;1389683000;44647000;;927345000;915413000;2305096000
LPLA;639823;USD;2017;Q4;2017-12-31;2018-02-21;89922000;92401000;822969000;219157000;;2643947000;412684000;12489000;2289631000;2714804000;5358751000;1757533000;;1830937000;2492540000;2562806000;4393743000;1556240000;-1309568000;718336000;965008000;5358751000
LPLA;639823;USD;2016;Q4;2016-12-31;2017-02-24;89213000;90781000;756571000;194526000;;2479353000;387368000;5559000;1962646000;2355573000;4834926000;1581232000;;1644200000;2281085000;2369731000;4013931000;1445376000;-1194645000;569949000;820995000;4834926000
LPLA;639823;USD;2015;Q4;2015-12-31;2016-02-25;93845000;95206000;734376000;148978000;;2275001000;275419000;6001000;1964640000;2246060000;4521061000;1407188000;;1472936000;2248180000;2332515000;3805451000;1418417000;-1172490000;469130000;715610000;4521061000
LPLA;639823;USD;2014;Q4;2014-12-31;2015-02-20;97813000;99402000;420926000;120325000;;1838824000;214154000;5035000;1983917000;2203106000;4041930000;1268743000;;1333527000;1625195000;1736803000;3070330000;1355203000;-780661000;396121000;971600000;4041930000
LPLA;639823;USD;2013;Q4;2013-12-31;2014-02-26;101760000;103315000;523437000;;;1864515000;189059000;7102000;1982155000;2178316000;4042831000;1201288000;;1275238000;1535096000;1667622000;2942860000;1292491000;-506205000;313570000;1099971000;4042831000
LPLA;639823;USD;2012;Q4;2012-12-31;2013-02-26;107783000;107000000;476463000;;;1831287000;130847000;9448000;2016942000;2157237000;3988524000;1297234000;;1359408000;1317825000;1489096000;2848504000;1228191000;-287998000;199827000;1140020000;3988524000
LPLA;639823;USD;2011;Q4;2011-12-31;2012-02-27;107799000;110957000;731939000;;;1753327000;91317000;7890000;1963792000;2062999000;3816326000;915314000;;975012000;1332668000;1496566000;2471578000;1137833000;-89037000;296802000;1344748000;3816326000
LPLA;639823;USD;2010;Q4;2010-12-31;2011-08-03;;;428771000;;;1599479000;78671000;8391000;1959626000;2046688000;3646167000;850772000;;909211000;1386639000;1563201000;2472412000;1051831000;0;126420000;1173755000;3646167000
LPLA;639823;USD;2018;Q4;2018-12-31;2019-02-26;85925000;88130000;524097000;298821000;;2731656000;461418000;4829000;2279565000;2745812000;5477468000;1851825000;;1932518000;2476372000;2570877000;4503395000;1634462000;-1730535000;1070146000;974073000;5477468000
RAVE;640428;USD;2017;Q4;2017-06-30;2017-09-25;10685000;10685000;451000;3436000;750000;5126000;3808000;;612000;4420000;9546000;5430000;1000000;6743000;2749000;4882000;11625000;26962000;-24636000;-4405000;-2079000;9546000
RAVE;640428;USD;2016;Q4;2016-06-30;2016-09-23;10297000;9229000;873000;2947000;197000;4641000;12979000;;885000;13864000;18505000;5035000;0;5499000;0;3603000;9102000;25953000;-24636000;8086000;9403000;18505000
RAVE;640428;USD;2015;Q4;2015-06-30;2015-09-24;10206000;10771000;5958000;3461000;180000;10963000;10020000;;2988000;13008000;23971000;4142000;;4671000;;2090000;6761000;24874000;-24636000;16972000;17210000;23971000
RAVE;640428;USD;2014;Q4;2014-06-30;2014-09-23;8658000;9122000;2796000;3357000;1703000;8415000;5133000;;2420000;7553000;15968000;2949000;500000;3789000;;1937000;5726000;16067000;-24636000;18811000;10242000;15968000
RAVE;640428;USD;2013;Q4;2013-06-30;2013-09-26;8061000;8676000;919000;3431000;1615000;6615000;4711000;;1209000;5920000;12535000;2364000;669000;3451000;;3015000;6466000;10327000;-24636000;20378000;6069000;12535000
RAVE;640428;USD;2012;Q4;2012-06-30;2012-09-24;8023000;7901000;590;3098;1852;6227;4794;;1477;6271;12498;3318;765;4283;;1907;6190;9305;-24636;21639;6308;12498
RAVE;640428;USD;2011;Q4;2011-06-30;2011-11-09;8011000;8037000;949;3128;1829;6691;3196;;1265;4461;11152;3660;333;4195;;1116;5311;9160;-24636;21317;5841;11152
RAVE;640428;USD;2018;Q4;2018-06-30;2018-09-24;14973000;19489000;1386000;2230000;545000;4739000;1510000;;4737000;6247000;10986000;1883000;0;1980000;1562000;2707000;4687000;33428000;-24636000;-2493000;6299000;10986000
TRUP;640535;USD;2017;Q4;2017-12-31;2018-02-14;29550426;23250010;63296000;20367000;;86558000;7868000;3237000;8196000;19301000;105859000;10376000;;45866000;9324000;11559000;57425000;134511000;-3201000;-82784000;48434000;105859000
TRUP;640535;USD;2016;Q4;2016-12-31;2017-02-15;29030395;29030395;53207000;10118000;;65387000;8464000;2850000;5644000;16958000;82345000;7422000;;30406000;4767000;7224000;37630000;129574000;-3201000;-81281000;44715000;82345000
TRUP;640535;USD;2015;Q4;2015-12-31;2016-02-17;27863439;27863439;43244000;8196000;;53633000;9719000;2688000;4877000;17284000;70917000;5478000;;23617000;0;1944000;25561000;122844000;-2601000;-74385000;45356000;70917000
TRUP;640535;USD;2014;Q4;2014-12-31;2015-02-24;27813620;27813620;75469000;7887000;;84655000;7862000;942000;4847000;13651000;98306000;6569000;;22544000;14900000;16487000;39031000;119045000;-2601000;-57180000;59275000;98306000
TRUP;640535;USD;2013;Q4;2013-12-31;2014-08-28;1361418;1361418;31027000;7771000;;39733000;3124000;832000;7964000;11920000;51653000;4923000;900000;26023000;25199000;58629000;84652000;5769000;-2601000;-36003000;-32999000;51653000
TRUP;640535;USD;2018;Q4;2018-12-31;2019-02-14;33747730;30491786;81111000;31565000;;117976000;69803000;3554000;16177000;89534000;207510000;14114000;;64205000;12862000;14132000;78337000;219838000;-6201000;-83711000;129173000;207510000
AGLE;640634;USD;2017;Q4;2017-12-31;2018-03-13;16622973;16622973;50299000;;;54991000;854000;;232000;1086000;56077000;5609000;;5629000;;111000;5740000;122952000;;-72513000;50337000;56077000
AGLE;640634;USD;2016;Q4;2016-12-31;2017-03-23;13424062;13424062;63502000;;;66424000;599000;;40000;639000;67063000;3894000;;3965000;;132000;4097000;108247000;;-45277000;62966000;67063000
AGLE;640634;USD;2015;Q4;2015-12-31;2016-05-19;627265;627265;33062000;;;38286000;348000;;20000;368000;38654000;2523000;;2523000;;27000;2550000;1373000;;-23579000;36104000;38654000
AGLE;640634;USD;2018;Q4;2018-12-31;2019-03-07;24032415;24032415;74513000;;;76671000;1018000;;50000;1068000;77739000;10239000;;10239000;;72000;10311000;184316000;;-116861000;67428000;77739000
KEM;641260;USD;2017;Q4;2018-03-31;2018-05-25;;59483000;286846000;144076000;204386000;676468000;405316000;12016000;124469000;541801000;1218269000;264376000;20540000;284916000;304083000;470390000;755306000;463303000;;2675000;462963000;1218269000
KEM;641260;USD;2016;Q4;2017-03-31;2017-06-01;;73321000;109774000;92526000;147955000;379037000;209311000;63416000;82561000;355288000;734325000;128141000;2000000;130141000;386211000;449712000;579853000;448138000;;-251854000;154472000;734325000
KEM;641260;USD;2015;Q4;2016-03-31;2016-05-25;;42379000;65004000;93168000;168879000;352547000;241839000;20334000;85060000;347233000;699780000;121754000;2000000;123754000;385833000;463545000;587299000;453286000;-9870000;-299510000;112481000;699780000
KEM;641260;USD;2014;Q4;2015-03-31;2015-05-22;;31501000;56362000;90857000;171843000;360565000;249641000;45016000;91471000;386128000;746693000;131125000;962000;132087000;390409000;449924000;582011000;461656000;-22297000;-245881000;164682000;746693000
KEM;641260;USD;2013;Q4;2014-03-31;2014-05-30;;45174000;57929000;98947000;187974000;400576000;292648000;46419000;104024000;443091000;843667000;152266000;7297000;166832000;391292000;454951000;621783000;465492000;-30054000;-231738000;221884000;843667000
KEM;641260;USD;2012;Q4;2013-03-31;2013-06-06;44951000;44951000;95978000;93774000;198888000;443425000;303682000;52738000;111746000;468166000;911591000;165026000;10793000;181480000;372707000;453195000;634675000;467561000;-35104000;-163235000;276916000;911591000
KEM;641260;USD;2011;Q4;2012-03-31;2012-05-18;44674000;60068000;210521000;104950000;212234000;564184000;315848000;;100830000;416678000;980862000;165739000;1951000;167690000;345380000;454176000;621866000;470524000;-42495000;-81053000;358996000;980862000
KEM;641260;USD;2010;Q4;2011-03-31;2011-05-20;36956000;75709000;152051000;150370000;206440000;542259000;310412000;;31638000;342050000;884309000;183553000;42101000;225654000;231215000;298902000;524556000;479717000;-54774000;-87745000;359753000;884309000
KEM;641260;USD;2009;Q4;2010-03-31;2010-08-05;;;79199000;137385000;150508000;388011000;319878000;;33072000;352950000;740961000;143531000;17880000;161411000;231629000;295278000;456689000;480000000;-56929000;-150789000;284272000;740961000
KEM;641260;USD;2018;Q4;2019-03-31;2019-05-30;;58982000;207918000;154059000;241129000;642053000;495280000;69949000;110813000;676042000;1318095000;250043000;28430000;278473000;266041000;400207000;678680000;465944000;;204195000;639415000;1318095000
LOGM;641732;USD;2017;Q4;2017-12-31;2018-02-20;52741000;54953000;252402000;93949000;;398824000;92154000;;3367130000;3459284000;3858108000;104658000;;445228000;;249139000;694367000;3277451000;-179725000;50445000;3163741000;3858108000
LOGM;641732;USD;2016;Q4;2016-12-31;2017-03-01;25532000;28275000;196466000;25901000;;228090000;23867000;;191336000;215203000;443293000;49893000;;206859000;30000000;40318000;247177000;314984000;-110496000;-1754000;196116000;443293000
LOGM;641732;USD;2015;Q4;2015-12-31;2016-02-19;25019000;26122000;208427000;16011000;;236435000;21711000;;197553000;219264000;455699000;42001000;;176298000;60000000;71590000;247888000;277068000;-85115000;21074000;207811000;455699000
LOGM;641732;USD;2014;Q4;2014-12-31;2015-02-20;24399575;26431555;201169000;18286000;;230895000;13476000;;73478000;86954000;317849000;36537000;;138209000;;5796000;144005000;237470000;-67025000;6516000;173844000;317849000
LOGM;641732;USD;2013;Q4;2013-12-31;2014-03-10;24187999;24187999;189556000;12957000;;212097000;13198000;;54318000;67516000;279613000;26500000;;108996000;;3278000;112274000;200489000;-30525000;-1439000;167339000;279613000
LOGM;641732;USD;2012;Q4;2012-12-31;2013-02-22;24808326;25400383;212093000;13231000;;232158000;6576000;;40804000;47380000;279538000;24430000;;90305000;;4596000;94901000;178794000;0;6243000;184637000;279538000
LOGM;641732;USD;2011;Q4;2011-12-31;2012-02-24;24423492;26411927;198643729;8747104;;211782815;5202721;;15071581;20274302;232057117;16747968;;72709827;;3541601;76251428;154685885;;2677128;155805689;232057117
LOGM;641732;USD;2010;Q4;2010-12-31;2011-07-28;23758967;25154791;167424471;4744392;;176390010;6198487;;4088772;10287259;186677269;13005700;;54768838;;1530173;56299011;133663683;;-3084316;130378258;186677269
LOGM;641732;USD;2018;Q4;2018-12-31;2019-02-21;50977000;51628000;148652000;95354000;;327893000;98238000;;3509822000;3608060000;3935953000;154826000;;524606000;200000000;436659000;961265000;3317170000;-428658000;84043000;2974688000;3935953000
DRAD;641822;USD;2018;Q4;2018-12-31;2019-03-01;2024500;2024500;1698000;12642000;5402000;21194000;21645000;;7755000;29400000;50594000;9265000;;13217000;9500000;11577000;24794000;145430000;-5728000;-113880000;25800000;50594000
DRAD;641822;USD;2017;Q4;2017-12-31;2018-02-28;2005900;2005900;1974000;15887000;5501000;25576000;28365000;;12762000;41127000;66703000;10918000;;16970000;19500000;21934000;38904000;148165000;-5728000;-114633000;27799000;66703000
DRAD;641822;USD;2016;Q4;2016-12-31;2017-02-28;1978100;2066900;3120000;14503000;5987000;27079000;31407000;;47777000;79184000;106263000;10672000;5358000;22673000;16070000;17109000;39782000;151698000;-5728000;-79437000;66481000;106263000
DRAD;641822;USD;2015;Q4;2015-12-31;2016-03-01;1941800;1994500;19095000;7274000;4381000;31747000;6252000;;26114000;32366000;64113000;4035000;0;8706000;0;1252000;9958000;153862000;-5728000;-93739000;54155000;64113000
DRAD;641822;USD;2014;Q4;2014-12-31;2015-03-06;1861100;1926000;21986000;5989000;3644000;32952000;4766000;;4183000;8949000;41901000;4860000;;8293000;;963000;9256000;153771000;-5728000;-115379000;32645000;41901000
DRAD;641822;USD;2013;Q4;2013-12-31;2014-03-20;1847400;1970200;26417000;5430000;3881000;36669000;4153000;;629000;4782000;41451000;4220000;;7625000;;440000;8065000;156970000;-5728000;-117854000;33386000;41451000
DRAD;641822;USD;2012;Q4;2012-12-31;2013-03-13;1927600;1927600;27193000;6329000;4979000;39387000;4693000;;829000;5522000;44909000;4236000;;8284000;;176000;8460000;156636000;-2086000;-118118000;36449000;44909000
DRAD;641822;USD;2011;Q4;2011-12-31;2012-02-17;1919300;1919300;30452000;6320000;6178000;43999000;5367000;;661000;6028000;50027000;3918000;;8414000;;126000;8540000;155706000;-1058000;-113194000;41487000;50027000
DRAD;641822;USD;2010;Q4;2010-12-31;2011-07-27;1887600;1887600;30247000;7527000;5432000;44067000;7185000;;992000;8177000;52244000;3672000;;8147000;;138000;8285000;154787000;-1039000;-109852000;43959000;52244000
FIT;642125;USD;2017;Q4;2017-12-31;2018-03-01;237053000;237053000;679300000;406019000;123895000;1384365000;104908000;;92802000;197710000;1582075000;665796000;;701300000;;56812000;758112000;956084000;;-132112000;823963000;1582075000
FIT;642125;USD;2016;Q4;2016-12-31;2017-03-01;224315000;153596000;706013000;477825000;230387000;1480571000;76553000;;264802000;341355000;1821926000;713728000;;756340000;;67054000;823394000;859368000;;140142000;998532000;1821926000
FIT;642125;USD;2015;Q4;2015-12-31;2016-02-29;213138000;247713000;664478000;469260000;178146000;1355414000;44501000;;119151000;163652000;1519066000;463809000;;508257000;;29358000;537615000;737841000;;242919000;981451000;1519066000
FIT;642125;USD;2014;Q4;2014-12-31;2015-08-07;40678000;63747000;195626000;238859000;115072000;563171000;26435000;;43445000;69880000;633051000;297237000;132589000;461311000;15797000;96478000;557789000;7983000;;67242000;75262000;633051000
PTN;642335;USD;2017;Q4;2017-06-30;2017-09-25;196123577;196123577;40450161;15116822;;56578204;198153;;56916;255069;56833273;12072465;7839259;54962296;6281660;7035621;61997917;351579691;;-356743785;-5164644;56833273
PTN;642335;USD;2016;Q4;2016-06-30;2016-09-19;156835850;156835850;9383224;0;;10697065;97801;;63213;161014;10858079;8481623;5402375;13883998;14120918;14560048;28444046;325828189;;-343412252;-17585967;10858079
PTN;642335;USD;2015;Q4;2015-06-30;2015-09-18;133781427;132288046;27299268;;;29196015;123158;;155279;278437;29474452;7329967;25871;7355838;9822835;9914139;17269977;303903744;;-291699316;12204475;29474452
PTN;642335;USD;2014;Q4;2014-06-30;2014-09-12;106730658;106730658;12184605;;;12340998;160748;;57308;218056;12559054;1770238;0;2770238;0;0;2770238;283822522;;-274033753;9788816;12559054
PTN;642335;USD;2013;Q4;2013-06-30;2013-09-27;105956800;105956800;24417286;;;24749553;266415;;58131;324546;25074099;1721636;338726;2060362;;35460;2095822;283083689;;-260105459;22978277;25074099
PTN;642335;USD;2012;Q4;2012-06-30;2012-09-10;34900591;34900591;3827198;27631;;4736839;318653;;324992;643645;5380484;3434723;22277;3457000;19909;92586;3549586;241074133;;-239243285;1830898;5380484
PTN;642335;USD;2011;Q4;2011-06-30;2011-11-14;33934362;33934362;18869639;131149;;19262735;1305331;;604787;1910118;21172853;2725009;34923;2806037;42186;175041;2981078;240181832;;-221990107;18191775;21172853
PTN;642335;USD;2018;Q4;2018-06-30;2018-09-13;200568026;226472122;38000171;0;;38513859;164035;;338916;502951;39016810;4326714;5948763;10762965;332898;1288936;12051901;359010775;;-332045906;26964909;39016810
INTT;645323;USD;2017;Q4;2017-12-31;2018-03-28;10308243;10376012;13290000;12166000;4966000;30999000;1541000;;29953000;31494000;62493000;6580000;;14419000;;8786000;23205000;25964000;-204000;12646000;39288000;62493000
INTT;645323;USD;2016;Q4;2016-12-31;2017-03-27;10273703;10298029;28611000;5377000;3676000;38006000;944000;;3894000;4838000;42844000;4234000;;5056000;;0;5056000;25682000;-204000;11671000;37788000;42844000
INTT;645323;USD;2015;Q4;2015-12-31;2016-03-29;10481610;10498425;25710000;4395000;3520000;34264000;1112000;;4608000;5720000;39984000;3692000;;4059000;;0;4059000;26391000;-204000;9013000;35925000;39984000
INTT;645323;USD;2014;Q4;2014-12-31;2015-03-26;10455483;10481348;23126000;5034000;3769000;32931000;1268000;;4539000;5807000;38738000;4095000;;4370000;;0;4370000;26427000;-204000;7152000;34368000;38738000
INTT;645323;USD;2013;Q4;2013-12-31;2014-03-27;10378379;10511911;19018000;5748000;3243000;29081000;1254000;;5146000;6400000;35481000;3948000;;4332000;;0;4332000;26293000;-204000;3713000;31149000;35481000
INTT;645323;USD;2012;Q4;2012-12-31;2013-03-29;10312165;10463160;15576000;5501000;3135000;25579000;1250000;;5570000;6820000;32399000;3865000;;4579000;;0;4579000;26135000;-204000;636000;27820000;32399000
INTT;645323;USD;2011;Q4;2011-12-31;2012-03-30;10193676;10281654;13957000;6189000;3896000;24797000;1134000;;5306000;6440000;31237000;4177000;;5038000;;0;5038000;26140000;-472000;-686000;26199000;31237000
INTT;645323;USD;2010;Q4;2010-12-31;2011-08-12;10042481;10184221;6895000;6244000;3489000;17058000;718000;;3632000;4350000;21408000;4703000;;5265000;;39000;5304000;26078000;-736000;-10549000;16104000;21408000
INTT;645323;USD;2018;Q4;2018-12-31;2019-03-26;10367132;10437479;17861000;10563000;6520000;35621000;2717000;;28849000;31566000;67187000;6185000;;21418000;;2889000;24307000;26618000;-204000;15683000;42880000;67187000
FMSA;645665;USD;2017;Q4;2017-12-31;2018-03-13;44827200;47602600;127967000;156916000;70528000;363176000;785513000;;116630000;902143000;1265319000;144640000;19189000;169489000;729741000;775536000;945025000;302335000;-285520000;318207000;320294000;1265319000
FMSA;645665;USD;2016;Q4;2016-12-31;2017-03-09;42200600;42200600;194069000;78942000;52650000;353803000;727735000;;121372000;849107000;1202910000;63373000;10707000;74155000;832306000;877635000;951790000;300071000;-294874000;264852000;251120000;1202910000
FMSA;645665;USD;2015;Q4;2015-12-31;2016-03-15;32291600;30115400;171486000;73566000;70494000;359674000;870997000;;123578000;994575000;1354249000;67206000;17385000;85525000;1205721000;1329092000;1414617000;779096000;-1227663000;405044000;-60368000;1354249000
FMSA;645665;USD;2014;Q4;2014-12-31;2015-03-31;32120765;33494325;76923000;206094000;131613000;455396000;841274000;;217346000;1058620000;1514016000;124567000;17274000;141841000;1235365000;1338701000;1480542000;774275000;-1227663000;497179000;33474000;1514016000
FMSA;645665;USD;2013;Q4;2013-12-31;2014-11-13;31241084;32967957;17815000;139688000;118349000;293590000;748838000;;241003000;989841000;1283431000;118704000;15687000;134391000;1246459000;1314398000;1448789000;735429000;-1227001000;326729000;-165358000;1283431000
WHG;646168;USD;2017;Q4;2017-12-31;2018-02-23;8186057;8551449;105573000;21660000;;138114000;4190000;0;50355000;54545000;192659000;31531000;;31531000;;4732000;36263000;179341000;-49788000;28607000;156396000;192659000
WHG;646168;USD;2016;Q4;2016-12-31;2017-02-23;7989221;8261937;90164000;23429000;;115957000;4280000;;59441000;63721000;179678000;29668000;;29668000;;3941000;33609000;162828000;-44353000;31881000;146069000;179678000
WHG;646168;USD;2015;Q4;2015-12-31;2016-02-25;7816095;8738020;95060000;19618000;;117604000;2192000;;61540000;63732000;181336000;35830000;;44853000;;2516000;47369000;143891000;-34910000;29674000;133967000;181336000
WHG;646168;USD;2014;Q4;2014-12-31;2015-02-26;7526141;8461596;97751000;14540000;;118764000;2633000;;18477000;21110000;139874000;27204000;;27204000;;2663000;29867000;119949000;-29028000;20317000;110007000;139874000
WHG;646168;USD;2013;Q4;2013-12-31;2014-02-28;7315867;8196832;75418000;14468000;;96219000;2746000;;17085000;19831000;116050000;24853000;;24853000;;2534000;27387000;103941000;-23169000;8148000;88663000;116050000
WHG;646168;USD;2012;Q4;2012-12-31;2013-02-28;7166466;7385835;63723000;8920000;;77370000;2145000;;17100000;19245000;96615000;18826000;;18826000;;1238000;20064000;88568000;-18502000;6455000;76551000;96615000
WHG;646168;USD;2011;Q4;2011-12-31;2012-02-28;6950564;7221055;60132000;7707000;;72482000;2239000;;15876000;18115000;90597000;17510000;;17523000;;2317000;19840000;77050000;-14706000;6473000;70757000;90597000
WHG;646168;USD;2010;Q4;2010-12-31;2011-07-20;;;45044000;7348000;;55882000;346000;;16400000;16746000;72628000;10832000;;11744000;;207000;11951000;65718000;-8749000;2782000;60677000;72628000
WHG;646168;USD;2018;Q4;2018-12-31;2019-02-21;8388802;8508352;118230000;18429000;;139739000;4454000;5425000;40867000;50746000;190485000;25695000;;25695000;;3641000;29336000;194218000;-58711000;30525000;161149000;190485000
WBMD;646643;USD;2010;Q4;2010-12-31;2011-06-08;57505000;72782000;400501000;134448000;;547110000;61516000;;333576000;395092000;942202000;53181000;;167551000;;21756000;189307000;9462997000;-129589000;-8580513000;752895000;942202000
TLRA;646927;USD;2017;Q4;2017-12-31;2018-03-02;51198660;51198660;76320000;59288000;;138107000;3194000;;9127000;12321000;150428000;59419000;;60954000;;6335000;67289000;288282000;-8443000;-196468000;83139000;150428000
TLRA;646927;USD;2016;Q4;2016-12-31;2017-03-10;51639440;51639440;43160000;29429000;;124592000;7141000;;22492000;29633000;154225000;32998000;;68424000;;7279000;75703000;283491000;-6037000;-198601000;78522000;154225000
TLRA;646927;USD;2015;Q4;2015-12-31;2016-03-15;52198970;52198970;59887000;70778000;;134386000;10094000;;23644000;33738000;168124000;58742000;;60238000;;6454000;66692000;279141000;;-177654000;101432000;168124000
TLRA;646927;USD;2014;Q4;2014-12-31;2015-03-16;51097946;51097946;77787000;46765000;;126123000;5574000;;46308000;51882000;178005000;37258000;;37293000;;939000;38232000;274099000;;-134424000;139773000;178005000
TLRA;646927;USD;2013;Q4;2013-12-31;2014-03-28;50441322;50441322;92691000;41458000;;136061000;3388000;;51111000;54499000;190560000;32312000;;32597000;;931000;33528000;267772000;;-110935000;157032000;190560000
TLRA;646927;USD;2012;Q4;2012-12-31;2013-08-14;7750619;7750619;32533000;36011000;;69518000;1995000;;58210000;60205000;129723000;21075000;;27411000;;3318000;30729000;17753000;;-81570000;98994000;129723000
TLRA;646927;USD;2018;Q4;2018-12-31;2019-03-19;50272108;50272108;47659000;104387000;;155427000;2789000;;16490000;19279000;174706000;109991000;;111674000;;8637000;120311000;293158000;-31980000;-205834000;54395000;174706000
IAC;647051;USD;2017;Q4;2017-12-31;2018-03-01;82279000;87762000;1635804000;304027000;;2125205000;315170000;64977000;3362458000;3742605000;5867810000;443495000;13750000;799728000;1979469000;2078392000;2878120000;12165279000;-10226721000;595038000;2989690000;5867810000
IAC;647051;USD;2016;Q4;2016-12-31;2017-02-28;79098000;74213000;1418529000;220138000;;1842735000;306248000;122810000;2374080000;2803138000;4645873000;407773000;20000000;713388000;1582484000;1888988000;2602376000;11921831000;-10176600000;290114000;2043497000;4645873000
IAC;647051;USD;2015;Q4;2015-12-31;2016-02-29;82997000;88320000;1520647000;250077000;;1945010000;302817000;137386000;2803478000;3243681000;5188691000;470134000;40000000;768546000;1726954000;2173929000;2942475000;11486585000;-9861350000;331394000;2246216000;5188691000
IAC;647051;USD;2014;Q4;2014-12-31;2015-02-27;83915000;95060000;1151053000;236086000;;1535888000;302459000;114983000;2303555000;2720997000;4256885000;478712000;0;673700000;1080000000;1549616000;2223316000;11415885000;-9661350000;325118000;2033569000;4256885000
IAC;647051;USD;2013;Q4;2013-12-31;2014-02-26;82999000;86953000;1106448000;207408000;;1475386000;293964000;179990000;2285344000;2759298000;4234684000;428691000;;586897000;1080000000;1875525000;2462422000;11562834000;-9830317000;-32735000;1772262000;4234684000
IAC;647051;USD;2012;Q4;2012-12-31;2013-03-01;87717000;94008000;770581000;229830000;;1156750000;270512000;161278000;2217288000;2649078000;3805828000;453546000;15844000;624889000;580000000;1415178000;2040067000;11607634000;-9601218000;-318519000;1765761000;3805828000
IAC;647051;USD;2011;Q4;2011-12-31;2012-02-29;83276000;92564000;869848000;177030000;;1159133000;259588000;173752000;1817392000;2250732000;3409865000;407888000;0;534185000;95844000;865191000;1399376000;11280423000;-8885146000;-477785000;2010489000;3409865000
IAC;647051;USD;2010;Q4;2010-12-31;2011-03-01;96356000;86492000;1306096000;119581000;;1543985000;267928000;200721000;1316445000;1785094000;3329079000;278698000;;356873000;95844000;862269000;1219142000;11048126000;-8363586000;-652018000;2109937000;3329079000
IAC;647051;USD;2009;Q4;2009-12-31;2010-07-29;;;1733588000;93474000;;2000049000;290333000;272930000;1350285000;1913548000;3913597000;232865000;;290277000;95844000;848179000;1138456000;10942367000;-7468532000;-751377000;2775141000;3913597000
IAC;647051;USD;2018;Q4;2018-12-31;2019-03-01;83608000;93310000;2255297000;279189000;;2762739000;318800000;235055000;3557991000;4111846000;6874585000;509793000;13750000;883558000;2245548000;2373539000;3257097000;12022665000;-10309612000;1258794000;3617488000;6874585000
MTCH;647179;USD;2017;Q4;2017-12-31;2018-03-01;273552000;292509000;272624000;116751000;;444744000;61620000;11137000;1612645000;1685402000;2130146000;120678000;;318773000;1252696000;1304068000;1622841000;81356000;0;532211000;507305000;2130146000
MTCH;647179;USD;2016;Q4;2016-12-31;2017-02-28;255172000;272801000;253651000;63853000;;490394000;62954000;55355000;1439975000;1558284000;2048678000;116077000;;314259000;1176493000;1231835000;1546094000;490843000;;182063000;502584000;2048678000
MTCH;647179;USD;2015;Q4;2015-12-31;2016-03-28;208015000;223267000;99795000;65851000;;204695000;48067000;55569000;1601061000;1704697000;1909392000;144323000;40000000;353644000;1176871000;1271030000;1624674000;405019000;;10612000;284718000;1909392000
MTCH;647179;USD;2014;Q4;2014-12-31;2016-03-28;;;127630000;33735000;;189177000;42997000;62979000;1006956000;1112932000;1302109000;106516000;0;241306000;190586000;257349000;498655000;0;;0;803454000;1302109000
MTCH;647179;USD;2018;Q4;2018-12-31;2019-02-28;278143000;295175000;186947000;99052000;;343765000;58351000;9076000;1641869000;1709296000;2053061000;145499000;;355434000;1515911000;1571763000;1927197000;-57293000;-133455000;453778000;125864000;2053061000
ZG;647182;USD;2018;Q4;2018-12-31;2019-02-21;203741000;203741000;1554925000;66083000;162829000;1880313000;135172000;;2275631000;2410803000;4291116000;101960000;;287498000;699020000;736439000;1023937000;3939863000;;-671779000;3267179000;4291116000
ZG;647182;USD;2017;Q4;2017-12-31;2018-02-15;189523000;180790000;762539000;54396000;0;841525000;112271000;;2276721000;2388992000;3230517000;84069000;;118387000;385416000;451307000;569694000;3254166000;;-592243000;2660823000;3230517000
ZG;647182;USD;2016;Q4;2016-12-31;2017-02-07;181876000;172798000;507515000;40527000;;582859000;98288000;;2468530000;2566818000;3149677000;66741000;;97242000;367404000;518848000;616090000;3030872000;;-497043000;2533587000;3149677000
ZG;647182;USD;2015;Q4;2015-12-31;2016-02-12;178438000;178438000;520289000;29789000;;574094000;85523000;;2476083000;2561606000;3135700000;57800000;;80422000;230000000;376225000;456647000;2956129000;;-276605000;2679053000;3135700000
ZG;647182;USD;2014;Q4;2014-12-31;2015-05-12;105475746;105475746;372594000;18684000;;401337000;41600000;83326000;123467000;248393000;649730000;32976000;;49196000;;11755000;60951000;716510000;;-127731000;588779000;649730000
GDDY;647209;USD;2017;Q4;2017-12-31;2018-02-27;128880000;256039000;595000000;18400000;;1059500000;297900000;;4380900000;4678800000;5738300000;529200000;16700000;1810700000;2410800000;3381100000;5191800000;484400000;;87700000;546400000;5738200000
GDDY;647209;USD;2016;Q4;2016-12-31;2017-02-28;87901000;74891000;572700000;8000000;;932800000;231000000;;2623100000;2854100000;3786900000;204700000;4000000;1262200000;1035700000;1810500000;3072700000;608300000;;-48700000;714000000;3786700000
GDDY;647209;USD;2015;Q4;2015-12-31;2016-03-03;66244000;66244000;352500000;4800000;;693900000;225000000;;2579900000;2804900000;3498800000;166400000;4200000;1113600000;1039800000;1704200000;2817800000;454600000;;-32200000;680800000;3498600000
GDDY;647209;USD;2014;Q4;2014-12-31;2015-08-06;38826000;38826000;142000000;3500000;;459400000;220900000;;2580400000;2801300000;3260700000;146400000;4400000;972200000;1410400000;1878100000;2850300000;410400000;;0;410400000;3260700000
GDDY;647209;USD;2018;Q4;2018-12-31;2019-02-22;168159000;183352000;951300000;26400000;;1427300000;299000000;;4357100000;4656100000;6083400000;475900000;16600000;1886200000;2394200000;3372700000;5258900000;699800000;;164800000;824300000;6083200000
RMBL;647388;USD;2017;Q4;2017-12-31;2018-02-27;12384322;;9170652;577107;2834666;12891305;3360832;;1900693;5261525;18152830;1213170;1081593;2294763;1459410;1492075;3786838;23385289;;-9019297;14365992;18152830
RMBL;647388;USD;2016;Q4;2016-12-31;2017-02-14;4301671;4301671;1350580;0;0;1352247;0;;45515;45515;1397762;219101;0;219101;1282;85220;304321;1540415;;-445974;1093441;1397762
RMBL;647388;USD;2015;Q4;2015-12-31;2016-03-14;-814769;;3713;;;3713;;;2692;2692;6405;19936;100000;160936;0;1865;162801;70000;;-221396;-156396;6405
RMBL;647388;USD;2014;Q4;2014-12-31;2015-03-17;5779673;;6195;;;6195;;;4750;4750;10945;4779;20000;104779;;5026;109805;70000;;-168860;-98860;10945
RMBL;647388;USD;2018;Q4;2018-12-31;2019-04-01;18476521;;9134902;8465810;52191523;77539180;5177877;;26209324;31387201;108926381;10760950;58555006;69315956;8792919;8792919;78108875;65017303;;-34201114;30817506;108926381
ANGI;647538;USD;2017;Q4;2017-12-31;2018-03-14;477520000;477520000;221521000;28085000;;262378000;53292000;;1151592000;1204884000;1467262000;94104000;13750000;171041000;258312000;271827000;442868000;1112878000;;-121764000;1024394000;1467262000
ANGI;647538;USD;2016;Q4;2016-12-31;2018-03-14;;;36377000;18696000;;63812000;23645000;;208060000;231705000;295517000;45982000;0;67648000;0;51475000;119123000;154852000;;0;176394000;295517000
ANGI;647538;USD;2018;Q4;2018-12-31;2019-03-01;496431000;546477000;361931000;27263000;;474127000;70859000;;1263041000;1333900000;1808027000;126070000;13750000;201237000;244971000;266640000;467877000;1333599000;;-18797000;1340150000;1808027000
GRMM;647541;USD;2017;Q4;2017-12-31;2018-04-17;306413639;306413639;436869;445388;426998;2344634;849893;;15852253;16702146;19046780;2522193;75000;5858457;5416934;6083429;11941886;48025806;;-40843568;7104894;19046780
GRMM;647541;USD;2016;Q4;2016-12-31;2017-03-27;249346854;249346854;443494;550145;390931;1526778;559538;0;14899322;15458860;16985638;1951679;0;4418104;3951278;6122704;10540808;41297395;;-34797909;6444830;16985638
GRMM;647541;USD;2015;Q4;2015-12-31;2016-05-11;7542194;7542194;107673;17453;;130982;;;32872;32872;163854;56453;;91204;;0;91204;2289053;;-2216403;72650;163854
GRMM;647541;USD;2018;Q4;2018-12-31;2019-04-16;133906799;133906799;633593;1123493;9018;2215944;1036313;;15557866;16594179;18810123;2156419;4505041;8963333;2410614;3064411;12027744;52392840;;-45457207;6782379;18810123
NYT;647918;USD;2017;Q4;2017-12-31;2018-02-27;162342000;166247000;491500000;184885000;;749699000;640939000;241411000;467731000;1350081000;2099780000;340603000;;415657000;250209000;786760000;1202417000;181383000;-171211000;1310136000;897363000;2099780000
NYT;647918;USD;2016;Q4;2016-12-31;2017-02-22;161196000;166192000;550227000;197355000;;796178000;596743000;187299000;605175000;1389217000;2185395000;332051000;;398737000;246978000;942414000;1341151000;166931000;-171211000;1331911000;844244000;2185395000
NYT;647918;USD;2015;Q4;2015-12-31;2016-02-24;162165000;166407000;613415000;207180000;;862532000;632439000;291136000;631583000;1555158000;2417690000;315024000;188377000;563585000;242851000;1025650000;1589235000;163256000;-156155000;1328744000;828455000;2417690000
NYT;647918;USD;2014;Q4;2014-12-31;2015-02-24;150462000;170682000;813350000;212690000;;1148095000;665758000;167820000;584801000;1418379000;2566474000;318110000;223662000;600508000;426458000;1237617000;1838125000;54469000;-86253000;1291907000;728349000;2566474000
NYT;647918;USD;2013;Q4;2013-12-31;2014-02-26;151480000;169282000;847625000;202303000;;1172267000;713356000;176155000;510774000;1400285000;2572552000;290483000;21000;348511000;684142000;1377507000;1726018000;48256000;-86253000;1283518000;846534000;2572552000
NYT;647918;USD;2012;Q4;2012-12-31;2013-02-28;148462000;161251000;955310000;197589000;;1397568000;773469000;4444000;631989000;1409902000;2807470000;333447000;;423156000;696752000;1718678000;2141834000;40719000;-96278000;1230450000;665636000;2807470000
NYT;647918;USD;2011;Q4;2011-12-31;2012-02-23;147452000;158156000;279997000;247436000;17780000;1263935000;937140000;0;663555000;1600695000;2864630000;450873000;;513976000;698220000;1813827000;2327803000;47107000;-110974000;1094603000;536827000;2864630000
NYT;647918;USD;2010;Q4;2010-12-31;2011-02-22;145945000;157711000;399642000;302245000;16132000;857232000;1156786000;;1271723000;2428509000;3285741000;431443000;38000;504377000;996405000;2117288000;2621665000;55167000;-134463000;1126294000;664076000;3285741000
NYT;647918;USD;2009;Q4;2009-12-31;2010-08-05;144530000;153246000;36520000;342075000;16303000;500573000;1250021000;;1337963000;2587984000;3088557000;422996000;;500500000;769176000;1980814000;2481314000;58518000;-149302000;1018590000;607243000;3088557000
NYT;647918;USD;2018;Q4;2018-12-31;2019-02-26;165195000;167654000;612805000;222464000;;893946000;638846000;213558000;450773000;1303177000;2197123000;335630000;253630000;673304000;0;481178000;1154482000;223712000;-171211000;1506004000;1042641000;2197123000
STMP;650092;USD;2017;Q4;2017-12-31;2018-02-28;17491000;18705000;153903000;80797000;;271493000;37507000;;370104000;407611000;679104000;103076000;8392000;115339000;60642000;65952000;181291000;962282000;-387545000;-76930000;497813000;679104000
STMP;650092;USD;2016;Q4;2016-12-31;2017-03-01;17021000;18028000;108443000;62756000;;184280000;36829000;;389020000;425849000;610129000;86205000;6329000;96392000;141025000;141025000;237417000;855397000;-252981000;-229715000;372712000;610129000
STMP;650092;USD;2015;Q4;2015-12-31;2016-02-29;16648000;15669000;73679000;55052000;;137076000;31707000;1529000;358302000;391538000;528614000;60816000;4267000;132292000;157353000;157353000;289645000;716305000;-172410000;-304944000;238969000;528614000
STMP;650092;USD;2014;Q4;2014-12-31;2015-03-16;15948000;16368000;47415000;12325000;;65811000;30427000;10215000;148278000;188920000;254731000;22521000;0;33910000;0;15790000;49700000;678126000;-172410000;-300746000;205031000;254731000
STMP;650092;USD;2013;Q4;2013-12-31;2014-03-17;16134000;16640000;73198000;17504000;;97243000;29763000;14012000;46100000;89875000;187118000;13928000;;15353000;;0;15353000;668775000;-159522000;-337628000;171765000;187118000
STMP;650092;USD;2012;Q4;2012-12-31;2013-03-15;15495000;16128000;35899000;14432000;;55933000;28631000;10720000;35568000;74919000;130852000;16366000;;17898000;;0;17898000;649744000;-155260000;-381781000;112954000;130852000
STMP;650092;USD;2011;Q4;2011-12-31;2012-03-14;15707000;16550000;55484000;10466000;;71926000;2165000;13379000;20510000;36054000;107980000;12075000;;13973000;;0;13973000;637532000;-123472000;-420338000;94007000;107980000
STMP;650092;USD;2010;Q4;2010-12-31;2011-08-09;58072299;58695825;20362000;4868000;;29245000;1694000;14937000;11566000;28197000;57442000;9011000;;13204000;;0;13204000;608569000;-118151000;-446603000;44238000;57442000
STMP;650092;USD;2018;Q4;2018-12-31;2019-03-01;17988000;18585000;113757000;83595000;;229611000;36337000;;586826000;623163000;852774000;133626000;10454000;151239000;50189000;87870000;239109000;1049725000;-528529000;91712000;613665000;852774000
NXST;650370;USD;2017;Q4;2017-12-31;2018-03-01;45778000;47530000;115652000;562943000;;1056218000;734138000;;5691291000;6425429000;7481647000;229980000;109467000;670703000;4269652000;5229634000;5900337000;1343014000;-78063000;299523000;1581310000;7481647000
NXST;650370;USD;2016;Q4;2016-12-31;2017-02-28;30715000;31800000;87680000;218058000;;363217000;276153000;;2326715000;2602868000;2966085000;135259000;44605000;189578000;2314326000;2492153000;2681731000;387237000;-41513000;-176583000;284354000;2966085000
NXST;650370;USD;2015;Q4;2015-12-31;2016-02-29;30617000;31575000;43416000;192991000;;260028000;266583000;;1308523000;1575106000;1835134000;97434000;39649000;146061000;1454075000;1602700000;1748761000;396540000;-47746000;-268120000;86373000;1835134000
NXST;650370;USD;2014;Q4;2014-12-31;2015-03-02;30964000;32104000;131912000;127878000;;275927000;237739000;;900436000;1138175000;1414102000;63538000;27775000;97266000;1204529000;1260299000;1357565000;398341000;;-345804000;56537000;1414102000
NXST;650370;USD;2013;Q4;2013-12-31;2014-03-03;30475000;25700000;40028000;109430000;;201166000;212259000;;750297000;962556000;1163722000;39053000;13139000;83922000;1064262000;1093031000;1176953000;397123000;;-410354000;-13231000;1163722000
NXST;650370;USD;2012;Q4;2012-12-31;2013-03-15;29118000;31245000;68999000;74553000;;163326000;180162000;;602327000;782489000;945815000;40132000;11269000;58003000;855467000;885573000;943576000;410808000;;-408569000;2239000;945815000
NXST;650370;USD;2011;Q4;2011-12-31;2012-03-16;28803000;28803000;7546000;71279000;;85990000;146613000;;348356000;494969000;580959000;33668000;6582000;46371000;644837000;717992000;764363000;406942000;;-590346000;-183404000;580959000
NXST;650370;USD;2010;Q4;2010-12-31;2011-08-11;;;23658000;63501000;;107216000;137036000;;358284000;495320000;602536000;28558000;1000000;53594000;652984000;724107000;777701000;403290000;;-578455000;-175165000;602536000
NXST;650370;USD;2018;Q4;2018-12-31;2019-02-27;45614000;47478000;145115000;547285000;;767075000;731538000;;5563417000;6294955000;7062030000;243725000;96093000;404172000;3884910000;4788874000;5193046000;1352404000;-105685000;620371000;1868984000;7062030000
SFLY;650373;USD;2017;Q4;2017-12-31;2018-02-20;32283000;36255000;667915000;82317000;11019000;802634000;266860000;9242000;456064000;732166000;1534800000;250721000;297054000;572424000;292457000;411652000;984076000;996304000;;-447358000;550724000;1534800000
SFLY;650373;USD;2016;Q4;2016-12-31;2017-02-14;33683000;38055000;315576000;57365000;11751000;432776000;284110000;14479000;464211000;762800000;1195576000;197659000;0;220588000;278792000;415827000;636415000;949867000;;-390674000;559161000;1195576000
SFLY;650373;USD;2015;Q4;2015-12-31;2016-02-16;35170000;35170000;311781000;55222000;13466000;412297000;281779000;29005000;482246000;793030000;1205327000;184463000;;211792000;264361000;387473000;599265000;900222000;;-294092000;606062000;1205327000
SFLY;650373;USD;2014;Q4;2014-12-31;2015-02-18;38414000;38414000;445409000;31105000;13016000;549158000;241742000;29928000;511450000;783120000;1332278000;165571000;;196986000;255218000;377486000;574472000;838317000;;-80458000;757806000;1332278000
SFLY;650373;USD;2013;Q4;2013-12-31;2014-02-14;;;499084000;21641000;9629000;578556000;155727000;0;531859000;687586000;1266142000;141104000;;165218000;243493000;312829000;478047000;771879000;;16216000;788095000;1266142000
SFLY;650373;USD;2012;Q4;2012-12-31;2013-02-14;;;245088000;13574000;5032000;286675000;92667000;;485782000;578449000;865124000;119975000;;137820000;0;36018000;173838000;652114000;;39172000;691286000;865124000
SFLY;650373;USD;2011;Q4;2011-12-31;2012-02-13;;;179915000;12997000;3726000;211106000;54123000;;444657000;498780000;709886000;68741000;;80847000;;20042000;100889000;589071000;;19926000;608997000;709886000
SFLY;650373;USD;2010;Q4;2010-12-31;2011-08-02;;;252244000;4845000;3580000;271185000;39726000;;32919000;72645000;343830000;61172000;;70903000;;3320000;74223000;263729000;;5878000;269607000;343830000
CARS;650652;USD;2017;Q4;2017-12-31;2018-03-06;71641000;71773000;20563000;100857000;;142639000;39740000;11053000;2317607000;2368400000;2511039000;43791000;21158000;90149000;557194000;741762000;831911000;1502546000;;176582000;1679128000;2511039000
CARS;650652;USD;2016;Q4;2016-12-31;2017-06-20;71588000;71588000;8896000;98303000;;119541000;20461000;11788000;2395476000;2427725000;2547266000;61981000;;71984000;;2475282000;2547266000;;;;0;2547266000
CARS;650652;USD;2018;Q4;2018-12-31;2019-02-28;68549000;68707000;25463000;108921000;;153937000;41482000;10271000;2394859000;2446612000;2600549000;64972000;26853000;110710000;665306000;862916000;973626000;1508684000;;118239000;1626923000;2600549000
TTD;650768;USD;2017;Q4;2017-12-31;2018-02-28;41135000;44478000;155950000;599565000;;765813000;17405000;;13946000;31351000;797164000;518532000;;518532000;27000000;33049000;551581000;209603000;;35980000;245583000;797164000
TTD;650768;USD;2016;Q4;2016-12-31;2017-02-16;38750000;29673000;133400000;377240000;;516403000;14779000;;6414000;21193000;537596000;344136000;;344136000;25847000;29080000;373216000;179198000;;-14818000;164380000;537596000
TTD;650768;USD;2015;Q4;2015-12-31;2016-11-10;10581000;17358000;4047000;191943000;;199802000;6625000;;3804000;10429000;210231000;118900000;;118900000;51815000;52985000;171885000;1039000;;13103000;38346000;210231000
TTD;650768;USD;2018;Q4;2018-12-31;2019-02-22;43244000;46811000;207232000;834764000;;1056523000;33046000;;28303000;61349000;1117872000;713991000;;713991000;;9314000;723305000;270447000;;124120000;394567000;1117872000
QUOT;651172;USD;2017;Q4;2017-12-31;2018-02-16;91053000;91053000;394537000;81189000;;484463000;16610000;;128002000;144612000;629075000;20004000;;80318000;145821000;150716000;231034000;686026000;;-287285000;398041000;629075000
QUOT;651172;USD;2016;Q4;2016-12-31;2017-02-16;86192000;86192000;175346000;71945000;;253584000;16376000;;92796000;109172000;362756000;18170000;;45890000;;5117000;51007000;647475000;-96574000;-238404000;311749000;362756000
QUOT;651172;USD;2015;Q4;2015-12-31;2016-03-11;83251000;83251000;159947000;63239000;;228483000;25128000;;67460000;92588000;321071000;23424000;;50936000;;4645000;55581000;570589000;-85427000;-218925000;265490000;321071000
QUOT;651172;USD;2014;Q4;2014-12-31;2015-03-19;81163000;81163000;201075000;51061000;;256305000;25399000;;50103000;75502000;331807000;21219000;;51468000;;3451000;54919000;531019000;-61935000;-192195000;276888000;331807000
QUOT;651172;USD;2013;Q4;2013-12-31;2014-05-08;20937000;20937000;38972000;42185000;;85177000;29942000;;19117000;49059000;134236000;19310000;;63757000;;272725000;336482000;28403000;-61935000;-168751000;-202246000;134236000
QUOT;651172;USD;2018;Q4;2018-12-31;2019-02-27;94284000;94284000;322766000;112108000;;444918000;15579000;;201856000;217435000;662353000;30167000;;92108000;155719000;190158000;282266000;703024000;;-322093000;380087000;662353000
SCHL;651267;USD;2018;Q4;2018-05-31;2018-07-25;34900000;34700000;391900000;204900000;294900000;958300000;555600000;;311500000;867100000;1825400000;413200000;7900000;445800000;0;58800000;504600000;614800000;-303500000;1065200000;1320800000;1825400000
SCHL;651267;USD;2017;Q4;2017-05-31;2017-07-24;35100000;35700000;444100000;199200000;282500000;970500000;475300000;;314600000;789900000;1760400000;356200000;6200000;387100000;;65400000;452500000;607200000;-296300000;1091200000;1307900000;1760400000
SCHL;651267;USD;2016;Q4;2016-05-31;2016-07-26;34500000;34900000;399700000;196300000;271200000;950100000;437600000;;325400000;763000000;1713100000;347300000;6300000;378300000;;77200000;455500000;601100000;-316600000;1059800000;1257600000;1713100000
SCHL;651267;USD;2015;Q4;2015-05-31;2015-07-29;33000000;34000000;506800000;193800000;257600000;1110500000;439700000;;272100000;711800000;1822300000;506000000;6000000;547600000;;69800000;617400000;591900000;-349900000;1039900000;1204900000;1822300000
SCHL;651267;USD;2014;Q4;2014-05-31;2014-07-29;32300000;32800000;20900000;212100000;256400000;663000000;465700000;;399800000;865500000;1528500000;344600000;15800000;429800000;120000000;183300000;613100000;581200000;-375700000;765100000;915400000;1528500000
SCHL;651267;USD;2013;Q4;2013-05-31;2013-07-29;31800000;32400000;87400000;214900000;278100000;721200000;311600000;;408200000;719800000;1441000000;370100000;2200000;421700000;57500000;154900000;576600000;583300000;-392400000;738900000;864400000;1441000000
SCHL;651267;USD;2012;Q4;2012-05-31;2012-07-27;31500000;32000000;194900000;313900000;295300000;930000000;327200000;;413100000;740300000;1670300000;445800000;7500000;502500000;209200000;337500000;840000000;583400000;-402800000;723900000;830300000;1670300000
SCHL;651267;USD;2011;Q4;2011-05-31;2011-07-27;31000000;31500000;105300000;220300000;308700000;758100000;339000000;;389900000;728900000;1487000000;328800000;44000000;422700000;214900000;324300000;747000000;577000000;-418900000;635800000;740000000;1487000000
SCHL;651267;USD;2010;Q4;2010-05-31;2010-10-01;;;244100000;212500000;315700000;887000000;316600000;;396800000;713400000;1600400000;299500000;51200000;393400000;257500000;376600000;770000000;569600000;-261600000;607800000;830400000;1600400000
SCHL;651267;USD;2019;Q4;2019-05-31;2019-07-29;35300000;37600000;334100000;250100000;323700000;960600000;577700000;;340200000;917900000;1878500000;403400000;7300000;541500000;0;64200000;605700000;621200000;-302600000;1012600000;1272800000;1878500000
GCI;651516;USD;2017;Q4;2017-12-31;2018-02-28;111788000;119519000;120589000;352546000;;589848000;933334000;64830000;981965000;1980129000;2569977000;387406000;;510197000;355000000;1042385000;1552582000;1788116000;-50046000;-64158000;1017395000;2569977000
GCI;651516;USD;2016;Q4;2016-12-31;2017-02-22;114689000;119508000;114324000;358041000;40426000;603506000;1087701000;82310000;1071164000;2241175000;2844681000;438724000;;571987000;400000000;1415933000;1987920000;1771071000;-32667000;1269000;856761000;2844681000
GCI;651516;USD;2015;Q4;2015-12-31;2016-02-25;115556000;118694000;196696000;330473000;25777000;629536000;896585000;64289000;837389000;1798263000;2427799000;411527000;;490494000;0;878729000;1369223000;1709447000;0;22553000;1058576000;2427799000
GCI;651516;USD;2014;Q4;2014-12-31;2015-08-06;114959000;114959000;71947000;357523000;38944000;531070000;934483000;63125000;855782000;1853390000;2384460000;332460000;;409583000;;2652989000;3062572000;0;;0;-678112000;2384460000
GCI;651516;USD;2018;Q4;2018-12-31;2019-02-27;113131000;117758000;93559000;343617000;;580561000;796009000;100861000;1000980000;1897850000;2478411000;387003000;;551568000;304264000;891737000;1443305000;1823283000;-50046000;-121435000;1035106000;2478411000
WIFI;651519;USD;2018;Q4;2018-12-31;2019-03-01;42596000;-128757736;149412000;42766000;;199993000;314179000;;88728000;402907000;602900000;84196000;2411000;171191000;153288000;301587000;472778000;259136000;;-129930000;130122000;602900000
WIFI;651519;USD;2017;Q4;2017-12-31;2018-03-12;40962000;-118174704;26685000;26148000;;59202000;262359000;;62748000;325107000;384309000;53994000;6646000;122348000;6747000;162931000;285279000;230683000;;-131967000;99030000;384309000
WIFI;651519;USD;2016;Q4;2016-12-31;2017-03-13;38413000;-113534900;19485000;42978000;;67807000;250765000;;62409000;313174000;380981000;43239000;5087000;99195000;20487000;183240000;282435000;211279000;;-112601000;98546000;380981000
WIFI;651519;USD;2015;Q4;2015-12-31;2016-03-11;37241000;-110007604;14718000;43552000;;62146000;214500000;;64366000;278866000;341012000;65553000;2636000;93948000;19086000;135029000;228977000;197616000;;-85176000;112035000;341012000
WIFI;651519;USD;2014;Q4;2014-12-31;2015-03-16;36160000;36160000;10463000;27917000;;42296000;111772000;;64547000;176319000;218615000;30113000;1184000;56785000;3006000;34400000;91185000;189729000;;-62884000;127430000;218615000
WIFI;651519;USD;2013;Q4;2013-12-31;2014-03-17;35452000;33916000;60300000;16326000;;80929000;67560000;;67026000;134586000;215515000;28171000;526000;47989000;473000;27093000;75082000;182931000;;-43363000;140433000;215515000
WIFI;651519;USD;2012;Q4;2012-12-31;2013-03-18;35248000;37896000;99696000;13043000;;116045000;42411000;;44076000;86487000;202532000;15967000;42000;33338000;136000;24695000;58033000;178223000;;-34547000;144499000;202532000
WIFI;651519;USD;2011;Q4;2011-12-31;2012-04-13;33760000;40078000;93933000;7382000;;105249000;39717000;;43954000;83671000;188920000;17332000;205000;31112000;197000;28729000;59841000;170724000;;-41842000;129079000;188920000
WIFI;651519;USD;2010;Q4;2010-12-31;2011-08-11;5834000;34197000;35094000;7946000;;46761000;36024000;;49258000;85282000;132043000;18480000;420000;29729000;;153299000;183028000;;-4575000;-46504000;-50985000;132043000
HMHC;651625;USD;2017;Q4;2017-12-31;2018-02-22;123060008;122855437;235428000;192569000;150694000;735371000;148659000;;1679561000;1828220000;2563591000;182385000;8000000;506749000;760194000;1261649000;1768398000;4881272000;-518030000;-3521527000;795193000;2563591000
HMHC;651625;USD;2016;Q4;2016-12-31;2017-02-23;122620608;121614470;306943000;216006000;162415000;705720000;175202000;;1850549000;2025751000;2731471000;191824000;8000000;505150000;764738000;1346281000;1851431000;4869705000;-518030000;-3418340000;880040000;2731471000
HMHC;651625;USD;2015;Q4;2015-12-31;2016-02-25;129544927;124900936;432403000;256099000;171446000;882825000;149680000;;2089445000;2239125000;3121950000;227605000;8000000;506608000;769283000;1417021000;1923629000;4834844000;-463013000;-3133782000;1198321000;3121950000
HMHC;651625;USD;2014;Q4;2014-12-31;2015-02-26;141578966;135787541;743345000;255669000;183961000;1201640000;138362000;;1650646000;1789008000;2990648000;193172000;67500000;450631000;175625000;780337000;1230968000;4786382000;;-2999913000;1759680000;2990648000
HMHC;651625;USD;2013;Q4;2013-12-31;2014-05-08;209917348;209479346;425349000;318101000;182194000;971616000;140848000;;1797922000;1938770000;2910386000;202540000;2500000;353131000;243125000;706979000;1060110000;4751989000;0;-2888422000;1850276000;2910386000
HMHC;651625;USD;2018;Q4;2018-12-31;2019-02-28;123580392;123263128;303198000;203574000;184209000;706278000;125925000;;1662921000;1788846000;2495124000;195079000;8000000;487692000;755649000;1238962000;1726654000;4894655000;-518030000;-3562971000;768470000;2495124000
WEB;651626;USD;2017;Q4;2017-12-31;2018-02-23;47064000;49617000;11976000;25424000;;113941000;57188000;;1325114000;1382302000;1496243000;54874000;16612000;333847000;630358000;887760000;1221607000;585228000;-111093000;-194996000;274636000;1496243000
WEB;651626;USD;2016;Q4;2016-12-31;2017-02-28;49158000;52350000;20447000;20567000;;115414000;53132000;;1345287000;1398419000;1513833000;52401000;16847000;324732000;647294000;953649000;1278381000;578536000;-62430000;-276634000;235452000;1513833000
WEB;651626;USD;2015;Q4;2015-12-31;2016-02-26;49703000;52529000;18706000;12892000;;103529000;41963000;;1011847000;1053810000;1157339000;37042000;11169000;271200000;411409000;647962000;919162000;565699000;-44750000;-280624000;238177000;1157339000
WEB;651626;USD;2014;Q4;2014-12-31;2015-02-27;50828000;50828000;22485000;16932000;;141543000;44000000;;1052036000;1096036000;1237579000;30874000;6193000;259530000;500262000;803959000;1063489000;553043000;-6975000;-370585000;174090000;1237579000
WEB;651626;USD;2013;Q4;2013-12-31;2014-02-28;49790000;49790000;13806000;17062000;;138444000;42090000;;1097225000;1139315000;1277759000;38223000;6586000;257316000;556506000;850398000;1107714000;528152000;0;-358127000;170045000;1277759000
WEB;651626;USD;2012;Q4;2012-12-31;2013-03-06;47090000;47090000;15181000;16247000;;120388000;40079000;;1167512000;1207591000;1327979000;34600000;4681000;233932000;688140000;932434000;1166366000;454071000;;-292463000;161613000;1327979000
WEB;651626;USD;2011;Q4;2011-12-31;2012-03-13;40788000;40788000;13364000;13094000;;112519000;25696000;;1261265000;1286961000;1399480000;36840000;4182000;191362000;714703000;936362000;1127724000;442002000;;-170246000;271756000;1399480000
WEB;651626;USD;2010;Q4;2010-12-31;2011-08-08;25713000;21177000;16307000;8100000;;42920000;8765000;;247804000;256569000;299489000;15351000;9533000;65053000;93623000;130829000;195882000;263480000;-1896000;-157937000;103607000;299489000
TCX;651784;USD;2017;Q4;2017-12-31;2018-03-06;10582247;10819600;18049164;12376104;2944246;153861445;24620298;;172168592;196788890;350650335;15839750;18289853;178560521;58634174;110742690;289303211;17534929;;42675805;61347124;350650335
TCX;651784;USD;2016;Q4;2016-12-31;2017-03-08;10450966;10639933;15105075;10925622;1210789;83282117;13450438;;57680817;71131255;154413372;13961698;2233110;84429363;8015698;29080833;113510196;17318421;;20399511;40903176;154413372
TCX;651784;USD;2015;Q4;2015-12-31;2016-03-09;10699367;11030937;7723253;7171388;903775;67867162;7126676;;54136841;61263517;129130679;10931174;3500000;78261022;0;21503634;99764656;23057028;;4381849;29366023;129130679
TCX;651784;USD;2014;Q4;2014-12-31;2015-03-11;11314661;11764679;8271377;6789685;393774;74465179;1609787;;49720900;51330687;125795866;8461150;;68418443;;21735030;90153473;43220117;;-6955283;35642393;125795866
TCX;651784;USD;2013;Q4;2013-12-31;2014-03-18;10913429;11568117;12418888;5305403;309686;68110022;1757836;;51484971;53242807;121352829;7772330;6300000;73444093;;20991518;94435611;40491578;;-13329379;26917218;121352829
TCX;651784;USD;2012;Q4;2012-12-31;2012-03-16;11525714;12431117;6415679;4413265;587104;63811198;1352144;;53609801;54961945;118773143;6218643;3700000;70786630;;21436306;92222936;44015946;;-17509843;26550207;118773143
TCX;651784;USD;2011;Q4;2011-12-31;2012-03-16;13370997;14500288;6408209;3880184;205597;58326424;1437564;;55925571;57363135;115689559;3847210;850000;63244690;;22025882;85270572;52352972;;-21933985;30418987;115689559
TCX;651784;USD;2010;Q4;2010-12-31;2011-08-11;13540444;14038261;4205729;3021995;;48062431;1552349;;51865887;53418236;101480667;3558252;1305883;55812421;;21747009;77559430;52025453;;-28104216;23921237;101480667
TTGT;652015;USD;2017;Q4;2017-12-31;2018-03-13;110117612;113001351;33616000;29601000;;67608000;9786000;496000;95279000;105561000;173169000;6500000;9888000;23986000;22339000;28436000;52422000;300816000;-170816000;-9318000;120747000;173169000
TTGT;652015;USD;2016;Q4;2016-12-31;2017-03-10;119723241;123001056;29473000;22551000;;57937000;9232000;7801000;95107000;112140000;170077000;5712000;6157000;17948000;32286000;34566000;52514000;296905000;-162731000;-16363000;117563000;170077000
TTGT;652015;USD;2015;Q4;2015-12-31;2016-03-11;131753546;137799039;25429000;26549000;;59476000;8922000;9262000;100199000;118383000;177859000;6110000;;15031000;;2827000;17858000;293054000;-113949000;-18782000;160001000;177859000
TTGT;652015;USD;2014;Q4;2014-12-31;2015-03-13;33320251;36245806;24755000;23200000;;53471000;9215000;13428000;101370000;124013000;177484000;9583000;;16523000;;5115000;21638000;280752000;-98851000;-25968000;155846000;177484000
TTGT;652015;USD;2013;Q4;2013-12-31;2014-03-17;33363968;32910968;29813000;22116000;;58000000;9457000;3959000;105566000;118982000;176982000;7161000;;14258000;;5662000;19920000;270774000;-83862000;-30049000;157062000;176982000
TTGT;652015;USD;2012;Q4;2012-12-31;2013-03-18;40469402;40956235;55019000;24185000;;81493000;8817000;21321000;108561000;138699000;220192000;8861000;;14846000;;6032000;20878000;263472000;-35810000;-28212000;199314000;220192000
TTGT;652015;USD;2011;Q4;2011-12-31;2012-03-15;39343580;43630804;56470000;26272000;;85811000;7942000;6751000;108683000;123376000;209187000;8125000;;15140000;;4372000;19512000;257504000;-35343000;-32236000;189675000;209187000
TTGT;652015;USD;2010;Q4;2010-12-31;2011-08-09;42450000;42450000;50134000;24678000;;76562000;6235000;0;110961000;117196000;193758000;8133000;;14786000;;5112000;19898000;246123000;-35343000;-36925000;173860000;193758000
TTGT;652015;USD;2018;Q4;2018-12-31;2019-03-13;110869831;114525221;35173000;30042000;;70118000;10901000;;95444000;106345000;176463000;7739000;1241000;14553000;23714000;29325000;43878000;307068000;-177905000;3637000;132585000;176463000
HMTV;652016;USD;2017;Q4;2017-12-31;2018-03-15;39111000;38163000;124299000;20007000;;166715000;24433000;30907000;275831000;331171000;497886000;21861000;2133000;31605000;206610000;227377000;258982000;265334000;-57303000;30401000;238904000;497886000
HMTV;652016;USD;2016;Q4;2016-12-31;2017-03-15;40477000;40785000;163090000;25566000;;203515000;25501000;;301425000;326926000;530441000;26345000;;30051000;210377000;231050000;261101000;261055000;-35069000;43837000;269340000;530441000
HMTV;652016;USD;2015;Q4;2015-12-31;2016-03-14;43124000;44530000;179532000;25519000;;216866000;25397000;;306633000;332030000;548896000;25964000;8278000;39850000;209756000;230405000;270255000;256555000;-3144000;25837000;278641000;548896000
HMTV;652016;USD;2014;Q4;2014-12-31;2015-03-31;84513828;85340391;142010000;24763000;;185841000;23867000;;308689000;332556000;518397000;20766000;2250000;28031000;219652000;233953000;261984000;246862000;-1961000;12098000;256413000;518397000
HMTV;652016;USD;2013;Q4;2013-12-31;2014-03-28;83817828;83817828;176622000;15589000;;207651000;24675000;;217794000;242469000;450120000;14969000;1750000;22042000;171568000;187290000;209332000;240821000;-938000;1541000;240788000;450120000
HMTV;652016;USD;2012;Q4;2012-12-31;2013-08-14;;;10084000;10511000;;29409000;26861000;;59588000;86449000;115858000;12953000;4608000;20769000;53331000;55430000;76199000;34608000;;5838000;39659000;115858000
HMTV;652016;USD;2018;Q4;2018-12-31;2019-03-12;38999000;38999000;94478000;30840000;;144824000;32209000;51658000;272576000;356443000;501267000;28125000;2134000;39918000;205090000;227950000;267868000;270349000;-59088000;19495000;233399000;501267000
EVC;652141;USD;2017;Q4;2017-12-31;2018-03-30;89980078;91613078;39560000;84348000;;352462000;60337000;;353168000;413505000;765967000;57563000;3000000;62522000;292489000;354575000;417097000;888660000;;-539730000;348870000;765967000
EVC;652141;USD;2016;Q4;2016-12-31;2017-03-10;89740353;91649544;61520000;65072000;;131462000;55368000;;331091000;386459000;517921000;30810000;3750000;34560000;286697000;299905000;334465000;904877000;;-718444000;183456000;517921000
EVC;652141;USD;2015;Q4;2015-12-31;2016-03-09;88226972;90579711;47924000;66399000;;120028000;57874000;;347060000;404934000;524962000;29787000;3750000;33537000;309587000;324152000;357689000;910237000;;-738849000;167273000;524962000
EVC;652141;USD;2014;Q4;2014-12-31;2015-03-06;87581354;90388540;31260000;64956000;;101511000;56784000;;369472000;426256000;527767000;32195000;3750000;36063000;336563000;346146000;382209000;912170000;;-764474000;145558000;527767000
EVC;652141;USD;2013;Q4;2013-12-31;2014-03-10;88110667;93707121;43822000;57043000;;111052000;58765000;;368420000;427185000;538237000;31246000;3750000;35114000;360313000;367099000;402213000;927386000;;-791596000;136024000;538237000
EVC;652141;USD;2012;Q4;2012-12-31;2013-03-11;85946433;86885758;36130000;48030000;;88405000;61435000;;288211000;349646000;438051000;39158000;150000;39426000;340664000;393224000;432650000;930822000;;-925421000;5401000;438051000
EVC;652141;USD;2011;Q4;2011-12-31;2012-03-09;85055710;85055710;58719000;44270000;;108928000;65226000;;293167000;358393000;467321000;39750000;0;39868000;379662000;428014000;467882000;938461000;;-939022000;-561000;467321000
EVC;652141;USD;2010;Q4;2010-12-31;2011-08-05;84517823;82309247;72390000;41552000;;121618000;71777000;;297415000;369192000;490810000;38550000;1000000;39668000;395119000;440785000;480453000;941179000;;-930822000;10357000;490810000
EVC;652141;USD;2018;Q4;2018-12-31;2019-05-07;88332619;90850866;179157000;79308000;;271048000;64939000;;354422000;419361000;690409000;51034000;3000000;54034000;240541000;303643000;357677000;862308000;;-528164000;332732000;690409000
DJCO;652264;USD;2013;Q4;2013-09-30;2013-08-14;1380746;1380746;148332000;6314000;56000;156965000;9230000;;36868000;46098000;203063000;8675000;;26221000;;63495000;89716000;1769000;;57670000;113347000;203063000
DJCO;652264;USD;2012;Q4;2012-09-30;2012-12-14;1380746;1380746;103141000;5709000;43000;110130000;9243000;;1591000;10834000;120964000;4939000;;10393000;;23346000;33739000;1769000;;53891000;87225000;120964000
DJCO;652264;USD;2011;Q4;2011-09-30;2011-12-12;1380746;1380746;59174000;6595000;44000;79145000;9374000;;2297000;11671000;90816000;5619000;;11780000;;14157000;25937000;1769000;;48350000;64879000;90816000
DJCO;652264;USD;2010;Q4;2010-09-30;2011-08-12;;;53697000;9209000;29000;76664000;9781000;;2476000;12257000;88921000;6255000;;12111000;;16144000;28255000;1769000;;40510000;60666000;88921000
SGA;652364;USD;2017;Q4;2017-12-31;2018-03-13;5807000;5807000;53030000;19307000;;76174000;56235000;;116360000;172595000;248769000;11978000;;20905000;25000000;48399000;69304000;62751000;-34894000;151608000;179465000;248769000
SGA;652364;USD;2016;Q4;2016-12-31;2017-03-10;5784000;5798000;26697000;17735000;;52772000;49174000;;118052000;167226000;219998000;4816000;;16045000;35287000;68971000;85016000;59631000;-33382000;108733000;134982000;219998000
SGA;652364;USD;2015;Q4;2015-12-31;2016-03-14;5678000;5689000;21614000;21300000;;47895000;58131000;;98545000;156676000;204571000;5591000;0;14338000;37145000;67417000;81755000;57584000;-32948000;98180000;122816000;204571000
SGA;652364;USD;2014;Q4;2014-12-31;2015-03-13;5712000;5759000;17907000;20661000;;43587000;55187000;;93270000;148457000;192044000;4889000;;13033000;36883000;63766000;76799000;52568000;-28501000;91178000;115245000;192044000
SGA;652364;USD;2013;Q4;2013-12-31;2014-03-17;5682000;5743000;17628000;19815000;;42081000;56337000;;94806000;151143000;193224000;4749000;1078000;14002000;46163000;69521000;83523000;51528000;-28520000;86693000;109701000;193224000
SGA;652364;USD;2012;Q4;2012-12-31;2013-03-15;22619020;22670989;15915000;19692000;;40434000;58462000;;98434000;156896000;197330000;5462000;0;13368000;59681000;79753000;93121000;51133000;-28670000;81746000;104209000;197330000
SGA;652364;USD;2011;Q4;2011-12-31;2012-03-15;-16938396;-16955376;6991000;19415000;;30960000;60622000;;98752000;159374000;190334000;4230000;3000000;14638000;67158000;82721000;97359000;50734000;-28590000;70831000;92975000;190334000
SGA;652364;USD;2010;Q4;2010-12-31;2011-08-09;5640423;5644423;13204000;18985000;;36559000;65561000;;97683000;163244000;199803000;5143000;6121000;18429000;91603000;101296000;119725000;50351000;-28473000;58200000;80078000;199803000
SGA;652364;USD;2018;Q4;2018-12-31;2019-03-15;5818000;5818000;44729000;19984000;;68595000;59103000;;120779000;179882000;248477000;8959000;5000000;23165000;15000000;40313000;63478000;64871000;-36561000;156689000;184999000;248477000
Mark;652365;USD;2017;Q4;2017-12-31;2018-04-02;27136000;27136000;22632000;3673000;;43783000;13387000;;46367000;59754000;103537000;36652000;41085000;90455000;0;92670000;183125000;220145000;;-299848000;-79588000;103537000
Mark;652365;USD;2016;Q4;2016-12-31;2017-04-05;21952000;21952000;6893000;1372000;;21174000;15531000;;68994000;84525000;105699000;30511000;279000;41853000;37825000;66446000;108299000;190529000;;-193113000;-2600000;105699000
Mark;652365;USD;2015;Q4;2015-12-31;2016-03-30;19512000;19512000;5422000;746000;;18393000;17338000;;58855000;76193000;94586000;26249000;305000;36813000;23616000;45715000;82528000;173497000;;-161434000;12058000;94586000
Mark;652365;USD;2014;Q4;2014-12-31;2015-03-31;22556000;22556000;1525000;41000;;2273000;1398000;;14285000;15683000;17956000;2566000;3008000;5660000;6581000;7118000;12778000;135129000;;-129987000;5178000;17956000
Mark;652365;USD;2013;Q4;2013-12-31;2014-03-31;10099358;10099358;1261000;101000;;1720000;213000;;5789000;6002000;7722000;1757000;177000;2020000;2651000;3445000;5465000;114037000;;-111777000;2257000;7722000
Mark;652365;USD;2012;Q4;2012-12-31;2013-04-15;7818563;7818563;1355332;101865;;1960453;400526;;3998196;4398722;6359175;976171;117549;1179465;2094214;2679651;3859116;107307191;;-104812502;2500059;6359175
Mark;652365;USD;2011;Q4;2011-12-31;2012-03-23;;;1531502;21730;;2249350;364386;;1122281;1486667;3736017;641375;;727120;;315714;1042834;101450202;;-98773900;2693183;3736017
Mark;652365;USD;2010;Q4;2010-12-31;2011-08-25;;;4843893;42741;;6111752;306460;;3469564;3776024;9887776;905899;;991644;;120250;1111894;100706731;;-91969380;8775882;9887776
Mark;652365;USD;2018;Q4;2018-12-31;2019-04-01;37389000;37389000;1410000;5762000;;44145000;2075000;;47588000;49663000;93808000;22487000;38314000;102581000;;4351000;106932000;308057000;;-321213000;-13124000;93808000
MOXC;652480;USD;2017;Q4;2017-09-30;2018-01-08;13401336;13401336;18494;;3130;174172;686296;;500000;1186296;1360468;;;4319438;;0;4319438;35542729;;-38682546;-2958970;1360468
MOXC;652480;USD;2016;Q4;2016-09-30;2016-12-22;16486263;16486263;76580;;9857;1015986;1508743;;3409874;4918617;5934603;;;5944765;;0;5944765;24755265;;-24988796;-10162;5934603
MOXC;652480;USD;2015;Q4;2015-09-30;2015-08-14;20508470;20508470;2398713;;38310;3479750;2941562;;6652894;9594456;13074206;;;7569115;;0;7569115;16565244;;-11174812;5505091;13074206
LFGR;652547;USD;2017;Q4;2017-12-31;2018-03-01;20925000;20925000;31344000;8663000;;42748000;11665000;;28829000;40494000;83242000;19162000;;21226000;;3496000;24722000;523014000;-35706000;-428771000;58520000;83242000
LFGR;652547;USD;2016;Q4;2016-12-31;2017-02-23;19770000;19480000;50864000;6849000;;65852000;11503000;;23897000;35400000;101252000;17468000;;19648000;;1854000;21502000;513141000;-35641000;-397638000;79750000;101252000
LFGR;652547;USD;2015;Q4;2015-12-31;2016-03-01;20117000;20117000;38570000;10469000;;54028000;14568000;;32863000;47431000;101459000;17142000;;20075000;;2264000;22339000;505605000;-30767000;-395627000;79120000;101459000
LFGR;652547;USD;2014;Q4;2014-12-31;2015-03-16;19372000;19372000;47820000;14504000;;69771000;22836000;;56948000;79784000;149555000;28987000;;32556000;;2157000;34713000;497811000;-30767000;-352126000;114842000;149555000
LFGR;652547;USD;2013;Q4;2013-12-31;2014-03-17;-51219000;-52561000;153511000;33301000;;260911000;42193000;;473984000;516177000;777088000;47493000;15000000;169863000;81250000;111220000;281083000;611039000;-30767000;-84769000;496005000;777088000
LFGR;652547;USD;2012;Q4;2012-12-31;2013-03-05;-184409000;-190855000;102933000;45517000;;212209000;35467000;;390321000;425788000;637997000;50960000;;144994000;;20812000;165806000;562703000;-25932000;-64595000;472191000;637997000
LFGR;652547;USD;2011;Q4;2011-12-31;2012-02-24;;;86035000;32665000;;177992000;32626000;;379485000;412111000;590103000;43978000;;133375000;;16462000;149837000;528042000;-17064000;-70771000;440266000;590103000
LFGR;652547;USD;2010;Q4;2010-12-31;2011-08-12;;;32338000;26843000;;110754000;34975000;;342738000;377713000;488467000;37900000;;114980000;;388903000;503883000;36723000;0;-52247000;-15416000;488467000
LFGR;652547;USD;2018;Q4;2018-12-31;2019-03-04;25402000;25402000;31081000;12627000;;47640000;13126000;;34356000;47482000;95122000;23668000;;25783000;;2652000;28435000;554406000;-35706000;-451961000;66687000;95122000
MEET;652598;USD;2017;Q4;2017-12-31;2018-03-16;71959506;57806738;24158444;26443675;;53847293;4524118;;216973360;221497478;275344771;26144284;15254399;45832133;40829243;43972078;89804211;408100986;;-221435888;185540560;275344771
MEET;652598;USD;2016;Q4;2016-12-31;2017-03-09;58946507;64205855;21852531;23737254;;47079052;2466110;;159944322;162410432;209489484;13745396;221302;14400895;0;0;14400895;351932750;;-156844161;195088589;209489484
MEET;652598;USD;2015;Q4;2015-12-31;2016-03-08;46104417;55403233;19298038;16509291;;36777568;2610307;;72102798;74713105;111490673;6904344;366114;7563872;221302;1256439;8820311;300772974;;-198102612;102670362;111490673
MEET;652598;USD;2014;Q4;2014-12-31;2015-03-13;44924116;44924116;17041050;9045269;;26876350;2458897;;73878512;76337409;103213759;6234663;2941087;9394234;1144028;1562558;10956792;297046082;;-204072240;92256967;103213759
MEET;652598;USD;2013;Q4;2013-12-31;2014-03-25;38491299;38491299;6330532;10136929;;17064594;2871800;;75639846;78511646;95576240;6593811;3262147;10131719;2816541;3636471;13768190;282535477;;-200110075;81808050;95576240
MEET;652598;USD;2012;Q4;2012-12-31;2013-03-14;36980462;36980462;5022007;15744789;;21749246;4772632;;77912789;82685421;104434667;6811177;2551941;9755730;9156788;9156788;18912518;275298844;;-189211750;85522149;104434667
MEET;652598;USD;2011;Q4;2011-12-31;2012-03-14;27302599;28419931;8271787;10293752;;19967474;4408694;;82428528;86837222;106804696;3724920;2405191;6903614;9255508;9255508;16159122;270010935;;-178903412;90645574;106804696
MEET;652598;USD;2010;Q4;2010-12-31;2011-08-15;;13616841;13546572;1361024;;15335658;645728;;471403;1117131;16452789;979989;;992353;6272545;6272545;7264898;175291606;;-166096889;9187891;16452789
MEET;652598;USD;2018;Q4;2018-12-31;2019-03-08;74244727;78365206;28365725;27148484;;60425266;4633764;;202793139;207426903;267852169;28183496;18700651;51504837;18146639;19126506;70631343;419530518;;-220276025;197220826;267852169
LEE;652664;USD;2017;Q4;2017-09-30;2017-12-08;54224000;55242000;10621000;49469000;3616000;67838000;114196000;39130000;399686000;553012000;620850000;41145000;30182000;98208000;496379000;613855000;712063000;252357000;;-328524000;-91213000;620850000
LEE;652664;USD;2016;Q4;2016-09-30;2016-12-09;53265000;54962000;16984000;51334000;4252000;77253000;128562000;39204000;417836000;585602000;662855000;45587000;25070000;99018000;565826000;691378000;790396000;250298000;;-356005000;-127541000;662855000
LEE;652664;USD;2015;Q4;2015-09-30;2015-12-11;52998000;53839000;11134000;58899000;3914000;82664000;143769000;44152000;477240000;665161000;747825000;51352000;25000000;105281000;700872000;801127000;906408000;247849000;;-390966000;-158583000;747825000
LEE;652664;USD;2014;Q4;2014-09-30;2014-12-12;52444000;55543000;16704000;62343000;6655000;96135000;157371000;48451000;509318000;715140000;811275000;56405000;31400000;118708000;773350000;870111000;988819000;245860000;;-414282000;-177544000;811275000
LEE;652664;USD;2013;Q4;2013-09-30;2013-12-13;51917000;51644000;17562000;63215000;6409000;104325000;168913000;50047000;504420000;723380000;827705000;60015000;14371000;106991000;820187000;890404000;997395000;243061000;;-421077000;-169690000;827705000
LEE;652664;USD;2012;Q4;2012-09-30;2012-12-14;50803000;50803000;13920000;67925000;7271000;122338000;184370000;52234000;702194000;938798000;1061136000;60943000;11982000;110311000;914244000;1064881000;1175192000;241562000;;-342760000;-114056000;1061136000
LEE;652664;USD;2011;Q4;2011-09-30;2011-12-09;44958000;44958000;23555000;69307000;7060000;135741000;202041000;58228000;762238000;1022507000;1158248000;60787000;994550000;1094239000;0;164903000;1259142000;230802000;;-326062000;-100894000;1158248000
LEE;652664;USD;2010;Q4;2010-09-30;2011-08-05;;;19422000;77558000;10822000;121617000;235400000;77339000;1005760000;1318499000;1440116000;69728000;81500000;187852000;1000927000;1195157000;1383009000;229366000;;-179194000;57107000;1440116000
LEE;652664;USD;2018;Q4;2018-09-30;2018-12-14;55009000;56039000;5380000;43711000;5684000;59342000;92328000;40174000;383567000;516069000;575411000;34419000;7027000;65341000;460777000;546330000;611671000;254083000;;-279691000;-36260000;575411000
ASPU;652699;USD;2017;Q4;2017-04-30;2018-07-13;15257929;15257929;14612559;6802723;;21989763;2862166;1315050;15421553;19598769;41588532;2886068;1050000;6777576;1000000;1077365;7854941;66575339;-70000;-32771748;33733591;41588532
ASPU;652699;USD;2016;Q4;2016-04-30;2017-07-25;11964833;9730790;2756217;4434862;;8314074;1454715;657542;247223;2359480;10673554;1019612;50000;2746377;0;86937;2833314;33620927;-70000;-25710687;7840240;10673554
ASPU;652699;USD;2015;Q4;2015-04-30;2016-07-27;10754449;10754449;783796;2051934;;2959604;1148632;127099;271436;1547167;4506771;186175;1050000;2362837;301783;330952;2693789;26488409;-70000;-24605427;1812982;4506771
ASPU;652699;USD;2014;Q4;2014-04-30;2015-07-28;9473175;9473175;2159463;1058339;;4461881;1211048;;245319;1456367;5918248;352772;1050000;2476080;843989;843989;3320069;25026901;-70000;-22358722;2598179;5918248
ASPU;652699;USD;2013;Q4;2013-04-30;2014-07-29;5900006;5900006;247380;649890;;1816702;1280729;;486409;1767138;3583840;599249;2962229;4516816;844175;851926;5368742;16375532;-70000;-18090434;-1784902;3583840
ASPU;652699;USD;2012;Q4;2012-04-30;2013-03-18;2243010;2243010;724982;364788;;1634191;1263740;;503754;1767494;3401685;441974;200000;1935860;850000;871450;2807310;13404461;-70000;-12740086;594375;3401685
ASPU;652699;USD;2011;Q4;2011-04-30;2012-05-15;985631;985631;766602;847234;;1867314;997109;772793;376390;2146292;4013606;1261557;206383;2307925;233215;263257;2571182;3287134;0;-5326370;1442424;4013606
ASPU;652699;USD;2018;Q4;2018-04-30;2019-07-09;18586498;18586498;9519352;10656470;;21037112;4391340;3085243;14690808;22167391;43204503;2350639;50000;6350227;9646672;10392848;16743075;68581393;-70000;-42049965;26461428;43204503
NLN;652800;USD;2014;Q4;2014-12-31;2015-03-04;178142040;210465860;25898000;8056000;304000;36287000;3830000;;11821000;15651000;51938000;19610000;;29212000;;17418000;46630000;89413000;;-84105000;5308000;51938000
NLN;652800;USD;2013;Q4;2013-12-31;2014-03-13;169598194;169598194;19644270;5289136;481012;27159006;3357626;;13059363;16416989;43575995;18340522;;27213894;;16893248;44107142;87140600;;-87671747;-531147;43575995
NLN;652800;USD;2012;Q4;2012-12-31;2013-03-08;164135106;164135106;11108107;4193949;416541;18152506;3446648;;15504840;18951488;37103994;14579905;320560;20627849;;17089338;37717187;84780209;;-85393402;-613193;37103994
NLN;652800;USD;2011;Q4;2011-12-31;2012-03-16;;;12346882;3494077;797436;18871922;4294476;;18163357;22457833;41329755;14911667;0;21549658;;16437089;37986747;78657646;;-75314638;3343008;41329755
NLN;652800;USD;2010;Q4;2010-12-31;2011-08-23;;;12929325;2356843;946780;18805581;5119422;;20783080;25902502;44708083;10935706;;17368177;;10963001;28331178;76872558;;-60963093;16376905;44708083
RLJE;653411;USD;2017;Q4;2017-12-31;2018-03-16;38939177;38939177;6215000;24926000;4448000;107269000;1185000;21589000;21737000;44511000;151780000;64121000;;80665000;52639000;53157000;133822000;132436000;;-130842000;17958000;151780000
RLJE;653411;USD;2016;Q4;2016-12-31;2017-03-23;18398707;18398707;7834000;19569000;6215000;95153000;1336000;16491000;23000000;40827000;135980000;67609000;;79524000;42053000;43768000;123292000;106064000;;-127388000;12688000;135980000
RLJE;653411;USD;2015;Q4;2015-12-31;2016-04-15;4283054;4283054;4530000;23886000;8325000;104851000;1815000;20098000;23864000;45777000;150628000;67922000;;87363000;61250000;63089000;150452000;85405000;;-105514000;176000;150628000
RLJE;653411;USD;2014;Q4;2014-12-31;2015-05-08;12623000;12623000;6662000;17389000;13029000;107238000;2372000;22281000;60163000;84816000;192054000;67075000;;72682000;80913000;82915000;155597000;87720000;0;-50534000;36457000;192054000
RLJE;653411;USD;2013;Q4;2013-12-31;2014-03-19;12462000;12462000;7674000;20324000;15589000;46114000;1759000;106874000;65523000;174156000;220270000;74446000;;84265000;76264000;78078000;162343000;86951000;0;-29334000;57927000;220270000
IHRT;653413;USD;2017;Q4;2017-12-31;2018-05-03;85173000;85173000;267109000;1508370000;;2067347000;1884714000;;8308370000;10193084000;12260431000;1195826000;14972367000;16354597000;5676814000;7250178000;23604775000;2072658000;-2474000;-13142001000;-11344344000;12260431000
IHRT;653413;USD;2016;Q4;2016-12-31;2017-02-23;84748000;84748000;845030000;1364404000;;2504687000;1948162000;;8409398000;10357560000;12862247000;1131563000;342908000;1674574000;20022080000;22073148000;23747722000;2070694000;-2119000;-12733952000;-10885475000;12862247000
IHRT;653413;USD;2015;Q4;2015-12-31;2016-02-25;252593644;252593644;772678000;1442038000;;2778115000;2212556000;;8682444000;10895000000;13673115000;1266792000;181512000;1659228000;20539099000;22620568000;24279796000;2069039000;-1917000;-12437011000;-10606681000;13673115000
IHRT;653413;USD;2014;Q4;2014-12-31;2015-02-19;251605284;251605284;457024000;1395248000;;2142350000;2699064000;;9161035000;11860099000;14002449000;1184633000;3604000;1364285000;20322414000;22303372000;23667657000;2102878000;-1246000;-11682390000;-9665208000;14002449000
IHRT;653413;USD;2013;Q4;2013-12-31;2014-02-20;83668;83055;708151000;1440501000;;2513294000;2897630000;;9686378000;12584008000;15097302000;1133424000;453734000;1763618000;20030479000;22030319000;23793937000;2148392000;-5856000;-10888629000;-8696635000;15097302000
IHRT;653413;USD;2012;Q4;2012-12-31;2013-02-19;330732038;330732038;1225010000;1440169000;;2987753000;3036854000;;10268106000;13304960000;16292713000;1089853000;381728000;1782142000;20365369000;22505762000;24287904000;2142008000;-6166000;-10281746000;-7995191000;16292713000
IHRT;653413;USD;2011;Q4;2011-12-31;2012-02-21;82659000;82659000;1228682000;1399135000;;2985285000;3063327000;;10493427000;13556754000;16542039000;1017088000;268638000;1428962000;19938531000;22585018000;24013980000;2132451000;-2876000;-9857267000;-7471941000;16542039000
IHRT;653413;USD;2010;Q4;2010-12-31;2011-08-03;82025000;82025000;1920926000;1373880000;;3603173000;3145554000;;10711655000;13857209000;17460382000;1078066000;867735000;2098579000;19739617000;22566489000;24665068000;2130954000;-2571000;-9555173000;-7204686000;17460382000
IHRT;653413;USD;2018;Q4;2018-12-31;2019-03-05;85609000;85531000;224037000;868861000;;2235017000;502202000;;9532296000;10034498000;12269515000;348585000;46105000;1247649000;0;22582208000;23829857000;2074724000;-2558000;-13345346000;-11560342000;12269515000
MNI;653890;USD;2017;Q4;2017-12-31;2018-03-12;7681000;7681000;99387000;101081000;7918000;245274000;257639000;;1003005000;1260644000;1505918000;101766000;74140000;236342000;799157000;1473908000;1710250000;2215185000;-51000;-1970097000;-204332000;1505918000
MNI;653890;USD;2016;Q4;2016-12-31;2017-03-06;7544000;7544000;5291000;112583000;13939000;167545000;297506000;;1371703000;1669209000;1836754000;108572000;16749000;190049000;881031000;1532792000;1722841000;2213173000;-6000;-1637739000;113913000;1836754000
MNI;653890;USD;2018;Q4;2018-12-31;2019-03-08;7812000;7740000;21906000;81709000;9115000;150353000;233692000;;911256000;1144948000;1295301000;107469000;4312000;180538000;633383000;1456428000;1636966000;2216758000;-2000;-1954132000;-341665000;1295301000
MVEN;654363;USD;2017;Q4;2017-12-31;2018-05-15;20478287;20478287;619249;53202;;3860967;2687727;;20000;2707727;6568694;385007;;416444;;3000000;3416444;11455825;;-8472071;3152250;6568694
GSEG;654541;USD;2016;Q4;2016-12-31;2018-05-23;60691827;60691827;118059;;;118059;349;;1310;1659;119718;87398;1321148;1408546;;;1408546;2031256;;-3336831;-1288828;119718
GSEG;654541;USD;2015;Q4;2015-12-31;2017-03-06;47870389;47870389;389791;;;389791;15355;;993968;1009323;1399114;56851;724185;781036;;;781036;1513050;;-910635;618078;1399114
GSEG;654541;USD;2014;Q4;2014-12-31;2015-03-30;;;27888;3637;;31525;1924;;2625;4549;36074;16105;4194;20299;;;20299;37870;0;;15775;36074
GSEG;654541;USD;2013;Q4;2013-12-31;2014-08-08;;;14029;660;;14689;2480;;2875;5355;20044;9685;0;9685;;;9685;15784;;;10359;20044
GSEG;654541;USD;2017;Q4;2017-12-31;2018-10-04;;;13512;;;13512;1998;;1900;3898;17410;342403;315787;691926;;0;691926;3991813;;-4684994;-674516;17410
FRLF;654792;USD;2018;Q4;2018-06-30;2018-10-15;179079948;179079948;54380;161975;201689;1025514;4786050;995400;1592574;7374024;8399538;557654;381575;939229;4441911;4441911;5381140;12563277;;-9540976;3018398;8399538
FRLF;654792;USD;2017;Q4;2017-06-30;2017-10-19;106244842;106244842;2498;637817;0;641915;0;0;348904;348904;990819;47680;73819;174256;0;628745;803001;5107858;;-4920988;187818;990819
FRLF;654792;USD;2016;Q4;2016-06-30;2016-10-07;147945192;147945192;1758;2899;2465;7122;;;11048;11048;18170;86789;44521;176310;;126250;302560;3895138;;-4010338;-284389;18171
FRLF;654792;USD;2015;Q4;2015-06-30;2015-10-06;379358708;379358708;901;4480;0;5381;;;8328;8328;13709;50161;0;50161;;194355;244516;768311;;-999118;-230807;13709
FRLF;654792;USD;2014;Q4;2014-06-30;2014-08-08;-75000000;-75000000;0;0;;0;;;0;0;0;0;;0;;0;0;0;;0;0;0
ACLZ;655300;USD;2017;Q4;2017-12-31;2018-03-27;65586611;65586611;166883;2692636;;3457862;69405;;4048647;4118052;7575914;2479083;1224194;7059026;4670926;5733426;12792452;26367686;;-31542684;-5216538;7575914
ACLZ;655300;USD;2016;Q4;2016-12-31;2017-03-22;65256337;65256337;1680127;2229610;;4357924;149115;;2886585;3035700;7393624;2639008;506867;5238271;4588227;6075727;11313998;25275151;;-29118196;-3920374;7393624
ACLZ;655300;USD;2015;Q4;2015-12-31;2016-03-17;65096302;65096302;908095;1833007;;2981023;1956864;;124882;2081746;5062769;2236750;0;6845627;0;0;6845627;23505434;;-25266612;-1782858;5062769
ACLZ;655300;USD;2014;Q4;2014-12-31;2015-03-19;62870540;62870540;1130667;1749566;;3084501;1424858;;467034;1891892;4976393;1202495;;1408970;2900000;2900000;4308970;19680968;;-19002574;667423;4976393
ACLZ;655300;USD;2013;Q4;2013-12-31;2014-03-25;57998515;74258622;1157315;1041671;;2284012;756696;;962963;1719659;4003671;1703007;;1786318;;;1786318;17966672;;-15749319;2217353;4003671
ACLZ;655300;USD;2018;Q4;2018-12-31;2019-04-16;66183633;66183633;27295;0;;2413606;0;;160246;160246;2573852;0;;6861284;;9185743;16047027;66179;29498125;-42960124;-13473175;2573852
IPDN;655301;USD;2017;Q4;2017-12-31;2018-03-30;3947238;3947238;2926088;905723;;5635581;221184;;13322300;13543484;19179065;2286658;;6775197;;2102065;8877262;80055857;-37117;-69745785;10301803;19179065
IPDN;655301;USD;2016;Q4;2016-12-31;2017-03-31;2880592;2880592;6068973;2170529;;9619665;277534;;31240678;31518212;41137877;3134504;;8620103;;3742151;12362254;76270976;-37117;-47458236;28775623;41137877
IPDN;655301;USD;2015;Q4;2015-12-31;2016-03-30;1808246;1808246;2570693;2510530;;6629231;444398;;34354187;34798585;41427816;5303653;445000;15828046;;5414330;21242376;63572291;-37117;-43349734;20185440;41427816
IPDN;655301;USD;2014;Q4;2014-12-31;2015-03-31;1589127;1589127;6718345;3448748;;11844718;874769;;61872985;62747754;74592472;5490862;1841804;17842893;;3107557;20950450;58773602;-37117;-5094463;53642022;74592472
IPDN;655301;USD;2013;Q4;2013-12-31;2014-03-27;1041012;1041012;18736495;1218112;;20053701;54781;;1911715;1966496;22020197;411423;0;1521064;;0;1521064;21946775;-11255;-1436387;20499133;22020197
IPDN;655301;USD;2012;Q4;2012-12-31;2013-05-21;538671;538671;1119643;1923048;;3106673;34863;;1984912;2019775;5126448;350340;1487900;2338240;;0;2338240;2786705;0;0;2788208;5126448
IPDN;655301;USD;2018;Q4;2018-12-31;2019-04-16;4866232;4866232;1441607;816698;;2756278;278441;;2203381;2481822;5238100;2833314;500000;6140278;;208610;6348888;83777465;-37117;-84826796;-1110788;5238100
MYAN;658464;USD;2017;Q4;2017-12-31;2017-12-29;4260811;4260811;5449000;6500;;5694200;120700;195900;85300;401900;6096100;796000;32800;1545300;3400;3400;1548700;80194000;;-75646600;4547400;6096100
MYAN;658464;USD;2016;Q4;2016-12-31;2016-12-22;1006139;1006139;318200;5100;;401900;9500;0;100700;110200;512100;491500;57500;1540500;36100;36100;1576600;67469300;;-68533800;-1064500;512100
MYAN;658464;USD;2015;Q4;2015-12-31;2016-01-05;-302965963;-302965963;432100;11800;;548200;1700;;17200;18900;567100;3352000;2400;4877900;525700;525700;5403600;57756400;;-62592900;-4836500;567100
MYAN;658464;USD;2014;Q4;2014-12-31;2014-12-29;101917408;89116925;1240600;9300;;1308100;8700;;19300;28000;1336100;2102400;3500;2824100;273600;273600;3097700;57451900;;-59213500;-1761600;1336100
MYAN;658464;USD;2013;Q4;2013-12-31;2013-12-23;236190440;236190440;1273600;26600;;1363900;16800;;21500;38300;1402200;2517400;7200;3556200;6000;6000;3562200;54390700;;-56550700;-2160000;1402200
MYAN;658464;USD;2012;Q4;2012-12-31;2013-01-15;1928326;-3297906;7700;12400;;81700;20000;;23600;43600;125300;4260100;7392800;13195000;5000;5000;13200000;32568600;;-45643300;-13074700;125300
MYAN;658464;USD;2011;Q4;2011-12-31;2011-12-22;-52286046;-54364653;73600;19200;;225700;32700;;111600;144300;370000;2263700;4269100;11781300;10200;10200;11791500;30815000;;-42236500;-11421500;370000
MYAN;658464;USD;2010;Q4;2010-12-31;2011-09-09;56023921;56023921;62000;48900;;195800;23000;;18700;41700;237500;1986000;126900;4438400;3400;3400;4441800;29165600;;-33369900;-4204300;237500
MYAN;658464;USD;2018;Q4;2018-12-31;2018-12-11;6404250;6404250;3254700;63300;;3510600;110800;0;1530400;1641200;5151800;619700;1300;1165400;699900;699900;1865300;89265100;;-85245300;3286500;5151800
TRLI;658467;USD;2017;Q4;2018-03-31;2018-06-29;129131715;129131715;213600;;;235246;57500;;625000;682500;917746;93885;;93885;;0;93885;5358136;;-6231207;823861;917746
TRLI;658467;USD;2016;Q4;2017-03-31;2017-06-30;2554611;2554611;1983;;;1983;;;;;1983;737647;49952;821051;1955934;1955934;2776985;2984363;;-5759365;-2775002;1983
TRLI;658467;USD;2015;Q4;2016-03-31;2016-06-29;2553990;2553990;13245;;;13245;;;;;13245;344640;0;389976;1955934;1955934;2345910;2984002;;-5316667;-2332665;13245
TRLI;658467;USD;2014;Q4;2015-03-31;2015-07-14;2554698;2554698;13393;;;13393;;;;;13393;1859857;82975;2316865;137500;137500;2454365;2569844;;-5010816;-2440972;13393
TRLI;658467;USD;2013;Q4;2014-03-31;2014-07-15;1881105;1881105;4249;;;4249;;;;;4249;1033821;82975;3192230;780625;780625;3972855;2145351;;-6113957;-3968606;4249
TRLI;658467;USD;2012;Q4;2013-03-31;2013-07-01;1407595;1407595;1296;;;78329;;;;;78329;678000;0;678000;42975;42975;720975;1528064;;-2170710;-642646;78329
TCNT;658757;USD;2017;Q4;2018-02-28;2018-12-17;7100000;7100000;39720;;;51455;;;;;51455;100;;76838;;;76838;44678;;-70061;-25383;51455
TCNT;658757;USD;2016;Q4;2017-02-28;2018-11-15;7090707;7090707;1727;;;4462;;;;;4462;2015;;21048;;;21048;44678;;-61264;-16586;4462
TCNT;658757;USD;2015;Q4;2016-02-29;2016-04-19;5100000;5100000;3757;;;3757;;;;;3757;0;;4678;;;4678;26000;;-26921;-921;3757
TCNT;658757;USD;2014;Q4;2015-02-28;2015-06-29;;;14392;;;14392;;;;;14392;;;1678;;;1678;26000;;-13286;12714;14392
JBCT;658900;USD;2017;Q4;2017-12-31;2018-04-12;291094;;1488;;3201;4689;;;0;0;4689;8576;50378;134233;;;134233;115185;;-244729;-129544;4689
JBCT;658900;USD;2016;Q4;2016-12-31;2017-03-31;285000;285000;0;;0;0;;;;;0;9101;0;17374;;;17374;77500;;-94874;-17374;0
JBCT;658900;USD;2015;Q4;2015-12-31;2016-05-11;285000;285000;1671;;;1671;;;;;1671;1041;0;4985;;;4985;77500;;-80814;-3314;1671
JBCT;658900;USD;2014;Q4;2014-12-31;2015-03-12;283483;283483;45035;;;48633;;;;;48633;;0;3944;;;3944;77500;;-32811;44689;48633
JBCT;658900;USD;2013;Q4;2013-12-31;2014-06-20;240000;240000;3300;;;9800;;;;;9800;;;0;;;0;24000;;-14200;9800;9800
RIHT;658986;USD;2016;Q4;2016-12-31;2017-04-14;125486595;125439636;5047;0;;70120;54113;;;54113;124233;1885977;50000;2216293;;;2216293;9791631;;-11883691;-2092060;124233
RIHT;658986;USD;2015;Q4;2015-12-31;2016-03-30;103886382;102670170;193014;;;293244;142520;;;142520;435764;1407864;0;2618294;;;2618294;8345414;;-10527944;-2182530;435764
RIHT;658986;USD;2014;Q4;2014-12-31;2015-03-10;73475185;73475185;1666914;;;1857260;240272;;16900;257172;2114432;608567;10000;3037654;;;3037654;6170155;;-7093377;-923222;2114432
RIHT;658986;USD;2013;Q4;2013-12-31;2014-03-25;35598772;-854019398;36331;;;55970;56453;;33800;90253;146223;928304;202609;1130913;;;1130913;3255982;;-4240672;-984690;146223
RIHT;658986;USD;2012;Q4;2012-12-31;2013-02-13;;;10049;;;44630;28851;;50700;79551;124181;514874;518975;1033849;;;1033849;1285005;;-2197893;-909668;124181
VAPE;659172;USD;2017;Q4;2017-09-30;2018-11-15;885260871;526789383;5360;0;0;8657;;;;;8657;1458022;842001;3820751;0;0;3820751;32911935;-372601;-36351428;-3812094;8657
VAPE;659172;USD;2016;Q4;2016-09-30;2018-03-07;1106586744;224920464;0;2010;18254;28483;;;;;28483;1029648;837291;5059483;41121;41121;5100604;30325148;-372601;-35024668;-5072121;28483
VAPE;659172;USD;2015;Q4;2015-09-30;2016-01-14;12486370;7653037;273904;72401;194937;753908;118327;;135217;253544;1007452;323547;216493;4043181;420266;447501;4490682;25815021;-367531;-28930720;-3483230;1007452
VAPE;659172;USD;2014;Q4;2014-09-30;2014-12-29;10242855;10242855;48370;16771;227530;583262;106377;;134465;240842;824104;385901;187667;619400;178200;3182837;3802237;22402762;0;-25380895;-2978133;824104
CMLS;659310;USD;2017;Q4;2017-12-31;2018-03-29;3809829;3809829;102891000;235247000;;393620000;191604000;;1442095000;1633699000;2027319000;36157000;;36157000;;2687277000;2723434000;1626749000;-229310000;-2093554000;-696115000;2027319000
CMLS;659310;USD;2016;Q4;2016-12-31;2017-03-16;3803716;3797817;131259000;231585000;;439927000;162063000;;1810701000;1972764000;2412691000;100791000;;100791000;2384157000;2803638000;2904429000;1625136000;-229310000;-1887564000;-491738000;2412691000
CMLS;659310;USD;2015;Q4;2015-12-31;2016-03-10;-49255765;-49282756;31657000;243428000;;359275000;169437000;;2473676000;2643113000;3002388000;122770000;;122770000;2402901000;2863586000;2986356000;1622186000;-229310000;-1376844000;16032000;3002388000
CMLS;659310;USD;2014;Q4;2014-12-31;2015-03-02;-72666726;-73256773;7271000;248308000;;370826000;221497000;;3153118000;3374615000;3745441000;155622000;;155622000;2485127000;3048239000;3203861000;1603518000;-231588000;-830350000;541580000;3745441000
CMLS;659310;USD;2013;Q4;2013-12-31;2014-03-17;26477386;27292941;32792000;264805000;;377055000;254702000;;3238678000;3493380000;3870435000;150383000;5937000;156320000;2620956000;3201375000;3357695000;1606052000;-251193000;-842119000;512740000;3870435000
CMLS;659310;USD;2012;Q4;2012-12-31;2013-03-18;-42473576811;-43363070611;88050000;207563000;;353119000;255903000;;3134553000;3390456000;3743575000;107389000;76468000;195243000;2624599000;3229830000;3425073000;1516836000;-252001000;-1018202000;318502000;3743575000
CMLS;659310;USD;2011;Q4;2011-12-31;2011-11-14;18451149;17469258;30592000;236804000;;324339000;278070000;;3438182000;3716252000;4040591000;165185000;13250000;178435000;2837287000;3457996000;3636431000;1527852000;-251666000;-985473000;404160000;4040591000
CMLS;659310;USD;2010;Q4;2010-12-31;2011-08-15;5251715;5334025;12814000;38267000;;59693000;39684000;;220259000;259943000;319636000;23934000;15165000;42782000;575843000;618163000;660945000;964816000;-256792000;-1049333000;-341309000;319636000
FRZT;659371;USD;2016;Q4;2016-12-31;2017-03-31;17298826;17298826;193892;0;;238659;106319;;0;106319;344978;48648;72112;120760;;23995;144755;176;;200047;200223;344978
MJTK;659836;USD;2017;Q4;2017-12-31;2018-04-13;1867168808;1867168808;12656;113;;12769;;57500;1500;59000;71769;299671;655980;955651;;;955651;15700616;;-16588998;-883882;71769
MJTK;659836;USD;2016;Q4;2016-12-31;2017-04-17;32963404;32963404;7090;0;;7090;;32500;182236;214736;221826;592411;380740;973151;;;973151;9712967;;-10464292;-751325;221826
MJTK;659836;USD;2015;Q4;2015-12-31;2016-04-14;48584595;48584595;7720;4550;;12270;5178;1081975;255000;1342153;1354423;174950;352966;527916;;;527916;6443193;;-5616686;826507;1354423
MJTK;659836;USD;2014;Q4;2014-12-31;2015-03-30;835767;553411;525720;2224;;530772;7987;;37502;45489;576261;76523;;76523;;;76523;2258568;;-1758830;499738;576261
MJTK;659836;USD;2013;Q4;2013-12-31;2014-02-28;83800;;88389;;;90074;0;;;0;90074;12579;;12579;;;12579;109988;;-32493;77495;90074
MJTK;659836;USD;2012;Q4;2012-12-31;2013-03-28;83800;;1759;819;;3036;;;;;3036;135535;32000;167535;0;0;167535;42004;;-206503;-164499;3036
MJTK;659836;USD;2011;Q4;2011-12-31;2012-03-26;83800;;5850;1134;;7429;;;;;7429;103209;;103209;12000;12000;115209;39004;;-146784;-107780;7429
MJTK;659836;USD;2010;Q4;2010-12-31;2011-09-15;83800;;2330;1326;;4089;;;;;4089;78641;;78641;0;0;78641;35792;;-110344;-74552;4089
MMEG;659865;USD;2016;Q4;2016-12-31;2017-04-13;0;0;15704;;;63247;;;23397;23397;86644;169469;182735;1683506;;;1683506;1938292;;-3535292;-1596862;86644
MMEG;659865;USD;2015;Q4;2015-12-31;2016-04-11;0;0;14;;5984;47129;;;294;294;47423;74242;727830;921817;;;921817;845655;;-1720050;-874394;47423
MMEG;659865;USD;2014;Q4;2014-12-31;2015-03-31;0;0;10744;;55149;493991;;;14579;14579;508570;141835;228080;905038;;;905038;296595;;-693063;-396468;508570
MMEG;659865;USD;2013;Q4;2013-12-31;2014-11-14;0;0;495;;2873;3368;;;2000;2000;5368;121970;25000;309716;;;309716;48595;;-352943;-304348;5368
UOLI;660762;USD;2014;Q4;2014-12-31;2015-04-30;1996355;1996355;236;;;236;;;;;236;72000;;3194700;;167554;3362254;199566;;-3555454;-3362018;236
UOLI;660762;USD;2013;Q4;2013-12-31;2014-11-24;1996355;1996355;236;;;236;;;;;236;73000;;3183439;;167610;3351049;199566;;-3543150;-3350813;236
UOLI;660762;USD;2012;Q4;2012-12-31;2014-11-21;1996355;1996355;1017;;;1017;;;;;1017;63000;;3174087;;167672;3341759;199566;;-3531854;-3340742;1017
SIGN;661042;USD;2014;Q4;2014-12-31;2015-03-30;12934750;12934750;48291;;;86791;;;4607291;4607291;4694082;2122901;0;2122901;;-3716088;-1593187;6282269;;;6287269;4694082
SIGN;661042;USD;2013;Q4;2013-12-31;2014-03-28;9199808;9199808;19544;;;58044;;;4607291;4607291;4665335;1888901;0;1888901;;-3354301;-1465400;6125735;;;6130735;4665335
SIGN;661042;USD;2012;Q4;2012-12-31;2013-04-01;8914655;8914655;107373;;;145873;;;4607291;4607291;4753164;1646901;0;1646901;;-2964397;-1317496;6065660;;;6070660;4753164
SIGN;661042;USD;2011;Q4;2011-12-31;2012-03-30;7194125;7194125;22507;;;47507;;;4607291;4607291;4654798;1447913;0;1447913;;-2533365;-1085452;5735250;;;5740250;4654798
SIGN;661042;USD;2010;Q4;2010-12-31;2011-09-14;;;10659;;;10659;;;4607291;4607291;4617950;1198772;0;1198772;;-2218471;-1019699;5632649;;;5637649;4617950
WESC;662182;USD;2017;Q4;2017-06-30;2017-09-28;86885795;86885795;5010;;;5547;;;11565;11565;17112;10681;;66069;;;66069;1068180;;-1127081;-48957;17112
WESC;662182;USD;2016;Q4;2016-06-30;2016-09-28;63303300;63303300;5647;824;;6471;;;11613;11613;18084;13245;;118263;;;118263;963399;;-1072229;-100179;18084
WESC;662182;USD;2015;Q4;2015-06-30;2015-09-28;69926848;69926848;10893;603;;11496;;;12009;12009;23505;9270;;79523;;;79523;963399;;-1023523;-56018;23505
WESC;662182;USD;2014;Q4;2014-06-30;2014-09-30;47900000;47900000;14570;2208;;17259;8156;;14058;22214;39473;15430;;174499;;;174499;808016;;-942382;-135026;39473
WESC;662182;USD;2013;Q4;2013-06-30;2013-11-01;47900000;47900000;221835;0;;221835;21860;;34996;56856;278691;10654;;233506;;;233506;808016;;-766382;45185;278691
WESC;662182;USD;2012;Q4;2012-06-30;2012-10-11;54992897;;327215;1380;;353048;34841;;35035;69876;422924;17454;;119677;;;119677;808016;;-505169;303247;422924
WESC;662182;USD;2018;Q4;2018-06-30;2018-09-27;82489391;82489391;2925;;;2971;;;11415;11415;14386;11283;;114388;;;114388;1068180;;-1178120;-100002;14386
CLOW;662407;USD;2016;Q4;2016-12-31;2017-04-25;802927;802927;;;;73461;;;;;73461;14682;0;210719;0;0;210719;95317;;-173854;-137258;73461
CWRL;662568;USD;2015;Q4;2015-12-31;2016-03-31;-311908206;-311908206;1268;1265;;44057;;;;;44057;484185;338958;833020;;0;833020;11975286;;-12764249;-788963;44057
CWRL;662568;USD;2014;Q4;2014-12-31;2015-03-31;-466024354;-466024354;94857;36755;;180663;0;;;0;180663;480778;152952;799804;186006;186006;985810;11969802;;-12774949;-805147;180663
MXMG;662984;USD;2014;Q4;2014-11-30;2015-02-26;198466840;;320;;;320;;;;;320;930;;6083;;;6083;26500;;-32263;-5763;320
AJBI;663635;USD;2013;Q4;2013-06-30;2013-09-30;60836664;60836664;8689;;;8689;;;;;8689;31515;;31515;;;31515;49005;;-71831;-22826;8689
RAVN;664566;USD;2017;Q4;2018-01-31;2018-03-23;35877258;36386151;40535000;58532000;55351000;160279000;106280000;;60244000;166524000;326803000;35052000;;36942000;;13795000;50737000;126267000;-100402000;252772000;276066000;326803000
RAVN;664566;USD;2016;Q4;2017-01-31;2017-03-31;36174550;36474965;50648000;43143000;42336000;138816000;106324000;;56369000;162693000;301509000;26522000;;28382000;;13696000;42078000;122855000;-90402000;230649000;259431000;301509000
RAVN;664566;USD;2015;Q4;2016-01-31;2016-03-29;36599033;36692658;33782000;38069000;45839000;125229000;115704000;;57755000;173459000;298688000;18080000;;18819000;;15640000;34459000;120913000;-82700000;229443000;264229000;298688000
RAVN;664566;USD;2014;Q4;2015-01-31;2015-03-27;38117870;38216893;52199000;56576000;55152000;170979000;117513000;;74381000;191894000;362873000;30732000;;31843000;;25793000;57636000;120184000;-53362000;244180000;305237000;362873000
RAVN;664566;USD;2013;Q4;2014-01-31;2014-03-31;36486652;36731126;53237000;54643000;54865000;169405000;98076000;;34338000;132414000;301819000;28572000;;29819000;;20538000;50357000;75874000;-53362000;231029000;251462000;301819000
RAVN;664566;USD;2012;Q4;2013-01-31;2013-03-29;36381243;36516422;49353000;56303000;46189000;156748000;81238000;;35224000;116462000;273210000;31630000;;33061000;;18702000;51763000;71108000;-53362000;205695000;221447000;273210000
RAVN;664566;USD;2011;Q4;2012-01-31;2012-03-30;36267960;36520880;25842000;60759000;54756000;147559000;61894000;;36250000;98144000;245703000;39155000;;40646000;;24467000;65113000;42173000;-53362000;193650000;180590000;245703000
RAVN;664566;USD;2010;Q4;2011-01-31;2011-06-03;;;38563000;39967000;43679000;128181000;41522000;;18057000;59579000;187760000;32811000;;34335000;;12211000;46546000;39571000;-53362000;156125000;141214000;187760000
RAVN;664566;USD;2009;Q4;2010-01-31;2011-06-03;;;43684000;34327000;34475000;117747000;33029000;;19533000;52562000;170309000;24654000;;25960000;;11098000;37058000;38082000;-53362000;149732000;133251000;170309000
RAVN;664566;USD;2018;Q4;2019-01-31;2019-03-22;36061232;36476893;65787000;54472000;54076000;183071000;106615000;;70559000;177174000;360245000;31750000;;33053000;;18235000;51288000;126944000;-100402000;285969000;308957000;360245000
BFS;664571;USD;2017;Q4;2017-12-31;2018-02-27;22071000;22185000;10908000;54057000;;64965000;1315034000;;42453000;1357487000;1422452000;41643000;897888000;968615000;60734000;60734000;1029349000;352811000;;-197710000;393103000;1422452000
BFS;664571;USD;2016;Q4;2016-12-31;2017-03-07;21674000;21828000;8322000;52774000;;61096000;1242534000;;39395000;1281929000;1343025000;38791000;783400000;852887000;48217000;116889000;969776000;328388000;;-188584000;373249000;1343025000
BFS;664571;USD;2015;Q4;2015-12-31;2016-03-04;21234000;21313000;10003000;51076000;;61079000;1197340000;;36989000;1234329000;1295408000;43067000;796169000;871345000;26695000;70336000;941681000;305221000;;-180091000;353727000;1295408000
AKR;664572;USD;2017;Q4;2017-12-31;2018-02-27;;83733884;74823000;51738000;;291236000;3126620000;;542391000;3669011000;3960247000;234296000;;291088000;1453520000;1453520000;1744608000;1596598000;;-32013000;2215639000;3960247000
AKR;664572;USD;2016;Q4;2016-12-31;2017-02-24;;82239200;71805000;43842000;;414714000;3094934000;;486312000;3581246000;3995960000;245297000;;258988000;1558847000;1558847000;1817835000;1595010000;;-5635000;2178125000;3995960000
AKR;664572;USD;2015;Q4;2015-12-31;2016-02-19;;69291556;72776000;40425000;;297673000;2437580000;;297066000;2734646000;3032319000;139115000;;173159000;1337806000;1337806000;1510965000;1092309000;;12642000;1521354000;3032319000
AKR;664572;USD;2018;Q4;2018-12-31;2019-02-19;;81560652;21268000;62191000;;206652000;3281148000;;470980000;3752128000;3958780000;239554000;;255177000;1621656000;1621656000;1876833000;1548685000;;-89696000;2081947000;3958780000
ALEX;664573;USD;2017;Q4;2017-12-31;2018-03-01;49300000;63200000;68900000;34100000;99300000;274800000;1147500000;151000000;657900000;1956400000;2231200000;832800000;46000000;926800000;585200000;645300000;1572100000;1161700000;;-473000000;659100000;2231200000
ALEX;664573;USD;2016;Q4;2016-12-31;2017-03-01;49100000;49500000;2200000;32100000;44300000;138300000;1231600000;179500000;606900000;2018000000;2156300000;41500000;42400000;165100000;472700000;767200000;932300000;1157300000;;95200000;1224000000;2156300000
ALEX;664573;USD;2015;Q4;2015-12-31;2016-02-29;49000000;49200000;1300000;38600000;55900000;152500000;1269400000;183500000;636900000;2089800000;2242300000;41000000;90400000;184700000;496600000;818900000;1003600000;1151700000;;117200000;1238700000;2242300000
PESI;664574;USD;2017;Q4;2017-12-31;2018-03-16;11731000;11731000;1063000;7940000;393000;17313000;14870000;0;27355000;42225000;59538000;11110000;1184000;19581000;2663000;11511000;31092000;106429000;-88000;-77893000;28446000;59538000
PESI;664574;USD;2016;Q4;2016-12-31;2017-03-24;11669000;11669000;163000;8705000;370000;14607000;17115000;212000;33401000;50728000;65335000;10515000;1184000;16738000;7649000;16441000;33179000;106059000;-88000;-74213000;32156000;65335000
PESI;664574;USD;2015;Q4;2015-12-31;2016-03-24;11547000;11625000;1435000;9673000;377000;20116000;19993000;0;42804000;62797000;82913000;10450000;2431000;17150000;7405000;20061000;37211000;105567000;-88000;-60808000;45702000;82913000
PESI;664574;USD;2014;Q4;2014-12-31;2015-03-31;11471000;11430000;3680000;8272000;498000;22742000;22824000;;42685000;65509000;88251000;9890000;3733000;22370000;7639000;19546000;41916000;104552000;-88000;-59758000;46335000;88251000
PESI;664574;USD;2013;Q4;2013-12-31;2014-04-15;-33828724;-33828724;333000;8241000;520000;20569000;26060000;;45431000;71491000;92060000;10663000;2876000;23067000;11372000;22862000;45929000;103465000;-88000;-58533000;46131000;92060000
PESI;664574;USD;2012;Q4;2012-12-31;2013-03-22;11240800;11240800;4368000;11395000;473000;30210000;35314000;;74167000;109481000;139691000;15329000;2794000;27558000;11402000;26594000;54152000;102875000;-88000;-19103000;85539000;139691000
PESI;664574;USD;2011;Q4;2011-12-31;2012-03-15;11154000;11170000;12055000;16848000;573000;50274000;39835000;;73545000;113380000;163654000;22747000;3521000;42740000;14195000;32605000;75345000;102467000;-88000;-15744000;88309000;163654000
PESI;664574;USD;2010;Q4;2010-12-31;2011-08-05;43923056;43990981;101000;8541000;465000;25216000;40443000;;59656000;100099000;125315000;10887000;3612000;22887000;6637000;23924000;46811000;100876000;-88000;-23569000;78504000;125315000
PESI;664574;USD;2018;Q4;2018-12-31;2019-04-01;-35434580;-35665580;810000;7735000;449000;14758000;15739000;;26945000;42684000;57442000;11653000;1184000;21511000;2386000;9798000;31309000;107560000;-88000;-79630000;26133000;57442000
SEGN;667106;USD;2017;Q4;2017-12-31;2018-04-11;106700164;106700164;54742;123000;;214140;;;;;214140;104600;;317737;;0;317737;101340;;-204937;-103597;214140
SEGN;667106;USD;2016;Q4;2016-12-31;2017-04-14;10360000;10360000;459;0;;459;;;;;459;25959;;144534;;0;144534;36700;;-180775;-144075;459
SEGN;667106;USD;2015;Q4;2015-12-31;2016-04-13;;;13501;;;13501;;;;;13501;30911;;96222;;0;96222;36700;;-119421;-82721;13501
SEGN;667106;USD;2014;Q4;2014-12-31;2015-05-20;;;0;;;0;;;;;0;0;;9434;;0;9434;36700;;-46134;-9434;0
SEGN;667106;USD;2013;Q4;2013-12-31;2014-07-01;;;15540;;;15540;;;;;15540;;;5100;;;5100;31600;;-21160;10440;15540
SEGN;667106;USD;2018;Q4;2018-12-31;2019-04-15;75000000;75000000;520772;1325383;;1997914;;;;;1997914;1232998;;1455791;;0;1455791;101340;;442240;542121;1997912
OMGB;667156;USD;2013;Q4;2013-10-31;2014-01-23;62478570;62478570;4039;;;4039;;;;;4039;6770;;6770;;;6770;29800;;-32531;-2731;4039
JOUT;667535;USD;2017;Q4;2017-09-30;2017-12-08;9907000;9963000;110417000;46814000;79148000;240849000;48938000;;63872000;112810000;353659000;70475000;;84077000;;26578000;110655000;73304000;-2198000;166905000;243004000;353659000
JOUT;667535;USD;2016;Q4;2016-09-30;2016-12-13;9861000;9730000;87294000;41522000;68397000;201968000;48998000;;59313000;108311000;310279000;55008000;381000;67654000;7008000;35129000;102783000;71629000;-1892000;135405000;207496000;310279000
JOUT;667535;USD;2015;Q4;2015-09-30;2015-12-08;9770000;9456000;69159000;44798000;79919000;198721000;45287000;;55196000;100483000;299204000;57399000;368000;69554000;7062000;31682000;101236000;70047000;-889000;125173000;197968000;299204000
JOUT;667535;USD;2014;Q4;2014-09-30;2014-12-05;9662000;9291000;70793000;44452000;66341000;197550000;46100000;;44976000;91076000;288626000;47587000;360000;60232000;7431000;29936000;90168000;68382000;-275000;117573000;198458000;288626000
JOUT;667535;USD;2013;Q4;2013-09-30;2013-12-06;;9558000;55694000;44104000;76363000;188572000;43394000;;56384000;99778000;288350000;50682000;539000;63372000;7794000;27310000;90682000;66873000;-715000;112144000;197668000;288350000
JOUT;667535;USD;2012;Q4;2012-09-30;2012-12-11;;8933000;58904000;40673000;67058000;182952000;36667000;;44013000;80680000;263632000;45257000;526000;58967000;8334000;31061000;90028000;64679000;-9000;92817000;173604000;263632000
JOUT;667535;USD;2011;Q4;2011-09-30;2011-12-16;;8957000;44514000;47209000;68462000;176445000;35158000;;47753000;82911000;259356000;49415000;3494000;65000000;11478000;30831000;95831000;62010000;;82683000;163525000;259356000
JOUT;667535;USD;2010;Q4;2010-09-30;2011-08-10;;9288000;33316000;46928000;72095000;160128000;33767000;;32861000;66628000;226756000;44235000;8871000;67015000;14939000;33372000;100387000;60258000;-1000;50039000;126369000;226756000
JOUT;667535;USD;2018;Q4;2018-09-30;2018-12-07;9952000;10028000;150591000;40866000;88864000;285694000;55934000;;54308000;110242000;395936000;80218000;;92784000;;23955000;116739000;75528000;-2646000;202828000;279197000;395936000
FLLZ;667668;USD;2018;Q4;2018-08-31;2018-11-29;75000000;75000000;631;0;;631;;;;;631;0;;540766;;;540766;111116;;-651251;-540135;631
FLLZ;667668;USD;2017;Q4;2017-08-31;2017-11-29;50344176;50344176;0;70115;;80115;;;;;80115;46215;;382034;;;382034;111116;;-413035;-301919;80115
FLLZ;667668;USD;2016;Q4;2016-08-31;2016-11-29;4897889;4897889;76;;704;11247;6973;;;6973;18220;5000;;33204;;;33204;21850;;-36834;-14984;18220
FLLZ;667668;USD;2015;Q4;2015-08-31;2016-08-30;;;2284;;1930;4734;2595;;;2595;7329;5000;;9129;;;9129;3000;;-4800;-1800;7329
GDI;668481;USD;2012;Q4;2012-12-31;2013-02-27;198215698000;199115348000;254000000;444815000;343197000;1116989000;295244000;;1089571000;1384815000;2501804000;409060000;359433000;768493000;9727000;279148000;1047641000;619055000;-430853000;1226237000;1454163000;2501804000
GDI;668481;USD;2011;Q4;2011-12-31;2012-02-27;206521419000;208057666000;155259000;477505000;311679000;1015734000;290912000;;1058922000;1349834000;2365568000;428062000;77692000;505754000;326133000;580183000;1085937000;602452000;-315314000;972867000;1279631000;2365568000
GDI;668481;USD;2010;Q4;2010-12-31;2011-02-28;209026519000;210753199000;157029000;369860000;241485000;828537000;286563000;;911998000;1198561000;2027098000;322372000;37228000;359600000;250682000;477825000;837425000;592583000;-182544000;705699000;1189673000;2027098000
GDI;668481;USD;2009;Q4;2009-12-31;2010-08-05;;;109736000;326234000;226453000;718511000;306235000;;914302000;1220537000;1939048000;289949000;33581000;323530000;330935000;551509000;875039000;559319000;-132935000;543272000;1064009000;1939048000
TUES;668563;USD;2017;Q4;2017-06-30;2017-08-24;44024000;44009000;6263000;;221906000;236518000;118397000;;3238000;121635000;358153000;111597000;;111597000;30500000;47717000;159314000;235073000;-6812000;-29422000;198839000;358153000
TUES;668563;USD;2016;Q4;2016-06-30;2016-08-19;43785000;43884000;14150000;;242315000;263597000;94723000;;3650000;98373000;361970000;124650000;;124650000;;10038000;134688000;230951000;-6789000;3120000;227282000;361970000
TUES;668563;USD;2015;Q4;2015-06-30;2015-08-20;43626000;44425000;44788000;;209984000;262573000;70447000;;1855000;72302000;334875000;109993000;;109993000;;4593000;114586000;227543000;-6661000;-593000;220289000;334875000
TUES;668563;USD;2014;Q4;2014-06-30;2014-08-21;43178000;42861000;49686000;;207663000;264265000;65939000;;3018000;68957000;333222000;125903000;;126781000;;3131000;129912000;220806000;-6518000;-10978000;203310000;333222000
TUES;668563;USD;2013;Q4;2013-06-30;2013-08-28;42493000;42493000;28896000;;211981000;250787000;66009000;;5084000;71093000;321880000;108762000;;108762000;;5661000;114423000;214457000;-6198000;-802000;207457000;321880000
TUES;668563;USD;2012;Q4;2012-06-30;2012-08-30;41480000;43138000;39740000;;265630000;317262000;75771000;;4134000;79905000;397167000;128323000;;128323000;;8653000;136976000;210763000;-6092000;55574000;260191000;397167000
TUES;668563;USD;2011;Q4;2011-06-30;2011-10-31;42709000;44442000;19400000;;264361000;297892000;76982000;;4282000;81264000;379156000;109872000;;109872000;;9150000;119022000;208562000;;51661000;260134000;379156000
TUES;668563;USD;2018;Q4;2018-06-30;2018-08-21;44418000;44415000;9510000;;234365000;251382000;121117000;;3757000;124874000;376256000;130743000;;130743000;38480000;65259000;196002000;238426000;-6812000;-51360000;180254000;376256000
TUES;668563;USD;2019;Q4;2019-06-30;2019-08-22;44842000;44839000;11395000;;237895000;256500000;110146000;;3875000;114021000;370521000;137174000;;137174000;34650000;62038000;199212000;241921000;-6812000;-63800000;171309000;370521000
PBYI;668565;USD;2017;Q4;2017-12-31;2018-03-09;37541526;37541526;81698000;9670000;2029000;106394000;4470000;;54661000;59131000;165525000;58340000;;58340000;48477000;53434000;111774000;1142217000;;-1088466000;53751000;165525000
PBYI;668565;USD;2016;Q4;2016-12-31;2017-03-01;35711788;35711788;229476000;;;236474000;5153000;;11163000;16316000;252790000;37461000;;37461000;;5505000;42966000;1006348000;;-796511000;209824000;252790000
PBYI;668565;USD;2015;Q4;2015-12-31;2016-02-29;32454750;32454750;215889000;;;223549000;2383000;;13910000;16293000;239842000;32442000;;32442000;;1393000;33835000;726654000;;-520500000;206007000;239842000
PBYI;668565;USD;2014;Q4;2014-12-31;2015-03-02;30241207;30241207;141327000;1760000;;149379000;2157000;;11222000;13379000;162758000;44441000;;44441000;;434000;44875000;399194000;;-281216000;117883000;162758000
PBYI;668565;USD;2013;Q4;2013-12-31;2014-03-03;28750905;28750905;83948000;9813000;;96396000;1684000;;6294000;7978000;104374000;19271000;;19271000;;1116000;20387000;223235000;;-139251000;83987000;104374000
PBYI;668565;USD;2012;Q4;2012-12-31;2013-04-01;26783944;26783944;137408000;10612000;;148972000;1479000;;1248000;2727000;151699000;21701000;;21701000;;-83503000;-61802000;213501000;;;213501000;151699000
PBYI;668565;USD;2011;Q4;2011-12-31;2012-03-29;18986116;18986116;53382000;;;53663000;682000;;1053000;1735000;55398000;587000;;587000;;-9801000;-9214000;64612000;;;64612000;55398000
UPLD;668870;USD;2017;Q4;2017-12-31;2018-03-09;19514892;19514892;22326000;26504000;;51686000;2927000;;226646000;229573000;281259000;21192000;2301000;75139000;108843000;114705000;189844000;174946000;;-81128000;91415000;281259000
UPLD;668870;USD;2016;Q4;2016-12-31;2017-03-30;17486921;17486921;28758000;15254000;;47299000;4356000;;98933000;103289000;150588000;9314000;2190000;39698000;45739000;51877000;91575000;124568000;;-62403000;59013000;150588000
UPLD;668870;USD;2015;Q4;2015-12-31;2016-03-30;15114345;15114345;18473000;13972000;;35048000;6001000;;81365000;87366000;122414000;10162000;1500000;34002000;22366000;28142000;62144000;112449000;;-48890000;60270000;122414000
UPLD;668870;USD;2014;Q4;2014-12-31;2015-03-31;9507301;9507301;30988000;14559000;;47616000;3930000;;84140000;88070000;135686000;8934000;10964000;45445000;12327000;18844000;64289000;108339000;;-35226000;71397000;135686000
UPLD;668870;USD;2013;Q4;2013-12-31;2014-12-22;303081;303081;4703000;11026000;;18291000;3942000;;72614000;76556000;94847000;6659000;5245000;29557000;23438000;30634000;60191000;0;;-15109000;34656000;94847000
UPLD;668870;USD;2018;Q4;2018-12-31;2019-03-15;20191391;20191391;16738000;40841000;;67288000;2827000;;413083000;415910000;483198000;26741000;6015000;107649000;273713000;288242000;395891000;180483000;;-85675000;87307000;483198000
CKP;669154;USD;2015;Q4;2015-12-31;2016-03-03;42368000;42368000;124289000;113698000;82126000;340932000;75864000;;241074000;316938000;657870000;125244000;279000;175322000;70362000;207756000;383078000;431719000;-78154000;-38546000;274792000;657870000
CKP;669154;USD;2014;Q4;2014-12-31;2015-03-05;42190000;43196000;135537000;131720000;91860000;390602000;76332000;;271732000;348064000;738666000;126393000;236000;158051000;65161000;252684000;410735000;446466000;-71520000;-12331000;327931000;738666000
CKP;669154;USD;2013;Q4;2013-12-31;2014-03-31;41834000;41036000;121573000;167864000;83521000;411185000;75067000;;313241000;388308000;799493000;140576000;435000;177733000;91187000;275435000;453168000;438884000;-71520000;-23284000;346325000;799493000
CKP;669154;USD;2012;Q4;2012-12-31;2013-03-05;41148000;41148000;118829000;175141000;82225000;448791000;88044000;;332280000;420324000;869115000;154052000;4367000;219071000;108921000;295735000;514806000;429191000;-71520000;-4356000;354309000;869115000
CKP;669154;USD;2011;Q4;2011-12-31;2012-03-02;40650000;40278000;93481000;208889000;130987000;492236000;132161000;;420084000;552245000;1044481000;163281000;21778000;259120000;128684000;256021000;515141000;422635000;-71520000;164268000;529340000;1044481000
CKP;669154;USD;2010;Q4;2010-12-31;2011-02-22;40160000;40682000;172473000;178076000;106694000;510547000;121258000;;402105000;523363000;1033910000;150057000;22225000;215409000;119724000;236947000;452356000;411767000;-71520000;230837000;581554000;1033910000
CKP;669154;USD;2009;Q4;2009-12-31;2010-07-29;;;162097000;173057000;89247000;482690000;117598000;;423945000;541543000;1024233000;159581000;25772000;240881000;91100000;224798000;465679000;394686000;-71520000;205951000;558554000;1024233000
TRC;669774;USD;2017;Q4;2017-12-31;2018-03-12;23538696;23599755;90975000;7608000;2469000;103901000;45332000;267336000;101630000;414298000;518199000;5355000;4004000;10477000;65816000;80912000;91389000;333114000;;70392000;426810000;518199000
TRC;669774;USD;2016;Q4;2016-12-31;2017-03-13;19549249;19415603;27933000;8740000;3084000;42864000;46034000;248265000;102538000;396837000;439701000;5603000;3853000;18685000;69853000;86549000;105234000;240167000;;71947000;334467000;439701000
TRC;669774;USD;2015;Q4;2015-12-31;2016-03-08;18827897;18899132;34745000;6511000;3517000;48893000;44469000;235466000;103091000;383026000;431919000;7981000;815000;10321000;73223000;90290000;100611000;227147000;;71389000;331308000;431919000
TRC;669774;USD;2014;Q4;2014-12-31;2015-03-16;21254770;21298547;47778000;8506000;4098000;64838000;43094000;219654000;104337000;367085000;431923000;7824000;244000;16082000;74023000;91508000;107590000;223081000;;68439000;324333000;431923000
TRC;669774;USD;2013;Q4;2013-12-31;2014-03-17;20995730;21720954;64467000;7108000;3510000;83244000;146542000;;113093000;259635000;342879000;7675000;234000;8774000;4459000;13918000;22692000;221130000;;62785000;320187000;342879000
TRC;669774;USD;2012;Q4;2012-12-31;2013-03-15;19409092;19599331;72268000;8768000;3839000;90753000;146590000;;90513000;237103000;327856000;5977000;41000;7213000;212000;12384000;19597000;208160000;;65550000;308259000;327856000
TRC;669774;USD;2011;Q4;2011-12-31;2012-03-12;18672961;18826504;86938000;7832000;3587000;103773000;128430000;;89773000;218203000;321976000;8005000;37000;10167000;253000;11370000;21537000;204261000;;61109000;300439000;321976000
TRC;669774;USD;2010;Q4;2010-12-31;2011-08-05;;;71012000;9812000;2982000;88817000;117275000;;81999000;199274000;288091000;3521000;35000;4157000;290000;7282000;11439000;193690000;;45215000;276652000;288091000
TRC;669774;USD;2018;Q4;2018-12-31;2019-03-01;25969540;26011262;79657000;10876000;2618000;96499000;46086000;283385000;103078000;432549000;529048000;9612000;4018000;16493000;61780000;77883000;94376000;349506000;;74647000;434672000;529048000
BPL;669884;USD;2017;Q4;2017-12-31;2018-02-23;;;2180000;270648000;301425000;656598000;6735792000;1494412000;1417857000;9648061000;10304659000;425984000;;685360000;4658321000;4750977000;5436337000;4562306000;;;4868322000;10304659000
BPL;669884;USD;2016;Q4;2016-12-31;2017-02-24;;;640340000;236416000;356803000;1318897000;6483282000;89564000;1529360000;8102206000;9421103000;373276000;;399548000;4217695000;4323132000;4722680000;4437316000;;;4698423000;9421103000
BPL;669884;USD;2015;Q4;2015-12-31;2016-02-25;;;4881000;213830000;192992000;551550000;6202081000;84128000;1531522000;7817731000;8369281000;392311000;;504309000;3732824000;3848231000;4352540000;3833230000;;;4016741000;8369281000
BPL;669884;USD;2014;Q4;2014-12-31;2015-02-26;;;8208000;265830000;243475000;632299000;5735787000;82849000;1614785000;7433421000;8065720000;454153000;;621955000;3368618000;3503169000;4125124000;3817916000;;;3940596000;8065720000
BPL;669884;USD;2013;Q4;2013-12-31;2014-02-26;;;4950000;335143000;312135000;901086000;4925294000;72349000;1106834000;6104477000;7005563000;376604000;;685043000;3092711000;3239684000;3924727000;3169217000;;;3080836000;7005563000
BPL;669884;USD;2012;Q4;2012-12-31;2013-02-26;;;6776000;262023000;259163000;634322000;4188648000;68713000;1089326000;5346687000;5981009000;305177000;;594366000;2735244000;2997803000;3592169000;2531092000;;;2388840000;5981009000
BPL;669884;USD;2011;Q4;2011-12-31;2012-02-27;;;12986000;206601000;298304000;626036000;3847573000;65882000;1030885000;4944340000;5570376000;301920000;;554979000;2393574000;2691440000;3246419000;2430910000;;;2323957000;5570376000
BPL;669884;USD;2010;Q4;2010-12-31;2011-02-28;;;13626000;167274000;351605000;626631000;2305884000;107047000;534654000;2947585000;3574216000;213410000;1525000;516520000;1519393000;1647436000;2163956000;1413664000;;;1410260000;3574216000
BPL;669884;USD;2009;Q4;2009-12-31;2010-08-06;;;37574000;124165000;310214000;617258000;2238321000;96851000;534141000;2869313000;3486571000;170197000;6178000;430840000;1500495000;1603437000;2034277000;242334000;;;1452294000;3486571000
BPL;669884;USD;2018;Q4;2018-12-31;2019-02-15;;;1830000;219751000;210884000;523637000;6914796000;1111793000;805324000;8831913000;9355550000;423718000;525000000;1127765000;4011715000;4096615000;5224380000;4160143000;;;4131170000;9355550000
TWLO;670420;USD;2018;Q4;2018-12-31;2019-03-01;99479814;99479814;748343000;97712000;;872948000;63534000;;92228000;155762000;1028710000;114838000;0;137810000;434496000;452665000;590475000;808627000;;-371674000;438235000;1028710000
TWLO;670420;USD;2017;Q4;2017-12-31;2018-03-01;93255551;93255551;290873000;43113000;;353265000;50541000;;45976000;96517000;449782000;64730000;;78527000;;11409000;89936000;608259000;;-250438000;359846000;449782000
TWLO;670420;USD;2016;Q4;2016-12-31;2017-02-22;86833698;86833698;305665000;26203000;;353380000;37552000;;21762000;59314000;412694000;63482000;;73704000;;9543000;83247000;516177000;;-186730000;329447000;412694000
TWLO;670420;USD;2015;Q4;2015-12-31;2016-08-09;17041673;17041673;108835000;19094000;;136475000;14058000;;6983000;21041000;157516000;34297000;;40443000;;448000;40891000;22120000;;-145406000;116625000;157516000
HDP;670518;USD;2017;Q4;2017-12-31;2018-03-15;71300065;71300065;72512000;112013000;;195334000;16383000;;39016000;55399000;250733000;39565000;;234466000;;81303000;315769000;842883000;;-907700000;-65036000;250733000
HDP;670518;USD;2016;Q4;2016-12-31;2017-03-15;60411078;60411078;85096000;82368000;;172295000;19381000;4084000;40076000;63541000;235836000;36479000;;166319000;;58155000;224474000;714967000;;-702542000;11362000;235836000
HDP;670518;USD;2015;Q4;2015-12-31;2016-03-15;45407470;45407470;94301000;53913000;;153490000;15422000;2592000;40515000;58529000;212019000;34039000;;124446000;;19982000;144428000;518991000;;-450854000;67591000;212019000
HDP;670518;USD;2014;Q4;2014-12-31;2015-05-14;16943423;16943423;204465000;32900000;;241093000;11182000;;3764000;14946000;256039000;23333000;;73613000;;15356000;88969000;439009000;;-271737000;167070000;256039000
LBTYA;670717;USD;2017;Q4;2017-12-31;2018-02-14;;;1672400000;1411000000;;4331600000;14245300000;6671400000;32348500000;53265200000;57596800000;3755800000;3680100000;9965800000;29023400000;41238000000;51203800000;11366700000;-100000;-6217600000;6393000000;57596800000
LBTYA;670717;USD;2016;Q4;2016-12-31;2017-02-16;;;1076600000;1374900000;;7051800000;17249300000;6388700000;37994300000;61632300000;68684100000;4714000000;2624300000;9722800000;34886500000;44229300000;53952100000;17588800000;-300000;-3454800000;14732000000;68684100000
LBTYA;670717;USD;2015;Q4;2015-12-31;2016-02-16;;;982100000;1467700000;;3357400000;21684000000;2839600000;39678000000;64201600000;67559000000;5226500000;2537900000;9157900000;44211200000;48226800000;57384700000;;;;10174300000;67559000000
LBTYA;670717;USD;2014;Q4;2014-12-31;2015-02-13;;;1158500000;1499500000;;3630200000;23840600000;1808200000;43562900000;69211700000;72841900000;5143500000;1550900000;9190300000;44608100000;49535600000;58725900000;;;;14116000000;72841900000
LBTYA;670717;USD;2013;Q4;2013-12-31;2014-02-13;;;2701900000;1588700000;;5256500000;23974900000;3491200000;34991700000;62457800000;67714300000;4374700000;1023400000;7683000000;43680900000;48489800000;56172800000;12817300000;-7700000;-3312600000;11541500000;67714300000
LBTYA;670717;USD;2012;Q4;2012-12-31;2013-08-01;;;2038900000;1031000000;;3725800000;13437600000;950100000;20194200000;34581900000;38307700000;2837200000;363500000;4620300000;27161000000;31602300000;36222600000;2958200000;0;-2348700000;2085100000;38307700000
LBTYA;670717;USD;2018;Q4;2018-12-31;2019-02-27;;;1480500000;1342100000;;4141400000;13878900000;5121800000;30011500000;49012200000;53153600000;3876300000;3615200000;10306100000;26190000000;38699200000;49005300000;9221900000;-100000;-5172200000;4148300000;53153600000
WGO;670940;USD;2017;Q4;2017-08-31;2017-10-20;31592000;31718000;35945000;124539000;142265000;314137000;71560000;;516815000;588375000;902512000;114318000;2850000;167158000;271726000;293680000;460838000;106289000;-342730000;679138000;441674000;902512000
WGO;670940;USD;2016;Q4;2016-08-31;2016-10-18;26896000;27046000;85583000;66184000;122522000;280589000;55931000;;54198000;110129000;390718000;63852000;0;92949000;0;29410000;122359000;58605000;-421767000;620546000;268359000;390718000
WGO;670940;USD;2015;Q4;2015-08-31;2015-10-27;26939000;27078000;70239000;66936000;112165000;266217000;37250000;;58707000;95957000;362174000;55147000;;81610000;;59601000;141211000;57906000;-420610000;585941000;220963000;362174000
WGO;670940;USD;2014;Q4;2014-08-31;2014-10-28;27065000;27166000;57804000;69699000;112848000;271693000;25135000;;61474000;86609000;358302000;59013000;;99719000;;65835000;165554000;57560000;-417500000;554496000;192748000;358302000
WGO;670940;USD;2013;Q4;2013-08-31;2013-10-29;27928000;28041000;64277000;29145000;112541000;223850000;20266000;2108000;62921000;85295000;309145000;51530000;;70354000;;68062000;138416000;55222000;-394785000;509443000;170729000;309145000
WGO;670940;USD;2012;Q4;2012-08-31;2012-10-23;29066000;29105000;62683000;22726000;87094000;187068000;19978000;9074000;69952000;99004000;286072000;41933000;;61018000;;80363000;141381000;54384000;-383497000;477490000;144691000;286072000
WGO;670940;USD;2011;Q4;2011-08-31;2011-12-23;29130000;29205000;69307000;19981000;69165000;164854000;22589000;10627000;41857000;75073000;239927000;33729000;;51318000;;79879000;131197000;56019000;-379353000;432518000;108730000;239927000
WGO;670940;USD;2018;Q4;2018-08-31;2018-10-18;31534000;31877000;2342000;164585000;195128000;371938000;101193000;;578674000;679867000;1051805000;129139000;0;204185000;291441000;313175000;517360000;112111000;-347374000;768816000;534445000;1051805000
WGO;670940;USD;2019;Q4;2019-08-31;2019-10-23;31507000;31702000;37431000;158049000;201126000;410657000;127572000;;566002000;693574000;1104231000;106022000;8892000;197744000;245402000;274275000;472019000;117073000;-351256000;866886000;632212000;1104231000
ACLS;670942;USD;2017;Q4;2017-12-31;2018-03-14;31829000;34797000;133407000;75302000;120544000;339775000;36168000;;112275000;148443000;488218000;53870000;;79287000;;55321000;134608000;556179000;;-204745000;353610000;488218000
ACLS;670942;USD;2016;Q4;2016-12-31;2017-03-14;29424000;31530000;70791000;50573000;113853000;240729000;30840000;;30662000;61502000;302231000;30378000;;47731000;;53045000;100776000;535438000;;-331704000;201455000;302231000
ACLS;670942;USD;2015;Q4;2015-12-31;2016-03-04;50162000;52877000;78889000;36868000;109408000;229957000;30031000;;21796000;51827000;281784000;29051000;;44368000;;53652000;98020000;529118000;-1218000;-342705000;183764000;281784000
ACLS;670942;USD;2014;Q4;2014-12-31;2015-03-12;90600375;90278563;30753000;42794000;104063000;185135000;30464000;;12055000;42519000;227654000;26033000;14530000;52098000;;7204000;59302000;519181000;-1218000;-350887000;168352000;227654000
ACLS;670942;USD;2013;Q4;2013-12-31;2014-03-03;6860375;6860375;46290000;36587000;95789000;184908000;32006000;;16635000;48641000;233549000;24713000;471000;35460000;14529000;22087000;57547000;511102000;-1218000;-339621000;176002000;233549000
ACLS;670942;USD;2012;Q4;2012-12-31;2013-03-01;6744688;6744688;44986000;24843000;100234000;175225000;34413000;;12520000;46933000;222158000;17727000;;29782000;;6300000;36082000;504751000;-1218000;-322477000;186076000;222158000
ACLS;670942;USD;2011;Q4;2011-12-31;2012-02-29;6655375;6781125;46877000;35071000;120023000;212033000;37204000;;20008000;57212000;269245000;28483000;;47472000;;7218000;54690000;499439000;-1218000;-288443000;214555000;269245000
ACLS;670942;USD;2010;Q4;2010-12-31;2011-08-05;6572938;6572938;45743000;57888000;109653000;228630000;38594000;;13648000;52242000;280872000;47306000;;68129000;;7176000;75305000;494073000;-1218000;-293520000;205567000;280872000
ACLS;670942;USD;2018;Q4;2018-12-31;2019-03-11;32471000;33970000;177993000;78727000;129000000;396771000;41149000;;110521000;151670000;548441000;55635000;;84997000;;55107000;140104000;565149000;;-157260000;408337000;548441000
ACW;671043;USD;2015;Q4;2015-12-31;2016-02-29;48016000;45314000;29759000;53065000;41761000;151930000;194821000;;256868000;451689000;603619000;98560000;10286000;121898000;304254000;410867000;532765000;444253000;;-369824000;70854000;603619000
ACW;671043;USD;2014;Q4;2014-12-31;2014-11-03;47750000;45191000;29773000;56271000;43065000;149880000;212183000;;236359000;448542000;598422000;97071000;0;97071000;323234000;470548000;567619000;442631000;;-362190000;30803000;598422000
ACW;671043;USD;2013;Q4;2013-12-31;2014-03-06;47588000;47588000;33426000;51382000;39329000;149268000;219624000;;242885000;462509000;611777000;89999000;;89999000;330183000;459894000;549893000;440479000;;-359883000;61884000;611777000
ACW;671043;USD;2012;Q4;2012-12-31;2013-03-18;47409000;47409000;26751000;56888000;61192000;162714000;267377000;;247725000;515102000;677816000;106761000;;106761000;324133000;506182000;612943000;438277000;;-321570000;64873000;677816000
ACW;671043;USD;2011;Q4;2011-12-31;2012-03-15;47299000;47134000;56915000;90001000;72827000;240149000;271562000;;357151000;628713000;868862000;128489000;;128489000;323082000;482990000;611479000;435368000;;-143563000;257383000;868862000
ASTC;671045;USD;2017;Q4;2017-06-30;2017-09-18;4051329;4051329;13084000;146000;166000;13665000;3180000;1990000;0;5170000;18835000;1809000;;1809000;;256000;2065000;191865000;-4121000;-170913000;16770000;18835000
ASTC;671045;USD;2016;Q4;2016-06-30;2016-09-29;3902000;3902000;21501000;156000;496000;22923000;3392000;4208000;;7600000;30523000;1800000;;1800000;;96000;1896000;190713000;-2828000;-159117000;28627000;30523000
ASTC;671045;USD;2015;Q4;2015-06-30;2015-09-22;4112400;4112400;25491000;198000;509000;32594000;3108000;8516000;;11624000;44218000;2389000;;2389000;;101000;2490000;190146000;-2672000;-146022000;41728000;44218000
ASTC;671045;USD;2014;Q4;2014-06-30;2014-09-30;3902600;3902600;3831000;59000;0;5684000;1211000;0;33887000;35098000;40782000;2749000;;10093000;;389000;10482000;185537000;-237000;-156800000;30300000;40782000
ASTC;671045;USD;2013;Q4;2013-06-30;2013-10-15;-11552938;-11552938;5096000;5317000;;10916000;37035000;;51000;37086000;48002000;4918000;387000;6609000;5655000;5913000;12522000;184769000;-237000;-151840000;35480000;48002000
ASTC;671045;USD;2012;Q4;2012-06-30;2012-09-28;7389776;7312176;10177000;1926000;;12695000;37270000;;84000;37354000;50049000;4667000;372000;7875000;6042000;6042000;13917000;185294000;-237000;-151655000;36132000;50049000
ASTC;671045;USD;2011;Q4;2011-06-30;2011-11-14;-10620342;-10620342;14994000;2429000;;18386000;38418000;;816000;39234000;57620000;2099000;348000;13366000;6422000;6696000;20062000;184816000;-237000;-148942000;37558000;57620000
ASTC;671045;USD;2018;Q4;2018-06-30;2018-09-25;4066934;4066934;4103000;12000;7000;4276000;733000;50000;81000;864000;5140000;960000;;960000;;188000;1148000;192315000;-4128000;-184164000;3992000;5140000
AKS;671046;USD;2017;Q4;2017-12-31;2018-02-15;314500000;319900000;38000000;517800000;1385000000;2071100000;1986200000;;417500000;2403700000;4474800000;960900000;;1001000000;2110100000;3173200000;4174200000;2888000000;-5400000;-2877000000;300600000;4474800000
AKS;671046;USD;2016;Q4;2016-12-31;2017-02-17;288600000;286900000;173200000;442000000;1113900000;1823700000;2014400000;;197900000;2212300000;4036000000;824000000;;865300000;1816600000;3080000000;3945300000;2858500000;-2400000;-3064800000;90700000;4036000000
AKS;671046;USD;2015;Q4;2015-12-31;2016-02-19;177400000;177100000;56600000;444900000;1226300000;1806200000;2086500000;;191700000;2278200000;4084400000;964900000;;1042600000;2354100000;3637400000;4680000000;2268600000;-2000000;-3057000000;-595600000;4084400000
AKS;671046;USD;2014;Q4;2014-12-31;2015-02-20;177300000;177300000;70200000;644300000;1172100000;1958000000;2213200000;388700000;268100000;2870000000;4828000000;1069600000;;1125200000;2422000000;3779800000;4905000000;2260900000;-1000000;-2548000000;-77000000;4828000000
AKS;671046;USD;2013;Q4;2013-12-31;2014-02-21;135800000;135800000;45300000;525200000;586600000;1273200000;1880100000;214100000;238300000;2332500000;3605700000;744700000;800000;831400000;1506200000;2581600000;3413000000;2080700000;-174000000;-2451100000;192700000;3605700000
AKS;671046;USD;2012;Q4;2012-12-31;2013-02-28;121600000;121600000;227000000;473900000;609200000;1442700000;2012300000;150000000;298100000;2460400000;3903100000;703100000;700000;812400000;1411200000;3181700000;3994100000;2071200000;-173300000;-2404300000;-91000000;3903100000
AKS;671046;USD;2011;Q4;2011-12-31;2012-02-27;109900000;109100000;42000000;564200000;418700000;1274400000;2170200000;156800000;848500000;3175500000;4449900000;756400000;700000;1137100000;650000000;2935600000;4072700000;1923400000;-171600000;-1366000000;377200000;4449900000
AKS;671046;USD;2010;Q4;2010-12-31;2011-02-22;109900000;109000000;216800000;482800000;448700000;1404100000;2033200000;55600000;695700000;2784500000;4188600000;698100000;700000;844500000;650600000;2703000000;3547500000;1910600000;-170100000;-1188400000;641100000;4188600000
AKS;671046;USD;2009;Q4;2009-12-31;2010-02-23;108800000;108300000;461700000;463100000;416700000;1630100000;1976000000;107700000;560900000;2644600000;4274700000;595900000;700000;740700000;605800000;2653900000;3394600000;1912600000;-162200000;-1037500000;880100000;4274700000
AKS;671046;USD;2008;Q4;2008-12-31;2009-08-04;;;562700000;469900000;566800000;2002800000;2061300000;106000000;511900000;2679200000;4682000000;581100000;700000;734200000;632600000;2977100000;3711300000;1900100000;-150800000;-940900000;970700000;4682000000
AKS;671046;USD;2018;Q4;2018-12-31;2019-02-15;314900000;314700000;48600000;635800000;1419900000;2201300000;1911600000;;402800000;2314400000;4515700000;1089900000;;1128600000;1993700000;2957600000;4086200000;2898100000;-6400000;-2691800000;429500000;4515700000
AIR;671123;USD;2018;Q4;2018-05-31;2018-07-11;34800000;35400000;31100000;202000000;460700000;942700000;133200000;;448800000;582000000;1524700000;308300000;;333300000;177200000;255100000;588400000;515800000;-280700000;733200000;936300000;1524700000
AIR;671123;USD;2017;Q4;2017-05-31;2017-07-12;34300000;34800000;10300000;234500000;433400000;888400000;117200000;;498500000;615700000;1504100000;304100000;100000;335000000;154100000;254900000;589900000;506000000;-279800000;727900000;914200000;1504100000
AIR;671123;USD;2016;Q4;2016-05-31;2016-07-13;34300000;34300000;31200000;248300000;452000000;881700000;238100000;;336200000;574300000;1456000000;329400000;12000000;341400000;136100000;248800000;590200000;496200000;-267600000;681600000;865800000;1456000000
AIR;671123;USD;2015;Q4;2015-05-31;2015-07-15;40200000;40100000;54700000;229000000;456000000;895800000;214800000;;343500000;558300000;1454100000;343000000;69000000;412000000;82400000;197000000;609000000;487500000;-246300000;644300000;845100000;1454100000
AIR;671123;USD;2014;Q4;2014-05-31;2014-07-17;38600000;39100000;89200000;283100000;495300000;1111400000;314900000;;767700000;1082600000;2194000000;332400000;69700000;402100000;564300000;791200000;1193300000;481100000;-98300000;646000000;1000700000;2194000000
AIR;671123;USD;2013;Q4;2013-05-31;2013-07-26;38300000;38600000;75300000;297400000;453700000;1033700000;361700000;;741500000;1103200000;2136900000;302600000;86400000;389000000;622200000;828400000;1217400000;476300000;-100100000;584900000;919500000;2136900000
AIR;671123;USD;2012;Q4;2012-05-31;2012-07-19;38900000;43100000;67700000;302100000;461200000;1063300000;382900000;;749500000;1132400000;2195700000;350400000;122800000;473200000;669400000;856500000;1329700000;468400000;-90400000;541800000;866000000;2195700000
AIR;671123;USD;2011;Q4;2011-05-31;2011-07-13;38527000;44893000;57433000;287435000;363399000;913985000;324377000;;465365000;789742000;1703727000;301935000;114075000;416010000;329802000;452428000;868438000;468791000;-100431000;486130000;835289000;1703727000
AIR;671123;USD;2010;Q4;2010-05-31;2010-09-23;38278000;43813000;79370000;238466000;356983000;846331000;219646000;;434204000;653850000;1500181000;223856000;100833000;324689000;336191000;429142000;753831000;461712000;-104447000;419287000;746350000;1500181000
SHLM;671141;USD;2017;Q4;2017-08-31;2017-10-25;29426000;29550000;53251000;408439000;276459000;781305000;298703000;;673772000;972475000;1753780000;432432000;32013000;464445000;1005467000;1202592000;1667037000;327736000;-382841000;220357000;86743000;1753780000
SHLM;671141;USD;2016;Q4;2016-08-31;2016-10-26;29346000;28972000;35260000;376786000;263617000;724069000;314822000;;708548000;1023370000;1747439000;404318000;25447000;429765000;1039638000;1269603000;1699368000;323625000;-382963000;219039000;48071000;1747439000
SHLM;671141;USD;2015;Q4;2015-08-31;2015-10-20;29222000;30107000;96872000;413943000;317328000;888348000;314494000;;1148869000;1463363000;2351711000;436606000;20710000;457316000;1165638000;1421949000;1879265000;322688000;-383121000;607690000;472446000;2351711000
SHLM;671141;USD;2014;Q4;2014-08-31;2014-10-22;29087000;29591000;135493000;384444000;292141000;852551000;253921000;;406012000;659933000;1512484000;421595000;31748000;453343000;339546000;522690000;976033000;316730000;-379894000;606898000;536451000;1512484000
SHLM;671141;USD;2013;Q4;2013-08-31;2013-10-24;29214000;28734000;134054000;310749000;261658000;747685000;210521000;;280136000;490657000;1238342000;361348000;8373000;369721000;207435000;353877000;723598000;311252000;-378927000;574370000;514744000;1238342000
SHLM;671141;USD;2012;Q4;2012-08-31;2012-10-24;29324000;29462000;124031000;304698000;247222000;708354000;225876000;;259537000;485413000;1193767000;331894000;35411000;367305000;174466000;318773000;686078000;307211000;-371099000;571205000;507689000;1193767000
SHLM;671141;USD;2011;Q4;2011-08-31;2012-01-05;30635000;30792000;155753000;347036000;264747000;801912000;234300000;;203775000;438075000;1239987000;360645000;11550000;372195000;184598000;313487000;685682000;302000000;-344759000;541256000;554305000;1239987000
AAOI;671827;USD;2017;Q4;2017-12-31;2018-02-28;19416757;20064637;82972000;59850000;75768000;229697000;197943000;;25344000;223287000;452984000;70149000;559000;70708000;49000000;49000000;119708000;285395000;;38138000;333276000;452984000
AAOI;671827;USD;2016;Q4;2016-12-31;2017-03-09;17634882;18106368;50268000;49766000;51817000;157552000;144098000;;20668000;164766000;322318000;51801000;7865000;59973000;34961000;34961000;94934000;265282000;;-37013000;227384000;322318000
AAOI;671827;USD;2015;Q4;2015-12-31;2016-03-14;16857370;18721788;35960000;38775000;66238000;153928000;109699000;;9848000;119547000;273475000;40174000;30908000;74080000;33997000;33997000;108077000;233353000;;-68247000;165398000;273475000
AAOI;671827;USD;2014;Q4;2014-12-31;2015-03-05;14846481;15724026;40364000;31589000;33780000;113239000;64808000;;5623000;70431000;183670000;37739000;9591000;48601000;19057000;20057000;68658000;192127000;;-79040000;115012000;183670000
AAOI;671827;USD;2013;Q4;2013-12-31;2014-03-06;30327591;30168296;29976000;22089000;19608000;77936000;31134000;;1987000;33121000;111057000;19525000;17185000;39057000;8923000;8923000;47980000;144036000;;-83323000;63077000;111057000
AAOI;671827;USD;2012;Q4;2012-12-31;2013-11-14;265626;265626;10723000;13525000;12493000;39246000;24838000;;1664000;26502000;65748000;10156000;13900000;25577000;9163000;9163000;34740000;5542000;;-81917000;31008000;65748000
AAOI;671827;USD;2018;Q4;2018-12-31;2019-02-26;19798549;18812687;55646000;30534000;93256000;194275000;234211000;;38354000;272565000;466840000;49201000;23589000;77418000;60328000;60328000;137746000;292500000;;35992000;329094000;466840000
VOXX;672273;USD;2011;Q4;2012-02-29;2012-05-14;23092941;23444877;13606000;142585000;129514000;307112000;31779000;27995000;265996000;325770000;632882000;66044000;3592000;122830000;40056000;88255000;211085000;281463000;-18369000;162676000;421797000;632882000
VOXX;672273;USD;2010;Q4;2011-02-28;2011-10-11;23040778;23276165;98630000;108048000;113620000;340830000;19563000;26264000;114440000;160267000;501097000;40932000;4471000;82302000;7425000;25849000;108151000;278144000;-18376000;137027000;392946000;501097000
BXC;673388;USD;2017;Q4;2018-01-31;2018-03-01;9080000;9453000;4696000;134072000;187512000;343404000;83772000;;66919000;150691000;494095000;101445000;5388000;117605000;301169000;341488000;459093000;259679000;;-188170000;35002000;494095000
BXC;673388;USD;2016;Q4;2017-01-31;2017-03-02;8980600;9574600;5540000;125857000;191287000;345810000;88322000;;10005000;98327000;444137000;112780000;29469000;154341000;270792000;319637000;473978000;258062000;;-251252000;-29841000;444137000
BXC;673388;USD;2015;Q4;2016-01-31;2016-03-28;8747600;8690000;4808000;138545000;226660000;402024000;101576000;;9542000;111118000;513142000;109539000;6611000;130173000;377773000;428865000;559038000;255994000;;-267116000;-45896000;513142000
BXC;673388;USD;2014;Q4;2015-01-31;2015-02-20;8654000;8594200;4522000;144537000;242546000;414894000;105267000;;15804000;121071000;535965000;100214000;2679000;117242000;400257000;454749000;571991000;253939000;;-255540000;-36026000;535965000
BXC;673388;USD;2013;Q4;2014-01-31;2014-02-24;8517500;8517500;5034000;150297000;223580000;401725000;111119000;;15645000;126764000;528489000;83913000;9141000;106826000;387238000;427561000;534387000;252016000;;-241621000;-5898000;528489000
CRUS;674434;USD;2017;Q4;2018-03-31;2018-05-30;62647000;64727000;262001000;100801000;205760000;613674000;191154000;172499000;452790000;816443000;1430117000;118228000;;140209000;0;128180000;268389000;1312434000;;-139345000;1161728000;1430117000
CRUS;674434;USD;2016;Q4;2017-03-31;2017-05-24;64242000;67363000;450979000;119974000;167895000;775928000;168139000;0;469403000;637542000;1413470000;129085000;;144075000;60000000;117703000;261778000;1259279000;;-107014000;1151692000;1413470000
CRUS;674434;USD;2015;Q4;2016-03-31;2016-05-25;62840000;65472000;229375000;88532000;142015000;506129000;162656000;20631000;492467000;675754000;1181883000;107816000;;128124000;160439000;194276000;322400000;1203496000;;-344345000;859483000;1181883000
CRUS;674434;USD;2014;Q4;2015-03-31;2015-05-27;62854000;65953000;200647000;112608000;84196000;451913000;144346000;60072000;492447000;696865000;1148778000;151762000;;176578000;180439000;215429000;392007000;1159494000;;-400613000;756771000;1148778000
CRUS;674434;USD;2013;Q4;2014-03-31;2014-05-28;62270000;64459000;295267000;63220000;69743000;475333000;103650000;89243000;56518000;249411000;724744000;69869000;;82523000;;4863000;87386000;1078878000;;-440634000;637358000;724744000
CRUS;674434;USD;2012;Q4;2013-03-31;2013-05-29;63871000;67214000;171637000;69289000;119300000;444534000;100623000;64910000;41280000;206813000;651347000;81699000;;93079000;;10094000;103173000;1041834000;;-492741000;548174000;651347000
CRUS;674434;USD;2011;Q4;2012-03-31;2012-05-30;64254000;67553000;181874000;44153000;55915000;351587000;66978000;2914000;122983000;192875000;544462000;65757000;;72985000;;5620000;78605000;1008228000;;-541609000;465857000;544462000
CRUS;674434;USD;2010;Q4;2011-03-31;2011-07-25;68202000;73084000;196567000;39098000;40497000;319470000;34563000;12702000;129886000;177151000;496621000;45210000;;52054000;;6188000;58242000;991947000;;-552814000;438379000;496621000
CRUS;674434;USD;2018;Q4;2019-03-31;2019-05-24;59019000;61656000;286355000;120656000;164733000;624983000;186185000;158968000;382504000;727657000;1352640000;94026000;;115540000;;96860000;212400000;1363736000;;-222430000;1140240000;1352640000
ENR;674540;USD;2017;Q4;2017-09-30;2017-11-14;61400000;61900000;378000000;230200000;317100000;1020200000;176500000;;626900000;803400000;1823600000;219300000;108100000;582000000;978500000;1156500000;1738500000;197300000;;198700000;85100000;1823600000
ENR;674540;USD;2016;Q4;2016-09-30;2016-11-15;62000000;62700000;287300000;190900000;289200000;889500000;201700000;;640300000;842000000;1731500000;217000000;61400000;533100000;981700000;1228400000;1761500000;195200000;-30000000;70900000;-30000000;1731500000
ENR;674540;USD;2015;Q4;2015-09-30;2015-11-20;62200000;62200000;502100000;155500000;275900000;1076900000;205600000;;336100000;541700000;1618600000;167000000;8200000;466400000;984300000;1212300000;1678700000;182300000;0;6900000;-60100000;1618600000
ENR;674540;USD;2014;Q4;2014-09-30;2015-08-11;62200000;62200000;89600000;218500000;292400000;747100000;212500000;;235100000;447600000;1194700000;190900000;0;380400000;0;89800000;470200000;0;0;0;724500000;1194700000
ENR;674540;USD;2018;Q4;2018-09-30;2018-11-16;59600000;61600000;522100000;230400000;323100000;1171100000;166700000;;1841000000;2007700000;3178800000;228900000;251300000;751200000;2206800000;2403100000;3154300000;218400000;-129400000;177300000;24500000;3178800000
ARCW;674718;USD;2017;Q4;2017-06-30;2017-09-26;18170371;18170371;593000;10488000;14369000;30054000;41349000;;28220000;69569000;99623000;11954000;3171000;17785000;44710000;47171000;64956000;31119000;-94000;3569000;34667000;99623000
ARCW;674718;USD;2016;Q4;2016-06-30;2016-09-09;18123883;18123883;3620000;13677000;15500000;40636000;41644000;;38232000;79876000;120512000;10927000;16485000;32700000;38699000;43269000;75969000;29712000;-94000;13771000;44543000;120512000
ARCW;674718;USD;2015;Q4;2015-06-30;2015-09-25;17814001;17814001;4821000;15385000;16386000;39594000;43813000;;42616000;86429000;126023000;10364000;6852000;22498000;54755000;56784000;79282000;29756000;-94000;15931000;46741000;126023000
ARCW;674718;USD;2014;Q4;2014-06-30;2013-11-13;14674348;14674348;9384000;15337000;15231000;42558000;45268000;;48563000;93831000;136389000;15335000;15543000;34294000;67480000;70754000;105048000;14296000;-94000;16143000;31341000;136389000
ARCW;674718;USD;2013;Q4;2013-06-30;2013-10-04;13732187;13732187;3601000;10636000;10780000;26291000;24051000;;16330000;40381000;66672000;7761000;7410000;16301000;24654000;24382000;40683000;13283000;-1000;11627000;25989000;66672000
ARCW;674718;USD;2012;Q4;2012-06-30;2012-11-14;10077250;10077250;1448000;3585000;3649000;9672000;4473000;;7188000;11661000;21333000;1663000;1491000;3660000;5377000;5074000;8734000;2609000;0;9146000;12599000;21333000
ARCW;674718;USD;2011;Q4;2011-06-30;2012-03-14;3962662;3962662;11048000;740000;185000;11990000;227000;;123000;350000;12340000;655000;49000;704000;;0;704000;20800000;;-9164000;11636000;12340000
ARCW;674718;USD;2010;Q4;2010-06-30;2011-08-12;3962662;3962662;11643000;385000;548000;12605000;272000;;116000;388000;12993000;616000;95000;711000;0;0;711000;20800000;;-8518000;12282000;12993000
ARCW;674718;USD;2018;Q4;2018-06-30;2018-09-28;23233172;23233172;365000;11251000;12327000;26898000;39980000;;23055000;63035000;89933000;13794000;3150000;18712000;38092000;39057000;57769000;41841000;-94000;-9627000;32164000;89933000
DXPE;674720;USD;2017;Q4;2017-07-31;2018-03-28;17393000;18233000;22047000;167272000;91413000;317915000;53337000;;267831000;321168000;639083000;98786000;3381000;124825000;238643000;245712000;370537000;153261000;;134193000;268546000;639083000
DXPE;674720;USD;2016;Q4;2016-07-31;2017-03-31;16579000;18259000;1590000;148919000;83699000;257325000;60807000;;283920000;344727000;602052000;95660000;51354000;166659000;173331000;182844000;349503000;152486000;;117395000;252549000;602052000
DXPE;674720;USD;2015;Q4;2015-07-31;2016-02-29;14511000;12831000;1693000;162925000;103819000;303961000;68503000;;311516000;380019000;683980000;97972000;50829000;180118000;298680000;304992000;485110000;110452000;-12577000;109783000;198870000;683980000
DXPE;674720;USD;2014;Q4;2014-07-31;2015-03-16;14468000;11948000;47000;239236000;115658000;386278000;69979000;;385375000;455354000;841632000;135871000;38608000;207202000;370194000;391478000;598680000;115751000;-15524000;148409000;242952000;841632000
DXPE;674720;USD;2013;Q4;2013-07-31;2014-03-11;14466000;15306000;5469000;186854000;105271000;314487000;58253000;;263875000;322128000;636615000;100179000;26213000;150055000;168372000;190310000;340365000;110036000;-5171000;193737000;296250000;636615000
DXPE;674720;USD;2012;Q4;2012-07-31;2013-03-11;14365000;15205000;10455000;174832000;101422000;295702000;58713000;;215317000;274030000;569732000;91268000;22057000;128452000;216339000;232787000;361239000;78695000;-4867000;133590000;208493000;569732000
DXPE;674720;USD;2011;Q4;2011-07-31;2012-03-09;28547721;30226881;1507000;137024000;93901000;239201000;16911000;;149226000;166137000;405338000;77245000;694000;134458000;114205000;114205000;248663000;75345000;-1445000;82695000;156675000;405338000
DXPE;674720;USD;2010;Q4;2010-07-31;2011-07-27;14154000;14992000;770000;99781000;75887000;185309000;14917000;;120398000;135315000;320624000;66845000;10930000;92883000;103621000;103621000;196504000;72756000;0;51348000;124120000;320624000
DXPE;674720;USD;2018;Q4;2018-07-31;2019-03-08;17189000;18029000;40304000;191829000;114830000;385590000;51330000;;263042000;314372000;699962000;108682000;3407000;143277000;236979000;248431000;391708000;156364000;;169735000;308254000;699962000
ADNT;675558;USD;2017;Q4;2017-09-30;2017-11-22;93200000;93700000;709000000;2224000000;735000000;4499000000;2502000000;;6169000000;8671000000;13170000000;3402000000;38000000;4328000000;3440000000;4222000000;8550000000;3942000000;;734000000;4620000000;13170000000
ADNT;675558;USD;2016;Q4;2016-09-30;2017-02-08;93700000;93600000;105000000;2082000000;660000000;5691000000;2195000000;;5070000000;7265000000;12956000000;3206000000;79000000;4260000000;3442000000;4355000000;8615000000;4452000000;;0;4341000000;12956000000
ADNT;675558;USD;2018;Q4;2018-09-30;2018-11-29;93200000;92900000;687000000;2091000000;824000000;4309000000;1683000000;;4950000000;6633000000;10942000000;3432000000;8000000;4192000000;3422000000;3986000000;8178000000;3951000000;;-1028000000;2764000000;10942000000
BSET;675839;USD;2017;Q4;2017-11-30;2018-01-18;10673795;10755494;77074000;19640000;54476000;159382000;103244000;;31122000;134366000;293748000;52844000;3405000;83356000;329000;18932000;102288000;54652000;;139378000;191460000;293748000
BSET;675839;USD;2016;Q4;2016-11-30;2017-01-19;10642551;10773770;58269000;18358000;53215000;140569000;104655000;;33043000;137698000;278267000;48542000;3290000;77013000;3821000;20549000;97562000;53870000;;129388000;180705000;278267000
BSET;675839;USD;2015;Q4;2015-11-30;2016-01-21;10832069;10938512;59393000;21197000;59896000;147284000;96104000;;39155000;135259000;282543000;50578000;5273000;79850000;8500000;25327000;105177000;59140000;;120904000;177366000;282543000
BSET;675839;USD;2014;Q4;2014-11-30;2015-01-22;10420550;10538887;49798000;15228000;57272000;130094000;74812000;;35840000;110652000;240746000;44255000;316000;66773000;1902000;17141000;83914000;52467000;;106339000;156832000;240746000
BSET;675839;USD;2013;Q4;2013-11-30;2014-01-23;10732639;10842633;40858000;16080000;53069000;126374000;64271000;;35204000;99475000;225849000;35227000;;51441000;2467000;16999000;68440000;54297000;;104526000;157409000;225849000
BSET;675839;USD;2012;Q4;2012-11-30;2012-10-04;10744905;10931881;45566000;15755000;57916000;132508000;56624000;;38048000;94672000;227180000;40327000;;52580000;3053000;17320000;69900000;54184000;;104319000;157280000;227180000
BSET;675839;USD;2011;Q4;2011-11-30;2012-02-03;11271673;11435711;69601000;14756000;45129000;140203000;49946000;;33025000;82971000;223174000;42589000;;51827000;3662000;18912000;70739000;56712000;;96331000;152435000;223174000
BSET;675839;USD;2010;Q4;2010-11-30;2011-10-06;;;11071000;31621000;41810000;91471000;46250000;15111000;44485000;105846000;197317000;43139000;9521000;61831000;4295000;29181000;91012000;58273000;;48459000;106305000;197317000
BSET;675839;USD;2018;Q4;2018-11-30;2019-01-17;10551244;10639570;56111000;19055000;64192000;148547000;104863000;;38231000;143094000;291641000;54370000;292000;81819000;0;19513000;101332000;52638000;;140009000;190309000;291641000
PRTS;675964;USD;2018;Q4;2018-12-31;2019-03-13;34988000;31743000;2032000;3727000;49626000;58785000;15184000;;23996000;39180000;97965000;44286000;594000;48319000;8559000;10824000;59143000;183177000;-7146000;-137791000;38822000;97965000
PRTS;675964;USD;2017;Q4;2017-12-31;2018-03-14;35070000;39159000;2859000;2470000;54231000;62532000;15085000;;23081000;38166000;100698000;43362000;579000;48898000;9173000;11439000;60337000;179943000;-7146000;-132996000;40361000;100698000
PRTS;675964;USD;2016;Q4;2016-12-31;2017-03-07;34878000;24871000;6673000;3266000;50904000;63658000;16478000;;1998000;18476000;82134000;40557000;542000;46789000;9770000;12023000;58812000;180188000;-1376000;-156520000;23322000;82134000
PRTS;675964;USD;2015;Q4;2015-12-31;2016-03-11;34083000;34083000;5602000;3236000;51216000;62529000;18431000;;2796000;21227000;83756000;32790000;521000;48924000;10168000;12689000;61613000;176907000;0;-157011000;22143000;83756000
PRTS;675964;USD;2014;Q4;2014-12-31;2015-03-20;33580000;32806000;7715000;3804000;48362000;62550000;16966000;;3391000;20357000;82907000;33109000;269000;47905000;9270000;12779000;60684000;174402000;;-155489000;22223000;82907000
PRTS;675964;USD;2013;Q4;2013-12-31;2014-03-12;33310000;33310000;865000;5029000;36986000;46114000;19663000;;3405000;23068000;69182000;25628000;269000;36353000;9502000;12023000;48376000;168726000;;-148370000;20806000;69182000
PRTS;675964;USD;2012;Q4;2012-12-31;2013-03-25;31129000;31129000;1140000;7431000;42727000;55474000;28559000;;4844000;33403000;88877000;38510000;70000;59540000;70000;1693000;61233000;159812000;;-132552000;27644000;88877000
PRTS;675964;USD;2011;Q4;2011-12-31;2012-03-26;30618000;30620000;11460000;7922000;52245000;75175000;34627000;2104000;30310000;67041000;142216000;52868000;135000;66955000;11662000;14337000;81292000;157171000;;-96574000;60924000;142216000
PRTS;675964;USD;2010;Q4;2010-12-31;2011-08-10;30400418;30400418;18657000;5339000;48100000;77742000;33140000;4141000;38514000;75795000;153537000;47147000;132000;58926000;18060000;21807000;80733000;153992000;;-81437000;72804000;153537000
LIVN;678892;USD;2018;Q4;2018-12-31;2019-03-18;48540000;46826000;47204000;256135000;153535000;533297000;191400000;;1825004000;2016404000;2549701000;223550000;28794000;496746000;139538000;549217000;1045963000;1781255000;-1462000;-251579000;1503738000;2549701000
LIVN;678892;USD;2017;Q4;2017-12-31;2018-02-28;48240000;48989000;93615000;282145000;144470000;869858000;192359000;;1441674000;1634033000;2503891000;177683000;84034000;406016000;61958000;282561000;688577000;1809798000;-133000;-39664000;1815314000;2503891000
LIVN;678892;USD;2016;Q4;2016-12-31;2017-03-01;48391000;48901000;39789000;213256000;133017000;812690000;203708000;;1326233000;1529941000;2342631000;161362000;47650000;349890000;75215000;285832000;635722000;1794471000;-4500000;-14575000;1706909000;2342631000
BHGE;679135;USD;2017;Q4;2017-12-31;2018-02-23;424000000;424000000;7030000000;6015000000;4507000000;18424000000;6959000000;;31117000000;38076000000;56500000000;3377000000;2037000000;9227000000;6312000000;8863000000;18090000000;15083000000;;-103000000;38410000000;56500000000
BHGE;679135;USD;2016;Q4;2016-12-31;2017-07-28;;;981000000;2563000000;3224000000;7401000000;2325000000;;11995000000;14320000000;21721000000;1898000000;239000000;4934000000;38000000;18514000000;23448000000;0;;0;-1727000000;21721000000
BHGE;679135;USD;2018;Q4;2018-12-31;2019-02-19;461000000;466000000;3723000000;5969000000;4620000000;14971000000;6228000000;;31240000000;37468000000;52439000000;4025000000;942000000;9020000000;6285000000;8406000000;17426000000;18659000000;;25000000;35013000000;52439000000
FNJN;679470;USD;2018;Q4;2018-12-31;2019-03-13;27468113;26396732;43314000;2550000;;52444000;99000;3518000;8532000;12149000;64593000;4951000;;6451000;;3463000;9914000;28537000;;26142000;54679000;64593000
BRK;679473;USD;2015;Q4;2015-04-30;2016-07-29;43083200;43083200;4612;;808;5420;5055;;;5055;10475;18264;246940;372243;;;372243;34050;;-395818;-361768;10475
JILL;680726;USD;2017;Q4;2018-01-31;2018-04-13;49908730;51806385;25978000;4733000;80591000;132468000;118420000;;346669000;465089000;597557000;102721000;2799000;105520000;238881000;312721000;418241000;117830000;;61486000;179316000;597557000
JILL;680726;USD;2016;Q4;2017-01-31;2017-06-12;52103801;52103801;13468000;3851000;66641000;104441000;102322000;;361542000;463864000;568305000;84559000;2799000;87358000;264440000;358083000;445441000;116743000;;6121000;122864000;568305000
JILL;680726;USD;2018;Q4;2019-01-31;2019-04-08;18607644;19033119;66204000;4007000;77349000;175294000;118044000;;333650000;451694000;626988000;100318000;2799000;103117000;237464000;310076000;413193000;122072000;;91723000;213795000;626988000
LYV;682157;USD;2017;Q4;2017-12-31;2018-02-27;205987846;178952725;1825322000;725304000;;3152742000;885936000;;3465585000;4351521000;7504263000;2143549000;347593000;3577000000;1952366000;2264392000;5841392000;2376075000;-6865000;-1079472000;1662871000;7504263000
LYV;682157;USD;2016;Q4;2016-12-31;2017-02-23;202594409;180316880;1526591000;568936000;;2673551000;751536000;;3339179000;4090715000;6764266000;1562999000;53317000;2460344000;2259736000;2607338000;5067682000;2383045000;-6865000;-1073457000;1696584000;6764266000
LYV;682157;USD;2015;Q4;2015-12-31;2016-02-25;201578103;186221136;1303125000;452600000;;2288315000;731282000;;3136644000;3867926000;6156241000;1408212000;42352000;2101206000;2002662000;2344401000;4445607000;2430586000;-6865000;-1075111000;1710634000;6156241000
LYV;682157;USD;2014;Q4;2014-12-31;2015-02-26;199674842;170067560;1382029000;419301000;;2267691000;695337000;;3005333000;3700670000;5968361000;1408139000;47443000;2010739000;1995957000;2304920000;4315659000;2416432000;-6865000;-1042603000;1652702000;5968361000
LYV;682157;USD;2013;Q4;2013-12-31;2014-02-24;197246587;187832886;1299184000;439151000;;2160104000;706800000;;2816617000;3523417000;5683521000;1436372000;278403000;2255518000;1530484000;1777156000;4032674000;2370259000;-6865000;-951796000;1650847000;5683521000
LYV;682157;USD;2012;Q4;2012-12-31;2013-02-26;187253910;182221311;1001055000;415790000;;1812812000;721786000;;2756208000;3477994000;5290806000;1287394000;62050000;1768172000;1677955000;1971960000;3740132000;2274759000;0;-908418000;1550674000;5290806000
LYV;682157;USD;2011;Q4;2011-12-31;2012-02-24;186312608;181938055;844253000;389346000;;1576790000;720136000;55796000;2724622000;3500554000;5077344000;1141149000;52632000;1492553000;1652629000;1959620000;3452173000;2245455000;-2787000;-745191000;1625171000;5077344000
LYV;682157;USD;2010;Q4;2010-12-31;2011-05-05;170782645;170782645;892758000;329947000;;1603497000;737064000;30077000;2824922000;3592063000;5195560000;1038041000;54150000;1474221000;1677714000;2112130000;3586351000;2054957000;-6122000;-662175000;1609209000;5195560000
LYV;682157;USD;2018;Q4;2018-12-31;2019-02-28;208091511;191143603;2371540000;829320000;;3848074000;946593000;;3702219000;4648812000;8496886000;2372880000;82142000;3749866000;2732878000;3074922000;6824788000;2270300000;-6865000;-1019223000;1672098000;8496886000
JACK;682281;USD;2018;Q4;2018-09-30;2018-11-21;27363000;27723000;2705000;57422000;1858000;94973000;419669000;;308755000;728424000;823397000;151892000;31828000;183720000;1037927000;1231376000;1415096000;471647000;-2530439000;1561353000;-591699000;823397000
JACK;682281;USD;2017;Q4;2017-09-30;2017-11-30;29983000;30370000;4467000;59609000;3445000;139278000;484276000;;611191000;1095467000;1234745000;163420000;64225000;261990000;1079982000;1360885000;1622875000;454250000;-2190439000;1485820000;-388130000;1234745000
JACK;682281;USD;2016;Q4;2016-09-30;2016-11-22;33184000;33445000;17030000;73360000;8229000;155405000;719050000;;470557000;1189607000;1345012000;221986000;55935000;277921000;935372000;1284297000;1562218000;433380000;-1863286000;1399721000;-217206000;1345012000
JACK;682281;USD;2015;Q4;2015-09-30;2015-11-19;36632000;37249000;17743000;47975000;7376000;107956000;728263000;;467760000;1196023000;1303979000;202712000;26677000;229389000;688579000;1058637000;1288026000;403797000;-1571433000;1316119000;15953000;1303979000
JACK;682281;USD;2014;Q4;2014-09-30;2014-11-21;39534000;40635000;10578000;50014000;7481000;146560000;722129000;;401976000;1124105000;1270665000;195436000;10871000;206307000;497012000;806447000;1012754000;357528000;-1254382000;1244897000;257911000;1270665000
JACK;682281;USD;2013;Q4;2013-09-30;2013-11-22;42888000;44719000;9644000;41749000;7181000;117212000;770859000;;431138000;1201997000;1319209000;190785000;20889000;211674000;349393000;635517000;847191000;297549000;-934692000;1171823000;472018000;1319209000
JACK;682281;USD;2012;Q4;2012-09-30;2012-11-21;44040000;45069000;8469000;78798000;7752000;231181000;820792000;;411752000;1232544000;1463725000;259350000;15952000;275302000;405276000;776478000;1051780000;221858000;-794571000;1120671000;411945000;1463725000
JACK;682281;USD;2011;Q4;2011-09-30;2011-11-23;46450000;47221000;11424000;86213000;7529000;258452000;851385000;;322485000;1173870000;1432322000;261835000;21148000;282983000;447350000;743383000;1026366000;203434000;-764558000;1063020000;405956000;1432322000
JACK;682281;USD;2010;Q4;2010-09-30;2010-11-24;54098000;54847000;10607000;81150000;37391000;274922000;878039000;;254131000;1132170000;1407092000;269402000;13781000;283183000;352630000;603446000;886629000;188289000;-571459000;982420000;520463000;1407092000
JACK;682281;USD;2009;Q4;2009-09-30;2010-08-05;56996000;57841000;53002000;49036000;37675000;300049000;936290000;;219571000;1155861000;1455910000;269720000;67977000;337697000;357270000;593724000;931421000;170180000;-474459000;912210000;524489000;1455910000
ULH;682408;USD;2017;Q4;2017-12-31;2018-03-16;28381000;28390000;16816000;171036000;;228666000;267195000;;114731000;381926000;610592000;146236000;40870000;199070000;207108000;242757000;441827000;34784000;-51532000;186226000;168765000;610592000
ULH;682408;USD;2016;Q4;2016-12-31;2017-03-15;28415000;28415000;16114000;144712000;;207451000;246277000;;116729000;363006000;570457000;105464000;34455000;144516000;226812000;278209000;422725000;34370000;-50044000;166033000;147732000;570457000
ULH;682408;USD;2015;Q4;2015-12-31;2016-03-15;28300000;28301000;26361000;141275000;;202840000;177189000;;123126000;300315000;503155000;88287000;62140000;153840000;173255000;218234000;372074000;33799000;-50018000;149743000;131081000;503155000
ULH;682408;USD;2014;Q4;2014-12-31;2015-03-16;29939000;29944000;22310000;151107000;;210894000;178069000;;140051000;318120000;529014000;100493000;10644000;114033000;227685000;277820000;391853000;33305000;-14953000;117913000;137161000;529014000
ULH;682408;USD;2013;Q4;2013-12-31;2014-03-14;30083000;30130000;21849000;132001000;;198513000;142656000;;148967000;291623000;490136000;90278000;7074000;100970000;235069000;283601000;384571000;31820000;-9322000;80952000;105565000;490136000
ULH;682408;USD;2012;Q4;2012-12-31;2013-03-18;30023000;30039000;12516000;118903000;;164260000;127791000;;35318000;163109000;327369000;99624000;0;103717000;146000000;166280000;269997000;31235000;-9316000;34589000;57372000;327369000
ULH;682408;USD;2011;Q4;2011-12-31;2012-03-15;30082000;30082000;21570000;112815000;;168717000;114200000;;32930000;147130000;315847000;91521000;16385000;113413000;66676000;107563000;220976000;96036000;-8325000;5998000;94871000;315847000
ULH;682408;USD;2010;Q4;2010-12-31;2011-08-10;73894000;73894000;21302000;68833000;;98524000;78206000;;35318000;113524000;212048000;42294000;;42294000;;5543000;47837000;96036000;-6625000;72559000;164211000;212048000
ULH;682408;USD;2018;Q4;2018-12-31;2019-03-18;28369000;28373000;15060000;215991000;;275258000;303234000;;264655000;567889000;843147000;151502000;51903000;221169000;348549000;412679000;633848000;35197000;-52462000;231525000;209299000;843147000
CDW;683318;USD;2017;Q4;2017-12-31;2018-03-01;152400000;154800000;144200000;2329300000;411500000;3396300000;161100000;;3409300000;3570400000;6966700000;1983000000;25500000;2522100000;3210000000;3459000000;5981100000;2913100000;0;-1831600000;985600000;6966700000
CDW;683318;USD;2016;Q4;2016-12-31;2017-03-01;160100000;163500000;263700000;2168600000;452000000;3238100000;163700000;;3546600000;3710300000;6948400000;1848600000;18500000;2280700000;3215900000;3622200000;5902900000;2858900000;0;-1673800000;1045500000;6948400000
CDW;683318;USD;2015;Q4;2015-12-31;2016-02-25;168500000;170200000;37600000;2017400000;393100000;2790800000;175400000;;3789100000;3964500000;6755300000;1451600000;27200000;1887300000;3232500000;3772100000;5659400000;2808600000;;-1651600000;1095900000;6755300000
CDW;683318;USD;2014;Q4;2014-12-31;2015-02-26;171700000;173200000;344500000;1561100000;337500000;2453400000;137200000;86700000;3398600000;3622500000;6075900000;1194300000;15400000;1468000000;3150600000;3671400000;5139400000;2713600000;;-1760500000;936500000;6075900000
CDW;683318;USD;2013;Q4;2013-12-31;2014-03-05;169100000;175200000;188100000;1451000000;382000000;2213500000;131100000;0;3580000000;3711100000;5924600000;1069700000;45400000;1402600000;3205800000;3810300000;5212900000;2689800000;;-1971800000;711700000;5924600000
CDW;683318;USD;2012;Q4;2012-12-31;2013-03-08;145400000;145800000;37900000;1285000000;314600000;1834700000;142700000;;3742600000;3885300000;5720000000;918100000;40000000;1168200000;3731000000;4415300000;5583500000;2209100000;;-2073000000;136500000;5720000000
CDW;683318;USD;2011;Q4;2011-12-31;2012-03-09;;;99900000;1273000000;321700000;1897500000;154300000;;3915900000;4070200000;5967700000;958000000;201000000;1359400000;3865000000;4615600000;5975000000;2186100000;;-2191300000;-7300000;5967700000
CDW;683318;USD;2010;Q4;2010-12-31;2011-09-14;;;36600000;1091500000;292800000;1702300000;158100000;;4083400000;4241500000;5943800000;725100000;132600000;1026900000;4157400000;4960400000;5987300000;2166700000;;-2208000000;-43500000;5943800000
CDW;683318;USD;2018;Q4;2018-12-31;2019-02-27;148900000;152000000;205800000;2671200000;454300000;3796800000;156100000;;3214800000;3370900000;7167700000;2248300000;25300000;2803100000;3183300000;3389400000;6192500000;2998400000;;-1892600000;975200000;7167700000
RUBI;683438;USD;2017;Q4;2017-12-31;2018-03-15;49306000;49306000;129146000;165890000;;304656000;47393000;;31586000;78979000;383635000;214103000;;217244000;;1780000;219024000;418354000;;-253784000;164611000;383635000
RUBI;683438;USD;2016;Q4;2016-12-31;2017-03-15;48078000;42920000;189973000;192064000;;391577000;36246000;;91952000;128198000;519775000;214903000;;218437000;;1825000;220262000;398787000;;-99001000;299513000;519775000
RUBI;683438;USD;2015;Q4;2015-12-31;2016-03-04;42172000;61500000;139748000;218235000;;365707000;25403000;13483000;132143000;171029000;536736000;247967000;;250163000;;8472000;258635000;358406000;;-80290000;278101000;536736000
RUBI;683438;USD;2014;Q4;2014-12-31;2015-03-06;34714000;34714000;97196000;133267000;;237977000;15196000;;43308000;58504000;296481000;151021000;105000;154402000;;13327000;167729000;209472000;;-80712000;128752000;296481000
RUBI;683438;USD;2013;Q4;2013-12-31;2014-05-15;11654000;11654000;29956000;94722000;;128819000;8712000;;12356000;21068000;149887000;120198000;288000;123387000;3893000;62911000;186298000;25532000;;-62039000;-36411000;149887000
RUBI;683438;USD;2018;Q4;2018-12-31;2019-02-27;;;87976000;205683000;;300541000;33487000;;25984000;59471000;360012000;239678000;;240982000;;1017000;241999000;433878000;;-315606000;118013000;360012000
AHS;683491;USD;2017;Q4;2017-12-31;2018-02-16;47618000;49280000;15147000;391508000;;474153000;73431000;;706373000;779804000;1253957000;251742000;;265272000;319843000;426158000;691430000;453835000;-33425000;142229000;562527000;1253957000
AHS;683491;USD;2016;Q4;2016-12-31;2017-02-17;47807000;49207000;10622000;391210000;;450628000;59954000;;676299000;736253000;1186881000;245505000;3750000;274790000;359192000;462708000;737498000;452972000;-13261000;9671000;449383000;1186881000
AHS;683491;USD;2015;Q4;2015-12-31;2016-02-24;47707000;49167000;9576000;328803000;;375628000;50134000;;454670000;504804000;880432000;202523000;7500000;251017000;180990000;281555000;532572000;444210000;0;-96167000;347860000;880432000
AHS;683491;USD;2014;Q4;2014-12-31;2015-02-25;46637000;48469000;13073000;214717000;;282670000;32880000;;365181000;398061000;680731000;146988000;7500000;178295000;135690000;245855000;424150000;434995000;;-178058000;256581000;680731000
AHS;683491;USD;2013;Q4;2013-12-31;2014-02-21;46014000;47822000;15580000;165748000;;232897000;21158000;;350233000;371391000;604288000;127263000;0;143090000;148672000;243456000;386546000;429515000;;-211275000;217742000;604288000
AHS;683491;USD;2012;Q4;2012-12-31;2013-02-22;44292000;52965000;5681000;160977000;;203744000;14815000;;298827000;313642000;517386000;102062000;;109525000;158178000;225750000;335275000;424749000;;-242195000;182111000;517386000
AHS;683491;USD;2011;Q4;2011-12-31;2012-03-09;40456000;46031000;3962000;169151000;;212473000;16863000;;306295000;323158000;535631000;93458000;28125000;140052000;174198000;259920000;399972000;395363000;;-259331000;135659000;535631000
AHS;683491;USD;2010;Q4;2010-12-31;2011-08-05;39169000;39169000;1883000;144546000;;179261000;21777000;;361072000;382849000;562110000;88390000;13875000;117893000;200811000;290762000;408655000;386942000;;-233066000;153455000;562110000
AHS;683491;USD;2018;Q4;2018-12-31;2019-02-21;46812000;48091000;13856000;416014000;;482166000;90419000;;920136000;1010555000;1492721000;284662000;;307270000;440607000;546461000;853731000;453218000;-100438000;286059000;638990000;1492721000
ATRO;683677;USD;2017;Q4;2017-12-31;2018-03-01;33106638;33106638;17914000;132633000;150196000;315329000;125830000;;294797000;420627000;735956000;80595000;2689000;102891000;269078000;303138000;406029000;297000;;;329927000;735956000
ATRO;683677;USD;2016;Q4;2016-12-31;2017-02-24;34358376;35146770;17901000;109415000;116597000;255073000;122812000;;226459000;349271000;604344000;60756000;2636000;86560000;145484000;180335000;266895000;65049000;-17618000;305512000;337449000;604344000
ATRO;683677;USD;2015;Q4;2015-12-31;2016-02-24;34713922;35702074;18561000;95277000;115467000;249967000;124742000;;234534000;359276000;609243000;62896000;2579000;104232000;167210000;204786000;309018000;58121000;0;257168000;300225000;609243000
ATRO;683677;USD;2014;Q4;2014-12-31;2015-02-27;34198002;35451874;21197000;88888000;115053000;245818000;116316000;;200776000;317092000;562910000;61368000;2796000;109216000;180212000;225517000;334733000;49878000;;190248000;228177000;562910000
ATRO;683677;USD;2013;Q4;2013-12-31;2014-03-07;33045736;34839717;54635000;60942000;85269000;211198000;70900000;;209173000;280073000;491271000;51241000;12279000;84267000;188041000;235495000;319762000;41005000;;134115000;171509000;491271000
ATRO;683677;USD;2012;Q4;2012-12-31;2013-02-22;29689785;31367067;7380000;45473000;48624000;108010000;53537000;;50442000;103979000;211989000;26226000;9268000;47968000;20715000;38887000;86855000;23028000;;106889000;125134000;211989000
ATRO;683677;USD;2011;Q4;2011-12-31;2012-03-07;27887079;29760157;10919000;35669000;40094000;92310000;41122000;;41473000;82595000;174905000;22127000;5290000;33477000;27973000;38565000;72042000;19260000;-2281000;86622000;102863000;174905000
ATRO;683677;USD;2010;Q4;2010-12-31;2011-08-09;32500545;34261013;22709000;30941000;37763000;97140000;30873000;;22875000;53748000;150888000;20599000;5314000;31285000;33264000;42388000;73673000;14326000;-2281000;65047000;77215000;150888000
ATRO;683677;USD;2018;Q4;2018-12-31;2019-03-01;30695242;31598180;16622000;182308000;138685000;374171000;120862000;;279607000;400469000;774640000;98436000;1870000;128092000;232112000;259923000;388015000;343000;;;386625000;774640000
SVU;684097;USD;2017;Q4;2018-02-28;2018-04-24;38000000;38000000;41000000;590000000;981000000;1861000000;1342000000;;1184000000;2526000000;4387000000;1326000000;34000000;1548000000;1873000000;2332000000;3880000000;2848000000;-3000000;-2130000000;507000000;4387000000
SVU;684097;USD;2016;Q4;2017-02-28;2017-04-25;38000000;38000000;327000000;376000000;645000000;1541000000;876000000;;1163000000;2039000000;3580000000;954000000;24000000;1229000000;1432000000;1968000000;3197000000;2831000000;-2000000;-2175000000;383000000;3580000000
SVU;684097;USD;2015;Q4;2016-02-29;2016-04-26;;;42000000;406000000;738000000;1635000000;1021000000;;1714000000;2735000000;4370000000;977000000;123000000;1572000000;2391000000;3231000000;4803000000;2811000000;-5000000;-2825000000;-433000000;4370000000
SVU;684097;USD;2014;Q4;2015-02-28;2015-04-28;260000000;267000000;114000000;482000000;984000000;1700000000;1470000000;;1264000000;2734000000;4434000000;1325000000;35000000;1517000000;2658000000;3553000000;5070000000;2813000000;-33000000;-3003000000;-636000000;4434000000
SVU;684097;USD;2013;Q4;2014-02-28;2014-04-23;258000000;261000000;83000000;493000000;861000000;1543000000;1497000000;;1334000000;2831000000;4374000000;1233000000;45000000;1491000000;2732000000;3613000000;5104000000;2865000000;-101000000;-3195000000;-730000000;4374000000
SVU;684097;USD;2012;Q4;2013-02-28;2013-04-24;212000000;212000000;72000000;466000000;854000000;2970000000;1700000000;;6364000000;8064000000;11034000000;1364000000;74000000;4350000000;2815000000;8099000000;12449000000;3048000000;-474000000;-3377000000;-1415000000;11034000000
SVU;684097;USD;2011;Q4;2012-02-29;2012-04-19;212000000;212000000;64000000;499000000;908000000;3273000000;2099000000;;6729000000;8828000000;12101000000;1466000000;345000000;3639000000;2881000000;8441000000;12080000000;3085000000;-515000000;-1892000000;21000000;12101000000
SVU;684097;USD;2010;Q4;2011-02-28;2011-04-21;212000000;212000000;172000000;743000000;2270000000;3420000000;6604000000;;3734000000;10338000000;13758000000;2661000000;403000000;3786000000;6348000000;8632000000;12418000000;3085000000;-521000000;-778000000;1340000000;13758000000
SVU;684097;USD;2009;Q4;2010-02-28;2010-04-26;;;211000000;814000000;2342000000;3711000000;7026000000;;5699000000;12725000000;16436000000;2775000000;613000000;4167000000;7022000000;9382000000;13549000000;3087000000;-528000000;806000000;2887000000;16436000000
SVU;684097;USD;2008;Q4;2009-02-28;2009-10-21;211000000;211000000;240000000;874000000;2709000000;4105000000;7528000000;;5971000000;13499000000;17604000000;3169000000;516000000;4472000000;7968000000;10551000000;15023000000;3083000000;-541000000;542000000;2581000000;17604000000
HFC;684316;USD;2017;Q4;2017-12-31;2018-02-21;176190000;179742000;630757000;720733000;1630092000;3062828000;4713274000;;2916052000;7629326000;10692154000;1422710000;;1422710000;2498993000;3372504000;4795214000;4135256000;-2140911000;3346615000;5896940000;10692154000
HFC;684316;USD;2016;Q4;2016-12-31;2017-02-22;175931000;175762000;1134727000;479199000;1135676000;2851009000;4008448000;;2576204000;6584652000;9435661000;1083229000;;1083229000;2235137000;3050447000;4133676000;4029365000;-2135311000;2776728000;5301985000;9435661000
HFC;684316;USD;2015;Q4;2015-12-31;2016-02-24;181292000;181841000;210552000;351978000;841869000;1448065000;4115662000;;2824572000;6940234000;8388299000;860615000;;860615000;1040040000;1717911000;2578526000;4013612000;-2027231000;3271189000;5809773000;8388299000
HFC;684316;USD;2014;Q4;2014-12-31;2015-02-25;195275000;194873000;1042095000;589905000;1035131000;2782998000;3670539000;;2776510000;6447049000;9230047000;1233994000;;1233994000;1054297000;1895334000;3129328000;4006188000;-1289075000;2778577000;6100719000;9230047000
HFC;684316;USD;2013;Q4;2013-12-31;2014-02-26;198309000;200094000;1665263000;708802000;1354247000;3896444000;3394596000;;2765699000;6160295000;10056739000;1450491000;;1674490000;997519000;1772851000;3447341000;3993190000;-1138872000;3144480000;6609398000;10056739000
BBSI;684470;USD;2017;Q4;2017-12-31;2018-03-06;7301000;7878000;60509000;136664000;;308235000;24909000;1199000;348142000;374250000;682485000;195829000;221000;322255000;4171000;271396000;593651000;12384000;;77880000;88834000;682485000
BBSI;684470;USD;2016;Q4;2016-12-31;2017-03-08;7243000;7571000;56443000;126484000;;235383000;26673000;642000;319190000;346505000;581888000;168769000;221000;275164000;4392000;237031000;512195000;9710000;;59986000;69693000;581888000
BBSI;684470;USD;2015;Q4;2015-12-31;2016-05-26;7205000;7588000;25218000;90529000;;206068000;22820000;6082000;261807000;290709000;496777000;130726000;19833000;237393000;0;204833000;442226000;7036000;;47546000;54551000;496777000
BBSI;684470;USD;2014;Q4;2014-12-31;2015-03-16;7120000;6869000;41501000;102627000;;163664000;22675000;79463000;186599000;288737000;452401000;124786000;25220000;225302000;19833000;194279000;419581000;4481000;;28362000;32820000;452401000
BBSI;684470;USD;2013;Q4;2013-12-31;2014-03-14;7166000;7767000;113344000;85586000;;201956000;20549000;17114000;73703000;111366000;313322000;97317000;220000;146464000;5053000;94305000;240769000;5853000;;66726000;72553000;313322000
BBSI;684470;USD;2012;Q4;2012-12-31;2013-03-15;18953539;19383534;62495000;63921000;;131270000;18489000;19625000;59477000;97591000;228861000;72141000;220000;111276000;5273000;63689000;174965000;983000;;52890000;53896000;228861000
BBSI;684470;USD;2011;Q4;2011-12-31;2012-03-15;25103500;25303500;66449000;46520000;;122999000;16249000;25318000;58531000;100098000;223097000;54279000;0;79318000;1879000;42124000;121442000;21042000;;80647000;101655000;223097000
BBSI;684470;USD;2010;Q4;2010-12-31;2011-08-09;5102000;5129000;55435000;37596000;;97185000;15037000;14732000;60930000;90699000;187884000;38931000;;58723000;2686000;33796000;92519000;25266000;;70164000;95365000;187884000
BBSI;684470;USD;2018;Q4;2018-12-31;2019-03-05;7385000;7966000;35787000;151597000;;201264000;24812000;1687000;528326000;554825000;756089000;187988000;221000;326738000;3951000;310314000;637052000;15511000;;108594000;119037000;756089000
SAFM;684669;USD;2017;Q4;2017-10-31;2017-12-14;22398000;22398000;419285000;138868000;252765000;849538000;876808000;;6897000;883705000;1733243000;198721000;;198721000;;101660000;300381000;157802000;;1275060000;1432862000;1733243000
SAFM;684669;USD;2016;Q4;2016-10-31;2016-12-15;22236000;22236000;234111000;124348000;220306000;613324000;803991000;;5385000;809376000;1422700000;148189000;;148189000;;84249000;232438000;148548000;;1041714000;1190262000;1422700000
SAFM;684669;USD;2015;Q4;2015-10-31;2015-12-17;22050000;22050000;196659000;112924000;198753000;558081000;682334000;;6337000;688671000;1246752000;151247000;10000000;161247000;;55644000;216891000;134208000;;895653000;1029861000;1246752000
SAFM;684669;USD;2014;Q4;2014-10-31;2014-12-18;22452000;22452000;165610000;118296000;190823000;510706000;596125000;;4421000;600546000;1111252000;137635000;10000000;147635000;10000000;65669000;213304000;173252000;;724696000;897948000;1111252000
SAFM;684669;USD;2013;Q4;2013-10-31;2013-12-17;22386000;22386000;85563000;108980000;205855000;430743000;488466000;;5436000;493902000;924645000;150744000;10799000;161543000;29414000;91503000;253046000;165498000;;506101000;671599000;924645000
SAFM;684669;USD;2012;Q4;2012-10-31;2012-12-18;22352000;22307000;27802000;98022000;235912000;397787000;495313000;;3353000;498666000;896453000;124837000;10757000;135594000;150212000;210784000;346378000;158252000;;391823000;550075000;896453000
SAFM;684669;USD;2011;Q4;2011-10-31;2011-12-20;22148000;22148000;11075000;94021000;211753000;437958000;505505000;;5058000;510563000;948521000;102556000;11106000;113662000;273670000;327959000;441621000;153400000;;353500000;506900000;948521000
SAFM;684669;USD;2010;Q4;2010-10-31;2011-02-24;;;73419000;92467000;153289000;344968000;493727000;;2925000;496652000;841620000;105754000;1048000;106802000;62075000;89105000;195907000;149658000;;496055000;645713000;841620000
SAFM;684669;USD;2018;Q4;2018-10-31;2018-12-20;22191000;22191000;121193000;121932000;240056000;566489000;1087588000;;5363000;1092951000;1659440000;198889000;;198889000;;72658000;271547000;103369000;;1284524000;1387893000;1659440000
FSI;684672;USD;2017;Q4;2017-12-31;2018-04-02;11520053;11740459;6912138;2105471;4686852;13959541;1938509;13414;1861906;3813829;17773370;2040712;201193;2700513;150896;150896;2851409;15126433;;451621;14921961;17773370
FSI;684672;USD;2016;Q4;2016-12-31;2017-03-31;11451526;11701337;2470066;3008153;3786093;9493011;3393944;122480;2149052;5665476;15158487;1795904;201193;2342405;352089;352089;2694494;14854321;;-1303120;12463993;15158487
FSI;684672;USD;2015;Q4;2015-12-31;2016-03-29;13178118;13355719;2498738;1954877;3275476;7972433;3791109;0;2379088;6170197;14142630;1119553;201193;1561197;553282;553282;2114479;16330403;;-3096454;12028151;14142630
FSI;684672;USD;2014;Q4;2014-12-31;2015-03-31;13169991;12885035;747517;2322373;3467438;6660839;4764900;;2809115;7574015;14234854;955983;358214;2108790;754475;754475;2863265;16240291;;-4601150;11371589;14234854
FSI;684672;USD;2013;Q4;2013-12-31;2014-03-31;13169991;12935841;568087;2012115;3061536;6049892;5831123;;2874155;8705278;14755170;570476;304556;2288582;993274;993274;3281856;16149123;;-5004495;11473314;14755170
FSI;684672;USD;2012;Q4;2012-12-31;2013-04-01;13169991;12936423;361867;2199359;3361760;6049995;7185730;;500516;7686246;13736241;723967;318644;2560167;1407406;1407406;3967573;16019968;;-6826129;9768668;13736241
FSI;684672;USD;2011;Q4;2011-12-31;2012-03-29;13151516;13513002;506903;2332019;2890511;5864794;8205514;;434939;8640453;14505247;952888;329389;2244669;1647603;1647603;3892272;15877518;;-5741682;10612975;14505247
FSI;684672;USD;2010;Q4;2010-12-31;2011-08-15;13962567;;2763420;1198939;2539190;6693818;7867672;;432075;8299747;14993565;1132380;122726;1505106;2206075;2206075;3711181;16652190;;-5924671;11282384;14993565
HNRG;684673;USD;2017;Q4;2017-12-31;2018-03-13;29954000;29954000;14390000;16762000;22847000;71637000;420006000;11890000;14660000;446556000;518193000;21115000;;54286000;165773000;214584000;268870000;98172000;;150236000;249323000;518193000
HNRG;684673;USD;2016;Q4;2016-12-31;2017-03-10;29286000;29286000;11551000;22307000;20191000;82750000;422760000;11699000;14114000;448573000;531323000;19918000;;48714000;204944000;265719000;314433000;94110000;;122052000;216890000;531323000
HNRG;684673;USD;2015;Q4;2015-12-31;2016-03-11;29094000;29094000;17273000;16675000;26170000;66615000;445235000;17112000;11416000;473763000;540378000;26184000;;51040000;219502000;282518000;333558000;92567000;;114341000;206820000;540378000
HNRG;684673;USD;2014;Q4;2014-12-31;2015-03-06;28805000;28805000;15125000;27297000;34641000;84409000;457610000;18717000;18849000;495176000;579585000;28105000;;49980000;284470000;339730000;389710000;90507000;;99003000;189875000;579585000
HNRG;684673;USD;2013;Q4;2013-12-31;2014-03-07;28640000;28028000;16228000;10577000;7604000;40170000;182341000;21306000;15382000;219029000;259199000;10357000;;10357000;16000000;66722000;77079000;88159000;;93582000;182120000;259199000
HNRG;684673;USD;2012;Q4;2012-12-31;2013-03-07;28377000;29256000;21888000;8127000;4606000;34863000;166838000;16199000;11307000;194344000;229207000;11046000;;11046000;11400000;56152000;67198000;86861000;;75118000;162009000;229207000
HNRG;684673;USD;2011;Q4;2011-12-31;2012-03-02;-56210505;-57090756;37542000;6689000;4065000;48876000;161828000;15430000;6294000;183552000;232428000;15536000;;33096000;;38339000;71435000;86267000;;74685000;160993000;232428000
HNRG;684673;USD;2010;Q4;2010-12-31;2011-08-05;27814;28505;10277000;5450000;4511000;26232000;145392000;10092000;4948000;160432000;186664000;8809000;;19501000;17500000;40430000;59931000;84352000;;42381000;126733000;186664000
AVGO;686523;USD;2018;Q4;2018-11-30;2018-12-21;411000000;409000000;4292000000;3325000000;1124000000;9107000000;2635000000;;38382000000;41017000000;50124000000;1526000000;0;2338000000;17493000000;21129000000;23467000000;23285000000;;3487000000;26657000000;50124000000
AVGO;686523;USD;2017;Q4;2017-11-30;2018-06-14;411000000;358000000;11204000000;2448000000;1447000000;15823000000;2599000000;;35996000000;38595000000;54418000000;1731000000;117000000;2529000000;17431000000;28703000000;31232000000;20505000000;;-129000000;23186000000;54418000000
ALTR;686620;USD;2017;Q4;2017-12-31;2018-03-21;58752000;58752000;39213000;86635000;1980000;143888000;31446000;;112537000;143983000;287871000;31440000;232000;197463000;178000;29817000;227280000;232162000;;-166499000;60591000;287871000
ALTR;686620;USD;2016;Q4;2016-12-31;2017-12-01;49845000;57166000;16874000;70498000;1227000;105103000;29708000;;115965000;145673000;250776000;27964000;10435000;158005000;74806000;127424000;285429000;39693000;;-67092000;-34653000;250776000
ALTR;686620;USD;2018;Q4;2018-12-31;2019-03-01;70653000;77022000;35345000;96803000;1964000;154034000;30153000;;299029000;329182000;483216000;40097000;331000;127758000;31417000;68676000;196434000;379839000;;-82005000;286782000;483216000
TPX;686753;USD;2016;Q4;2016-12-31;2017-02-24;55600000;57000000;65700000;341600000;196500000;667700000;422200000;;1608900000;2031100000;2698800000;490800000;70300000;561100000;1817800000;2172000000;2733100000;493800000;-1700000000;1264800000;-34300000;2698800000
TPX;686753;USD;2015;Q4;2015-12-31;2016-02-12;62500000;62900000;153900000;379400000;199200000;809100000;361700000;;1484700000;1846400000;2655500000;531500000;181500000;713000000;1273300000;1639900000;2352900000;464400000;-1174400000;1110300000;302600000;2655500000
TPX;686753;USD;2014;Q4;2014-12-31;2015-02-13;60800000;63600000;62500000;385800000;217200000;722000000;355600000;;1505100000;1860700000;2582700000;471700000;66400000;538100000;1498300000;1829300000;2367400000;412900000;-1191300000;1036800000;215300000;2582700000
TPX;686753;USD;2013;Q4;2013-12-31;2014-02-21;60300000;63200000;81000000;349200000;199200000;727500000;411600000;;1590800000;2002400000;2729900000;401100000;39600000;441500000;1796900000;2158300000;2599800000;397500000;-1193100000;927900000;130100000;2729900000
TPX;686753;USD;2012;Q4;2012-12-31;2013-02-01;59600000;62000000;179300000;136300000;93000000;827600000;186000000;;305900000;491900000;1319500000;189200000;0;215700000;1025000000;1081500000;1297200000;380000000;-1199400000;849300000;22300000;1319500000
TPX;686753;USD;2011;Q4;2011-12-31;2012-01-30;65221000;66940000;111400000;142400000;91200000;379800000;160500000;;297900000;458400000;838200000;167000000;;167600000;585000000;639800000;807400000;362800000;-1059800000;742500000;30800000;838200000
GBT;687412;USD;2017;Q4;2017-12-31;2018-02-27;43845755;43845755;314825000;;;324312000;16571000;14607000;1230000;32408000;356720000;25891000;;26264000;;11652000;37916000;617097000;;-297957000;318804000;356720000
GBT;687412;USD;2016;Q4;2016-12-31;2017-03-13;36652218;36652218;147274000;;;149769000;2420000;50058000;140000;52618000;202387000;14606000;;15515000;;563000;16078000;367408000;;-180933000;186309000;202387000
GBT;687412;USD;2015;Q4;2015-12-31;2016-03-29;29666558;29666558;148502000;;;149724000;2114000;;140000;2254000;151978000;8907000;;9627000;;1556000;11183000;239260000;;-98465000;140795000;151978000
GBT;687412;USD;2014;Q4;2014-12-31;2015-09-24;1903830;1903830;52069000;;;53593000;2023000;;140000;2163000;55756000;2336000;;2537000;102161000;102545000;105082000;2000;;-49328000;-49326000;55756000
GBT;687412;USD;2018;Q4;2018-12-31;2019-02-27;53039753;53039753;477534000;;;485780000;14981000;114281000;2601000;131863000;617643000;32874000;;33773000;;11071000;44844000;1044997000;;-472150000;572799000;617643000
PAH;687589;USD;2018;Q4;2018-12-31;2019-02-28;288500000;272800000;233600000;382400000;188100000;2482200000;266900000;;6652400000;6919300000;9401500000;290400000;25300000;1142500000;5350700000;6077900000;7220400000;4065000000;-3500000;-1195400000;2181100000;9401500000
PAH;687589;USD;2017;Q4;2017-12-31;2018-02-28;287100000;287100000;258400000;399800000;186400000;2340600000;287400000;;7624400000;7911800000;10252400000;316700000;10100000;1091700000;5437100000;6300700000;7392400000;4034900000;-100000;-869700000;2860000000;10252400000
PAH;687589;USD;2016;Q4;2016-12-31;2017-03-13;279700000;365600000;422600000;1054800000;416400000;2071200000;460500000;;7522400000;7982900000;10054100000;966600000;116100000;1082700000;5122900000;6081600000;7164300000;3984100000;0;-573500000;2889800000;10054100000
PAH;687589;USD;2015;Q4;2015-12-31;2016-03-11;217200000;217200000;432200000;1023000000;484600000;2237600000;491600000;;7461000000;7952600000;10190200000;1007700000;54700000;1062400000;5173600000;6208600000;7271000000;3522700000;;-532700000;2919200000;10190200000
PAH;687589;USD;2014;Q4;2014-12-31;2015-03-30;168100000;152700000;397300000;327300000;205800000;1576500000;178600000;;2792200000;2970800000;4547300000;227500000;13200000;240700000;1392400000;1754000000;1994700000;2814300000;;-224100000;2552600000;4547300000
BMS;687804;USD;2017;Q4;2017-12-31;2018-02-23;90700000;91300000;71100000;448700000;620200000;1237100000;1318100000;;1144700000;2462800000;3699900000;507700000;21000000;666100000;1542400000;1832600000;2498700000;603300000;-1332400000;2324800000;1201200000;3699900000
BMS;687804;USD;2016;Q4;2016-12-31;2017-02-17;93300000;93800000;74200000;461900000;549400000;1165500000;1283800000;;1266400000;2550200000;3715700000;409200000;17300000;576100000;1527800000;1879900000;2456000000;594400000;-1228600000;2341700000;1259700000;3715700000
BMS;687804;USD;2015;Q4;2015-12-31;2016-02-19;95800000;97000000;59200000;451300000;525900000;1119000000;1206300000;;1164500000;2370800000;3489800000;370000000;35400000;589100000;1353900000;1693300000;2282400000;586000000;-1084700000;2216000000;1207400000;3489800000
BMS;687804;USD;2014;Q4;2014-12-31;2015-02-20;99000000;100200000;47100000;496300000;575800000;1287800000;1142900000;;1180100000;2323000000;3610800000;291500000;31300000;481400000;1311600000;1696400000;2177800000;572500000;-934600000;2086800000;1433000000;3610800000
BMS;687804;USD;2013;Q4;2013-12-31;2014-02-21;102600000;103600000;141700000;615400000;648500000;1504500000;1284300000;;1321400000;2605700000;4110200000;395100000;14900000;601900000;1421400000;1823500000;2425400000;560900000;-782500000;2005100000;1684800000;4110200000
BMS;687804;USD;2012;Q4;2012-12-31;2013-02-28;103300000;104200000;114100000;645200000;661900000;1525000000;1351300000;;1309400000;2660700000;4185700000;416400000;8900000;643000000;1417600000;1901800000;2544800000;558100000;-705200000;1900900000;1640900000;4185700000
BMS;687804;USD;2011;Q4;2011-12-31;2012-02-29;102758000;103105000;109800000;665400000;646000000;1549000000;1440900000;;1330500000;2771400000;4320400000;439700000;15100000;682000000;1554800000;2056300000;2738300000;545100000;-705200000;1832900000;1582100000;4320400000
BMS;687804;USD;2010;Q4;2010-12-31;2011-03-01;108091000;108179000;60404000;637738000;673863000;1466919000;1540753000;;1278159000;2818912000;4285831000;569288000;2947000;675259000;1283525000;1683140000;2358399000;580698000;-544100000;1751908000;1927432000;4285831000
BMS;687804;USD;2009;Q4;2009-12-31;2010-08-09;;;1065687000;467988000;399067000;2005348000;1157193000;;766164000;1923357000;3928705000;403545000;31322000;524855000;1227514000;1552167000;2077022000;579812000;-498341000;1649804000;1851683000;3928705000
BMS;687804;USD;2018;Q4;2018-12-31;2019-02-15;91000000;92000000;76100000;443300000;619500000;1234600000;1250300000;;1086100000;2336400000;3571000000;549200000;12000000;701600000;1348600000;1653500000;2355100000;617100000;-1332400000;2456700000;1215900000;3571000000
ZDPY;687925;USD;2017;Q4;2017-12-31;2018-03-13;17339058;15612551;824240;;;952142;7206090;;1893989;9100079;10052221;96828;;2217378;;0;2217378;20647994;;-12815151;7834843;10052221
ZDPY;687925;USD;2016;Q4;2016-12-31;2017-03-27;17195598;17195598;366024;;;506034;8059687;;1070278;9129965;9635999;282564;2100000;2957314;500000;500000;3457314;20369738;;-14193053;6178685;9635999
ZDPY;687925;USD;2015;Q4;2015-12-31;2016-03-09;17057388;17057388;1281464;;;1387148;7271081;;430152;7701233;9088381;221573;2100000;2847823;500000;500000;3347823;19430035;;-13691477;5740558;9088381
ZDPY;687925;USD;2014;Q4;2014-12-31;2016-03-09;;;1066377;;;1241690;8545645;;74173;8619818;9861508;151731;2100000;2751731;500000;500000;3251731;18927224;;-12319447;6609777;9861508
ZDPY;687925;USD;2018;Q4;2018-12-31;2019-03-28;17442154;17435508;354867;;;471834;7758782;;600;7759382;8231216;207421;;2301971;6032;6032;2308003;20763642;;-14842429;5923213;8231216
WPTH;687927;USD;2013;Q4;2013-12-31;2015-08-12;578000;-236771000;54157;;;752037;4717000;;150000;4867000;5619037;12701977;36726149;52852126;0;0;52852126;-9584184;;-37649826;-47233089;5619037
WPTH;687927;USD;2012;Q4;2012-12-31;2015-08-12;578000;;35049;;;733118;4717000;;0;4717000;5450118;9093385;35695666;48748051;;;48748051;-9584184;;-33714670;-43297933;5450118
WPTH;687927;USD;2011;Q4;2011-12-31;2012-06-05;;;1423236;;;1672078;10475000;;;10475000;12147078;6077826;34233533;44338597;;;44338597;-9584184;;-22608256;-32191519;12147078
WPTH;687927;USD;2010;Q4;2010-12-31;2012-06-05;;;456716;;;918181;21100000;;;21100000;22018181;2546861;30481238;37647506;;;37647506;-9584184;;-6046062;-15629325;22018181
NATR;687929;USD;2017;Q4;2017-12-31;2018-03-16;18910000;18106000;42910000;8888000;44047000;102509000;71086000;;21600000;92686000;195195000;49803000;;53657000;17814000;21806000;75463000;131525000;;-2072000;119732000;195195000
NATR;687929;USD;2016;Q4;2016-12-31;2017-03-14;18756000;18899000;34060000;7738000;47597000;94501000;74663000;;36406000;111069000;205570000;49444000;9919000;63035000;6755000;10137000;73172000;129654000;;12718000;132398000;205570000
NATR;687929;USD;2015;Q4;2015-12-31;2016-03-14;18595000;19155000;43192000;7700000;38495000;101518000;69772000;;29230000;99002000;200520000;46280000;2696000;53136000;7809000;11119000;64255000;126670000;;18088000;136265000;200520000
NATR;687929;USD;2014;Q4;2014-12-31;2015-03-13;18756000;19910000;61245000;6732000;40438000;121249000;52381000;;23169000;75550000;196799000;53192000;0;57909000;6598000;9933000;67842000;125489000;;10891000;128957000;196799000
NATR;687929;USD;2013;Q4;2013-12-31;2014-03-17;16202000;17002000;79253000;10206000;41910000;148594000;32993000;;18025000;51018000;199612000;62129000;2267000;68569000;22402000;25784000;94353000;83122000;;36100000;105259000;199612000
NATR;687929;USD;2012;Q4;2012-12-31;2013-03-07;15781000;16267000;81312000;9614000;43280000;145333000;29226000;;19360000;48586000;193919000;53729000;3350000;61390000;12841000;16893000;78283000;77292000;;48910000;115636000;193919000
NATR;687929;USD;2011;Q4;2011-12-31;2012-03-05;15569000;15998000;64646000;9868000;41611000;125103000;26566000;;24142000;50708000;175811000;61899000;3296000;67798000;16320000;20575000;88373000;71628000;;25879000;87438000;175811000
NATR;687929;USD;2010;Q4;2010-12-31;2011-08-05;15524000;15602000;54074000;5947000;36235000;106538000;29169000;;23708000;52877000;159415000;61783000;;65168000;21366000;25865000;91033000;67752000;;8278000;68382000;159415000
NATR;687929;USD;2018;Q4;2018-12-31;2019-03-08;19213000;18355000;50638000;7751000;42048000;106825000;65369000;;20822000;86191000;193016000;63960000;;66687000;2192000;5761000;72448000;133684000;;-2072000;120568000;193016000
SSP;688615;USD;2017;Q4;2017-12-31;2018-02-28;81788000;81625000;148699000;245365000;;605534000;209995000;7699000;1306320000;1524014000;2129548000;65586000;5656000;210788000;687619000;981275000;1192063000;1129836000;;-90061000;937485000;2129548000
SSP;688615;USD;2016;Q4;2016-12-31;2017-02-24;82388000;82762000;134352000;178537000;;345895000;225437000;14221000;1150353000;1390011000;1735906000;47174000;6571000;104131000;386614000;685840000;789971000;1133359000;;-94077000;945935000;1735906000
SSP;688615;USD;2015;Q4;2015-12-31;2016-02-26;84147000;84147000;114621000;171901000;;302630000;271047000;13856000;1093327000;1378230000;1680860000;65275000;6656000;119823000;392487000;660054000;779877000;1164823000;;-174038000;900983000;1680860000
SSP;688615;USD;2014;Q4;2014-12-31;2015-03-13;23000;3611000;158459000;99609000;;315824000;157841000;9454000;547985000;715280000;1031104000;34888000;2000000;134538000;194373000;376633000;511171000;526026000;;118693000;519933000;1031104000
SSP;688615;USD;2013;Q4;2013-12-31;2014-03-04;57468000;57468000;221255000;139703000;6543000;402054000;353797000;16567000;193712000;564076000;966130000;43515000;2000000;113121000;198000000;305272000;418393000;509803000;;116893000;547737000;966130000
SSP;688615;USD;2012;Q4;2012-12-31;2013-03-06;62063890;63170604;242642000;125639000;6437000;402700000;374931000;21115000;232022000;628068000;1030768000;60447000;15900000;146033000;180200000;344825000;490858000;518243000;;136293000;539910000;1030768000
SSP;688615;USD;2011;Q4;2011-12-31;2012-03-07;61577026;61577026;127889000;135537000;6783000;325410000;387972000;23214000;233932000;645118000;970528000;52942000;15900000;125048000;196100000;328479000;453527000;515964000;;96105000;517001000;970528000
SSP;688615;USD;2010;Q4;2010-12-31;2011-08-09;;;204924000;115568000;7859000;362579000;389650000;10652000;64661000;464963000;827542000;78382000;0;138484000;0;97526000;236010000;558808000;;111641000;591532000;827542000
SSP;688615;USD;2018;Q4;2018-12-31;2019-03-01;80646000;82218000;107114000;281330000;;471017000;237927000;7162000;1413955000;1659044000;2130061000;71848000;3000000;198059000;685764000;1005837000;1203896000;1107791000;;-86229000;926165000;2130061000
IFON;689587;USD;2017;Q4;2017-12-31;2018-03-08;-1206874;-1206874;346000;11856000;1631000;14852000;391000;;7209000;7600000;22452000;12117000;3374000;15932000;5540000;8855000;24787000;7579000;;-9786000;-2335000;22452000
IFON;689587;USD;2016;Q4;2016-12-31;2017-03-10;-1724418;-1724418;2200000;7569000;4071000;15510000;132000;;384000;516000;16026000;5436000;;5436000;;0;5436000;33161000;;-19876000;10590000;16026000
IFON;689587;USD;2015;Q4;2015-12-31;2016-03-11;-1722939;-1738659;2647000;9387000;6637000;20696000;156000;;129000;285000;20981000;6741000;;6741000;;0;6741000;32873000;;-17041000;14240000;20981000
IFON;689587;USD;2014;Q4;2014-12-31;2015-03-10;574440;607000;1464000;15714000;5880000;25836000;137000;;31000;168000;26004000;7175000;;9900000;;0;9900000;32628000;;-15798000;16104000;26004000
IFON;689587;USD;2013;Q4;2013-12-31;2014-03-14;567360;566760;2369000;12019000;2467000;20290000;200000;;179000;379000;20669000;4341000;;4341000;;0;4341000;32405000;;-16059000;16328000;20669000
IFON;689587;USD;2012;Q4;2012-12-31;2013-03-22;567360;567360;5230000;10342000;3429000;21525000;367000;;229000;596000;22121000;5300000;;5300000;;0;5300000;32296000;;-15462000;16821000;22121000
IFON;689587;USD;2011;Q4;2011-12-31;2012-03-16;;;11422000;8686000;2238000;25831000;311000;;69000;380000;26211000;7225000;;7225000;;0;7225000;32065000;;-12962000;18986000;26211000
IFON;689587;USD;2010;Q4;2010-12-31;2011-08-12;;;12484000;12847000;1688000;28382000;294000;;68000;362000;28744000;7422000;;7479000;;0;7479000;31870000;;-10474000;21265000;28744000
IFON;689587;USD;2018;Q4;2018-12-31;2019-04-16;16503342;7854;1281000;3549000;3623000;11567000;1009000;;1115000;2124000;13691000;6568000;4464000;13575000;2873000;2873000;16448000;35311000;;-37057000;-2757000;13691000
QSIM;689588;USD;2016;Q4;2016-06-30;2016-10-13;22693274;22693274;180805;;;223919;985231;;120029;1105260;1329179;1758158;1596403;3575784;;;3575784;44232116;;-46478721;-2246605;1329179
QSIM;689588;USD;2015;Q4;2015-06-30;2015-09-28;22251539;22251539;398570;;65668;503319;1346346;;124025;1470371;1973690;425582;240139;2083813;;;2083813;42009373;;-42119496;-110123;1973690
PRLE;691898;USD;2015;Q4;2015-12-31;2016-02-05;405096;405096;174000;0;;184000;0;;0;0;184000;16000;;16000;198000;198000;214000;28151000;-801000;-27385000;-30000;184000
HCOM;692076;USD;2017;Q4;2017-12-31;2018-03-13;11588768;11588768;40759000;32229000;6810000;86025000;608298000;;45183000;653481000;739506000;68610000;10250000;100441000;299066000;418856000;519297000;182805000;;53368000;220209000;739506000
HCOM;692076;USD;2016;Q4;2016-12-31;2017-03-14;11513479;11685550;15821000;33377000;8090000;68610000;595997000;;139314000;735311000;803921000;68799000;3000000;93139000;281699000;405868000;499007000;180073000;;160059000;304914000;803921000
HCOM;692076;USD;2015;Q4;2015-12-31;2016-03-08;11379756;11695471;30312000;32736000;8499000;77717000;579107000;;142871000;721978000;799695000;59332000;3000000;85815000;283046000;406181000;491996000;178134000;;158953000;307699000;799695000
HCOM;692076;USD;2014;Q4;2014-12-31;2015-03-12;10664939;11385068;39885000;32662000;9337000;88963000;565956000;;141805000;707761000;796724000;69898000;3000000;94374000;284179000;397816000;492190000;170628000;;157853000;304534000;796724000
HCOM;692076;USD;2013;Q4;2013-12-31;2014-03-13;10384143;11183967;49551000;34521000;15939000;114732000;524375000;;138908000;663283000;778015000;59015000;3000000;84549000;291679000;380454000;465003000;167974000;;149754000;313012000;778015000
HCOM;692076;USD;2012;Q4;2012-12-31;2013-03-14;10281845;10770013;66993000;34082000;11352000;125496000;507197000;;152399000;659596000;785092000;56888000;3000000;79034000;292410000;429198000;508232000;166044000;;139266000;276860000;785092000
HCOM;692076;USD;2011;Q4;2011-12-31;2012-03-15;10175181;10648074;82063000;37712000;8190000;134199000;482371000;;45202000;527573000;661772000;48596000;2600000;69517000;297400000;456059000;525576000;164430000;;29284000;136196000;661772000
ARMK_old;692435;USD;2012;Q4;2012-09-30;2012-12-20;;;136689000;1315997000;508416000;2158374000;1003377000;;7314571000;8317948000;10476322000;2105050000;37462000;2142512000;5375819000;6761330000;8903842000;1451241000;;161137000;1572480000;10476322000
ARMK_old;692435;USD;2011;Q4;2011-09-30;2011-12-15;;;213323000;1252266000;450848000;2130822000;1004690000;;7374040000;8378730000;10509552000;2001965000;49064000;2051029000;5588614000;6981560000;9032589000;1476061000;;46468000;1476963000;10509552000
ARMK_old;692435;USD;2010;Q4;2010-09-30;2011-08-11;;;160266000;932932000;421883000;1811047000;1047691000;;7363177000;8410868000;10221915000;1879430000;51647000;1948602000;5350178000;6876356000;8824958000;1446187000;;79296000;1396957000;10221915000
CMRO;692525;USD;2016;Q4;2017-01-31;2017-05-01;14528000;14536000;618000;;;632000;;;;;632000;395000;;395000;;0;395000;19871000;;-19634000;237000;632000
CMRO;692525;USD;2015;Q4;2016-01-31;2016-05-02;14646000;14646000;680000;122000;;843000;2000;;77000;79000;922000;1570000;;1570000;;0;1570000;19831000;;-20479000;-648000;922000
CMRO;692525;USD;2014;Q4;2015-01-31;2015-04-30;44022632;44536206;2140000;;;2269000;8000;;5000;13000;2282000;1625000;;1625000;;;1625000;19790000;;-19133000;657000;2282000
CMRO;692525;USD;2013;Q4;2014-01-31;2014-04-30;29462530;29462456;1096000;;;1241000;14000;;82000;96000;1337000;6542000;;9062000;;;9062000;17448000;;-25173000;-7725000;1337000
CMRO;692525;USD;2012;Q4;2013-01-31;2013-04-30;7552000;7529000;104000;1132000;466000;3009000;120000;;82000;202000;3211000;7519000;;9985000;;;9985000;16341000;;-23115000;-6774000;3211000
CMRO;692525;USD;2011;Q4;2012-01-31;2012-04-30;7390000;7390000;908000;673000;1131000;3709000;126000;;92000;218000;3927000;5227000;;5227000;;41000;5268000;16182000;;-17523000;-1341000;3927000
CMRO;692525;USD;2010;Q4;2011-01-31;2011-09-14;7344000;7344000;6381000;3550000;1521000;12341000;420000;;0;420000;12761000;8942000;;8942000;;0;8942000;16032000;;-12213000;3819000;12761000
TXMD;692917;USD;2017;Q4;2017-12-31;2018-02-23;212980164;212980164;127135628;4328802;1485358;139554072;437055;;3238783;3675838;143229910;4097600;;13321195;;;13321195;516567835;;-386659120;129908715;143229910
TXMD;692917;USD;2016;Q4;2016-12-31;2017-02-28;196623182;196623182;131534101;4500699;1076321;139410173;516839;;2545008;3061847;142472020;7358514;;14982599;;;14982599;437191740;;-309702319;127489421;142472020
TXMD;692917;USD;2015;Q4;2015-12-31;2016-02-26;179260354;179260354;64706355;3049715;690153;70680120;198592;;2850134;3048726;73728846;3126174;;10665700;;;10665700;282890006;;-219826860;63063146;73728846
TXMD;692917;USD;2014;Q4;2014-12-31;2015-03-12;156203391;156203391;51361607;2154217;1182113;56235344;63293;;2780851;2844144;59079488;6327129;;10690381;;;10690381;183138943;;-134749836;48389107;59079488
TXMD;692917;USD;2013;Q4;2013-12-31;2014-03-05;145161284;145161284;54191260;1690753;1043618;59403346;61318;;2551729;2613047;62016393;2114217;;7317986;;0;7317986;135231033;;-80532626;54698407;62016393
TXMD;692917;USD;2012;Q4;2012-12-31;2013-03-12;99921460;99921460;1553474;714425;1615210;4635047;65673;;1225159;1290832;5925879;1641366;;3619772;3589167;3739235;7359007;50680185;;-52113313;-1433128;5925879
TXMD;692917;USD;2011;Q4;2011-12-31;2012-03-27;78492950;78492950;126421;26720;588073;1237274;26752;;174695;201447;1438721;2484832;;3150579;0;0;3150579;15281220;;-16993078;-1711858;1438721
TXMD;692917;USD;2018;Q4;2018-12-31;2019-02-27;238832458;238832458;161613077;11063821;3267670;186779261;472683;;24731980;25204663;211983924;22743841;;41078789;73381014;73381014;114459803;616800401;;-519276280;97524121;211983924
LHCG;693030;USD;2017;Q4;2017-12-31;2018-03-01;17751120;18051283;2849000;161898000;;200965000;46453000;;546284000;592737000;793702000;84497000;286000;102252000;144000000;171466000;273718000;126716000;-42249000;364401000;519984000;793702000
LHCG;693030;USD;2016;Q4;2016-12-31;2017-03-09;17597882;17693111;3264000;124803000;;149741000;43251000;;421079000;464330000;614071000;64569000;252000;80467000;87544000;119485000;199952000;119972000;-39135000;314289000;414119000;614071000
LHCG;693030;USD;2015;Q4;2015-12-31;2016-03-03;17451023;17560588;6139000;110350000;;138830000;38096000;;389128000;427224000;566054000;52684000;241000;70166000;98543000;125687000;195853000;114015000;-37139000;277706000;370201000;566054000
LHCG;693030;USD;2014;Q4;2014-12-31;2015-03-11;17274719;17358476;531000;97498000;;135352000;34787000;;321600000;356387000;491739000;41744000;230000;60842000;60778000;97785000;158627000;108928000;-35660000;245371000;333112000;491739000
LHCG;693030;USD;2013;Q4;2013-12-31;2014-03-06;17093831;17148431;14014000;88964000;;129555000;31052000;;261619000;292671000;422226000;49144000;249000;59646000;22963000;55438000;115084000;104190000;-34715000;223534000;307142000;422226000
LHCG;693030;USD;2012;Q4;2012-12-31;2013-03-18;17036821;17047095;9720000;83951000;;120730000;29531000;;236633000;266164000;386894000;44787000;;55210000;19500000;48044000;103254000;100835000;-33846000;201192000;283640000;386894000
LHCG;693030;USD;2011;Q4;2011-12-31;2012-03-15;18302925;18099157;256000;91183000;;138265000;28182000;;229929000;258111000;396376000;48690000;;57536000;34820000;60758000;118294000;96147000;-6216000;173752000;278082000;396376000
LHCG;693030;USD;2010;Q4;2010-12-31;2011-08-09;18167144;18279029;288000;79939000;;107148000;26862000;;223295000;250157000;357305000;44129000;;51465000;0;16817000;68282000;91198000;-4453000;186996000;289023000;357305000
LHCG;693030;USD;2018;Q4;2018-12-31;2019-02-28;30955813;31228131;49363000;252592000;;366905000;79563000;;1482247000;1561810000;1928715000;161389000;7773000;206112000;235930000;283533000;489645000;938324000;-49374000;427975000;1439070000;1928715000
TYL;693134;USD;2017;Q4;2017-12-31;2018-02-21;37702000;39509000;229085000;246188000;;520815000;152315000;50617000;887604000;1090536000;1611351000;72849000;;371462000;;48153000;419615000;627348000;-60029000;624463000;1191736000;1611351000
TYL;693134;USD;2016;Q4;2016-12-31;2017-02-22;36650000;38973000;56424000;200334000;;282960000;124268000;33221000;917496000;1074985000;1357945000;63284000;;361501000;10000000;80919000;442420000;557144000;-77449000;435876000;915525000;1357945000
TYL;693134;USD;2015;Q4;2015-12-31;2016-02-24;35335000;37867000;46510000;176360000;;268215000;101112000;38199000;949044000;1088355000;1356570000;55945000;;337572000;66000000;160141000;497713000;608236000;-75352000;326019000;858857000;1356570000
TYL;693134;USD;2014;Q4;2014-12-31;2015-02-18;33275000;35659000;206167000;112660000;;337036000;65910000;2498000;164368000;232776000;569812000;43627000;;232839000;;0;232839000;201870000;-126001000;261150000;336973000;569812000
TYL;693134;USD;2013;Q4;2013-12-31;2014-02-19;32507000;35358000;78876000;106570000;;209476000;64844000;2412000;167756000;235012000;444488000;35372000;;192110000;;6059000;198169000;182657000;-138502000;202210000;246319000;444488000
TYL;693134;USD;2012;Q4;2012-12-31;2013-02-20;30735000;33379000;6406000;99212000;;116098000;45381000;4421000;172766000;222568000;338666000;29185000;;169735000;18000000;23632000;193367000;154499000;-172041000;163109000;145299000;338666000
TYL;693134;USD;2011;Q4;2011-12-31;2012-02-23;29880000;32088000;1351000;90012000;;101997000;40915000;5662000;146817000;193394000;295391000;27962000;;151640000;60700000;65641000;217281000;153340000;-204990000;130115000;78110000;295391000
TYL;693134;USD;2010;Q4;2010-12-31;2011-07-28;34075000;36779000;2139000;81860000;;95343000;34851000;5594000;128244000;168689000;264032000;22059000;;124649000;26500000;32411000;157060000;154057000;-149368000;102558000;106972000;264032000
TYL;693134;USD;2018;Q4;2018-12-31;2019-02-20;38627000;39904000;178585000;298912000;;518858000;155177000;86358000;1030570000;1272105000;1790963000;73390000;;423902000;0;42215000;466117000;731916000;-178949000;771925000;1324846000;1790963000
TNDM;693227;USD;2016;Q4;2016-12-31;2017-03-08;3086700;3086700;53538000;11172000;21195000;90092000;18409000;;3891000;22300000;112392000;19325000;;31476000;78960000;86843000;118319000;398654000;;-404580000;-5927000;112392000
TNDM;693227;USD;2015;Q4;2015-12-31;2016-02-24;3021600;3021600;71106000;14055000;17543000;104984000;15526000;;4215000;19741000;124725000;19116000;;26520000;29275000;34737000;61257000;384581000;;-321133000;63468000;124725000
TNDM;693227;USD;2014;Q4;2014-12-31;2015-02-24;2358200;2358200;67282000;7652000;11913000;88751000;12581000;;5132000;17713000;106464000;14591000;;18094000;29440000;33798000;51892000;303279000;;-248715000;54572000;106464000
SYNT;693332;USD;2017;Q4;2017-12-31;2018-02-26;83071000;83248000;122495000;115052000;;292026000;106298000;;85392000;191690000;483716000;107359000;;134867000;334446000;361771000;496638000;;;;-12922000;483716000
SYNT;693332;USD;2016;Q4;2016-12-31;2017-03-02;84118000;83826000;99946000;118299000;;279590000;106476000;;68477000;174953000;454543000;103404000;;132641000;478616000;504989000;637630000;67423000;35043000;-30648000;-183087000;454543000
SYNT;693332;USD;2015;Q4;2015-12-31;2016-02-26;84080000;84203000;1040544000;136926000;;1244341000;105776000;;73153000;178929000;1423270000;109472000;;247169000;;17656000;264825000;67423000;38389000;1288242000;1158445000;1423270000
SYNT;693332;USD;2014;Q4;2014-12-31;2015-02-27;83898000;84056000;867061000;111993000;;1063477000;109051000;;51487000;160538000;1224015000;118119000;;130237000;129750000;145948000;276185000;67423000;30935000;1035716000;947830000;1224015000
SYNT;693332;USD;2013;Q4;2013-12-31;2014-02-28;167186000;83902000;668934000;101974000;;843112000;109605000;;44459000;154064000;997176000;112193000;;124285000;138375000;150345000;274630000;67423000;23450000;785976000;722546000;997176000
SYNT;693332;USD;2012;Q4;2012-12-31;2013-02-28;208526000;209003000;421275000;86004000;;570890000;119118000;;35828000;154946000;725836000;93712000;;148435000;0;11731000;160166000;67423000;18062000;566318000;565670000;725836000
SYNT;693332;USD;2011;Q4;2011-12-31;2012-02-27;41652000;41737000;320426000;88573000;;460483000;106002000;;30763000;136765000;597248000;84370000;;94062000;;9997000;104059000;67423000;13692000;484508000;493189000;597248000
SYNT;693332;USD;2010;Q4;2010-12-31;2011-08-05;41569000;41680000;287200000;75873000;;412107000;102107000;;31903000;134010000;546117000;72411000;;82194000;;12453000;94647000;67421000;11008000;371626000;451470000;546117000
KHC;693432;USD;2017;Q4;2017-12-31;2018-02-16;1219000000;1226000000;1629000000;921000000;2815000000;7266000000;7120000000;;105846000000;112966000000;120232000000;5700000000;3203000000;10132000000;28333000000;43853000000;53985000000;58723000000;-224000000;8589000000;66247000000;120232000000
KHC;693432;USD;2016;Q4;2016-12-31;2017-02-23;1218000000;1224000000;4204000000;769000000;2684000000;8753000000;6688000000;;105039000000;111727000000;120480000000;5415000000;2691000000;9501000000;29713000000;53405000000;62906000000;58605000000;-207000000;588000000;57574000000;120480000000
KHC;693432;USD;2015;Q4;2015-12-31;2016-03-03;1245000000;1223000000;4837000000;871000000;2618000000;9780000000;6524000000;;106669000000;113193000000;122973000000;5280000000;83000000;6932000000;25151000000;58125000000;65057000000;58387000000;-31000000;0;57916000000;122973000000
KHC;693432;USD;2014;Q4;2014-12-31;2015-08-10;377000000;377000000;2298000000;690000000;1185000000;4915000000;2365000000;;29291000000;31656000000;36571000000;2347000000;;3092000000;13358000000;26481000000;29573000000;7324000000;0;0;6998000000;36571000000
KHC;693432;USD;2018;Q4;2018-12-31;2019-06-07;1219000000;1196000000;1130000000;2129000000;2667000000;9075000000;7078000000;;87308000000;94386000000;103461000000;5283000000;398000000;7503000000;30770000000;44180000000;51683000000;58735000000;-282000000;-4853000000;51778000000;103461000000
FND;693510;USD;2017;Q4;2017-12-31;2018-03-05;94974591;106176449;556000;54041000;427950000;503212000;220952000;;343828000;564780000;1067992000;333277000;3500000;359300000;185562000;265832000;625132000;323515000;;119550000;442860000;1067992000
FND;693510;USD;2016;Q4;2016-12-31;2017-05-25;166802473;177370453;451000;34533000;293702000;336215000;150471000;;344480000;494951000;831166000;225758000;3500000;243714000;387243000;453169000;696883000;117353000;;16754000;134283000;831166000
FND;693510;USD;2018;Q4;2018-12-31;2019-02-25;97428000;104077000;644000;67527000;471014000;559458000;328366000;;346267000;674633000;1234091000;395541000;3500000;404285000;141834000;245497000;649782000;340560000;;243563000;584309000;1234091000
MDXG;693702;USD;2016;Q4;2016-12-31;2017-03-01;105991199;113217382;34391000;67151000;17814000;126538000;13786000;;52939000;66725000;193263000;40510000;;50732000;;9531000;60263000;161371000;-2216000;-26155000;133000000;193263000
MDXG;693702;USD;2015;Q4;2015-12-31;2016-02-29;105174071;112133012;31486000;53755000;7460000;96310000;9475000;;30128000;39603000;135913000;26244000;;26777000;;1148000;27925000;163242000;-17125000;-38129000;107988000;135913000
MDXG;693702;USD;2014;Q4;2014-12-31;2015-03-13;106299215;129251486;52332000;26672000;5133000;85677000;5447000;3250000;14885000;23582000;109259000;17688000;;18404000;;1526000;19930000;162541000;-5637000;-67575000;89329000;109259000
MDXG;693702;USD;2013;Q4;2013-12-31;2014-03-04;99110594;99110594;44078000;16093000;3881000;65389000;4086000;0;15219000;19305000;84694000;9485000;;9608000;;1518000;11126000;147388000;-25000;-73795000;73568000;84694000
MDXG;693702;USD;2012;Q4;2012-12-31;2013-03-15;87267352;87267352;6754485;7653561;3022784;18088791;1071625;;16022192;17093817;35182608;4995618;;5017201;4012442;10158105;15175306;89716024;-25000;-69683722;20007302;35182608
MDXG;693702;USD;2011;Q4;2011-12-31;2012-03-29;73553533;73553533;4112326;1891919;712602;6881511;869411;;19345270;20214681;27096192;2300638;2424786;4732044;2744587;10467583;15199627;73942911;-25000;-62021346;11896565;27096192
MDXG;693702;USD;2010;Q4;2010-12-31;2011-08-04;;;1340922;162376;111554;1705798;756956;;4889491;5646447;7352245;848285;403432;1251717;0;0;1251717;57952888;-25000;-51827360;6100528;7352245
ITRI;693852;USD;2017;Q4;2017-12-31;2018-03-01;38750000;39534000;176274000;398029000;193835000;849742000;200768000;;1055637000;1256405000;2106147000;368771000;19688000;507783000;607284000;792732000;1300515000;1294767000;;-337873000;805632000;2106147000
ITRI;693852;USD;2016;Q4;2016-12-31;2017-03-01;38285000;39432000;133565000;351506000;163049000;732466000;176458000;;668887000;845345000;1577811000;265508000;14063000;413046000;308888000;514412000;927458000;1270467000;;-409536000;650353000;1577811000
ITRI;693852;USD;2015;Q4;2015-12-31;2016-06-30;37906000;38474000;131018000;330895000;190465000;758940000;190256000;;731120000;921376000;1680316000;277666000;11250000;477774000;376500000;579839000;1057613000;1246671000;;-441306000;622703000;1680316000
ITRI;693852;USD;2014;Q4;2014-12-31;2015-02-20;38932000;38464000;112371000;346547000;154221000;782462000;207152000;;762133000;969285000;1751747000;300600000;30000000;520069000;309372000;533136000;1053205000;1270045000;;-453984000;698542000;1751747000
ITRI;693852;USD;2013;Q4;2013-12-31;2014-02-26;39146000;38549000;124805000;356709000;177467000;799366000;246820000;;836325000;1083145000;1882511000;299783000;26250000;455012000;376598000;554528000;1009540000;1290629000;;-413671000;872971000;1882511000
ITRI;693852;USD;2012;Q4;2012-12-31;2013-02-22;39228000;39603000;136411000;375326000;170719000;820950000;255212000;;1013279000;1268491000;2089441000;328846000;18750000;467373000;425240000;612555000;1079928000;1294213000;;-266862000;1009513000;2089441000
ITRI;693852;USD;2011;Q4;2011-12-31;2012-02-17;40507000;39601000;133086000;371641000;195837000;840354000;262670000;;961258000;1223928000;2064282000;352031000;15000000;510722000;464450000;632015000;1142737000;1319222000;;-375137000;921545000;2064282000
ITRI;693852;USD;2010;Q4;2010-12-31;2011-02-25;40428000;40937000;169477000;371662000;208157000;882217000;299242000;;1564338000;1863580000;2745797000;372153000;228721000;703734000;408591000;613768000;1317502000;1328249000;;135020000;1428295000;2745797000
ITRI;693852;USD;2009;Q4;2009-12-31;2010-08-04;40147000;40147000;121893000;337948000;170084000;725916000;318217000;;1810488000;2128705000;2854621000;305224000;10871000;443384000;783825000;1010723000;1454107000;1299134000;;30250000;1400514000;2854621000
ITRI;693852;USD;2018;Q4;2018-12-31;2019-02-28;39448000;38333000;120221000;437161000;220674000;896141000;226551000;;1486290000;1712841000;2608982000;413307000;28438000;652707000;1001423000;1222227000;1874934000;1334364000;;-425396000;734048000;2608982000
AMKR;693881;USD;2017;Q4;2017-12-31;2018-02-23;239132000;240600000;596364000;798264000;213649000;1644004000;2695065000;;169319000;2864384000;4508388000;1194211000;123848000;1318059000;1240581000;1470620000;2788679000;1903642000;-215982000;-13903000;1719709000;4508388000
AMKR;693881;USD;2016;Q4;2016-12-31;2017-02-24;238196000;239485000;549518000;563107000;267990000;1409696000;2564648000;;117742000;2682390000;4092086000;970469000;35192000;1005661000;1364638000;1683021000;2688682000;1895373000;-214490000;-303557000;1403404000;4092086000
AMKR;693881;USD;2015;Q4;2015-12-31;2016-02-22;236964000;236961000;523172000;526143000;238205000;1317480000;2579017000;;129931000;2708948000;4026428000;941414000;76770000;1018184000;1435269000;1790708000;2808892000;1883875000;-213758000;-467747000;1217536000;4026428000
AMKR;693881;USD;2014;Q4;2014-12-31;2015-02-19;236855000;237046000;449946000;469683000;223379000;1197948000;2206476000;117733000;113248000;2437457000;3635405000;695590000;5000000;700590000;1450824000;1803879000;2504469000;1879092000;-213028000;-516962000;1130936000;3635405000
AMKR;693881;USD;2013;Q4;2013-12-31;2014-02-28;218332000;235979000;610442000;385542000;200423000;1232416000;2006553000;105214000;83115000;2194882000;3427298000;629586000;61350000;690936000;1516390000;1771422000;2462358000;1812792000;-211449000;-647348000;964940000;3427298000
AMKR;693881;USD;2012;Q4;2012-12-31;2013-03-08;152233000;318259000;413048000;389699000;227439000;1091408000;1819969000;38690000;75148000;1933807000;3025215000;652627000;0;652627000;1320000000;1705794000;2358421000;1614341000;-210983000;-756644000;666794000;3025215000
AMKR;693881;USD;2011;Q4;2011-12-31;2012-02-24;176801000;259082000;434631000;298543000;198427000;996830000;1656214000;36707000;83296000;1776217000;2773047000;582791000;59395000;642186000;1062256000;1429640000;2071826000;1611439000;-130560000;-798462000;701221000;2773047000
AMKR;693881;USD;2010;Q4;2010-12-31;2011-02-24;183408000;282760000;404998000;392327000;191072000;1062067000;1537226000;28215000;109314000;1674755000;2736822000;622127000;150081000;772208000;964219000;1327933000;2100141000;1505110000;-284000;-890270000;636681000;2736822000
AMKR;693881;USD;2009;Q4;2009-12-31;2010-08-05;183124000;337812000;395406000;328252000;155185000;932925000;1364630000;19108000;116246000;1499984000;2432909000;516893000;88944000;605837000;1095241000;1437371000;2043208000;1500429000;0;-1122241000;389701000;2432909000
AMKR;693881;USD;2018;Q4;2018-12-31;2019-02-22;239381000;239578000;681569000;724456000;230589000;1671208000;2650448000;;173791000;2824239000;4495447000;1043844000;114579000;1158423000;1217732000;1481124000;2639547000;1909710000;-216171000;113189000;1855900000;4495447000
TIS;693955;USD;2017;Q4;2017-12-31;2018-03-16;10498582;10561770;3823000;11825000;20563000;39393000;285758000;;21384000;307142000;346535000;18660000;169220000;187880000;33000;16868000;204748000;104370000;;37417000;141787000;346535000
TIS;693955;USD;2016;Q4;2016-12-31;2017-03-15;10298091;10311499;8750000;8954000;18414000;47137000;249184000;;23559000;272743000;319880000;13414000;6728000;20142000;133989000;166493000;186635000;98895000;;34350000;133245000;319880000
TIS;693955;USD;2015;Q4;2015-12-31;2016-03-07;10289045;10374960;4361000;10509000;13501000;38313000;173378000;;37046000;210424000;248737000;14978000;3882000;18860000;70357000;96094000;114954000;97844000;;35939000;133783000;248737000
TIS;693955;USD;2014;Q4;2014-12-31;2015-03-09;8766295;8832170;1021000;9109000;9650000;24298000;119720000;;26721000;146441000;170739000;16844000;2700000;19544000;33662000;50682000;70226000;64284000;;36229000;100513000;170739000
TIS;693955;USD;2013;Q4;2013-12-31;2014-03-06;8043300;7795428;12240000;6585000;10921000;31307000;95745000;;40000;95785000;127092000;7715000;1152000;8867000;13927000;33376000;42243000;46306000;;38543000;84849000;127092000
TIS;693955;USD;2012;Q4;2012-12-31;2013-03-11;7611364;7764966;10761000;5406000;10275000;28123000;91188000;;47000;91235000;119358000;6517000;1152000;7669000;15079000;34511000;42180000;41246000;;35932000;77178000;119358000
TIS;693955;USD;2011;Q4;2011-12-31;2012-03-07;7517577;7735325;6316000;6939000;7811000;22629000;92285000;;54000;92339000;114968000;6135000;1152000;7287000;16231000;35032000;42319000;39531000;;33118000;72649000;114968000
TIS;693955;USD;2010;Q4;2010-12-31;2011-05-05;7487984;7759845;9660000;6155000;7595000;28690000;93805000;;76000;93881000;122571000;7519000;10742000;18261000;16615000;34714000;52975000;38923000;;30673000;69596000;122571000
TIS;693955;USD;2018;Q4;2018-12-31;2019-04-05;10670348;10670348;4806000;12334000;21130000;42244000;271531000;;20410000;291941000;334185000;29083000;187356000;216439000;31000;13374000;229813000;104627000;;-255000;104372000;334185000
FNKO;694474;USD;2017;Q4;2017-12-31;2018-03-19;;;7728000;115478000;79082000;224015000;40438000;;365860000;406298000;630313000;108697000;7928000;129926000;215170000;219232000;349158000;129324000;;1041000;281155000;630313000
FNKO;694474;USD;2016;Q4;2016-12-31;2018-03-19;;;6161000;83607000;43616000;152424000;25473000;;344340000;369813000;522237000;58683000;7130000;97542000;203894000;207318000;304860000;277401000;;-60024000;217377000;522237000
FNKO;694474;USD;2018;Q4;2018-12-31;2019-03-06;24837000;-25415000;13486000;148627000;86622000;260639000;44296000;;361405000;405701000;666340000;112657000;10593000;143250000;216704000;229836000;373086000;146158000;;8717000;293254000;666340000
ZAYO;694556;USD;2018;Q4;2018-06-30;2018-08-24;247200000;247000000;256700000;235600000;;637900000;5427600000;;3144400000;8572000000;9209900000;430800000;16900000;616700000;5811700000;7092900000;7709600000;1881800000;;-366000000;1500300000;9209900000
ZAYO;694556;USD;2017;Q4;2017-06-30;2017-08-22;245800000;251500000;220700000;191600000;;514600000;5016000000;;3208800000;8224800000;8739400000;461300000;13000000;620300000;5626300000;6708600000;7328900000;1884200000;;-479100000;1410500000;8739400000
ZAYO;694556;USD;2016;Q4;2016-06-30;2016-08-26;242100000;242100000;170700000;148400000;;397100000;4079500000;;2250900000;6330400000;6727500000;351300000;5800000;486500000;4130200000;5021800000;5508300000;1777800000;;-563100000;1219200000;6727500000
ZAYO;694556;USD;2015;Q4;2015-06-30;2015-09-18;242800000;241800000;308600000;88000000;;438400000;3299200000;;2357000000;5656200000;6094600000;279400000;20900000;386900000;3680500000;4496500000;4883400000;1706000000;;-486900000;1211200000;6094600000
ZAYO;694556;USD;2014;Q4;2014-06-30;2014-11-10;223000000;223000000;297400000;57200000;;382000000;2822400000;;1777300000;4599700000;4981700000;259200000;22900000;357500000;3156100000;4207800000;4565300000;733600000;;-331600000;416400000;4981700000
ZAYO;694556;USD;2019;Q4;2019-06-30;2019-09-04;235600000;238400000;186100000;177000000;;485200000;5808900000;;3040500000;8849400000;9334600000;453600000;15000000;643500000;6011900000;7349600000;7993100000;1581400000;;-216000000;1341500000;9334600000
AYX;695370;USD;2017;Q4;2017-12-31;2018-03-08;59694000;59694000;174102000;49797000;;242339000;7492000;19964000;21621000;49077000;291416000;20627000;;130840000;;7072000;137912000;257404000;;-103546000;153504000;291416000
AYX;695370;USD;2016;Q4;2016-12-31;2017-05-11;32592000;32592000;52700000;35367000;;100438000;6212000;;4765000;10977000;111415000;14198000;329000;85577000;99182000;103448000;189025000;8443000;;-86047000;-77613000;111412000
AYX;695370;USD;2018;Q4;2018-12-31;2019-03-01;61476000;77136000;329692000;94922000;;461813000;11729000;96551000;48074000;156354000;618167000;40565000;;124580000;173647000;191769000;316349000;315297000;;-12908000;301818000;618167000
ACY;696963;USD;2017;Q4;2017-12-31;2018-03-08;1414874;1414874;8657800;3825100;;41311700;;;195098200;195098200;236409900;174914100;;180509500;;8533700;189043200;14781700;-3036800;35621800;47366700;236409900
ACY;696963;USD;2016;Q4;2016-12-31;2017-03-09;1566699;1566699;2194400;4046100;;25936300;;;192799800;192799800;218736100;157568300;;159472200;;16763700;176235900;14781700;-504100;28222600;42500200;218736100
ACY;696963;USD;2015;Q4;2015-12-31;2016-03-11;1547369;1520898;2721000;5693500;;25766900;;;155258100;155258100;181025000;122372300;;124329700;;15416800;139746500;14781700;-504100;27000900;41278500;181025000
ACY;696963;USD;2014;Q4;2014-12-31;2015-03-12;1543257;1503450;1840500;2128600;;10907900;;;186762600;186762600;197670500;147347800;;148990000;;13839600;162829600;14781700;-504100;20563300;34840900;197670500
ACY;696963;USD;2013;Q4;2013-12-31;2014-03-12;1543257;1587322;2112700;3303800;;11679700;;;152954600;152954600;164634300;97013900;;97660600;;20838800;118499400;14781700;-504100;31857300;46134900;164634300
ACY;696963;USD;2012;Q4;2012-12-31;2013-03-14;1543257;1572823;1596800;3196200;;8758800;;;143667700;143667700;152426500;84374500;;85126900;;21420400;106547300;14781700;-504100;31601600;45879200;152426500
ACY;696963;USD;2011;Q4;2011-12-31;2012-03-09;1543257;1543257;995500;2936100;;6581000;;;124245000;124245000;130826000;71875900;;72434100;;17701700;90135800;14781700;-504100;26412600;40690200;130826000
ACY;696963;USD;2010;Q4;2010-12-31;2011-08-12;1543257;1581755;1949400;2005000;;6188700;;;126822600;126822600;133011300;72865200;;73442400;;17428300;90870700;14781700;-504100;27863000;42140600;133011300
ACY;696963;USD;2018;Q4;2018-12-31;2019-03-19;1546947;1546947;1542500;3967200;;33063200;69100;;184019900;184089000;217152200;2064900;131092200;136524900;31802300;39339400;175864300;16784600;-3037300;27540600;41287900;217152200
MB;698225;USD;2017;Q4;2017-12-31;2018-03-01;46872215;46872215;232019000;10753000;;248548000;32871000;;19894000;52765000;301313000;20547000;;28693000;14932000;20684000;49377000;454196000;;-202153000;251935000;301312000
MB;698225;USD;2016;Q4;2016-12-31;2017-03-01;40530053;40530053;85864000;9129000;;98695000;33084000;;11736000;44820000;143515000;15297000;;20737000;15450000;21122000;41859000;289317000;;-187361000;101656000;143515000
MB;698225;USD;2015;Q4;2015-12-31;2016-03-04;39629802;39629802;93405000;6643000;;103130000;31754000;;6530000;38284000;141414000;12337000;;16349000;15961000;19282000;35631000;270436000;;-164382000;105783000;141414000
MB;698225;USD;2014;Q4;2014-12-31;2015-08-07;11066602;11066602;34675000;3193000;;40430000;28568000;;4053000;32621000;73051000;10625000;;13468000;15496000;16872000;30340000;;;-124793000;42711000;73051000
EGY;699964;USD;2017;Q4;2017-12-31;2018-03-07;58826000;58825000;19669000;3556000;3263000;36452000;23221000;;19960000;43181000;79633000;24575000;6666000;46588000;2309000;22756000;69344000;77895000;-37953000;-29653000;10289000;79633000
EGY;699964;USD;2016;Q4;2016-12-31;2016-05-10;57851000;57851000;20474000;6751000;913000;38475000;28019000;;14538000;42557000;81032000;29602000;7500000;55554000;6940000;25836000;81390000;76879000;-37933000;-39304000;-358000;81032000
EGY;699964;USD;2015;Q4;2015-12-31;2016-03-16;58480453;58480453;25357000;5353000;833000;63742000;33357000;;26859000;60216000;123958000;62587000;;66716000;15000000;31166000;97882000;75722000;-37882000;-11764000;26076000;123958000
EGY;699964;USD;2014;Q4;2014-12-31;2015-03-16;57800387;56650807;69051000;19527000;2191000;113050000;108124000;;27675000;135799000;248849000;38540000;;38540000;15000000;29846000;68386000;70870000;-37299000;146892000;180463000;248849000
EGY;699964;USD;2013;Q4;2013-12-31;2014-03-13;56786998;56954114;130529000;16972000;516000;167464000;138524000;;2179000;140703000;308167000;42561000;;45829000;;11464000;57293000;61863000;-35431000;224442000;250874000;308167000
EGY;699964;USD;2012;Q4;2012-12-31;2013-03-14;57855047;59073245;130800000;7961000;1020000;149125000;106608000;;12223000;118831000;267956000;30326000;;45063000;;10368000;55431000;55130000;-23975000;181370000;212525000;267956000
EGY;699964;USD;2011;Q4;2011-12-31;2012-03-12;57120124;57733324;137139000;10087000;992000;162923000;99848000;;12244000;112092000;275015000;24677000;;25090000;;16858000;41948000;72360000;-23975000;180739000;233067000;275015000
EGY;699964;USD;2010;Q4;2010-12-31;2011-08-08;56579200;57383212;81234000;14068000;1049000;139357000;96820000;;2223000;99043000;238400000;26702000;;26702000;;15455000;42157000;70596000;-25665000;146594000;196243000;238400000
EGY;699964;USD;2018;Q4;2018-12-31;2019-03-08;59558000;60456000;33360000;11907000;785000;58794000;52724000;;54794000;107518000;166312000;25495000;;41044000;;15441000;56485000;79075000;-37827000;68579000;109827000;166312000
WLK;700084;USD;2017;Q4;2017-12-31;2018-02-21;129248402;128792355;1531000000;1001000000;900000000;3463000000;6412000000;;2201000000;8613000000;12076000000;1257000000;710000000;1967000000;3127000000;4740000000;6707000000;556000000;-302000000;4613000000;5369000000;12076000000
WLK;700084;USD;2016;Q4;2016-12-31;2017-02-22;128903999;129938291;459000000;939000000;801000000;2408000000;6420000000;;2062000000;8482000000;10890000000;1034000000;149000000;1183000000;3679000000;5815000000;6998000000;552000000;-319000000;3412000000;3892000000;10890000000
WLK;700084;USD;2015;Q4;2015-12-31;2016-02-24;130377843;130835732;1182669000;508532000;434060000;2175189000;3004067000;;390029000;3394096000;5569285000;522642000;0;522642000;758148000;1484712000;2007354000;543495000;-258312000;3109987000;3561931000;5569285000
WLK;700084;USD;2014;Q4;2014-12-31;2015-02-25;132849503;133346783;880601000;560666000;525776000;2011287000;2757557000;61305000;383841000;3202703000;5213990000;537180000;;537180000;763997000;1474922000;2012102000;531788000;-96372000;2555528000;3201888000;5213990000
WLK;700084;USD;2013;Q4;2013-12-31;2014-02-21;133129241;133696965;700689000;428457000;471879000;1649082000;2088014000;66875000;256938000;2411827000;4060909000;404858000;;404858000;763879000;1237448000;1642306000;512778000;-46220000;1954661000;2418603000;4060909000
WLK;700084;USD;2012;Q4;2012-12-31;2013-02-22;132875656;133403614;914951000;400159000;399298000;1751413000;1510048000;43736000;106999000;1660783000;3412196000;398510000;;398510000;763761000;1141430000;1539940000;496926000;-13302000;1399472000;1872256000;3412196000
WLK;700084;USD;2011;Q4;2011-12-31;2012-02-23;131905874;132561554;825901000;407372000;490777000;1756156000;1232066000;46741000;231858000;1510665000;3266821000;364595000;;364595000;764563000;1145914000;1510509000;468462000;-2518000;1299438000;1756312000;3266821000
WLK;700084;USD;2010;Q4;2010-12-31;2011-08-03;131113894;131794778;630299000;362863000;450028000;1475960000;1170334000;46314000;261536000;1478184000;2954144000;323578000;;323578000;764482000;1125496000;1449074000;453366000;;1058737000;1505070000;2954144000
WLK;700084;USD;2018;Q4;2018-12-31;2019-02-20;129071705;129393213;753000000;1037000000;1014000000;2842000000;6595000000;;2165000000;8760000000;11602000000;1183000000;;1183000000;2668000000;4343000000;5526000000;557000000;-382000000;5477000000;6076000000;11602000000
BCPC;700317;USD;2017;Q4;2017-12-31;2018-03-01;31942957;32285593;40416000;91226000;60696000;199336000;189793000;;574507000;764300000;963636000;73396000;35000000;108396000;189811000;238359000;346755000;153884000;0;464639000;616881000;963636000
BCPC;700317;USD;2016;Q4;2016-12-31;2017-02-28;31637511;32019517;38643000;83252000;57245000;188442000;165754000;;594430000;760184000;948626000;66008000;35000000;101008000;252386000;326585000;427593000;139793000;;388089000;521033000;948626000
BCPC;700317;USD;2015;Q4;2015-12-31;2016-02-29;31369495;31733815;84795000;60485000;46085000;198292000;158515000;;522879000;681394000;879686000;46120000;35000000;81120000;267646000;334861000;415981000;124696000;-74000;344197000;463705000;879686000
BCPC;700317;USD;2014;Q4;2014-12-31;2015-02-27;30634981;31211827;50287000;71982000;49623000;181302000;131588000;;548641000;680229000;861531000;60522000;35000000;95522000;303450000;374111000;469633000;99347000;0;295202000;391898000;861531000
BCPC;700317;USD;2013;Q4;2013-12-31;2014-02-27;29965835;31057812;208747000;39386000;24824000;277774000;54916000;;44182000;99098000;376872000;35753000;0;35753000;3877000;9761000;45514000;79533000;0;251627000;331358000;376872000
BCPC;700317;USD;2012;Q4;2012-12-31;2013-02-25;29094442;30386605;144737000;41999000;20693000;211909000;52725000;;47911000;100636000;312545000;30234000;;30234000;3431000;9299000;39533000;59162000;;214609000;273012000;312545000
BCPC;700317;USD;2011;Q4;2011-12-31;2012-02-29;28703221;30342126;114781000;34433000;18637000;175740000;44282000;;51695000;95977000;271717000;29526000;1387000;30913000;2811000;8795000;39708000;51877000;;181070000;232009000;271717000
BCPC;700317;USD;2010;Q4;2010-12-31;2011-08-09;;;77253000;32050000;15720000;129652000;43388000;;55584000;98972000;228624000;28026000;1482000;29508000;6007000;11649000;41157000;40474000;;147542000;187467000;228624000
BCPC;700317;USD;2018;Q4;2018-12-31;2019-02-28;32168066;32448734;54268000;99545000;67187000;226314000;194339000;;560702000;755041000;981355000;82056000;;82056000;163372000;207681000;289737000;167249000;-56000;528027000;691618000;981355000
UPL;700786;USD;2017;Q4;2017-12-31;2018-02-28;197983000;198522000;16631000;;13450000;167425000;1334637000;;10920000;1345557000;1512982000;248490000;;248490000;2116211000;2419128000;2667618000;2116018000;-49000;-3270605000;-1154636000;1512982000
UPL;700786;USD;2016;Q4;2016-12-31;2017-02-22;80012000;80768000;401478000;;4906000;521393000;1018161000;;1374000;1019535000;1540928000;138208000;;138208000;;4330871000;4469079000;510063000;-49000;-3438165000;-2928151000;1540928000
UPL;700786;USD;2018;Q4;2018-12-31;2019-03-08;197198000;199505000;17014000;;18757000;214730000;1509362000;;9196000;1518558000;1733288000;197548000;7313000;267211000;1932722000;2286603000;2553814000;2137443000;-49000;-3186016000;-820526000;1733288000
FC;702498;USD;2017;Q4;2017-08-31;2017-11-14;13826000;13826000;8924000;66343000;3353000;91835000;19730000;;99166000;118896000;210731000;37986000;1868000;80626000;25452000;45040000;125666000;213837000;-198895000;69456000;85065000;210731000
FC;702498;USD;2016;Q4;2016-08-31;2016-11-14;14000000;14394000;10456000;65960000;5042000;89741000;16083000;;85047000;101130000;190871000;31548000;1662000;54057000;22943000;43099000;97156000;212556000;-196691000;76628000;93715000;190871000
FC;702498;USD;2015;Q4;2015-08-31;2015-11-13;16451000;16614000;16234000;65182000;3949000;95425000;15499000;;89721000;105220000;200645000;25409000;1473000;39634000;24605000;35505000;75139000;209988000;-154286000;69612000;125506000;200645000
FC;702498;USD;2014;Q4;2014-08-31;2014-11-14;16845000;17069000;10483000;61490000;6367000;93016000;17271000;;94899000;112170000;205186000;41587000;1298000;42885000;26078000;35587000;78472000;208501000;-141734000;58496000;126714000;205186000
FC;702498;USD;2013;Q4;2013-08-31;2013-11-14;16351000;16479000;12291000;52684000;4321000;81108000;17180000;;91117000;108297000;189405000;41799000;1139000;42938000;27376000;39961000;82899000;211580000;-147189000;40429000;106506000;189405000
FC;702498;USD;2012;Q4;2012-08-31;2012-11-14;17794000;18839000;11011000;38087000;4161000;64195000;18496000;;81389000;99885000;164080000;35657000;992000;36649000;28515000;36876000;73525000;189147000;-128112000;26110000;90555000;164080000
FC;702498;USD;2011;Q4;2011-08-31;2012-01-26;34349968;35437885;3016000;32412000;4301000;52056000;19143000;;80228000;99371000;151427000;34544000;857000;35401000;29507000;36710000;72111000;186128000;-128673000;18269000;79316000;151427000
FC;702498;USD;2018;Q4;2018-08-31;2018-11-14;13908000;13908000;10153000;71914000;3160000;103385000;21401000;;89089000;110490000;213875000;40864000;2092000;94844000;30320000;38531000;133375000;212633000;-196043000;63569000;80500000;213875000
HTGM;702606;USD;2017;Q4;2017-12-31;2018-03-23;13045236;13045236;9968600;6356268;1180521;17948457;3304890;;2953;3307843;21256300;11979183;;13341967;2960760;10973870;24315837;131506524;;-134566061;-3059537;21256300
HTGM;702606;USD;2016;Q4;2016-12-31;2017-03-23;7495266;7495266;11812560;1377441;1511053;15134382;3270197;;49630;3319827;18454209;8821731;;10020991;5389137;14026080;24047071;110089272;-75000;-115606044;-5592862;18454209
HTGM;702606;USD;2015;Q4;2015-12-31;2016-03-25;6937846;6937846;31495490;716246;2201301;34858254;1932213;2603901;;4536114;39394368;5699141;;6319610;7737586;16181360;22500970;106576249;-75000;-89566494;16893398;39394368
HTGM;702606;USD;2014;Q4;2014-12-31;2015-06-08;113361;113361;3613392;801125;1685814;6212366;1146599;;1369281;2515880;8728246;3261894;;3303142;9705655;75095030;78398172;-1426223;-75000;-68168703;-69669926;8728246
HTGM;702606;USD;2018;Q4;2018-12-31;2019-03-07;28579939;28579939;31113649;5012678;1306609;38001145;2373790;;3396345;5770135;43771280;5208386;;7017374;9678854;15661844;22679218;172115494;;-151019979;21092062;43771280
ADVM;702608;USD;2018;Q4;2018-12-31;2019-03-06;63260000;63260000;205079000;;;208754000;3586000;;1155000;4741000;213495000;10491000;;10719000;;1609000;12328000;522509000;;-320543000;201167000;213495000
ADVM;702608;USD;2017;Q4;2017-12-31;2018-03-06;46110000;46110000;190485000;;;193741000;3024000;;5140000;8164000;201905000;8695000;;10674000;;7203000;17877000;439053000;;-254062000;184028000;201905000
ADVM;702608;USD;2016;Q4;2016-12-31;2017-03-09;41429000;41429000;222170000;886000;;225274000;4169000;;5140000;9309000;234583000;7950000;;9896000;;9087000;18983000;413522000;;-197915000;215600000;234583000
ADVM;702608;USD;2015;Q4;2015-12-31;2016-03-04;25789000;25789000;259080000;449000;;260992000;3187000;;140000;3327000;264319000;4612000;;6574000;;5153000;11727000;336771000;;-84168000;252592000;264319000
ADVM;702608;USD;2014;Q4;2014-12-31;2015-03-05;22864000;22864000;159404000;;;160278000;1085000;;543000;1628000;161906000;4658000;;5471000;;6952000;12423000;186188000;;-36715000;149483000;161906000
ADVM;702608;USD;2013;Q4;2013-12-31;2014-09-12;3673000;3673000;564000;8000;;822000;69000;;194000;263000;1085000;1162000;;1162000;;141000;1303000;632000;;-8869000;-218000;1085000
IMO;702831;USD;2017;Q4;2017-12-31;2018-03-01;835200000;837700000;1195000000;2712000000;1500000000;5407000000;34473000000;865000000;856000000;36194000000;41601000000;3934000000;202000000;4136000000;5005000000;13030000000;17166000000;1536000000;;24714000000;24435000000;41601000000
IMO;702831;USD;2016;Q4;2016-12-31;2017-02-23;847600000;850200000;391000000;2023000000;1417000000;3831000000;36333000000;1030000000;460000000;37823000000;41654000000;3681000000;202000000;3883000000;5032000000;12750000000;16633000000;1566000000;;25352000000;25021000000;41654000000
IMO;702831;USD;2015;Q4;2015-12-31;2016-02-24;847600000;850300000;203000000;1581000000;1614000000;3670000000;37799000000;1254000000;447000000;39500000000;43170000000;3441000000;1952000000;5393000000;6564000000;14352000000;19745000000;1566000000;;23687000000;23425000000;43170000000
IMO;702831;USD;2014;Q4;2014-12-31;2015-02-25;847600000;850300000;215000000;1539000000;1501000000;3569000000;35574000000;1406000000;281000000;37261000000;40830000000;4003000000;1978000000;5981000000;4913000000;12319000000;18300000000;1566000000;;23023000000;22530000000;40830000000
IMO;702831;USD;2013;Q4;2013-12-31;2014-02-26;847600000;850000000;272000000;2084000000;1372000000;4287000000;31320000000;1332000000;279000000;32931000000;37218000000;5245000000;1843000000;7088000000;4444000000;10606000000;17694000000;1566000000;;19679000000;19524000000;37218000000
IMO;702831;USD;2012;Q4;2012-12-31;2013-02-27;847400000;850200000;482000000;1976000000;1107000000;4092000000;23922000000;1090000000;260000000;25272000000;29364000000;5433000000;472000000;5905000000;1175000000;7082000000;12987000000;1566000000;;17266000000;16377000000;29364000000
IMO;702831;USD;2011;Q4;2011-12-31;2012-02-27;847700000;852600000;1202000000;2290000000;1001000000;5083000000;19162000000;920000000;264000000;20346000000;25429000000;5585000000;364000000;5949000000;843000000;6159000000;12108000000;1528000000;;14031000000;13321000000;25429000000
IMO;702831;USD;2010;Q4;2010-12-31;2011-02-25;847600000;853400000;267000000;2000000000;773000000;3538000000;15905000000;870000000;267000000;17042000000;20580000000;4348000000;229000000;4577000000;527000000;4826000000;9403000000;1511000000;;11090000000;11177000000;20580000000
IMO;702831;USD;2009;Q4;2009-12-31;2010-02-26;847700000;854300000;513000000;1714000000;811000000;3505000000;12852000000;854000000;262000000;13968000000;17473000000;3659000000;109000000;3768000000;31000000;4266000000;8034000000;1508000000;;9252000000;9439000000;17473000000
IMO;702831;USD;2008;Q4;2008-12-31;2009-08-05;;;1974000000;1455000000;853000000;4643000000;11248000000;881000000;263000000;12392000000;17035000000;4084000000;109000000;4193000000;34000000;3777000000;7970000000;1528000000;;8484000000;9065000000;17035000000
IMO;702831;USD;2018;Q4;2018-12-31;2019-02-27;787300000;789600000;988000000;2529000000;1838000000;5355000000;34225000000;857000000;1019000000;36101000000;41456000000;3753000000;202000000;3955000000;7921000000;13012000000;16967000000;1446000000;;24560000000;24489000000;41456000000
AXTA;702906;USD;2017;Q4;2017-12-31;2018-02-22;240200000;251600000;769800000;870200000;608600000;2315600000;1388600000;;3128000000;4516600000;6832200000;1044500000;37700000;1082200000;3877900000;4342200000;5424400000;1596900000;-58400000;-21400000;1407800000;6832200000
AXTA;702906;USD;2016;Q4;2016-12-31;2017-02-28;239100000;251400000;535400000;801900000;529700000;1920000000;1315700000;;2630500000;3946200000;5866200000;914200000;27900000;942100000;3236000000;3677500000;4619600000;1533600000;0;-58100000;1246600000;5866200000
AXTA;702906;USD;2015;Q4;2015-12-31;2016-04-28;237200000;248600000;485000000;765800000;530700000;1847800000;1382900000;;2599400000;3982300000;5830100000;824900000;50100000;875000000;3391400000;3813900000;4688900000;1475800000;;-132800000;1141200000;5830100000
AXTA;702906;USD;2014;Q4;2014-12-31;2015-05-06;229500000;233300000;382100000;820400000;538300000;1872900000;1514100000;;2783700000;4297800000;6170700000;899300000;40100000;946700000;3574200000;4112000000;5058700000;1374500000;;-226500000;1112000000;6170700000
AXTA;702906;USD;2018;Q4;2018-12-31;2019-02-26;236100000;242500000;693600000;860800000;613000000;2309600000;1298200000;;3067900000;4366100000;6675700000;998400000;42200000;1040600000;3821800000;4324600000;5365200000;1654800000;-312200000;198600000;1310500000;6675700000
IMMY;703115;USD;2016;Q4;2016-12-31;2017-03-21;13761657;13761657;8853000;2921000;1841000;14753000;7295000;0;5199000;12494000;27247000;5176000;4431000;9905000;9255000;10910000;20815000;83283000;;-76851000;6432000;27247000
IMMY;703115;USD;2015;Q4;2015-12-31;2016-03-23;9862022;9862022;2685000;840000;1412000;5873000;2657000;;5601000;8258000;14131000;4607000;21000;5374000;8337000;10142000;15516000;56379000;;-57764000;-1385000;14131000
IMMY;703115;USD;2014;Q4;2014-12-31;2015-03-12;9257340;9257340;8211000;81000;373000;9056000;243000;;943000;1186000;10242000;1503000;24000;1560000;19000;532000;2092000;50015000;;-41865000;8150000;10242000
IMMY;703115;USD;2013;Q4;2013-12-31;2014-03-28;8986706;8986706;15579309;0;0;15734473;26892;;0;26892;15761365;650627;0;650627;0;0;650627;46858130;;-31747392;15110738;15761365
AVA;703252;USD;2017;Q4;2017-12-31;2018-02-21;64809000;65310000;16172000;185664000;58075000;337534000;4398810000;101317000;677071000;5177198000;5514732000;107289000;382836000;1497591000;1543346000;2286657000;3784248000;1133448000;;604470000;1730484000;5514732000
AVA;703252;USD;2016;Q4;2016-12-31;2017-02-22;64184000;64665000;8507000;180265000;53314000;351341000;4147500000;72224000;738690000;4958414000;5309755000;164788000;123287000;436233000;1730264000;3225046000;3661279000;1075281000;;581014000;1648476000;5309755000
AVA;703252;USD;2015;Q4;2015-12-31;2016-02-24;62306000;62655000;10484000;169413000;54148000;306046000;3898589000;59733000;642281000;4600603000;4906649000;160705000;198167000;505359000;1531658000;2873003000;3378362000;1004336000;;530940000;1528287000;4906649000
AVA;703252;USD;2014;Q4;2014-12-31;2015-02-25;62288000;62673000;22143000;171925000;66356000;395347000;3619962000;53449000;632213000;4305624000;4700971000;112974000;112855000;385269000;1532249000;2832460000;3217729000;999960000;;491599000;1483242000;4700971000
AVA;703252;USD;2013;Q4;2013-12-31;2014-02-26;60043000;60096000;82574000;221343000;44946000;549679000;3202425000;72438000;537381000;3812244000;4361923000;182088000;187765000;625340000;1371403000;2402427000;3027767000;896993000;;407092000;1334156000;4361923000
AVA;703252;USD;2012;Q4;2012-12-31;2013-02-26;59782000;59807000;75464000;193683000;47455000;505794000;3023716000;62875000;720794000;3807385000;4313179000;198914000;117337000;576149000;1301752000;2454957000;3031106000;889237000;;376940000;1282073000;4313179000
AVA;703252;USD;2011;Q4;2011-12-31;2012-02-28;58302000;58579000;74662000;203452000;52006000;614556000;2860776000;64470000;674729000;3599975000;4214531000;166954000;117142000;627174000;1254176000;2349673000;2976847000;855188000;;336150000;1237684000;4214531000
AVA;703252;USD;2010;Q4;2010-12-31;2011-02-25;56864000;57149000;69413000;230229000;48530000;579565000;2714237000;95786000;550507000;3360530000;3940095000;171707000;122821000;579175000;1199517000;2189014000;2768189000;827592000;;302518000;1171906000;3940095000
AVA;703252;USD;2009;Q4;2009-12-31;2010-08-06;54799000;55125000;37035000;210645000;37282000;418923000;2607011000;101273000;479752000;3188036000;3606959000;160861000;127889000;546028000;1087696000;1975484000;2521512000;778647000;;274990000;1085447000;3606959000
AVA;703252;USD;2018;Q4;2018-12-31;2019-02-20;65688000;65844000;14656000;165824000;63881000;346923000;4648930000;114697000;672026000;5435653000;5782576000;108372000;297645000;639584000;1807076000;3368947000;4008531000;1136491000;;644595000;1774045000;5782576000
MGEE;703431;USD;2017;Q4;2017-12-31;2018-02-23;34668000;34668000;107952000;42299000;43793000;290631000;1341357000;67772000;155422000;1564551000;1855182000;65491000;28452000;126514000;398161000;950481000;1076995000;;;;778187000;1855182000
MGEE;703431;USD;2016;Q4;2016-12-31;2017-02-24;34668000;34668000;95959000;39887000;41137000;275515000;1282059000;76290000;167196000;1525545000;1801060000;65186000;4333000;103505000;382791000;973467000;1076972000;350936000;;372950000;724088000;1801060000
MGEE;703431;USD;2015;Q4;2015-12-31;2016-02-25;34668000;34668000;81384000;37112000;48410000;254751000;1243445000;73631000;154576000;1471652000;1726403000;57112000;4266000;84146000;386744000;951799000;1035945000;350936000;;339165000;690458000;1726403000
MGEE;703431;USD;2014;Q4;2014-12-31;2015-02-26;34668000;34668000;65755000;41614000;46255000;250477000;1208106000;71760000;163841000;1443707000;1694184000;57982000;11182000;89996000;395256000;944787000;1034783000;350936000;;308007000;659401000;1694184000
MGEE;703431;USD;2013;Q4;2013-12-31;2014-02-27;34668000;34668000;68813000;44890000;35856000;220601000;1160224000;67952000;130283000;1358459000;1579060000;60076000;4102000;96666000;399414000;864884000;961550000;350936000;;266197000;617510000;1579060000
MGEE;703431;USD;2012;Q4;2012-12-31;2013-02-26;34659000;;46357000;41386000;38344000;222937000;1073464000;64595000;225928000;1363987000;1586924000;57877000;3013000;75797000;358491000;931698000;1007495000;350936000;;228399000;579429000;1586924000
MGEE;703431;USD;2011;Q4;2011-12-31;2012-02-24;34659000;;41169000;36744000;39801000;189131000;995566000;60332000;213853000;1269751000;1458882000;48604000;2667000;63074000;360903000;844856000;907930000;339382000;;211458000;550952000;1458882000
MGEE;703431;USD;2010;Q4;2010-12-31;2011-02-24;;;7110000;40153000;47239000;162302000;968007000;55845000;131739000;1155591000;1317893000;45070000;24167000;81212000;334351000;711601000;792813000;339382000;;185556000;525080000;1317893000
MGEE;703431;USD;2009;Q4;2009-12-31;2010-08-05;;;4704000;35309000;50994000;165081000;939764000;53455000;123585000;1116804000;1281885000;47737000;66028000;127138000;320942000;652952000;780090000;339382000;;162208000;501795000;1281885000
MGEE;703431;USD;2018;Q4;2018-12-31;2019-02-22;34668000;34668000;83102000;43593000;41995000;240560000;1509437000;78000000;160621000;1748058000;1988618000;66586000;17553000;120628000;493343000;1051346000;1171974000;350936000;;465708000;816644000;1988618000
OTTR;703658;USD;2017;Q4;2017-12-31;2018-02-20;39507796;39854798;16216000;68466000;88034000;239127000;1539603000;8629000;216919000;1765151000;2004278000;122527000;112557000;256653000;490380000;1050733000;1307386000;541237000;;161286000;696892000;2004278000
OTTR;703658;USD;2016;Q4;2016-12-31;2017-02-22;39236863;39551837;0;68242000;83740000;208015000;1477225000;8417000;218728000;1704370000;1912385000;122847000;76084000;215671000;505341000;1026610000;1242281000;534425000;;139479000;670104000;1912385000
OTTR;703658;USD;2015;Q4;2015-12-31;2016-02-29;37728095;37726477;0;62974000;85416000;206689000;1387814000;8284000;215896000;1611994000;1818683000;120508000;133094000;271116000;443846000;942544000;1213660000;482896000;;126025000;605023000;1818683000
DYN;703911;USD;2017;Q4;2017-12-31;2018-02-22;164000000;173000000;365000000;513000000;445000000;1524000000;8884000000;123000000;1240000000;10247000000;11771000000;655000000;105000000;1049000000;8328000000;8829000000;9878000000;3720000000;;-1851000000;1893000000;11771000000
DYN;703911;USD;2016;Q4;2016-12-31;2017-02-24;139000000;139000000;1776000000;386000000;445000000;2987000000;7121000000;0;2945000000;10066000000;13053000000;546000000;201000000;916000000;8778000000;10098000000;11014000000;3548000000;;-1927000000;2039000000;13053000000
DYN;703911;USD;2015;Q4;2015-12-31;2016-02-25;122000000;112000000;505000000;402000000;597000000;1932000000;8347000000;190000000;990000000;9527000000;11459000000;491000000;80000000;809000000;7129000000;7731000000;8540000000;3188000000;;-686000000;2919000000;11459000000
DYN;703911;USD;2014;Q4;2014-12-31;2015-02-25;120000000;120000000;1870000000;270000000;208000000;2674000000;3255000000;0;5303000000;8558000000;11232000000;453000000;31000000;661000000;7075000000;7548000000;8209000000;3339000000;;-736000000;3023000000;11232000000
DYN;703911;USD;2013;Q4;2013-12-31;2014-02-27;100000000;100000000;843000000;420000000;181000000;1685000000;3315000000;;291000000;3606000000;5291000000;481000000;13000000;621000000;1979000000;2463000000;3084000000;2614000000;;-463000000;2206000000;5290000000
AXTI;704072;USD;2017;Q4;2017-12-31;2018-03-09;38761000;40439000;64384000;22778000;45840000;140521000;46530000;12576000;11573000;70679000;211200000;22594000;;22594000;;289000;22883000;231718000;;-54837000;188317000;211200000
AXTI;704072;USD;2016;Q4;2016-12-31;2017-02-27;32424000;33985000;47567000;14453000;40152000;107286000;27805000;6156000;12999000;46960000;154246000;15951000;;15951000;;905000;16856000;194210000;;-64985000;137390000;154246000
AXTI;704072;USD;2015;Q4;2015-12-31;2016-03-11;31949000;31949000;36312000;18468000;38012000;96888000;31422000;7691000;15895000;55008000;151896000;12841000;;12841000;;1494000;14335000;194678000;;-70621000;137561000;151896000
AXTI;704072;USD;2014;Q4;2014-12-31;2015-03-13;32559000;32109000;41154000;17864000;38574000;103193000;33862000;7783000;16679000;58324000;161517000;14771000;;14771000;;2058000;16829000;195451000;;-68393000;144688000;161517000
AXTI;704072;USD;2013;Q4;2013-12-31;2014-03-14;33755000;33755000;37460000;14943000;39127000;99540000;37621000;10145000;16516000;64282000;163822000;15426000;;15426000;;2850000;18276000;194188000;;-67005000;145546000;163822000
AXTI;704072;USD;2012;Q4;2012-12-31;2013-03-15;32221000;32729000;40904000;17912000;40352000;106472000;37235000;9191000;14691000;61117000;167589000;13096000;;13096000;;3579000;16675000;193095000;;-59047000;150914000;167589000
AXTI;704072;USD;2011;Q4;2011-12-31;2012-03-15;63681282;65991801;31661000;17966000;46012000;103103000;34282000;8981000;16122000;59385000;162488000;10883000;;10883000;;4556000;15439000;191586000;;-62157000;147049000;162488000
AXTI;704072;USD;2010;Q4;2010-12-31;2011-08-09;123939441;129951490;33803000;23076000;35986000;96955000;24240000;7172000;11884000;43296000;140251000;14839000;;14839000;;5608000;20447000;190053000;;-82477000;119804000;140251000
AXTI;704072;USD;2018;Q4;2018-12-31;2019-03-11;39246000;40149000;38655000;19586000;58571000;128540000;82280000;717000;11987000;94984000;223524000;28709000;;28709000;;283000;28992000;234458000;;-45183000;194532000;223524000
GLBL;704271;USD;2016;Q4;2016-12-31;2017-06-15;131616724;131616724;680893000;37596000;;900338000;1355362000;16482000;176097000;1547941000;2448279000;131188000;327459000;474731000;758609000;827835000;1302566000;942150000;-4739000;-266242000;1145713000;2448279000
GLBL;704271;USD;2015;Q4;2015-12-31;2016-12-21;100297000;100297000;922318000;30287000;;1211091000;1206604000;22682000;246789000;1476075000;2687166000;138542000;319498000;502294000;952653000;1002219000;1504513000;925499000;-28000;-213210000;1182652000;2687165000
GLBL;704271;USD;2014;Q4;2014-12-31;2015-11-13;;;150146000;11728000;;234666000;386079000;21312000;31399000;438790000;673456000;12220000;31542000;92412000;567854000;607565000;699977000;0;0;0;-26521000;673456000
NEP;704398;USD;2017;Q4;2017-08-31;2018-02-21;54000000;54000000;154000000;85000000;;398000000;6197000000;218000000;1582000000;7997000000;8395000000;65000000;99000000;276000000;4218000000;6459000000;6735000000;1639000000;;;1660000000;8395000000
NEP;704398;USD;2016;Q4;2016-08-31;2017-02-23;54300000;54300000;150000000;87000000;;367000000;6298000000;298000000;1698000000;8294000000;8661000000;356000000;78000000;818000000;3508000000;5277000000;6095000000;1746000000;;;2566000000;8661000000
NEP;704398;USD;2015;Q4;2015-08-31;2016-02-19;29800000;29800000;164000000;80000000;;354000000;5122000000;146000000;1605000000;6873000000;7227000000;331000000;113000000;512000000;3334000000;4823000000;5335000000;935000000;;;1892000000;7227000000
NEP;704398;USD;2014;Q4;2014-08-31;2015-02-20;18700000;18700000;106000000;41000000;;486000000;3638000000;19000000;194000000;3851000000;4337000000;175000000;86000000;322000000;1807000000;2382000000;2704000000;551000000;;;1633000000;4337000000
NEP;704398;USD;2013;Q4;2013-08-31;2014-08-01;;;27000000;203000000;;240000000;2298000000;;95000000;2393000000;2633000000;59000000;370000000;454000000;1429000000;1466000000;1920000000;665000000;;63000000;713000000;2633000000
CQH;704560;USD;2017;Q4;2017-12-31;2018-02-21;231700000;231700000;659000;;;714000;;;0;0;714000;76000;;76000;;0;76000;393174000;;-392536000;638000;714000
CQH;704560;USD;2016;Q4;2016-12-31;2017-02-24;231700000;231700000;219000;153000;;423000;;;;;423000;78000;;78000;;0;78000;393174000;;-392829000;345000;423000
CQH;704560;USD;2015;Q4;2015-12-31;2016-02-19;231700000;231700000;917000;157000;;1100000;;;95000;95000;1195000;106000;;112000;;0;112000;393174000;;-392091000;1083000;1195000
CQH;704560;USD;2014;Q4;2014-12-31;2015-02-20;231700000;231700000;1261000;114000;;1396000;;;157000;157000;1553000;248000;;339000;;0;339000;393174000;;-391960000;1214000;1553000
CCH;704561;USD;2017;Q4;2017-12-31;2018-02-21;;;0;;0;259729000;8261383000;;138768000;8400151000;8659880000;264521000;;307919000;6669476000;6684685000;6992604000;;;;1667276000;8659880000
CCH;704561;USD;2016;Q4;2016-12-31;2017-05-04;;;0;;;254645000;6076672000;;305131000;6381803000;6636448000;146768000;618000;197819000;5081715000;5124820000;5322639000;;;;1313809000;6636448000
CCH;704561;USD;2018;Q4;2018-12-31;2019-02-26;;;0;46049000;26198000;489394000;11138825000;;92134000;11230959000;11720353000;178407000;168000000;385069000;9245552000;9254147000;9639216000;;;;2081137000;11720353000
CQP;704562;USD;2017;Q4;2017-12-31;2018-02-21;352600000;352600000;0;354000000;95000000;2139000000;15139000000;;275000000;15414000000;17553000000;649000000;;829000000;16046000000;16085000000;16914000000;1682000000;;;639000000;17553000000
CQP;704562;USD;2016;Q4;2016-12-31;2017-02-24;57100000;57100000;0;189000000;97000000;958000000;14158000000;;426000000;14584000000;15542000000;445000000;224000000;856000000;14209000000;14305000000;15161000000;141000000;;;381000000;15542000000
CQP;704562;USD;2015;Q4;2015-12-31;2016-02-19;57159000;57159000;146221000;2012000;16667000;493475000;11931602000;;408076000;12339678000;12833153000;240699000;1673379000;2063017000;10018325000;10019776000;12082793000;322325000;;;750360000;12833153000
CQP;704562;USD;2014;Q4;2014-12-31;2015-02-20;57079000;57079000;248830000;3984000;7786000;486520000;8978356000;;922639000;9900995000;10387515000;145176000;0;214756000;8991333000;9003814000;9218570000;520531000;;;1168945000;10387515000
CQP;704562;USD;2013;Q4;2013-12-31;2014-02-21;57235000;57235000;351032000;40000;10430000;613128000;6383939000;;1519716000;7903655000;8516783000;180198000;;265887000;6576273000;6572936000;6838823000;746886000;;;1677960000;8516783000
CQP;704562;USD;2012;Q4;2012-12-31;2013-02-22;;;419292000;;2625000;533123000;3219592000;;513072000;3732664000;4265787000;121608000;;155836000;2167113000;2192631000;2348467000;477908000;;;1917320000;4265787000
CQP;704562;USD;2011;Q4;2011-12-31;2012-02-24;;;81415000;853000;473000;109510000;1514416000;;113374000;1627790000;1737300000;17985000;;51818000;2192418000;2230501000;2282319000;-65822000;;;-545019000;1737300000
CQP;704562;USD;2010;Q4;2010-12-31;2011-08-05;;;53349000;2090000;1212000;78653000;1550465000;;114374000;1664839000;1743492000;18920000;;52134000;2187724000;2227366000;2279500000;-82112000;;;-536008000;1743492000
CQP;704562;USD;2018;Q4;2018-12-31;2019-02-26;348600000;348600000;0;462000000;99000000;2356000000;15390000000;;228000000;15618000000;17974000000;836000000;;1068000000;16066000000;16106000000;17174000000;1790000000;;;800000000;17974000000
LEVB;705447;USD;2017;Q4;2017-12-31;2017-12-26;5709256;;284246;1102591;588197;3693676;135476;;3240287;3375763;7069439;1482108;;1523525;;397000;1920525;10469272;;-6257421;5148914;7069439
LEVB;705447;USD;2016;Q4;2016-12-31;2017-12-26;;;34258;163974;614207;956317;180281;;486760;667041;1623358;1106536;;1904083;;12000;1916083;4850763;;-4487336;-292725;1623358
MICR;706150;USD;2017;Q4;2017-12-31;2018-03-26;2835163;2835163;606988;2595248;3413199;7426389;5744039;;754172;6498211;13924600;1534349;717779;4877697;3978415;3978415;8856112;11571472;-2966798;-3536186;5068488;13924600
MICR;706150;USD;2016;Q4;2016-12-31;2017-03-22;2816642;2732788;380381;2276608;3060085;6331436;6440911;;875074;7315985;13647421;1744261;487468;4800663;2402874;2559827;7360490;11496585;-3028564;-2181090;6286931;13647421
MICR;706150;USD;2015;Q4;2015-12-31;2016-03-10;2791728;2626588;272291;2798353;2118712;5783072;6626069;;926964;7553033;13336105;1553388;1062770;3293897;2586218;3159531;6453428;11420801;-3069496;-1468628;6882677;13336105
MICR;706150;USD;2014;Q4;2014-12-31;2015-03-20;2774020;3003852;209398;3536747;2514241;6779968;7618901;;704379;8323280;15103248;1857156;490341;5471496;1776207;2386637;7858133;11375958;-3133883;-1039462;7245115;15103248
MICR;706150;USD;2013;Q4;2013-12-31;2014-03-21;2708775;2708775;749766;3803853;2335291;8402107;7579556;;371621;7951177;16353284;2156031;335760;4923764;4371973;5082996;10006760;11275501;-3272808;-1698671;6346524;16353284
MICR;706150;USD;2012;Q4;2012-12-31;2013-05-31;2730170;2730170;477708;3181721;2415104;7043876;7158512;;2757826;9916338;16960214;2437778;267043;5936352;1000147;1327129;7263481;11149840;-3335268;1839659;9696733;16960214
MICR;706150;USD;2011;Q4;2011-12-31;2012-04-26;;;1255251;3460369;3267482;8852010;7641309;;2982769;10624078;19476088;2128447;0;3050637;483401;619476;3670113;10801603;-3099842;8061712;15805975;19476088
MICR;706150;USD;2010;Q4;2010-12-31;2011-08-15;;;3962454;3819361;3069177;11417196;6691817;;2178983;8870800;20287996;2280992;;2556189;288500;306368;2862557;10692475;-3099842;9790304;17425439;20287996
MICR;706150;USD;2018;Q4;2018-12-31;2019-03-19;2858730;2851271;1715;2325804;3685059;7090718;5131773;;58295;5190068;12280786;1200298;389420;4635220;3557458;3557458;8192678;11644082;-2907490;-4648484;4088108;12280786
MICT;706645;USD;2017;Q4;2017-12-31;2018-04-13;8186795;8179720;2114000;6275000;4979000;25308000;910000;;3514000;4424000;29732000;7119000;3789000;22246000;1379000;1512000;23758000;10889000;;-10147000;5974000;29732000
MICT;706645;USD;2016;Q4;2016-12-31;2017-03-31;6222272;;3517000;3365000;4290000;26647000;965000;;4304000;5269000;31916000;3483000;6126000;19619000;1281000;1339000;20958000;8754000;;-1990000;10958000;31916000
MICT;706645;USD;2015;Q4;2015-12-31;2016-04-14;5865378;5865378;8004000;13938000;7457000;33534000;1816000;;4793000;6609000;40143000;8194000;12049000;20243000;2375000;2444000;22687000;7818000;;3817000;17456000;40143000
MICT;706645;USD;2014;Q4;2014-12-31;2015-03-31;5843746;5843746;10617000;15401000;6658000;37057000;1948000;;5928000;7876000;44933000;10207000;10416000;20623000;3975000;4061000;24684000;7511000;;6284000;20249000;44933000
MICT;706645;USD;2013;Q4;2013-12-31;2014-03-19;5831246;5831246;19794000;14632000;4324000;39210000;2440000;;1179000;3619000;42829000;7716000;5058000;12774000;4172000;4457000;17231000;8059000;;8423000;25598000;42829000
MICT;706645;USD;2012;Q4;2012-12-31;2013-03-29;3241500;4654988;13794000;11853000;7392000;33984000;2269000;;1678000;3947000;37931000;8121000;6360000;14554000;5311000;6509000;21063000;960000;;8918000;16868000;37931000
MICT;706645;USD;2011;Q4;2011-12-31;2012-03-30;3241500;3241500;940000;8655000;2479000;12074000;482000;;22000;504000;12578000;2345000;1766000;4111000;4586000;4855000;8966000;6000;;3501000;3612000;12578000
MICT;706645;USD;2010;Q4;2010-12-31;2011-09-14;3241500;;626000;5030000;3138000;8794000;255000;;235000;490000;9284000;2957000;349000;4433000;561000;806000;5239000;84000;;2321000;4045000;9284000
MICT;706645;USD;2018;Q4;2018-12-31;2019-04-01;9311322;;2174000;1349000;4345000;7868000;661000;0;1614000;2275000;10143000;2742000;5810000;8552000;477000;587000;9139000;11914000;;-12757000;1004000;10143000
OUT;706846;USD;2018;Q4;2018-12-31;2019-02-27;139900000;138600000;52700000;264900000;;410600000;652900000;;2765200000;3418100000;3828700000;198100000;160000000;402600000;2149600000;2280800000;2683400000;1996400000;;-871600000;1145300000;3828700000
OUT;706846;USD;2017;Q4;2017-12-31;2018-02-28;138500000;136500000;48300000;231100000;;371300000;662100000;;2774800000;3436900000;3808200000;179600000;80000000;299600000;2145300000;2282000000;2581600000;1964400000;;-775600000;1226600000;3808200000
OUT;706846;USD;2016;Q4;2016-12-31;2017-02-23;138100000;139200000;65200000;222000000;;378200000;665000000;;2695300000;3360300000;3738500000;216700000;0;251500000;2136800000;2254000000;2505500000;1950900000;;-699500000;1233000000;3738500000
OUT;706846;USD;2015;Q4;2015-12-31;2016-02-29;137400000;135900000;101600000;209500000;;412200000;701700000;;2701600000;3403300000;3815500000;206600000;;265600000;2222000000;2337300000;2602900000;1935700000;;-602200000;1212600000;3815500000
OUT;706846;USD;2014;Q4;2014-12-31;2015-03-06;120500000;121600000;28500000;217500000;;355300000;782900000;;2885400000;3668300000;4023600000;209600000;;255200000;2198300000;2322900000;2578100000;1912600000;;-377000000;1445500000;4023600000
OUT;706846;USD;2013;Q4;2013-12-31;2014-05-08;120500000;121600000;29800000;178800000;;317200000;755400000;;2282900000;3038300000;3355500000;163700000;;212200000;0;388900000;601100000;2829500000;;0;2754400000;3355500000
ASCMA;707350;USD;2018;Q4;2018-12-31;2019-04-01;12399412;12399412;105921000;13121000;;151433000;36549000;;1225562000;1262111000;1413544000;48674000;1895175000;1968422000;1770000;10551000;1978973000;1425450000;;-1998487000;-565429000;1413544000
ASCMA;707350;USD;2017;Q4;2017-12-31;2018-03-05;12271828;12271828;116423000;12645000;;140243000;32823000;;1881919000;1914742000;2054985000;67374000;11000000;101554000;1780702000;1810759000;1912313000;1424023000;;-1277118000;142672000;2054985000
ASCMA;707350;USD;2016;Q4;2016-12-31;2017-03-08;12110707;12110707;90144000;13869000;;125033000;28331000;;1979068000;2007399000;2132432000;51553000;11000000;95116000;1756878000;1798671000;1893787000;1417629000;;-1169559000;238645000;2132432000
ASCMA;707350;USD;2015;Q4;2015-12-31;2016-02-29;12418196;12418196;92629000;13622000;;123273000;32440000;;2017592000;2050032000;2173305000;44618000;5500000;86211000;1717654000;1762325000;1848536000;1418022000;;-1078315000;324769000;2173305000
ASCMA;707350;USD;2014;Q4;2014-12-31;2015-02-27;13461139;13461139;135205000;13796000;;176500000;36010000;;1950832000;1986842000;2163342000;41585000;9166000;91143000;1600805000;1632511000;1723654000;1441427000;;-994931000;439688000;2163342000
ASCMA;707350;USD;2013;Q4;2013-12-31;2014-02-27;13120883;12384802;174197000;13019000;;204022000;56528000;;1965243000;2021771000;2225793000;45129000;9166000;95568000;1578796000;1615468000;1711036000;1470197000;;-957179000;514757000;2225793000
ASCMA;707350;USD;2012;Q4;2012-12-31;2013-02-27;13908649;13908649;221009000;10891000;;261673000;56491000;;1390729000;1447220000;1708893000;36686000;6950000;72150000;1101433000;1128140000;1200290000;1453841000;;-935708000;508603000;1708893000
ASCMA;707350;USD;2011;Q4;2011-12-31;2012-03-29;14056448;14056448;223935000;10973000;;289893000;74697000;;1261369000;1336066000;1625959000;28136000;60000000;123213000;892718000;951319000;1074532000;1461813000;;-905610000;551427000;1625959000
ASCMA;707350;USD;2010;Q4;2010-12-31;2011-08-08;;;149857000;11092000;;240686000;78211000;;1325985000;1404196000;1644882000;29935000;20000000;93906000;896733000;1003236000;1097142000;1467900000;;-917347000;547740000;1644882000
HEMA;708324;USD;2011;Q4;2011-12-31;2012-04-05;10582842;11162756;2266000;2013000;406000;5684000;2363000;;660000;3023000;8707000;1874000;18000;4054000;57000;521000;4575000;16544000;;-12412000;4132000;8707000
HEMA;708324;USD;2010;Q4;2010-12-31;2011-08-31;9710033;9781304;1638000;2780000;577000;6214000;2887000;;742000;3629000;9843000;2441000;16000;4551000;77000;610000;5161000;16289000;;-11607000;4682000;9843000
OKTA;708398;USD;2018;Q4;2019-01-31;2019-03-14;110335000;110335000;563768000;91926000;;709330000;52921000;;102084000;155005000;864335000;36982000;;292563000;271628000;319395000;611958000;744907000;;-492211000;252377000;864335000
OKTA;708398;USD;2017;Q4;2018-01-31;2018-03-12;103183000;103183000;229714000;52248000;;317498000;12540000;;69225000;81765000;399263000;21940000;;187943000;0;11980000;199923000;565663000;;-366714000;199340000;399263000
OKTA;708398;USD;2016;Q4;2017-01-31;2017-06-08;19602000;19602000;37672000;34544000;;92790000;11026000;;26819000;37845000;130635000;18121000;;134496000;227954000;239744000;374240000;44471000;;-287909000;-243605000;130635000
PEGI;708994;USD;2017;Q4;2017-12-31;2018-03-01;95218190;94997732;116753000;54900000;;270310000;3965121000;311223000;194877000;4471221000;4741531000;112831000;51996000;217034000;1878735000;2176355000;2393389000;1235826000;-3511000;-112175000;2348142000;4741531000
PEGI;708994;USD;2016;Q4;2016-12-31;2017-03-01;87115878;87115878;83932000;37510000;;218057000;3135162000;233294000;166254000;3534710000;3752767000;77908000;48716000;366875000;1334956000;1507148000;1874023000;1146635000;-2500000;-94270000;1878744000;3752767000
PEGI;708994;USD;2015;Q4;2015-12-31;2016-02-29;74516977;74313424;94808000;45292000;;203329000;3294620000;116473000;215170000;3626263000;3829592000;103398000;44144000;520687000;1371742000;1533143000;2053830000;983561000;-1577000;-77159000;1775762000;3829592000
PEGI;708994;USD;2014;Q4;2014-12-31;2015-03-02;61977041;35543814;101656000;35759000;;197088000;2377051000;29079000;192069000;2598199000;2795287000;64293000;109693000;250199000;1304165000;1380354000;1630553000;724559000;-717000;-44626000;1164734000;2795287000
HTM;709126;USD;2011;Q4;2011-12-31;2012-07-13;;85079638;4433051;335721;;8693620;193867155;92497;16377596;210337248;219030868;37701609;14183;37717879;61120708;69495470;107213349;93560378;;-31530306;111817519;219030868
HTM;709126;USD;2010;Q4;2010-12-31;2011-08-09;;83360052;8098905;532605;;9723006;40295117;178486;35126359;75599962;85322968;940563;242736;1185637;16798973;18326802;19512439;90368749;;-25308177;65810529;85322968
AGR;709430;USD;2017;Q4;2017-12-31;2018-03-26;309511444;310147532;41000000;1050000000;115000000;2260000000;22669000000;415000000;6327000000;29411000000;31671000000;2197000000;183000000;3114000000;5196000000;13461000000;16575000000;13656000000;-8000000;1475000000;15096000000;31671000000
AGR;709430;USD;2016;Q4;2016-12-31;2017-03-10;308650212;309869288;91000000;1144000000;132000000;2252000000;21548000000;442000000;7067000000;29057000000;31309000000;1711000000;349000000;2712000000;4510000000;13389000000;16101000000;13656000000;-5000000;1630000000;15208000000;31309000000
AGR;709430;USD;2015;Q4;2015-12-31;2016-04-01;262352848;262420444;427000000;1044000000;98000000;2474000000;20711000000;449000000;7109000000;28269000000;30743000000;1199000000;206000000;2035000000;4530000000;13642000000;15677000000;13656000000;;1449000000;15066000000;30743000000
AGR;709430;USD;2014;Q4;2014-12-31;2015-12-16;;;482000000;891000000;98000000;2202000000;17133000000;353000000;4474000000;21960000000;24162000000;970000000;148000000;1772000000;2489000000;9913000000;11685000000;11378000000;;1182000000;12477000000;24162000000
AGR;709430;USD;2018;Q4;2018-12-31;2019-03-01;309477424;309647974;36000000;1148000000;126000000;1969000000;23459000000;424000000;6315000000;30198000000;32167000000;2034000000;394000000;3004000000;5368000000;13760000000;16764000000;13660000000;-12000000;1528000000;15403000000;32167000000
VEC;710316;USD;2017;Q4;2017-12-31;2018-03-01;11113000;11298000;77453000;174995000;;271946000;3733000;;219872000;223605000;495551000;174412000;4000000;182178000;73211000;130001000;312179000;67637000;;117415000;183372000;495551000
VEC;710316;USD;2016;Q4;2016-12-31;2017-03-01;10793000;11021000;47651000;172072000;;244137000;3061000;;218107000;221168000;465305000;170665000;15750000;187836000;67842000;160068000;347904000;64019000;;57959000;117401000;465305000
VEC;710316;USD;2015;Q4;2015-12-31;2016-03-15;10601000;10868000;39995000;210561000;;261507000;4762000;;218127000;222889000;484396000;184493000;22000000;212518000;89615000;182568000;395086000;58746000;;34304000;89310000;484396000
VEC;710316;USD;2014;Q4;2014-12-31;2015-03-16;10482000;11346000;42823000;202732000;;263550000;8920000;;223505000;232425000;495975000;188140000;11375000;205321000;122484000;236779000;442100000;53072000;;3331000;53875000;495975000
VEC;710316;USD;2013;Q4;2013-12-31;2014-11-10;10474000;10474000;10446000;227534000;;255062000;9239000;;224863000;234102000;489164000;170813000;0;208186000;0;89646000;297832000;0;;0;191332000;489164000
VEC;710316;USD;2018;Q4;2018-12-31;2019-02-26;11267000;11385000;66145000;232119000;;313327000;13419000;;245497000;258916000;572243000;220486000;4500000;224986000;69137000;125957000;350943000;71842000;;152616000;221300000;572243000
CRY;710985;USD;2017;Q4;2017-12-31;2018-03-09;34042000;35177000;39977000;51441000;46684000;179280000;33579000;;376834000;410413000;589693000;23995000;718000;42940000;218236000;269695000;312635000;250311000;-12719000;37609000;277058000;589693000
CRY;710985;USD;2016;Q4;2016-12-31;2017-02-16;32230000;33588000;56642000;30096000;26293000;147233000;18502000;;150405000;168907000;316140000;19615000;4562000;30102000;67023000;77055000;107157000;187403000;-12134000;34143000;208983000;316140000
CRY;710985;USD;2015;Q4;2015-12-31;2016-02-16;27917000;30336000;37588000;26672000;14643000;109663000;11484000;;60032000;71516000;181179000;13772000;;19605000;;6323000;25928000;143186000;-11224000;23365000;155251000;181179000
CRY;710985;USD;2014;Q4;2014-12-31;2015-02-17;27271000;28204000;33375000;22863000;12739000;106028000;12002000;;58127000;70129000;176157000;12940000;;20627000;;6845000;27472000;135519000;-9481000;22768000;148685000;176157000
CRY;710985;USD;2013;Q4;2013-12-31;2014-02-21;26838000;28236000;37643000;18307000;9771000;106327000;12171000;;56185000;68356000;174683000;12811000;;20722000;;9214000;29936000;128867000;-2868000;18741000;144747000;174683000
CRY;710985;USD;2012;Q4;2012-12-31;2013-02-15;27014000;27727000;13009000;16520000;10557000;77503000;11667000;;67986000;79653000;157156000;13035000;;20029000;;9015000;29044000;122689000;-74000;5536000;128112000;157156000
CRY;710985;USD;2011;Q4;2011-12-31;2012-02-17;27471000;27721000;21705000;17505000;7320000;83870000;12308000;;51686000;63994000;147864000;13447000;;19567000;;6759000;26326000;135304000;-12723000;-1037000;121538000;147864000
CRY;710985;USD;2010;Q4;2010-12-31;2011-07-29;27690000;28028000;35497000;14313000;6429000;101490000;13086000;;22862000;35948000;137438000;12034000;;17233000;;6263000;23496000;134145000;-11763000;-8408000;113942000;137438000
CRY;710985;USD;2018;Q4;2018-12-31;2019-02-26;36658000;34643000;41489000;51432000;45478000;179168000;31028000;;360895000;391923000;571091000;27723000;1889000;34523000;221658000;261501000;296024000;260746000;-14591000;34984000;275067000;571091000
FRP;710987;USD;2016;Q4;2016-12-31;2017-03-06;26878200;27191180;34924000;62395000;;126715000;1024352000;;79768000;1104120000;1230835000;111823000;7627000;119450000;899681000;1165462000;1284912000;527997000;;-603610000;-54077000;1230835000
FRP;710987;USD;2015;Q4;2015-12-31;2016-03-02;26689617;27273882;26560000;60136000;;116136000;1118781000;;87609000;1206390000;1322526000;112911000;7318000;120229000;901368000;1203786000;1324015000;522111000;;-707592000;-1489000;1322526000
FRP;710987;USD;2014;Q4;2014-12-31;2015-03-04;26478901;26478901;37587000;71545000;;139898000;1213729000;;98744000;1312473000;1452371000;145544000;7027000;152571000;903203000;1900084000;2052655000;516347000;;-798008000;-600284000;1452371000
FRP;710987;USD;2013;Q4;2013-12-31;2014-03-05;26215559;26215559;42700000;89248000;;181169000;1301292000;;117437000;1418729000;1599898000;139000000;7845000;146845000;912169000;1762249000;1909094000;512272000;;-661689000;-309196000;1599898000
FRP;710987;USD;2012;Q4;2012-12-31;2013-03-07;26041932;26041932;23203000;86999000;;170292000;1438309000;;123760000;1562069000;1732361000;131326000;11220000;142953000;948470000;1907221000;2050174000;506415000;;-568239000;-317813000;1732361000
DATA;711049;USD;2017;Q4;2017-12-31;2018-02-26;80109000;80109000;854665000;203366000;;1089218000;106753000;148364000;54460000;309577000;1398795000;143303000;;562729000;;82443000;645172000;1168571000;;-402957000;753623000;1398795000
DATA;711049;USD;2016;Q4;2016-12-31;2017-02-23;76429000;76429000;908717000;206765000;;1151624000;106637000;0;28938000;135575000;1287199000;143178000;;428721000;;66630000;495351000;1007213000;;-216958000;791848000;1287199000
DATA;711049;USD;2015;Q4;2015-12-31;2016-02-25;72799000;72799000;795900000;131784000;;944739000;72350000;;13622000;85972000;1030711000;86993000;;272601000;;24165000;296766000;805811000;;-72509000;733945000;1030711000
DATA;711049;USD;2014;Q4;2014-12-31;2015-02-27;69662000;96574000;680613000;99910000;;810261000;45627000;;9774000;55401000;865662000;58289000;;180274000;;13382000;193656000;660675000;;11191000;672006000;865662000
DATA;711049;USD;2013;Q4;2013-12-31;2014-02-27;61387000;83294000;252674000;61158000;;332181000;21338000;;1408000;22746000;354927000;37999000;;104289000;;5978000;110267000;239413000;;5318000;244660000;354927000
DATA;711049;USD;2012;Q4;2012-12-31;2013-08-09;33948000;39817000;39302000;30752000;;76161000;10346000;;485000;10831000;86992000;19946000;;51930000;;5088000;57018000;11702000;;-1758000;29974000;86992000
DATA;711049;USD;2018;Q4;2018-12-31;2019-02-22;83978000;83978000;1022377000;236063000;;1415720000;94537000;26278000;98190000;219005000;1634725000;170685000;;548577000;;72563000;621140000;1340636000;;-315593000;1013585000;1634725000
RHE;712450;USD;2017;Q4;2017-12-31;2018-04-16;1642260;1642260;1818000;945000;;4704000;81213000;;20634000;101847000;106551000;18029000;1469000;19498000;65012000;69183000;88681000;61724000;;-106277000;17870000;106551000
RHE;712450;USD;2016;Q4;2016-12-31;2017-04-17;1654255;1654255;14045000;2429000;;20469000;79168000;;19849000;99017000;119486000;16132000;9136000;25268000;66816000;70719000;95987000;61643000;;-99590000;23499000;119486000
RHE;712450;USD;2018;Q4;2018-12-31;2019-05-17;1710498;1710498;2407000;971000;;8075000;77237000;;15258000;92495000;100570000;35219000;;36710000;54916000;57709000;94419000;61900000;;-118172000;6151000;100570000
OTEX;714157;USD;2018;Q4;2018-06-30;2018-08-02;267462000;269112000;682942000;487956000;;1327580000;264205000;;6173244000;6437449000;7765029000;340388000;10000000;994599000;2610523000;3053172000;4047771000;1707073000;-18732000;1994235000;3717258000;7765029000
OTEX;714157;USD;2017;Q4;2017-06-30;2017-08-03;263624000;265537000;443357000;445812000;;1003477000;227418000;;6249667000;6477085000;7480562000;373955000;182760000;1127043000;2387057000;2820200000;3947243000;1613454000;-27520000;1897624000;3533319000;7480562000
OTEX;714157;USD;2016;Q4;2016-06-30;2016-07-27;242574000;244028000;1295596000;285904000;;1672273000;183660000;;3298211000;3481871000;5154144000;289480000;8000000;671029000;2137987000;2503918000;3174947000;965068000;-25268000;992546000;1979197000;5154144000
OTEX;714157;USD;2015;Q4;2015-06-30;2015-07-29;244482000;245856000;711165000;284131000;;1069638000;160419000;;3123273000;3283692000;4353330000;258371000;8000000;624437000;1549370000;1899086000;2523523000;934427000;-19986000;863015000;1829807000;4353330000
OTEX;714157;USD;2014;Q4;2014-06-30;2014-07-31;242850000;244524000;427890000;292929000;;787520000;142261000;;2969917000;3112178000;3899698000;244902000;62582000;641201000;1256750000;1616330000;2257531000;905232000;-19132000;716317000;1642167000;3899698000
OTEX;714157;USD;2013;Q4;2013-06-30;2013-08-01;235572000;237076000;470445000;174927000;;706009000;88364000;;1860444000;1948808000;2654817000;192627000;51742000;527883000;513750000;789726000;1317609000;753507000;-29074000;572885000;1337208000;2654817000
OTEX;714157;USD;2012;Q4;2012-06-30;2012-08-10;233056000;235376000;559747000;163664000;;786873000;81157000;;1576263000;1657420000;2444293000;159821000;41374000;476794000;555000000;788107000;1264901000;730347000;-37387000;442068000;1179392000;2444293000
OTEX;714157;USD;2011;Q4;2011-06-30;2011-08-15;229092000;234684000;284140000;154568000;;487297000;77825000;;1367241000;1445066000;1932363000;144673000;15545000;415373000;282033000;477545000;892918000;688580000;-26499000;316894000;1039445000;1932363000
OTEX;714157;USD;2010;Q4;2010-06-30;2010-08-20;453089852;462261216;326192000;132143000;;523930000;54286000;;1137466000;1191752000;1715682000;159270000;15486000;422892000;285026000;404912000;827804000;664166000;-14000000;193691000;887878000;1715682000
OTEX;714157;USD;2009;Q4;2009-06-30;2009-08-21;210548000;213644000;275819000;115802000;;414289000;45165000;13103000;1034679000;1092947000;1507236000;127348000;3449000;320702000;299234000;500070000;820772000;510134000;;104479000;686464000;1507236000
OTEX;714157;USD;2008;Q4;2008-06-30;2009-05-07;811872008;841034912;254916000;134396000;0;416619000;43582000;0;974475000;1018057000;1434676000;112534000;3486000;297863000;304301000;491980000;789843000;477801000;;47541000;644833000;1434676000
OTEX;714157;USD;2019;Q4;2019-06-30;2019-08-01;269593000;270815000;941009000;463785000;;1561328000;249453000;;6123194000;6372647000;7933975000;363061000;10000000;1117563000;2604878000;2931742000;4049305000;1774214000;-28766000;2113883000;3884670000;7933975000
MFON;714287;USD;2017;Q4;2017-12-31;2018-04-11;36839866;36839866;460059;885743;;1555338;;;1568470;1568470;3123808;1687671;2236224;5579516;180810;281672;5861188;77947867;;-80619483;-2737380;3123808
MFON;714287;USD;2016;Q4;2016-12-31;2017-03-31;35294071;35294071;1188485;1244484;;3612345;;;1540013;1540013;5152358;1375044;1011910;2662028;361166;462028;3124056;76734772;;-74673471;2028302;5152358
MFON;714287;USD;2015;Q4;2015-12-31;2016-03-30;28851365;28851365;634129;700356;;1465830;;;4467783;4467783;5933613;789677;;1059446;;100862;1160308;69932315;;-65159010;4773305;5933613
MFON;714287;USD;2014;Q4;2014-12-31;2015-03-31;22795612;22847774;848230;384566;;1337010;;;4031500;4031500;5368510;597765;;1704890;;100862;1805752;62588722;;-59025964;3562758;5368510
MFON;714287;USD;2013;Q4;2013-12-31;2014-03-31;;16513780;2572685;280667;;2993466;;;4108224;4108224;7101690;751632;20000;1085458;24245;132415;1217873;54469017;;-48585200;5883817;7101690
MFON;714287;USD;2012;Q4;2012-12-31;2013-03-21;;-15489691;363;414671;;445043;;;2904964;2904964;3350007;1135851;3029653;9740026;0;0;9740026;25436150;;-31826169;-6390019;3350007
MFON;714287;USD;2011;Q4;2011-12-31;2012-04-16;;3832634;396;243846;;260166;25316;;4315622;4340938;4601104;1210894;1739000;5182219;2658238;2784084;7966303;21122043;;-24487242;-3365199;4601104
MFON;714287;USD;2010;Q4;2010-12-31;2011-09-01;;2406785;373439;49215;;490684;1609;;46317;47926;538610;309485;803156;1749579;0;0;1749579;6963284;;-8174253;-1210969;538610
MFON;714287;USD;2018;Q4;2018-12-31;2019-04-15;46776342;39101764;554255;601658;;2471091;;2113823;2846144;4959967;7431058;2091106;1148198;6051270;1054828;1155690;7206960;88054471;;-87835132;224098;7431058
SAM;714419;USD;2018;Q4;2018-12-31;2019-02-20;11625000;11616000;108399000;34073000;70249000;231571000;389789000;;18491000;408280000;639851000;120514000;;120514000;;59020000;179534000;405826000;;55688000;460317000;639851000
SAM;714419;USD;2017;Q4;2017-12-31;2018-02-21;11729000;11823000;65637000;33749000;50651000;168348000;384280000;;16996000;401276000;569624000;101758000;;101758000;;44343000;146101000;372706000;;52105000;423523000;569624000
SAM;714419;USD;2016;Q4;2016-12-31;2017-02-22;22814000;12625000;91035000;36694000;52499000;193887000;408411000;;13648000;422059000;615946000;101519000;;101519000;;67845000;169364000;350037000;;97648000;446582000;615946000
SAM;714419;USD;2015;Q4;2015-12-31;2016-02-18;9475000;13273000;94193000;38984000;56462000;223603000;409926000;;11871000;421797000;645400000;111102000;58000;111160000;471000;73019000;184179000;290224000;;171948000;461221000;645400000
SAM;714419;USD;2014;Q4;2014-12-31;2015-02-24;9365000;13520000;76402000;36860000;51307000;207462000;381569000;;16130000;397699000;605161000;110115000;55000;110170000;528000;58851000;169021000;225040000;;212233000;436140000;605161000
SAM;714419;USD;2013;Q4;2013-12-31;2014-02-25;8760000;13551000;49524000;42001000;56397000;164278000;266558000;;13239000;279797000;444075000;104324000;53000;104377000;584000;37613000;141990000;173153000;;129349000;302085000;444075000
SAM;714419;USD;2012;Q4;2012-12-31;2013-02-20;492000;13402000;74463000;31479000;44361000;162342000;189948000;;7194000;197142000;359484000;88832000;62000;88894000;566000;25499000;114393000;157433000;;88541000;245091000;359484000
SAM;714419;USD;2011;Q4;2011-12-31;2012-02-22;12619000;13360000;49450000;23233000;34072000;125723000;143586000;;3179000;146765000;272488000;67049000;;67049000;;20694000;87743000;138464000;;47119000;184745000;272488000
SAM;714419;USD;2010;Q4;2010-12-31;2011-08-02;13255000;13952000;48969000;20017000;26614000;112004000;142889000;;3637000;146526000;258530000;72199000;;72199000;;20743000;92942000;122150000;;43876000;165588000;258530000
CNDT;716302;USD;2017;Q4;2017-12-31;2018-03-01;204599000;215343000;658000000;1114000000;;2710000000;257000000;;4581000000;4838000000;7548000000;473000000;82000000;1368000000;1979000000;2509000000;3877000000;3852000000;;171000000;3671000000;7548000000
CNDT;716302;USD;2016;Q4;2016-12-31;2017-03-10;202875000;202875000;390000000;1286000000;;1917000000;283000000;;5509000000;5792000000;7709000000;433000000;28000000;1402000000;1913000000;2877000000;4279000000;3814000000;;0;3430000000;7709000000
CNDT;716302;USD;2015;Q4;2015-12-31;2016-11-10;;;140000000;1246000000;;1874000000;280000000;;6904000000;7184000000;9058000000;513000000;24000000;2741000000;37000000;6498000000;9239000000;0;;;-181000000;9058000000
GHC;716648;USD;2018;Q4;2018-12-31;2019-02-25;5269000;5308000;767837000;582280000;69477000;1532342000;293085000;;2938614000;3231699000;4764041000;497074000;6360000;812162000;470777000;1030751000;1842913000;398837000;-3922009000;6236125000;2921128000;4764041000
QSR;716651;USD;2017;Q4;2017-12-31;2018-02-23;267400000;476500000;1097400000;488800000;78000000;1749600000;2133300000;;17340600000;19473900000;21223500000;1361900000;78200000;1655000000;12044700000;15007900000;16662900000;2051500000;;650600000;4560600000;21223500000
QSR;716651;USD;2016;Q4;2016-12-31;2017-02-17;247300000;470900000;1460400000;403500000;71800000;2097000000;2054700000;;14973200000;17027900000;19124900000;922400000;93900000;1210700000;8628600000;11128600000;12339300000;1955100000;;445700000;6785600000;19124900000
QSR;716651;USD;2015;Q4;2015-12-31;2016-02-26;207000000;483900000;757800000;422000000;81300000;1369500000;2150600000;;14891000000;17041600000;18411100000;896400000;56100000;1121000000;8665700000;11080400000;12201400000;1824500000;;245800000;6209700000;18411100000
QSR;716651;USD;2014;Q4;2014-12-31;2015-03-02;318300000;362200000;1803200000;441200000;;2640800000;2436500000;;16265700000;18702200000;21343000000;630000000;1128800000;1945800000;9070200000;11760800000;13706600000;1755000000;;231000000;7636400000;21343000000
QSR;716651;USD;2013;Q4;2013-12-31;2015-03-02;;;786900000;179700000;;1074400000;801500000;;3952600000;4754100000;5828500000;242600000;81400000;346000000;2955600000;3966300000;4312300000;1243400000;-7300000;225500000;1516200000;5828500000
QSR;716651;USD;2018;Q4;2018-12-31;2019-02-22;343100000;469100000;913000000;452000000;75000000;1500000000;1996000000;;16645000000;18641000000;20141000000;1150000000;91000000;1408000000;12049000000;15115000000;16523000000;1737000000;;674000000;3618000000;20141000000
UIS;717085;USD;2017;Q4;2017-12-31;2018-03-12;50472000;50472000;733900000;;26100000;1389500000;142500000;;1010400000;1152900000;2542400000;241800000;10800000;971600000;633900000;2897300000;3868900000;4526900000;-102700000;-1963100000;-1326500000;2542400000
UIS;717085;USD;2016;Q4;2016-12-31;2017-02-21;50085000;28368000;370600000;;29000000;1027300000;145300000;;849000000;994300000;2021600000;189000000;106000000;981600000;194000000;2687400000;3669000000;4515700000;-100500000;-1893400000;-1647400000;2021600000
UIS;717085;USD;2015;Q4;2015-12-31;2016-02-29;49938000;49938000;365200000;;43800000;1111500000;153800000;;864700000;1018500000;2130000000;219300000;76800000;961100000;233700000;2547500000;3508600000;4501400000;-100100000;-1845700000;-1378600000;2130000000
UIS;717085;USD;2014;Q4;2014-12-31;2015-02-23;49689000;50728000;494300000;;46700000;1317300000;168700000;;862700000;1031400000;2348700000;262500000;1800000;997700000;222200000;2803400000;3801100000;4488800000;-99600000;-1735800000;-1452400000;2348700000
UIS;717085;USD;2013;Q4;2013-12-31;2014-02-24;43951000;45328000;639800000;;55100000;1540800000;174700000;;794500000;969200000;2510000000;246700000;;1024800000;210000000;2149100000;3173900000;4228100000;-62400000;-1782500000;-663900000;2510000000
UIS;717085;USD;2012;Q4;2012-12-31;2013-02-22;43974000;65591000;655600000;;50000000;1512400000;176400000;;731600000;908000000;2420400000;228600000;300000;1030300000;210000000;2978800000;4009100000;4223500000;-48800000;-1891000000;-1588700000;2420400000
UIS;717085;USD;2011;Q4;2011-12-31;2012-02-24;43392000;61347000;714900000;;64800000;1603400000;191300000;;817500000;1008800000;2612200000;241600000;900000;1116100000;358800000;2807100000;3923200000;4217800000;-48100000;-2036600000;-1311000000;2612200000
UIS;717085;USD;2010;Q4;2010-12-31;2011-02-22;42640000;40243000;828300000;;88900000;1875400000;219700000;;925800000;1145500000;3020900000;260700000;800000;1336700000;823200000;2618000000;3954700000;4207600000;-46000000;-2170600000;-933800000;3020900000
UIS;717085;USD;2009;Q4;2009-12-31;2010-07-30;;;647600000;;100500000;1773400000;225700000;;957800000;1183500000;2956900000;292200000;65800000;1450200000;845900000;2778400000;4228600000;4196900000;-45000000;-2406700000;-1271700000;2956900000
UIS;717085;USD;2018;Q4;2018-12-31;2019-03-04;51029000;117361000;605000000;;27300000;1301400000;121300000;;1034900000;1156200000;2457600000;268900000;10000000;923300000;642800000;2833900000;3757200000;4540300000;-105000000;-1694000000;-1299600000;2457600000
RFP;717558;USD;2017;Q4;2017-12-31;2018-03-01;91000000;89900000;6000000;399000000;526000000;1044000000;1716000000;;1387000000;3103000000;4147000000;420000000;1000000;421000000;788000000;2126000000;2547000000;3793000000;-120000000;-1294000000;1600000000;4147000000
RFP;717558;USD;2016;Q4;2016-12-31;2017-03-01;90300000;89800000;35000000;358000000;570000000;1081000000;1842000000;;1354000000;3196000000;4277000000;466000000;1000000;467000000;761000000;2099000000;2566000000;3775000000;-120000000;-1207000000;1711000000;4277000000
RFP;717558;USD;2015;Q4;2015-12-31;2016-02-29;89500000;89500000;58000000;377000000;541000000;1111000000;1810000000;;1299000000;3109000000;4220000000;436000000;1000000;437000000;590000000;1838000000;2275000000;3765000000;-120000000;-1126000000;1945000000;4220000000
RFP;717558;USD;2014;Q4;2014-12-31;2015-03-02;94600000;94600000;337000000;449000000;542000000;1464000000;1985000000;;1465000000;3450000000;4914000000;518000000;1000000;519000000;589000000;2278000000;2797000000;3754000000;-61000000;-869000000;2117000000;4914000000
RFP;717558;USD;2013;Q4;2013-12-31;2014-03-03;94600000;94600000;322000000;536000000;529000000;1562000000;2289000000;;1534000000;3823000000;5385000000;533000000;2000000;567000000;597000000;1979000000;2546000000;3751000000;-61000000;-592000000;2839000000;5385000000
RFP;717558;USD;2012;Q4;2012-12-31;2013-03-01;95500000;95900000;263000000;576000000;558000000;1630000000;2440000000;;2263000000;4703000000;6333000000;581000000;2000000;583000000;532000000;2625000000;3208000000;3730000000;-61000000;47000000;3125000000;6333000000
RFP;717558;USD;2011;Q4;2011-12-31;2012-03-30;97100000;97100000;369000000;582000000;475000000;1769000000;2502000000;;2027000000;4529000000;6298000000;544000000;;544000000;621000000;2277000000;2821000000;3687000000;;41000000;3477000000;6298000000
RFP;717558;USD;2018;Q4;2018-12-31;2019-03-01;91400000;93600000;304000000;347000000;508000000;1304000000;1515000000;;1116000000;2631000000;3935000000;427000000;223000000;650000000;422000000;1750000000;2400000000;3802000000;-120000000;-1198000000;1535000000;3935000000
CVNA;717670;USD;2017;Q4;2017-12-31;2018-03-06;;15893000;172680000;14105000;227446000;489718000;148681000;;2738000;151419000;641137000;52108000;5131000;306031000;48469000;55562000;361593000;41508000;;-12899000;279544000;641137000
CVNA;717670;USD;2018;Q4;2018-12-31;2019-02-27;;39391000;78861000;33120000;412243000;662854000;296839000;;31320000;328159000;991013000;121415000;11133000;329511000;425349000;434074000;763585000;148061000;;-74653000;227428000;991013000
MDB;720635;USD;2017;Q4;2018-01-31;2018-03-30;50686928;50686928;278974000;46872000;;343550000;59557000;;12089000;71646000;415196000;28117000;;142617000;0;79086000;221703000;638731000;-1319000;-443760000;193493000;415196000
MDB;720635;USD;2016;Q4;2017-01-31;2017-12-15;12896872;12896872;116500000;31340000;;158452000;4877000;;11103000;15980000;174432000;19512000;;97790000;;363156000;460946000;62570000;-1319000;-347401000;-286514000;174432000
MDB;720635;USD;2018;Q4;2019-01-31;2019-04-01;53900548;53900548;465970000;72808000;;566236000;73664000;;93576000;167240000;733476000;42304000;;164637000;216858000;304273000;468910000;754666000;-1319000;-488607000;264566000;733476000
JBLU;720902;USD;2017;Q4;2017-12-31;2018-02-16;322300000;324100000;693000000;245000000;55000000;1206000000;8049000000;2000000;524000000;8575000000;9781000000;984000000;196000000;2146000000;1003000000;2903000000;5049000000;2131000000;-890000000;3491000000;4732000000;9781000000
JBLU;720902;USD;2016;Q4;2016-12-31;2017-02-17;337500000;341200000;971000000;172000000;47000000;1403000000;7271000000;90000000;559000000;7920000000;9323000000;905000000;189000000;2214000000;1195000000;3096000000;5310000000;2054000000;-500000000;2446000000;4013000000;9323000000
JBLU;720902;USD;2015;Q4;2015-12-31;2016-02-17;319500000;341900000;876000000;136000000;44000000;1373000000;6652000000;49000000;570000000;7271000000;8644000000;774000000;448000000;2275000000;1379000000;3159000000;5434000000;1900000000;-366000000;1679000000;3210000000;8644000000
JBLU;720902;USD;2014;Q4;2014-12-31;2015-02-12;300000000;391000000;708000000;136000000;46000000;1200000000;6072000000;60000000;507000000;6639000000;7839000000;698000000;265000000;1936000000;1968000000;3374000000;5310000000;1715000000;-125000000;1002000000;2529000000;7839000000
JBLU;720902;USD;2013;Q4;2013-12-31;2014-02-19;289876000;378404000;627000000;129000000;48000000;1056000000;5656000000;114000000;524000000;6294000000;7350000000;580000000;469000000;1874000000;2116000000;3342000000;5216000000;1576000000;-43000000;601000000;2134000000;7350000000
JBLU;720902;USD;2012;Q4;2012-12-31;2013-02-21;282620000;344997000;731000000;106000000;36000000;1100000000;5343000000;136000000;491000000;5970000000;7070000000;521000000;394000000;1608000000;2457000000;3574000000;5182000000;1498000000;-35000000;433000000;1888000000;7070000000
JBLU;720902;USD;2011;Q4;2011-12-31;2012-02-28;-833704244000;-973068132000;1226000000;101000000;50000000;1628000000;4860000000;38000000;545000000;5443000000;7071000000;499000000;286000000;1412000000;2850000000;3902000000;5314000000;1475000000;-8000000;305000000;1757000000;7071000000
JBLU;720902;USD;2010;Q4;2010-12-31;2011-02-25;276423000;347864000;960000000;84000000;49000000;1360000000;4641000000;133000000;459000000;5233000000;6593000000;396000000;183000000;1093000000;2850000000;3846000000;4939000000;1449000000;-4000000;219000000;1654000000;6593000000
JBLU;720902;USD;2009;Q4;2009-12-31;2010-07-27;;;1136000000;81000000;40000000;1534000000;4638000000;6000000;371000000;5015000000;6549000000;330000000;384000000;1157000000;2920000000;3846000000;5003000000;1425000000;-2000000;122000000;1546000000;6549000000
JBLU;720902;USD;2018;Q4;2018-12-31;2019-02-21;307300000;310400000;887000000;211000000;78000000;1474000000;8315000000;3000000;634000000;8952000000;10426000000;1074000000;309000000;2418000000;1361000000;3397000000;5815000000;2207000000;-1272000000;3679000000;4611000000;10426000000
X;721031;USD;2017;Q4;2017-12-31;2018-02-21;;179326000;1553000000;1173000000;1738000000;4755000000;4280000000;480000000;347000000;5107000000;9862000000;2512000000;3000000;2721000000;2700000000;3820000000;6541000000;4108000000;-76000000;133000000;3321000000;9862000000
X;721031;USD;2016;Q4;2016-12-31;2017-02-28;;172008000;1515000000;976000000;1573000000;4356000000;3979000000;528000000;297000000;4804000000;9160000000;2087000000;50000000;2331000000;2981000000;4554000000;6885000000;4203000000;-182000000;-250000000;2275000000;9160000000
X;721031;USD;2015;Q4;2015-12-31;2016-02-29;;146357000;755000000;864000000;2074000000;3917000000;4411000000;540000000;299000000;5250000000;9167000000;1923000000;45000000;2148000000;3093000000;4582000000;6730000000;3754000000;-339000000;190000000;2437000000;9167000000
X;721031;USD;2014;Q4;2014-12-31;2015-02-24;;162066000;1354000000;1632000000;2496000000;5829000000;4574000000;577000000;1033000000;6184000000;12013000000;2926000000;378000000;3569000000;3120000000;4644000000;8213000000;3774000000;-396000000;1862000000;3800000000;12013000000
X;721031;USD;2013;Q4;2013-12-31;2014-02-25;;144747000;604000000;1818000000;2688000000;6078000000;5922000000;621000000;522000000;7065000000;13143000000;2709000000;323000000;3245000000;3616000000;6522000000;9767000000;3818000000;-480000000;1789000000;3376000000;13143000000
X;721031;USD;2012;Q4;2012-12-31;2013-02-15;;89784000;570000000;1862000000;2503000000;5496000000;6408000000;609000000;2704000000;9721000000;15217000000;2749000000;2000000;2990000000;3936000000;8749000000;11739000000;3803000000;-521000000;3463000000;3478000000;15217000000
X;721031;USD;2011;Q4;2011-12-31;2012-02-28;;116024000;408000000;1921000000;2775000000;5774000000;6579000000;683000000;3037000000;10299000000;16073000000;3021000000;20000000;3649000000;3828000000;8923000000;12572000000;3801000000;-550000000;3616000000;3501000000;16073000000
X;721031;USD;2010;Q4;2010-12-31;2011-02-22;;-286733106000;578000000;1921000000;2352000000;5304000000;6486000000;670000000;2890000000;10046000000;15350000000;2719000000;216000000;3147000000;3517000000;8351000000;11498000000;3801000000;-580000000;3698000000;3852000000;15350000000
X;721031;USD;2009;Q4;2009-12-31;2010-02-24;;143478000;1218000000;1423000000;1679000000;5015000000;6820000000;695000000;2892000000;10407000000;15422000000;2282000000;19000000;2474000000;3345000000;7969000000;10443000000;3803000000;-608000000;4209000000;4979000000;15422000000
X;721031;USD;2008;Q4;2008-12-31;2009-07-28;;116331000;724000000;2106000000;2492000000;5732000000;6676000000;695000000;2984000000;10355000000;16087000000;2440000000;81000000;2778000000;3064000000;8250000000;11028000000;3110000000;-612000000;5666000000;5059000000;16087000000
X;721031;USD;2018;Q4;2018-12-31;2019-02-15;;177526000;1000000000;1435000000;2092000000;4830000000;4865000000;513000000;774000000;6152000000;10982000000;2933000000;65000000;3197000000;2316000000;3582000000;6779000000;4094000000;-78000000;1212000000;4203000000;10982000000
NANO;721571;USD;2018;Q4;2018-12-31;2019-02-25;24405000;25009000;151792000;50854000;62095000;270881000;47900000;;56849000;104749000;375630000;41362000;;59773000;;3005000;62778000;248007000;;67402000;312852000;375630000
NANO;721571;USD;2017;Q4;2017-12-31;2018-02-26;25402000;26005000;117029000;62457000;54394000;240114000;44810000;;24775000;69585000;309699000;29438000;;44095000;;3221000;47316000;255394000;;9113000;262383000;309699000
NANO;721571;USD;2016;Q4;2016-12-31;2017-03-03;24962000;25806000;129961000;39457000;41294000;216379000;44226000;;27225000;71451000;287830000;24811000;;42026000;;2030000;44056000;271994000;;-22174000;243774000;287830000
NANO;721571;USD;2015;Q4;2015-12-31;2016-02-24;24205000;24606000;83085000;37832000;50605000;178114000;44493000;;12933000;57426000;235540000;23543000;;45211000;;3001000;48212000;258739000;;-66209000;187328000;235540000
NANO;721571;USD;2014;Q4;2014-12-31;2015-02-25;24050000;23321000;83962000;26121000;37017000;157846000;49633000;;15757000;65390000;223236000;19916000;;38202000;;5497000;43699000;251420000;;-69114000;179537000;223236000
NANO;721571;USD;2013;Q4;2013-12-31;2014-03-07;23420000;23420000;92862000;31436000;41421000;190754000;47439000;;24641000;72080000;262834000;19215000;;48957000;;6504000;55461000;244757000;;-37996000;207373000;262834000
NANO;721571;USD;2012;Q4;2012-12-31;2013-03-12;23378000;23762000;109908000;21388000;41933000;189314000;43213000;;26927000;70140000;259454000;13492000;928000;30727000;4374000;12956000;43683000;238349000;;-23850000;215771000;259454000
NANO;721571;USD;2011;Q4;2011-12-31;2012-03-14;22820000;23555000;97699000;29289000;53897000;201410000;35521000;;30290000;65811000;267221000;17519000;765000;40781000;6687000;16448000;57229000;236758000;;-28315000;209992000;267221000
NANO;721571;USD;2010;Q4;2010-12-31;2011-08-10;22233000;23322000;66460000;44523000;44634000;168247000;35186000;;16463000;51649000;219896000;20549000;572000;32477000;9467000;16570000;49047000;225777000;;-57000000;170849000;219896000
SSNC;721918;USD;2017;Q4;2017-12-31;2018-02-28;206148000;213165000;64100000;243900000;;359500000;100900000;0;5079100000;5180000000;5539500000;201100000;37900000;443600000;2007300000;2409500000;2853100000;2020200000;-18000000;766900000;2686400000;5539500000
SSNC;721918;USD;2016;Q4;2016-12-31;2017-02-28;202941000;207359000;117558000;241307000;;415112000;80395000;;5211464000;5291859000;5706971000;199259000;126144000;560625000;2374986000;2887768000;3448393000;1923302000;-18000000;492349000;2258578000;5706971000
APU;723175;USD;2017;Q4;2017-09-30;2017-11-21;;;7316000;201441000;116679000;413774000;1206710000;;2438777000;3645487000;4059261000;119990000;148447000;581532000;2563832000;2694658000;3276190000;747899000;;;783071000;4059261000
APU;723175;USD;2016;Q4;2016-09-30;2016-11-22;;;15827000;185308000;78823000;344448000;1274557000;;2438765000;3713322000;4057770000;136872000;161675000;588455000;2325334000;2450106000;3038561000;984221000;;;1019209000;4057770000
APU;723175;USD;2015;Q4;2015-09-30;2015-11-25;;;14757000;201427000;93934000;366361000;1324327000;;2429464000;3753791000;4120152000;150726000;77779000;546294000;2252257000;2373485000;2919779000;1164216000;;;1200373000;4120152000
APU;723175;USD;2014;Q4;2014-09-30;2014-11-26;;;13480000;280920000;181946000;505908000;1386910000;;2471240000;3858150000;4364058000;203835000;120589000;617514000;2280145000;2385654000;3003168000;1319720000;;;1360890000;4364058000
APU;723175;USD;2013;Q4;2013-09-30;2013-11-29;;;12635000;292210000;158928000;504994000;1437514000;;2495163000;3932677000;4437671000;220789000;128914000;621276000;2288097000;2392258000;3013534000;1370117000;;;1424137000;4437671000
APU;723175;USD;2012;Q4;2012-09-30;2012-11-21;;;60102000;267647000;163746000;523368000;1499225000;;2494738000;3993963000;4517331000;222150000;80606000;670845000;2297363000;2377926000;3048771000;1472677000;;;1468560000;4517331000
APU;723175;USD;2011;Q4;2011-09-30;2011-11-21;;;8632000;234634000;135815000;393819000;645755000;;756161000;1401916000;1795735000;174074000;100164000;450993000;928858000;993263000;1444256000;343616000;;;351479000;1795735000
APU;723175;USD;2010;Q4;2010-09-30;2010-11-19;;;7726000;179747000;114122000;325858000;642778000;;727583000;1370361000;1696219000;153460000;111123000;460262000;771279000;843071000;1303333000;375971000;;;392886000;1696219000
APU;723175;USD;2009;Q4;2009-09-30;2010-08-06;;;59213000;141998000;87940000;316507000;628899000;;712158000;1341057000;1657564000;139496000;82225000;420605000;783419000;860634000;1281239000;371406000;;;376325000;1657564000
APU;723175;USD;2018;Q4;2018-09-30;2018-11-20;;;6878000;209824000;130527000;451891000;1148383000;;2325544000;3473927000;3925818000;183106000;240626000;678028000;2561007000;2678122000;3356150000;536607000;;;569668000;3925818000
CORT;724383;USD;2017;Q4;2017-12-31;2018-02-28;114389000;128209000;88744000;15300000;4576000;124185000;518000;15281000;80553000;96352000;220537000;29569000;;29569000;;0;29569000;384189000;;-193146000;190968000;220537000
CORT;724383;USD;2016;Q4;2016-12-31;2017-03-06;111917000;123147000;51536000;9860000;2329000;65689000;205000;0;2859000;3064000;68753000;12710000;14664000;27374000;;0;27374000;363647000;;-322268000;41379000;68753000
CORT;724383;USD;2015;Q4;2015-12-31;2016-03-10;109292000;109292000;40435000;6221000;1682000;48980000;98000;;2824000;2922000;51902000;5753000;14965000;20876000;12528000;12528000;33404000;348906000;;-330408000;18498000;51902000
CORT;724383;USD;2014;Q4;2014-12-31;2015-03-13;101277000;101277000;24248000;3334000;1207000;30230000;236000;;4164000;4400000;34630000;4098000;9424000;13555000;24463000;24463000;38018000;320612000;;-324000000;-3388000;34630000
CORT;724383;USD;2013;Q4;2013-12-31;2014-03-14;99834000;99834000;54877000;1428000;1096000;58311000;203000;;4563000;4766000;63077000;6970000;5743000;12738000;29322000;29322000;42060000;313634000;;-292617000;21017000;63077000
CORT;724383;USD;2012;Q4;2012-12-31;2013-03-15;99937000;99937000;93032000;557000;853000;95062000;150000;;3954000;4104000;99166000;5693000;2650000;8359000;29030000;29030000;37389000;308383000;;-246606000;61777000;99166000
CORT;724383;USD;2011;Q4;2011-12-31;2012-03-13;84236000;84236000;39635000;;;39775000;26000;;32000;58000;39833000;5026000;;5026000;;0;5026000;243365000;;-208558000;34807000;39833000
CORT;724383;USD;2010;Q4;2010-12-31;2011-08-09;;;24578000;;;24996000;4000;;104000;108000;25104000;3438000;;3860000;;0;3860000;197545000;;-176204000;21244000;25104000
CORT;724383;USD;2018;Q4;2018-12-31;2019-02-26;115200000;125345000;206760000;17588000;4732000;236820000;655000;0;74219000;74874000;311694000;35573000;;35573000;;239000;35812000;417345000;-23657000;-117736000;275882000;311694000
VGR;726203;USD;2017;Q4;2017-12-31;2018-03-01;146265585;146846657;301353000;29481000;89790000;613709000;109468000;188131000;416970000;714569000;1328278000;1052000;33820000;204639000;1194244000;1455399000;1660038000;13437000;;-414785000;-331760000;1328278000
VGR;726203;USD;2016;Q4;2016-12-31;2017-03-01;143695810;143981684;393530000;18801000;89834000;705463000;104088000;221258000;373226000;698572000;1404035000;937000;39508000;196148000;1132943000;1461159000;1657307000;12774000;;-333529000;-253272000;1404035000
VGR;726203;USD;2015;Q4;2015-12-31;2016-03-08;129240190;128708721;240368000;23889000;86516000;583739000;98950000;217168000;380758000;696876000;1280615000;1011000;8919000;216292000;856108000;1186484000;1402776000;12379000;;-210113000;-122161000;1280615000
VGR;726203;USD;2014;Q4;2014-12-31;2015-03-04;117885164;117739997;326365000;23328000;90323000;751397000;94755000;52723000;524379000;671857000;1423254000;2674000;52640000;212424000;860711000;1231510000;1443934000;11450000;-12857000;-97009000;-20680000;1423254000
VGR;726203;USD;2013;Q4;2013-12-31;2014-03-03;130129572;131161097;234466000;12159000;93496000;588311000;100169000;29383000;546398000;675950000;1264261000;7362000;151577000;405110000;540766000;880760000;1285870000;9748000;-12857000;-114787000;-21609000;1264261000
VGR;726203;USD;2012;Q4;2012-12-31;2013-02-28;128231667;128161769;405855000;11247000;100392000;639056000;57153000;36094000;354428000;447675000;1086731000;79751000;36778000;195159000;586946000;970824000;1165983000;8989000;-12857000;-65116000;-79252000;1086731000
VGR;726203;USD;2011;Q4;2011-12-31;2012-02-24;122666050;101505355;240923000;24869000;109228000;509741000;56556000;35454000;326017000;418027000;927768000;74755000;50844000;315198000;493356000;701600000;1016798000;7944000;-12857000;-80440000;-89030000;927768000
VGR;726203;USD;2010;Q4;2010-12-31;2011-02-25;121223256;70334400;299825000;1849000;107079000;526763000;55412000;86616000;280804000;422832000;949595000;75332000;51345000;226872000;506052000;768957000;995829000;7494000;-12857000;-45327000;-46234000;949595000
VGR;726203;USD;2009;Q4;2009-12-31;2010-08-05;;;209454000;8098000;98486000;389208000;42986000;63567000;239781000;346334000;735542000;75986000;21889000;149008000;334920000;591216000;740224000;23054000;-12857000;0;-4682000;735542000
VGR;726203;USD;2018;Q4;2018-12-31;2019-03-01;146468006;146223747;584581000;34246000;90997000;872221000;112956000;;564327000;677283000;1549504000;5252000;256134000;484920000;1386697000;1611950000;2096870000;14092000;;-542169000;-547366000;1549504000
KRO;726370;USD;2017;Q4;2017-12-31;2018-03-12;115900000;115900000;322000000;346500000;382300000;1062500000;506400000;10700000;244800000;761900000;1824400000;230800000;700000;231500000;473800000;838600000;1070100000;1400200000;;-267200000;754300000;1824400000
KRO;726370;USD;2016;Q4;2016-12-31;2017-03-10;115900000;115900000;50700000;241100000;343500000;650400000;434000000;6000000;89200000;529200000;1179600000;163800000;3600000;182100000;335400000;602500000;784600000;1400000000;;-552200000;395000000;1179600000
KRO;726370;USD;2015;Q4;2015-12-31;2016-03-10;115900000;115900000;92500000;218300000;387200000;710800000;429500000;2400000;100000000;531900000;1242700000;178400000;3800000;201700000;337200000;579100000;780800000;1399900000;;-526000000;461900000;1242700000
KRO;726370;USD;2014;Q4;2014-12-31;2015-03-12;115900000;115900000;167700000;260200000;423600000;879900000;479700000;11100000;262400000;753200000;1633100000;210400000;3900000;234200000;339700000;617800000;852000000;1399800000;;-282900000;781100000;1633100000
KRO;726370;USD;2013;Q4;2013-12-31;2014-03-12;115900000;115900000;53800000;268300000;416600000;781200000;536300000;30400000;271200000;837900000;1619100000;251200000;3100000;278000000;180400000;406000000;684000000;1399700000;;-312600000;935100000;1619100000
KRO;726370;USD;2012;Q4;2012-12-31;2013-03-12;115900000;115900000;282700000;285800000;638300000;1223400000;522500000;21600000;259500000;803600000;2027000000;254700000;21200000;328400000;378900000;636500000;964900000;1400300000;;-141100000;1062100000;2027000000
KRO;726370;USD;2011;Q4;2011-12-31;2012-03-06;115900000;115900000;103400000;270300000;444200000;865000000;485500000;98400000;375000000;958900000;1823900000;311000000;2200000;328000000;362900000;571600000;899600000;1400200000;;-290100000;924300000;1823900000
KRO;726370;USD;2010;Q4;2010-12-31;2011-08-03;;;304700000;231200000;275800000;824300000;473600000;49700000;360000000;883300000;1707600000;203600000;2200000;220100000;537400000;726300000;946400000;1400000000;;-486500000;761200000;1707600000
KRO;726370;USD;2018;Q4;2018-12-31;2019-03-11;115900000;115900000;373300000;312500000;497900000;1201400000;486400000;3400000;206900000;696700000;1898100000;231900000;1500000;233400000;455100000;824900000;1058300000;1400300000;;-136200000;839800000;1898100000
REED;727073;USD;2017;Q4;2017-12-31;2018-04-02;16074621;16074621;12127000;2691000;5931000;20948000;353000;;3175000;3528000;24476000;14647000;420000;18645000;5176000;5323000;23968000;50515000;;-50101000;508000;24476000
REED;727073;USD;2016;Q4;2016-12-31;2017-04-24;13962677;13967051;451000;2485000;6885000;10321000;7726000;;805000;8531000;18852000;7127000;373000;11884000;1801000;8625000;20509000;29972000;;-31723000;-1657000;18852000
REED;727073;USD;2015;Q4;2015-12-31;2016-03-23;13284934;13284934;1816000;2894000;7974000;13453000;5369000;;1029000;6398000;19851000;7967000;313000;12723000;1933000;6343000;19066000;27400000;;-26709000;785000;19851000
REED;727073;USD;2014;Q4;2014-12-31;2015-03-26;13028446;12818453;959000;2500000;6306000;11499000;4572000;;1029000;5601000;17100000;6024000;259000;9292000;2656000;4156000;13448000;26301000;;-22743000;3652000;17100000
REED;727073;USD;2013;Q4;2013-12-31;2014-03-25;12671933;11803083;1104000;2143000;6293000;9974000;3686000;;1089000;4775000;14749000;3913000;190000;8627000;2253000;2735000;11362000;25277000;;-21984000;3387000;14749000
REED;727073;USD;2012;Q4;2012-12-31;2013-03-25;11520832;;1163000;1961000;5794000;9331000;3422000;;1083000;4505000;13836000;3851000;159000;7033000;2306000;2705000;9738000;23997000;;-20459000;4098000;13836000
REED;727073;USD;2011;Q4;2011-12-31;2012-03-26;10869606;;713000;1626000;6099000;8729000;3512000;;1114000;4626000;13355000;2852000;127000;6074000;2400000;2976000;9050000;22925000;;-19890000;4305000;13355000
REED;727073;USD;2010;Q4;2010-12-31;2011-08-11;10392682;;1084000;1295000;4555000;7150000;3650000;;1076000;4726000;11876000;3188000;94000;5320000;2414000;2414000;7734000;21702000;;-18884000;4142000;11876000
REED;727073;USD;2018;Q4;2018-12-31;2019-04-01;25710661;25710661;624000;2608000;7380000;10938000;896000;;658000;1554000;12492000;7204000;51000;14235000;4962000;5000000;19235000;53594000;;-60431000;-6743000;12492000
JSDA;727078;USD;2017;Q4;2017-12-31;2018-03-29;41455235;41455235;397000;1247000;1557000;3342000;39000;;8000;47000;3389000;1576000;;2434000;;12000;2446000;62683000;;-62131000;943000;3389000
JSDA;727078;USD;2016;Q4;2016-12-31;2017-03-23;41340941;40607564;733000;2174000;1850000;4899000;25000;;8000;33000;4932000;1910000;;3115000;;12000;3127000;62446000;;-60860000;1805000;4932000
JSDA;727078;USD;2015;Q4;2015-12-31;2016-03-24;41321287;41321287;772000;1840000;2569000;5297000;37000;;20000;57000;5354000;2666000;;3576000;;11000;3587000;62231000;;-60677000;1767000;5354000
JSDA;727078;USD;2014;Q4;2014-12-31;2015-03-25;40997866;40997866;857000;1237000;2603000;4818000;25000;;31000;56000;4874000;2212000;14000;2226000;2000;26000;2252000;61884000;;-59557000;2622000;4874000
JSDA;727078;USD;2013;Q4;2013-12-31;2014-03-31;38690304;38690304;1464000;1034000;2315000;5223000;232000;;59000;291000;5514000;1800000;13000;1813000;16000;441000;2254000;60922000;;-58017000;3260000;5514000
JSDA;727078;USD;2012;Q4;2012-12-31;2013-03-27;38569083;38569083;1654000;1742000;2223000;5883000;497000;;640000;1137000;7020000;1697000;24000;1721000;58000;515000;2236000;60457000;;-56124000;4784000;7020000
JSDA;727078;USD;2011;Q4;2011-12-31;2012-03-30;;;1709000;1966000;2386000;6265000;844000;;548000;1392000;7657000;2665000;23000;2688000;82000;564000;3252000;57206000;;-53221000;4405000;7657000
JSDA;727078;USD;2010;Q4;2010-12-31;2011-08-12;;;5448000;2220000;2279000;10732000;296000;;435000;731000;11463000;2591000;0;2591000;0;2000;2593000;54487000;;-46067000;8870000;11463000
JSDA;727078;USD;2018;Q4;2018-12-31;2019-03-22;41464373;41464373;991000;1362000;1349000;3947000;88000;;33000;121000;4068000;1672000;;2100000;2528000;2671000;4771000;63211000;;-64210000;-703000;4068000
SSYS;727537;USD;2011;Q4;2011-07-31;2012-03-12;21209590;21632855;34694608;26230289;22771460;93223408;39669433;32581472;56296052;128546957;221770365;19368197;;29136807;;9322195;38459002;118403339;-39004425;104011848;183311363;221770365
SSYS;727537;USD;2010;Q4;2010-07-31;2011-08-09;20760081;21411455;36352289;20051451;17880714;84212759;29872945;53689900;10684027;94246872;178459631;14408628;;24017149;;2160000;26177149;108047085;-39004425;83385484;152282482;178459631
CUB;727716;USD;2018;Q4;2018-09-30;2018-11-15;27254000;27600000;112208000;392367000;84199000;668147000;117546000;;519190000;636736000;1304883000;252398000;;328339000;208849000;252348000;580687000;45008000;-36078000;801834000;724196000;1304883000
CUB;727716;USD;2017;Q4;2017-09-30;2017-11-20;27125000;27069000;60143000;354040000;87715000;621543000;113220000;;601522000;714742000;1336285000;228485000;55000000;376479000;199761000;270175000;646654000;37850000;-36078000;794485000;689631000;1336285000
CUB;727716;USD;2016;Q4;2016-09-30;2016-11-22;26990000;27143000;210123000;382581000;66362000;782651000;96316000;;625441000;721757000;1504408000;230312000;240450000;520243000;200291000;294269000;814512000;32756000;-36078000;813035000;689896000;1504408000
CUB;727716;USD;2015;Q4;2015-09-30;2015-11-23;26883000;27045000;249009000;358925000;63700000;775302000;74690000;;450284000;524974000;1300276000;195764000;60525000;346776000;126180000;197212000;543988000;25560000;-36078000;818642000;756288000;1300276000
CUB;727716;USD;2014;Q4;2014-09-30;2014-11-26;26789000;26675000;217045000;394179000;38775000;765387000;64149000;;365070000;429219000;1194606000;177448000;563000;270175000;101827000;141930000;412105000;20669000;-36078000;803059000;782501000;1194606000
CUB;727716;USD;2013;Q4;2013-09-30;2013-12-05;106863792;106959766;207947000;379002000;59746000;742599000;56305000;;310714000;367019000;1109618000;162294000;557000;247158000;102363000;145380000;392538000;15825000;-36078000;740002000;717080000;1109618000
CUB;727716;USD;2012;Q4;2012-09-30;2012-12-14;106863792;106863792;212267000;348971000;42095000;701111000;55327000;;258112000;313439000;1014550000;182587000;4561000;263099000;6942000;74329000;337428000;12574000;-36078000;721333000;677122000;1014550000
CUB;727716;USD;2011;Q4;2011-09-30;2011-11-22;26736000;26736000;354977000;227290000;38359000;676106000;48467000;;241951000;290418000;966524000;169219000;4541000;308076000;11377000;79138000;387214000;12574000;-36078000;629560000;579310000;966524000
CUB;727716;USD;2010;Q4;2010-09-30;2011-08-05;26736000;26736000;379515000;212829000;40653000;680224000;47469000;;143826000;191295000;871519000;176389000;4545000;279449000;15949000;79021000;358470000;12574000;-36074000;553452000;513049000;871519000
CUB;727716;USD;2009;Q4;2009-09-30;2011-08-05;;;252201000;230984000;57605000;591187000;48895000;;123491000;172386000;763573000;153419000;4554000;241951000;20570000;73235000;315186000;12530000;-36071000;486170000;448387000;763573000
HSII;727845;USD;2017;Q4;2017-12-31;2018-03-13;18782000;17956000;207534000;98700000;;343790000;39514000;21319000;182581000;243414000;587204000;194174000;;265792000;0;108707000;374499000;226202000;-26096000;-716000;212705000;587204000
HSII;727845;USD;2016;Q4;2016-12-31;2017-03-23;18578000;19506000;165011000;93191000;;298430000;35099000;17346000;230627000;283072000;581502000;168092000;;220592000;;102320000;322912000;230153000;-32915000;58030000;258590000;581502000
HSII;727845;USD;2015;Q4;2015-12-31;2016-03-10;18400000;19049000;190452000;76058000;;308963000;36498000;14145000;213112000;263755000;572718000;168467000;;229430000;;88486000;317916000;232554000;-39583000;52572000;254802000;572718000
HSII;727845;USD;2014;Q4;2014-12-31;2015-03-11;18240000;18726000;211352000;68353000;;318235000;30417000;13709000;206260000;250386000;568621000;142611000;6000000;205848000;23500000;118109000;323957000;232271000;-44261000;45431000;244664000;568621000
HSII;727845;USD;2013;Q4;2013-12-31;2014-03-13;18118000;18471000;181646000;71666000;;290774000;34961000;13848000;213641000;262450000;553224000;123135000;6000000;175787000;29500000;129564000;305351000;232204000;-47811000;48511000;247873000;553224000
HSII;727845;USD;2012;Q4;2012-12-31;2013-03-15;17977000;18072000;117605000;69107000;;226282000;42362000;11902000;214446000;268710000;494992000;111963000;;152396000;;94249000;246645000;234206000;-52523000;51704000;248347000;494992000
HSII;727845;USD;2011;Q4;2011-12-31;2012-03-15;53457357;53457205;185390000;69081000;;310325000;44781000;9868000;150591000;205240000;515565000;145722000;;185090000;;79180000;264270000;238719000;-58690000;55029000;251295000;515565000
HSII;727845;USD;2010;Q4;2010-12-31;2011-08-01;17548000;17890000;181124000;83360000;;312466000;34406000;11021000;187134000;232561000;545027000;136585000;;172456000;;78029000;250485000;246797000;-69549000;99056000;294542000;545027000
HSII;727845;USD;2018;Q4;2018-12-31;2019-02-26;18954000;20078000;279906000;114977000;;450867000;33871000;19442000;196449000;249762000;700629000;245059000;;318951000;;114522000;433473000;227343000;-20298000;56049000;267156000;700629000
INTL;728087;USD;2017;Q4;2017-09-30;2017-12-14;18484415;18900875;314900000;243300000;124800000;4233900000;38700000;86600000;1884200000;2009500000;6243400000;3215800000;;5793500000;;0;5793500000;259200000;-46300000;261500000;449900000;6243400000
INTL;728087;USD;2016;Q4;2016-09-30;2016-12-14;18262697;18431684;316200000;213400000;123800000;4161800000;29400000;0;1759100000;1788500000;5950300000;3022600000;44500000;5516500000;;0;5516500000;249600000;-46300000;255100000;433800000;5950300000
INTL;728087;USD;2015;Q4;2015-09-30;2015-05-07;18288223;18924384;268100000;295700000;32800000;3500500000;19700000;;1549800000;1569500000;5070000000;2747300000;45500000;4672900000;;0;4672900000;241000000;-26800000;200400000;397100000;5070000000
INTL;728087;USD;2014;Q4;2014-09-30;2014-12-10;18402724;19281812;231300000;120800000;40000000;2705300000;15900000;;318500000;334400000;3039700000;2350400000;45500000;2694300000;;0;2694300000;229800000;-17500000;144700000;345400000;3039700000
INTL;728087;USD;2013;Q4;2013-09-30;2014-01-15;18644979;19796681;156100000;130700000;59000000;2555600000;17500000;;274900000;292400000;2848000000;2209200000;45500000;2512600000;;0;2512600000;224200000;-7800000;125400000;335400000;2848000000
INTL;728087;USD;2012;Q4;2012-09-30;2012-12-12;18271476;20178080;236300000;172900000;131600000;2650400000;18900000;;283700000;302600000;2953000000;2204800000;0;2639800000;;0;2639800000;213400000;-4100000;106100000;313200000;2953000000
INTL;728087;USD;2011;Q4;2011-09-30;2011-12-14;17316741;17340407;220600000;142200000;160600000;2287300000;15000000;;333400000;348400000;2635700000;1866400000;;2338100000;;0;2338100000;205400000;100000;97000000;297800000;2635900000
INTL;728087;USD;2010;Q4;2010-09-30;2011-08-09;17344902;18006935;81900000;107200000;125000000;1758100000;7300000;;256300000;263600000;2021700000;1453200000;;1761600000;17200000;17200000;1778800000;184800000;-100000;59700000;242900000;2021700000
INTL;728087;USD;2018;Q4;2018-09-30;2018-12-12;18619958;19484017;342300000;291800000;222500000;5370900000;42400000;225500000;2185900000;2453800000;7824700000;3793600000;;7319400000;;0;7319400000;267700000;-46300000;317000000;505300000;7824700000
NOVT;728364;USD;2018;Q4;2018-12-31;2019-02-27;34917000;35505000;82043000;83955000;104764000;281769000;65464000;;372343000;437807000;719576000;99661000;4535000;104196000;202843000;247125000;351321000;469874000;;-79092000;368255000;719576000
NOVT;728364;USD;2017;Q4;2017-12-31;2018-02-28;34843000;35699000;100057000;81482000;91278000;287879000;61718000;;377106000;438824000;726703000;89049000;9119000;98168000;225500000;270067000;368235000;457165000;;-127740000;358468000;726703000
NOVT;728364;USD;2016;Q4;2016-12-31;2017-03-06;34708000;34988000;68108000;63769000;59745000;199250000;35421000;;190966000;226387000;425637000;63130000;7366000;70496000;70554000;96271000;166767000;454132000;;-167547000;258870000;425637000
NOVT;728364;USD;2015;Q4;2015-12-31;2016-03-02;34581000;34225000;59959000;57188000;59566000;185212000;40550000;;190283000;230833000;416045000;49568000;7385000;56953000;88426000;114391000;171344000;453081000;;-189550000;244701000;416045000
NOVT;728364;USD;2014;Q4;2014-12-31;2015-03-09;34414000;33239000;51146000;51494000;62943000;183172000;40088000;;173034000;213122000;396294000;46182000;7345000;54059000;105030000;130981000;185040000;452446000;;-225165000;211254000;396294000
NOVT;728364;USD;2013;Q4;2013-12-31;2014-03-13;34119000;34611000;60980000;48552000;58290000;201629000;31303000;;145875000;177178000;378807000;47667000;7500000;61487000;64000000;74917000;136404000;449239000;;-200913000;242403000;378807000
NOVT;728364;USD;2012;Q4;2012-12-31;2013-03-18;33836000;34001000;65788000;42652000;52801000;208468000;32338000;;96654000;128992000;337460000;41419000;7500000;54926000;42500000;54328000;109254000;445780000;;-208222000;228206000;337460000
NOVT;728364;USD;2011;Q4;2011-12-31;2012-03-14;33508000;33641000;54835000;38847000;51539000;214311000;35955000;;98237000;134192000;348503000;33294000;10000000;59061000;58000000;80082000;139143000;441787000;;-227760000;209360000;348503000
NOVT;728364;USD;2010;Q4;2010-12-31;2011-08-11;33393000;33336000;56781000;55110000;66721000;218127000;45402000;;103638000;149040000;367167000;44256000;;59262000;107575000;129227000;188489000;438511000;;-256733000;178678000;367167000
OFLX;728561;USD;2017;Q4;2017-12-31;2018-03-05;10092000;10092000;37938000;15636000;8007000;63476000;6998000;;6617000;13615000;77091000;14521000;;18104000;;2918000;21022000;10910000;-1000;45457000;56069000;77091000
OFLX;728561;USD;2016;Q4;2016-12-31;2017-03-13;10092000;10092000;35318000;15005000;7372000;59676000;4402000;;6484000;10886000;70562000;19395000;;22735000;;1766000;24501000;10910000;-1000;36455000;46061000;70562000
OFLX;728561;USD;2015;Q4;2015-12-31;2016-03-04;30255816;30255816;30152000;16605000;8287000;56691000;4638000;;4945000;9583000;66274000;20502000;;23552000;;1568000;25120000;10910000;-1000;30656000;41154000;66274000
OFLX;728561;USD;2014;Q4;2014-12-31;2015-03-13;10092;10092;22585000;13723000;7364000;45140000;4483000;;5515000;9998000;55138000;15446000;;19018000;;2151000;21169000;10910000;-1000;23446000;33969000;55138000
OFLX;728561;USD;2013;Q4;2013-12-31;2014-03-14;;;8257000;12968000;6728000;29312000;4762000;;6000000;10762000;40074000;8975000;;12550000;;1893000;14443000;10910000;-1000;14929000;25631000;40074000
OFLX;728561;USD;2012;Q4;2012-12-31;2013-03-27;-10071816;-10071816;939000;12134000;7128000;21704000;4824000;;6141000;10965000;32669000;6992000;;11530000;;1397000;12927000;10910000;-1000;9181000;19742000;32669000
OFLX;728561;USD;2011;Q4;2011-12-31;2012-03-16;-10071816;-10071816;3476000;9052000;6465000;20233000;5270000;;5988000;11258000;31491000;4587000;;6730000;;1844000;8574000;10910000;-1000;12397000;22917000;31491000
OFLX;728561;USD;2010;Q4;2010-12-31;2011-09-02;10092000;10092000;2209000;7314000;6016000;16183000;5784000;;5091000;10875000;27058000;4914000;;6683000;;2109000;8792000;10910000;-1000;7750000;18266000;27058000
OFLX;728561;USD;2018;Q4;2018-12-31;2019-03-11;10092000;10092000;47336000;16451000;7976000;73622000;8378000;;4836000;13214000;86836000;14814000;;18405000;;2110000;20515000;10910000;-1000;56110000;66321000;86836000
TTOO;728864;USD;2017;Q4;2017-12-31;2018-03-19;35912942;35912942;41799000;467000;1344000;44318000;10015000;;528000;10543000;54861000;6866000;40696000;49544000;1008000;3977000;53521000;267457000;;-266117000;1340000;54861000
TTOO;728864;USD;2016;Q4;2016-12-31;2017-03-15;30495176;30495176;73488000;327000;803000;75438000;13589000;;541000;14130000;89568000;5870000;1269000;9885000;39504000;40345000;50230000;243027000;;-203689000;39338000;89568000
TTOO;728864;USD;2015;Q4;2015-12-31;2016-03-09;21334612;21334612;73662000;369000;683000;75552000;10655000;;618000;11273000;86825000;5390000;4449000;12253000;26121000;27633000;39886000;195824000;;-148885000;46939000;86825000
TTOO;728864;USD;2014;Q4;2014-12-31;2015-03-04;19457302;19457302;73849000;201000;115000;75321000;2760000;;1053000;3813000;79134000;4397000;295000;4859000;20660000;21274000;26133000;156596000;;-103595000;53001000;79134000
TTOO;728864;USD;2013;Q4;2013-12-31;2014-09-19;1405918;1405918;30198000;;;30393000;1118000;;374000;1492000;31885000;2262000;1759000;4046000;3299000;117382000;121428000;1000;;-89544000;-89543000;31885000
TTOO;728864;USD;2018;Q4;2018-12-31;2019-03-14;44230961;44230961;50805000;1786000;2677000;56608000;7315000;;386000;7701000;64309000;6817000;42373000;50155000;;2767000;52922000;328558000;;-317171000;11387000;64309000
PLPC;728955;USD;2017;Q4;2017-12-31;2018-03-09;5070000;5155000;44358000;73972000;77886000;207130000;108598000;;44057000;152655000;359785000;54237000;2312000;62833000;34598000;70249000;133082000;30493000;-68115000;311765000;226703000;359785000
PLPC;728955;USD;2016;Q4;2016-12-31;2017-03-10;5121000;5106000;30737000;63415000;74484000;189107000;105104000;;46726000;151830000;340937000;46441000;2763000;55455000;42943000;73993000;129448000;25083000;-59640000;303415000;211489000;340937000
PLPC;728955;USD;2015;Q4;2015-12-31;2016-03-11;5256000;5303000;30393000;63626000;69912000;179889000;91965000;;51516000;143481000;323370000;45497000;523000;51668000;31754000;64770000;116438000;23342000;-54570000;292311000;206932000;323370000
PLPC;728955;USD;2014;Q4;2014-12-31;2015-03-12;5355000;5328000;29643000;67942000;80037000;200663000;102531000;;50773000;153304000;353967000;48251000;1925000;55327000;31749000;67505000;122832000;23438000;-47018000;289849000;231135000;353967000
PLPC;728955;USD;2013;Q4;2013-12-31;2014-03-14;5338000;5512000;24291000;67587000;73835000;185734000;100461000;;46211000;146672000;332406000;45829000;1300000;52215000;13054000;37167000;89382000;22558000;;238168000;243024000;332406000
PLPC;728955;USD;2012;Q4;2012-12-31;2013-03-15;21280015;21467690;28120000;61695000;86916000;194101000;93326000;;45637000;138963000;333064000;52388000;468000;58243000;9322000;40274000;98517000;20589000;;227622000;234547000;333064000
PLPC;728955;USD;2011;Q4;2011-12-31;2012-03-14;5248000;5258000;32126000;68949000;88613000;205490000;82860000;;38998000;121858000;327348000;54516000;2631000;61833000;27991000;56469000;118302000;19573000;;206512000;209046000;327348000
PLPC;728955;USD;2010;Q4;2010-12-31;2011-08-09;-15723032;-16166660;22655000;56102000;73121000;167342000;76266000;;37371000;113637000;280979000;49572000;2522000;56558000;9374000;28956000;85514000;18090000;;184060000;195465000;280979000
PLPC;728955;USD;2018;Q4;2018-12-31;2019-03-08;5013000;5162000;43609000;73139000;85259000;214263000;102955000;;41579000;144534000;358797000;52015000;10490000;69487000;24960000;50948000;120435000;36055000;-72280000;334170000;238362000;358797000
LMB;733746;USD;2017;Q4;2017-12-31;2018-04-02;7504842;7163922;626000;129343000;;166260000;17918000;;28842000;46760000;213020000;100583000;6358000;135484000;20556000;21417000;156901000;54739000;;-6579000;56119000;213020000
LMB;733746;USD;2018;Q4;2018-12-31;2019-04-15;7591874;7326609;1619000;135687000;;204986000;20527000;;28121000;48648000;253634000;128154000;3141000;182138000;23614000;25128000;207266000;54792000;;-8424000;46368000;253634000
BGNE;734219;USD;2017;Q4;2017-12-31;2018-02-28;591093741;538027717;837516000;29428000;10930000;913497000;75033000;;57949000;132982000;1046479000;128533000;9222000;149988000;9222000;212260000;362248000;1000806000;;-330517000;684231000;1046479000
BGNE;734219;USD;2016;Q4;2016-12-31;2017-03-22;464550992;464550992;368174000;;;374399000;25977000;;5437000;31414000;405813000;35058000;;35058000;17284000;17848000;52906000;591265000;;-237412000;352907000;405813000
BGNE;734219;USD;2015;Q4;2015-12-31;2016-05-12;116242049;116242049;100486000;;;106269000;6612000;;3883000;10495000;116764000;17331000;;35172000;6188000;7273000;42445000;18239000;;-118195000;74319000;116764000
BGNE;734219;USD;2018;Q4;2018-12-31;2019-02-28;774208511;774208511;1781446000;41056000;16242000;1943842000;202119000;;103723000;305842000;2249684000;219585000;8727000;246452000;40785000;249585000;496037000;2744891000;;-1007215000;1753647000;2249684000
QTNA;734346;USD;2017;Q4;2017-12-31;2018-02-28;26929000;43829000;118627000;26786000;12662000;160819000;12511000;;39374000;51885000;212704000;24819000;3943000;28762000;;3339000;32101000;308026000;;-127216000;180603000;212704000
QTNA;734346;USD;2016;Q4;2016-12-31;2017-05-09;-6560121;-6560121;117045000;14480000;15820000;149815000;4742000;;232000;4974000;154789000;19577000;2257000;21834000;3680000;4207000;26041000;290322000;;-161574000;128748000;154789000
QTNA;734346;USD;2018;Q4;2018-12-31;2019-03-01;31725000;43401000;136149000;28326000;20218000;190018000;13691000;;41947000;55638000;245656000;35798000;;35798000;;3371000;39169000;331555000;;-124133000;206487000;245656000
XSPY;734429;USD;2014;Q4;2014-12-31;2015-03-05;13371000;13371000;351000;7171000;7697000;16015000;509000;;81000;590000;16605000;5126000;89000;11990000;21590000;21590000;33580000;46044000;;-63469000;-16975000;16605000
XSPY;734429;USD;2013;Q4;2013-12-31;2014-03-20;13205000;13205000;686000;6543000;5872000;13784000;438000;;135000;573000;14357000;4371000;93000;8488000;21560000;21560000;30048000;45332000;;-61543000;-15691000;14357000
XSPY;734429;USD;2012;Q4;2012-12-31;2013-03-20;13049000;13049000;818000;5611000;6274000;13489000;446000;;212000;658000;14147000;4063000;64000;8718000;19212000;19212000;27930000;44404000;;-58681000;-13783000;14147000
XSPY;734429;USD;2011;Q4;2011-12-31;2012-03-20;12751000;12751000;727000;4859000;6190000;12196000;730000;;115000;845000;13041000;4270000;565000;7319000;13197000;13197000;20516000;43493000;;-51439000;-7475000;13041000
XSPY;734429;USD;2010;Q4;2010-12-31;2011-09-02;11980000;11980000;263000;4173000;8902000;13970000;957000;;172000;1129000;15099000;4700000;40000;6975000;7099000;7099000;14074000;40973000;;-40499000;1025000;15099000
GWGH;734810;USD;2017;Q4;2017-12-31;2018-03-29;5815662;5815662;114421491;;;159429937;;650527353;8898884;659426237;818856174;25552671;;237790863;447393568;447393568;685184431;5813;;-39449517;133671743;818856174
GWGH;734810;USD;2016;Q4;2016-12-31;2017-03-15;5980886;3930635;78486982;;;127361725;;511192354;4688103;515880457;643242182;20064072;;176128890;397717423;399814794;575943684;7389495;;-18817294;67298498;643242182
GWGH;734810;USD;2015;Q4;2015-12-31;2016-03-22;5942913;3872461;34425105;;;36767005;;356649715;2461045;359110760;395877765;14918287;;78197883;299770500;301534468;379732351;14569776;;-19209203;16145414;395877765
GWGH;734810;USD;2014;Q4;2014-12-31;2015-03-13;5881531;5881531;30662704;;;38278157;;282883010;1909362;284792372;323070529;12846528;;85007576;210399462;215673017;300680593;16263556;;-14401486;22389936;323070529
GWGH;734810;USD;2013;Q4;2013-12-31;2014-03-20;-501198;-5954303;33449793;;;39640664;;234672794;1067018;235739812;275380476;8553360;;87553360;160921264;168596438;256149798;2946562;;-8438577;19230678;275380476
GWGH;734810;USD;2012;Q4;2012-12-31;2013-04-01;9989000;9989000;27497044;;;32545789;;164317183;1085063;165402246;197948035;5238878;;76238878;93563661;99065068;175303946;6981833;;-8243622;22644089;197948035
GWGH;734810;USD;2011;Q4;2011-12-31;2012-06-13;10004286;10004286;1878349;;;7004853;;122168524;215898;122384422;129389275;3291942;;63291942;48179271;52487488;115779430;8179292;;-7230723;13609845;129389275
ALGT;735180;USD;2017;Q4;2017-12-31;2018-03-01;15860000;15893000;412130000;71057000;;541275000;1512415000;78570000;47897000;1638882000;2180157000;125235000;214761000;544295000;950131000;1082551000;1626846000;253863000;-605655000;907943000;553311000;2180157000
ALGT;735180;USD;2016;Q4;2016-12-31;2017-02-24;16373000;16409000;333980000;40667000;;422054000;1095314000;124834000;29374000;1249522000;1671576000;112671000;86226000;392898000;722048000;805056000;1197954000;238258000;-517803000;753397000;473622000;1671576000
ALGT;735180;USD;2015;Q4;2015-12-31;2016-02-22;16710000;16750000;332695000;21815000;;401912000;885942000;64752000;5725000;956419000;1358331000;122932000;74069000;395137000;567609000;613189000;1008326000;228967000;-453415000;573619000;350005000;1358331000
ALGT;735180;USD;2014;Q4;2014-12-31;2015-02-26;17368000;17311000;359427000;14216000;;427356000;738783000;57390000;11551000;807724000;1235080000;124034000;52605000;361954000;536189000;579061000;941015000;221279000;-325396000;395783000;294065000;1235080000
ALGT;735180;USD;2013;Q4;2013-12-31;2014-02-28;19113000;19158000;351089000;16857000;;425715000;451584000;36037000;16855000;504476000;930191000;103026000;20237000;290651000;214063000;262223000;552874000;209235000;-186291000;352811000;377317000;930191000
ALGT;735180;USD;2012;Q4;2012-12-31;2013-02-26;19158000;19296000;328696000;18635000;;414471000;351204000;24030000;8489000;383723000;798194000;51009000;11623000;210546000;139229000;185924000;396470000;201034000;-102829000;302325000;401724000;798194000
ALGT;735180;USD;2011;Q4;2011-12-31;2012-02-27;18960000;19151000;305519000;12866000;;376348000;307842000;14007000;8546000;330395000;706743000;50852000;7885000;177505000;138184000;177734000;355239000;187035000;-97835000;262330000;351504000;706743000
ALGT;735180;USD;2010;Q4;2010-12-31;2011-08-09;18717000;18935000;148988000;7852000;;216598000;267298000;1305000;16065000;284668000;501266000;48438000;16532000;166613000;11604000;36918000;203531000;180725000;-95913000;212932000;297735000;501266000
PLCE;737152;USD;2017;Q4;2018-01-31;2018-03-22;17342000;17936000;259519000;26094000;324435000;656504000;258537000;;25187000;283724000;940228000;339064000;21460000;360524000;;106005000;466529000;260227000;0;226303000;473699000;940228000
PLCE;737152;USD;2016;Q4;2017-01-31;2017-03-23;17983000;18753000;243009000;31413000;286343000;611163000;264280000;;35056000;299336000;910499000;313817000;15380000;329197000;;85015000;414212000;241716000;0;274912000;496287000;910499000
PLCE;737152;USD;2015;Q4;2016-01-31;2016-03-24;19867000;20349000;227634000;26315000;268831000;581308000;290980000;;25660000;316640000;897948000;275022000;0;275022000;;95133000;370155000;234130000;0;321148000;527793000;897948000
PLCE;737152;USD;2014;Q4;2015-01-31;2015-03-26;21196000;21684000;225291000;31928000;297631000;609279000;310301000;;39038000;349339000;958618000;274467000;;274467000;;95033000;369500000;232537000;0;374074000;589118000;958618000
PLCE;737152;USD;2013;Q4;2014-01-31;2014-03-20;22254000;22909000;236497000;25960000;322422000;629320000;312149000;;49161000;361310000;990630000;271349000;;271349000;;102503000;373852000;228744000;0;389563000;616778000;990630000
PLCE;737152;USD;2012;Q4;2013-01-31;2012-05-31;23498000;28673000;209128000;18490000;266976000;545235000;330101000;;48074000;378175000;923410000;191506000;;191506000;;110955000;302461000;218009000;0;389682000;620949000;923410000
PLCE;737152;USD;2011;Q4;2012-01-31;2012-03-23;24857000;29439000;176655000;17382000;237786000;488928000;323863000;;53461000;377324000;866252000;131555000;;131555000;;109728000;241283000;212630000;0;399459000;624969000;866252000
PLCE;737152;USD;2010;Q4;2011-01-31;2011-03-28;26091000;26821000;183657000;16121000;210523000;477701000;320601000;;56029000;376630000;854331000;130396000;;130396000;;116208000;246604000;212573000;0;381997000;607727000;854331000
PLCE;737152;USD;2009;Q4;2010-01-31;2010-09-03;27437000;27714000;168380000;16910000;206227000;456882000;312801000;;84377000;397178000;854060000;145516000;;145516000;;119574000;265090000;207393000;;374016000;588970000;854060000
PLCE;737152;USD;2018;Q4;2019-01-31;2019-03-21;16136000;16275000;69136000;35123000;303466000;435395000;260357000;;31294000;291651000;727046000;282538000;48861000;331399000;;81210000;412609000;148579000;0;180792000;314437000;727046000
MTRN;739542;USD;2017;Q4;2017-12-31;2018-02-15;20087000;20527000;41844000;124014000;220352000;410943000;255578000;;124563000;380141000;791084000;78187000;777000;127109000;18899000;168994000;296103000;227930000;-166128000;536116000;494981000;791084000
MTRN;739542;USD;2016;Q4;2016-12-31;2017-02-17;19942000;20218000;31464000;100817000;200865000;345284000;252631000;;143383000;396014000;741298000;57259000;733000;90377000;3605000;156832000;247209000;216766000;-154399000;517903000;494089000;741298000
MTRN;739542;USD;2015;Q4;2015-12-31;2016-02-25;20004000;20237000;24236000;97236000;211820000;346091000;263629000;;132573000;396202000;742293000;54991000;8990000;96475000;4276000;162861000;259336000;212562000;-148559000;499659000;482957000;742293000
MTRN;739542;USD;2014;Q4;2014-12-31;2015-02-27;20108000;20575000;13150000;112780000;232409000;386694000;247588000;;128056000;375644000;762338000;61780000;653000;104066000;23613000;199253000;303319000;207561000;-140938000;474633000;459019000;762338000
MTRN;739542;USD;2013;Q4;2013-12-31;2014-03-14;20633000;21148000;22774000;113012000;232800000;395264000;261893000;;120788000;382681000;777945000;63242000;35566000;129016000;29267000;185608000;314624000;199842000;-118151000;441518000;463321000;777945000
MTRN;739542;USD;2012;Q4;2012-12-31;2013-03-08;20440000;20646000;16056000;126482000;206125000;400989000;272542000;;141386000;413928000;814917000;69269000;49432000;149067000;44880000;250855000;399922000;193328000;-118298000;428394000;414995000;814917000
MTRN;739542;USD;2011;Q4;2011-12-31;2012-02-29;20306000;20639000;12255000;117761000;187176000;370901000;263398000;;137804000;401202000;772103000;65278000;40944000;139671000;40463000;226450000;366121000;188096000;-118279000;408380000;405982000;772103000
MTRN;739542;USD;2010;Q4;2010-12-31;2011-08-09;20276000;20740000;16104000;139374000;154467000;355725000;265868000;;113817000;379685000;735410000;62207000;47835000;147360000;38305000;203694000;351054000;182661000;-115090000;368401000;384356000;735410000
MTRN;739542;USD;2018;Q4;2018-12-31;2019-02-14;20251000;20637000;70645000;130538000;214871000;439353000;251018000;;109970000;360988000;800341000;85538000;823000;139780000;17287000;106655000;246435000;239192000;-175426000;548374000;553906000;800341000
ULBI;739637;USD;2017;Q4;2017-12-31;2018-02-08;15626000;15955000;18241000;14657000;26326000;61916000;7570000;;27700000;35270000;97186000;11368000;;14239000;;3898000;18137000;182177000;-18469000;-82894000;79049000;97186000
ULBI;739637;USD;2016;Q4;2016-12-31;2017-02-09;15256000;15237000;10629000;13179000;23456000;49420000;7999000;;27325000;35324000;84744000;8722000;;11328000;;5556000;16884000;180095000;-18443000;-90542000;67860000;84744000
ULBI;739637;USD;2015;Q4;2015-12-31;2016-03-02;15192000;16141000;14393000;11430000;23814000;51854000;9038000;;20630000;29668000;81522000;9098000;;10847000;;4659000;15506000;178925000;-17808000;-94051000;66016000;81522000
ULBI;739637;USD;2014;Q4;2014-12-31;2015-03-11;17364000;;17711000;11295000;26086000;56744000;9812000;;21086000;30898000;87642000;8790000;;11211000;;4518000;15729000;177834000;-8420000;-96920000;71913000;87642000
ULBI;739637;USD;2013;Q4;2013-12-31;2014-03-14;17477000;17391000;16066000;14238000;26053000;58567000;10202000;;21425000;31627000;90194000;9055000;;12024000;;4525000;16549000;176820000;-7658000;-94804000;73645000;90194000
ULBI;739637;USD;2012;Q4;2012-12-31;2013-03-15;17440000;17440000;9656000;20913000;30370000;63702000;12415000;;21601000;34016000;97718000;14011000;0;19892000;0;4370000;24262000;175677000;-7658000;-93878000;73456000;97718000
ULBI;739637;USD;2011;Q4;2011-12-31;2012-03-13;17331000;17419000;5320000;19903000;34967000;64072000;12588000;;24155000;36743000;100815000;16576000;;23158000;;4431000;27589000;174183000;-7658000;-92280000;73226000;100815000
ULBI;739637;USD;2010;Q4;2010-12-31;2011-08-11;17235000;17256000;4641000;34270000;33122000;75446000;14485000;;24904000;39389000;114835000;18774000;8717000;36345000;251000;4695000;41040000;172885000;-7652000;-90200000;73795000;114835000
ULBI;739637;USD;2018;Q4;2018-12-31;2019-02-07;15950000;16143000;25583000;16015000;22843000;67221000;10744000;;42139000;52883000;120104000;11534000;;14947000;;623000;15570000;184635000;-19266000;-57964000;104534000;120104000
ARTX;739639;USD;2018;Q4;2018-12-31;2019-03-07;26520692;26520692;4222246;16259809;9912748;54474674;8914247;543205;54031519;63488971;117963645;12940964;7705069;27700812;6360569;13487116;41187928;251815863;;-176498057;76775717;117963645
SSC;739951;USD;2017;Q4;2017-12-31;2018-03-30;66020301;60686582;7205096;26962085;216453;55801238;113993;6975511;148874;7238378;63039616;27761078;3000000;31655009;;1261995;32917004;158037057;;-125865391;30122612;63039616
SSC;739951;USD;2016;Q4;2016-12-31;2017-03-31;49125506;49125506;3761814;9522151;203697;19319577;4963725;6654664;24808324;36426713;55746290;16612203;3000000;24015354;;1261995;25277349;152809837;;-115669268;30468941;55746290
DXC;740485;USD;2017;Q4;2018-03-31;2018-05-29;374477320;381033120;2593000000;5481000000;;9620000000;3363000000;;20938000000;24301000000;33921000000;5504000000;1918000000;9852000000;6092000000;10232000000;20084000000;12213000000;-85000000;1301000000;13837000000;33921000000
DXC;740485;USD;2016;Q4;2017-03-31;2017-03-31;163192520;154892440;1263000000;1643000000;;3247000000;903000000;;4513000000;5416000000;8663000000;1694000000;738000000;2950000000;2225000000;3547000000;6497000000;2220000000;0;-170000000;2166000000;8663000000
DXC;740485;USD;2018;Q4;2019-03-31;2019-06-13;268690000;271650000;2899000000;5181000000;;9066000000;3179000000;;17329000000;20508000000;29574000000;5881000000;1942000000;9453000000;5470000000;8396000000;17849000000;11304000000;-136000000;478000000;11725000000;29574000000
FLT;740486;USD;2017;Q4;2017-12-31;2018-03-01;89644000;92592000;913595000;1420011000;;3549701000;180057000;32859000;7555742000;7768658000;11318359000;2481298000;811000000;4095502000;2902104000;3546335000;7641837000;2214346000;-944888000;2958921000;3676522000;11318359000
FLT;740486;USD;2016;Q4;2016-12-31;2017-03-01;92576000;95236000;475018000;1202009000;;2527693000;142504000;36200000;6920335000;7099039000;9626732000;2135750000;591000000;3296318000;2521727000;3246376000;6542694000;2074215000;-542495000;2218721000;3084038000;9626732000
FLT;740486;USD;2015;Q4;2015-12-31;2016-02-29;92328000;94415000;447152000;638954000;;1944624000;80760000;76568000;5787854000;5945182000;7889806000;1081305000;614000000;2247474000;2059900000;2812285000;5059759000;1989038000;-354516000;1766336000;2830047000;7889806000
FLT;740486;USD;2014;Q4;2014-12-31;2015-03-02;87924000;90282000;477069000;673797000;;2137350000;73563000;141933000;6171855000;6387351000;8524701000;1644815000;675000000;2896618000;2168953000;3009521000;5906139000;1852562000;-346397000;1403905000;2618562000;8524701000
FLT;740486;USD;2013;Q4;2013-12-31;2014-03-03;82403000;85294000;338105000;573351000;;1353512000;53956000;;2524767000;2578723000;3932235000;1244511000;349000000;1908898000;474939000;779444000;2688342000;631784000;-375663000;1035198000;1243893000;3932235000
FLT;740486;USD;2012;Q4;2012-12-31;2013-03-01;83451000;85819000;283649000;525441000;;1195354000;45196000;;1481320000;1526516000;2721870000;636296000;298000000;1142222000;485217000;665826000;1808048000;542134000;-375663000;750697000;913822000;2721870000
FLT;740486;USD;2011;Q4;2011-12-31;2012-02-29;322199093;334365425;285159000;481791000;;1124268000;32724000;;1192177000;1224901000;2349169000;666283000;280000000;1126552000;278429000;411181000;1537733000;466317000;-175663000;534498000;811436000;2349169000
FLT;740486;USD;2010;Q4;2010-12-31;2011-08-15;39661;80934;114804000;260163000;;618983000;26818000;;838317000;865135000;1484118000;238437000;144000000;461122000;313796000;397051000;858173000;422103000;-175220000;387163000;625945000;1484118000
FLT;740486;USD;2018;Q4;2018-12-31;2019-03-01;87610000;90571000;1031145000;1425815000;;3875986000;186201000;42674000;7097616000;7326491000;11202477000;2563859000;886000000;4495213000;2748431000;3367084000;7862297000;2306966000;-1870584000;3817656000;3340180000;11202477000
FARO;740727;USD;2017;Q4;2017-12-31;2018-02-21;16752808;16664736;151957000;72105000;53786000;294159000;31879000;;132540000;164419000;458578000;43607000;;75885000;;30627000;106512000;223073000;-31809000;168624000;352066000;458578000
FARO;740727;USD;2016;Q4;2016-12-31;2017-02-24;16676769;16714165;149111000;61364000;51886000;278665000;31678000;;113371000;145049000;423714000;36316000;;66610000;;17447000;84057000;212620000;-31838000;183436000;339657000;423714000
FARO;740727;USD;2015;Q4;2015-12-31;2016-02-29;17038990;17148028;150350000;69918000;45571000;292158000;35946000;;81082000;117028000;409186000;33919000;;63031000;;18511000;81542000;207014000;-31838000;172329000;327644000;409186000
FARO;740727;USD;2014;Q4;2014-12-31;2015-02-25;17293975;17552660;174284000;83959000;43094000;323352000;29345000;;72766000;102111000;425463000;41564000;;67182000;;14427000;81609000;200108000;-9075000;159516000;343854000;425463000
FARO;740727;USD;2013;Q4;2013-12-31;2014-02-26;17145604;17429189;189624000;66309000;48940000;324119000;16451000;;50926000;67377000;391496000;36712000;;60953000;;14593000;75546000;191892000;-9075000;125867000;315950000;391496000
FARO;740727;USD;2012;Q4;2012-12-31;2013-02-27;16989947;17119336;158223000;62559000;48894000;288078000;15344000;;47385000;62729000;350807000;33515000;45000;55682000;19000;12389000;68071000;181112000;-9075000;104358000;282736000;350807000
FARO;740727;USD;2011;Q4;2011-12-31;2012-03-28;16704737;17179928;129537000;57512000;49934000;251487000;16233000;;45071000;61304000;312791000;34154000;84000;53948000;257000;10945000;64893000;169797000;-9075000;81360000;247898000;312791000
FARO;740727;USD;2010;Q4;2010-12-31;2011-05-06;16181827;16604736;115708000;51862000;28242000;208312000;15240000;;42467000;57707000;266019000;28371000;91000;45498000;125000;8044000;53542000;156327000;-9075000;57983000;212477000;266019000
FARO;740727;USD;2018;Q4;2018-12-31;2019-02-21;17245281;17863707;133576000;88927000;65444000;316742000;30417000;;159085000;189502000;506244000;61501000;;97523000;;32112000;129635000;251348000;-31609000;175353000;376609000;506244000
RE;741323;USD;2017;Q4;2017-12-31;2018-03-01;40589000;40819000;;;;3883176000;;18626535000;1082081000;19708616000;23591792000;2221300000;;14589165000;633395000;633395000;15222560000;2166459000;-3322244000;9685908000;8369232000;23591792000
RE;741323;USD;2016;Q4;2016-12-31;2017-03-01;40433000;40714000;;;;3039136000;;17483089000;799279000;18282368000;21321504000;1772069000;;12612932000;633176000;633176000;13246108000;2141472000;-3272244000;9422932000;8075396000;21321504000
RE;741323;USD;2015;Q4;2015-12-31;2016-02-29;42467000;42811000;;;;3015283000;;16676405000;853730000;17530135000;20545418000;1790014000;;12303875000;632958000;632958000;12936833000;2104324000;-2885956000;8621972000;7608585000;20545418000
RE;741323;USD;2014;Q4;2014-12-31;2015-03-02;44647000;45075000;;;;2592866000;;17435937000;789021000;18224958000;20817824000;1872123000;;12306788000;638364000;638364000;12945152000;2069490000;-2485897000;7819210000;7872672000;20817824000
RE;741323;USD;2013;Q4;2013-12-31;2014-03-03;47366000;47927000;;;;2519389000;;16596483000;692164000;17288647000;19808036000;1701113000;;12258063000;488319000;488319000;12746382000;2030454000;-1985873000;6765967000;7061654000;19808036000
RE;741323;USD;2012;Q4;2012-12-31;2013-03-01;51230000;51404000;;;;2323966000;;16576196000;877745000;17453941000;19777907000;1490084000;;12226279000;818161000;818161000;13044440000;1947110000;-1363958000;5613266000;6733467000;19777907000
RE;741323;USD;2011;Q4;2011-12-31;2012-02-29;53341000;53425000;;;;2096998000;;15797381000;999176000;16796557000;18893555000;1478334000;;12004071000;818109000;818109000;12822180000;1893653000;-1073970000;4884714000;6071375000;18893555000
RE;741323;USD;2010;Q4;2010-12-31;2011-03-01;54413000;54596000;;;;2182371000;;15365019000;836808000;16201827000;18384198000;1507531000;;11282621000;818060000;818060000;12100681000;1863691000;-981480000;5069048000;6283517000;18384198000
RE;741323;USD;2009;Q4;2009-12-31;2010-09-08;;;;;;2298875000;;14918816000;783621000;15702437000;18001312000;1478301000;;11081576000;818014000;818014000;11899590000;1845839000;-582926000;4566771000;6101722000;18001312000
RE;741323;USD;2018;Q4;2018-12-31;2019-03-01;40229000;40403000;;;;5147975000;;18433066000;1212958000;19646024000;24793999000;2739144000;;16256582000;633613000;633613000;16890195000;2189469000;-3397548000;9574440000;7903804000;24793999000
USNA;741592;USD;2017;Q4;2017-12-31;2018-02-28;24040000;24250000;247131000;;62918000;340159000;102847000;;76263000;179110000;519269000;11787000;;141183000;;14876000;156059000;76566000;;288070000;363210000;519269000
USNA;741592;USD;2016;Q4;2016-12-31;2017-03-01;24403000;25038000;175774000;;64810000;277861000;101267000;;91514000;192781000;470642000;9040000;;138491000;;6864000;145355000;71529000;;265405000;325287000;470642000
USNA;741592;USD;2015;Q4;2015-12-31;2016-03-01;25360000;26166000;143210000;;66119000;244264000;87982000;;90991000;178973000;423237000;10043000;;131412000;;10973000;142385000;69753000;;214875000;280852000;423237000
USNA;741592;USD;2014;Q4;2014-12-31;2015-03-17;24652000;25722000;111126000;;45248000;190927000;71164000;;88493000;159657000;350584000;7779000;;108705000;;11715000;120420000;61626000;;166406000;230164000;350584000
USNA;741592;USD;2013;Q4;2013-12-31;2014-03-13;27746000;28842000;145985000;;47242000;229045000;59180000;;80245000;139425000;368470000;9502000;;95871000;;12077000;107948000;54705000;;200023000;260522000;368470000
USNA;741592;USD;2012;Q4;2012-12-31;2013-03-11;28336000;28860000;70839000;;36481000;132545000;61751000;;73059000;134810000;267355000;7040000;;70844000;;10939000;81783000;43836000;;134800000;185572000;267355000
USNA;741592;USD;2011;Q4;2011-12-31;2012-03-14;29920000;30244000;50353000;;36968000;106059000;60754000;;77683000;138437000;244496000;7952000;;59696000;;10890000;70586000;49272000;;118799000;173910000;244496000
USNA;741592;USD;2010;Q4;2010-12-31;2011-08-10;31842000;32958000;24222000;;34078000;81677000;57568000;;77391000;134959000;216636000;6445000;;59029000;;10805000;69834000;51238000;;90207000;146802000;216636000
USNA;741592;USD;2018;Q4;2018-12-31;2019-02-26;23884000;24453000;277865000;;81948000;392335000;92025000;;70103000;162128000;554463000;9947000;;148686000;;14631000;163317000;72032000;;329501000;391146000;554463000
APTI;741619;USD;2017;Q4;2017-12-31;2018-02-21;41314000;41314000;148970000;68782000;;234729000;10437000;;18165000;28602000;263331000;22079000;21000;139823000;26000;6178000;146001000;314305000;;-196865000;117330000;263331000
APTI;741619;USD;2016;Q4;2016-12-31;2017-02-17;38464000;38464000;78748000;58587000;;142775000;12827000;38446000;734000;52007000;194782000;17647000;43000;116374000;51000;6840000;123214000;271986000;;-200324000;71568000;194782000
APTI;741619;USD;2015;Q4;2015-12-31;2016-11-04;12887000;12887000;23516000;52887000;;80393000;13487000;0;5271000;18758000;99151000;18194000;42000;101271000;95000;5918000;107189000;26510000;;-168771000;-8038000;99151000
DORM;742104;USD;2017;Q4;2017-12-31;2018-02-27;33521000;33595000;71691000;241880000;212149000;532849000;92692000;;140383000;233075000;765924000;110781000;;110781000;;20336000;131117000;45148000;;589659000;634807000;765924000
DORM;742104;USD;2016;Q4;2016-12-31;2017-02-27;34268000;34360000;149121000;230526000;168851000;551614000;88436000;;71742000;160178000;711792000;103848000;;103848000;;6302000;110150000;44532000;;557110000;601642000;711792000
DORM;742104;USD;2015;Q4;2015-12-31;2016-02-23;35260000;35320000;78659000;203923000;193725000;478633000;87046000;;56186000;143232000;621865000;98570000;;98570000;;5259000;103829000;43148000;;474888000;518036000;621865000
DORM;742104;USD;2014;Q4;2014-12-31;2015-02-25;35624000;35716000;47656000;206035000;173523000;430361000;82270000;;45085000;127355000;557716000;90833000;;90833000;;4822000;95655000;43769000;;418292000;462061000;557716000
DORM;742104;USD;2013;Q4;2013-12-31;2014-02-25;36363000;36552000;60593000;180777000;160387000;407608000;64786000;;56775000;121561000;529169000;91738000;;91738000;;23790000;115528000;43484000;;370157000;413641000;529169000
DORM;742104;USD;2012;Q4;2012-12-31;2013-03-01;36241000;36217000;27708000;140180000;145270000;315490000;48758000;;48435000;97193000;412683000;63685000;;63685000;;16126000;79811000;41372000;;291500000;332872000;412683000
DORM;742104;USD;2011;Q4;2011-12-31;2012-03-02;35899000;36153000;50196000;124324000;115845000;293026000;38904000;;44763000;83667000;376693000;44553000;;44553000;;15037000;59590000;37222000;;277071000;317103000;376693000
DORM;742104;USD;2010;Q4;2010-12-31;2011-08-01;35642000;36178000;30463000;101851000;120433000;254960000;28790000;;39409000;68199000;323159000;48160000;;48160000;;11846000;60006000;35102000;;225299000;263153000;323159000
DORM;742104;USD;2018;Q4;2018-12-31;2019-02-26;33340000;33504000;43458000;310114000;270504000;629728000;98647000;;159182000;257829000;887557000;141590000;;141590000;;18344000;159934000;48191000;;679432000;727623000;887557000
NP;743399;USD;2017;Q4;2017-12-31;2018-02-23;16835000;17249000;4500000;115700000;143500000;285200000;425200000;;194000000;619200000;904400000;123200000;1400000;124600000;254100000;379900000;504500000;;;;399900000;904400000
NP;743399;USD;2016;Q4;2016-12-31;2017-02-24;16786000;17161000;3100000;96500000;116300000;236300000;364600000;;164700000;529300000;765600000;106800000;1200000;108000000;219700000;319300000;427300000;317200000;-56500000;169600000;338300000;765600000
NP;743399;USD;2015;Q4;2015-12-31;2016-02-26;16806000;17154000;4200000;97300000;120600000;246600000;323000000;;181800000;504800000;751400000;104900000;1200000;106100000;228200000;333700000;439800000;311000000;-40100000;119000000;311600000;751400000
NP;743399;USD;2014;Q4;2014-12-31;2015-02-27;16665000;16951000;72600000;84700000;101200000;319100000;241700000;;163700000;405400000;724500000;88300000;1400000;117000000;226800000;318800000;435800000;300600000;-31700000;88200000;288700000;724500000
NP;743399;USD;2013;Q4;2013-12-31;2014-03-04;16260000;16618000;73400000;90500000;101100000;305400000;261700000;;108800000;370500000;675900000;82200000;21400000;103600000;190500000;304800000;408400000;285400000;-27200000;36600000;267500000;675900000
NP;743399;USD;2012;Q4;2012-12-31;2013-03-07;15888000;16189000;7800000;79600000;102900000;234100000;254800000;;121800000;376600000;610700000;82700000;4700000;87400000;177600000;325500000;412900000;274100000;-22600000;-3900000;197800000;610700000
NP;743399;USD;2011;Q4;2011-12-31;2012-03-08;15088000;15755000;12800000;71400000;68800000;193500000;252300000;;119300000;371600000;565100000;81800000;21700000;103500000;164500000;294900000;398400000;257700000;-10900000;-40400000;166700000;565100000
NP;743399;USD;2010;Q4;2010-12-31;2011-08-09;14795000;15704000;48300000;70700000;69400000;222000000;261900000;;122800000;384700000;606700000;78500000;13600000;92100000;231300000;355400000;447500000;249100000;-10400000;-62000000;159200000;606700000
NP;743399;USD;2018;Q4;2018-12-31;2019-02-22;16877000;17051000;9900000;114800000;131600000;277900000;396200000;;187100000;583300000;861200000;118500000;2300000;120800000;236800000;350200000;471000000;;;;390200000;861200000
CWH;744377;USD;2017;Q4;2017-12-31;2018-03-13;;;224163000;79881000;1415915000;1798907000;198022000;;564548000;762570000;2561477000;227545000;974887000;1320169000;907460000;1150471000;2470640000;50313000;;6192000;90837000;2561477000
CWH;744377;USD;2016;Q4;2016-12-31;2016-11-10;;;114196000;58488000;902711000;1126162000;130760000;;198855000;329615000;1455777000;146699000;626409000;868422000;621144000;731492000;1599914000;-29811000;;71000;-144137000;1455777000
CWH;744377;USD;2015;Q4;2015-12-31;2017-03-13;;;92025000;56356000;861847000;1050981000;149725000;;137399000;287124000;1338105000;134341000;599191000;863098000;674055000;769867000;1632965000;;;;-294860000;1338105000
CWH;744377;USD;2018;Q4;2018-12-31;2019-03-15;;;138557000;85711000;1558970000;1888162000;359855000;;558670000;918525000;2806687000;269427000;885980000;1305118000;1191627000;1468652000;2773770000;47908000;;-3370000;32917000;2806687000
NCLH;744483;USD;2017;Q4;2017-12-31;2018-02-27;228496332;230210311;176190000;43961000;82121000;518337000;11040488000;;2536044000;13576532000;14094869000;567150000;619373000;2490021000;5688392000;5855082000;8345103000;3998927000;-239255000;1963128000;5749766000;14094869000
NCLH;744483;USD;2016;Q4;2016-12-31;2017-02-27;227179749;227805798;128347000;63215000;66255000;411093000;10117689000;;2445129000;12562818000;12973911000;579755000;560193000;2312818000;5838494000;6123367000;8436185000;3890351000;-239255000;1201103000;4537726000;12973911000
NCLH;744483;USD;2015;Q4;2015-12-31;2016-02-29;228981937;235356511;115937000;44996000;58173000;340411000;9458805000;;2465541000;11924346000;12264757000;691937000;629840000;2366519000;5767697000;6117358000;8483877000;3814768000;-189256000;568018000;3780880000;12264757000
NCLH;744483;USD;2014;Q4;2014-12-31;2015-02-27;212750680;218077150;84824000;32432000;56555000;283735000;8623773000;;2561488000;11185261000;11468996000;654497000;576947000;2086599000;5503076000;5863584000;7950183000;3702574000;-82000000;140881000;3518813000;11468996000
NCLH;744483;USD;2013;Q4;2013-12-31;2014-02-21;205202123;223906767;56467000;18260000;43715000;182924000;5647670000;;820384000;6468054000;6650978000;340540000;286575000;1075488000;2841214000;2944224000;4019712000;2823069000;;-197471000;2631266000;6650978000
NCLH;744483;USD;2012;Q4;2012-12-31;2013-05-08;178339027;179139798;45500000;15062000;39681000;164929000;4960142000;;813356000;5773498000;5938427000;310166000;221233000;945089000;2764120000;2974554000;3919643000;2327122000;;-299185000;2018784000;5938427000
NCLH;744483;USD;2018;Q4;2018-12-31;2019-02-27;219843399;221345575;163851000;55249000;90202000;550313000;12119253000;;2536404000;14655657000;15205970000;876063000;681218000;3150500000;5810873000;6092469000;9242969000;4129874000;-904066000;2898840000;5963001000;15205970000
MAA;744578;USD;2012;Q4;2012-12-31;2013-02-22;42263000;47892000;9075000;;;9883000;2679964000;;61221000;2741185000;2751068000;99305000;1190848000;1311576000;483000000;494382000;1805958000;1543421000;;;945110000;2751068000
MAA;744578;USD;2011;Q4;2011-12-31;2012-02-24;38164000;40221000;57317000;;;58679000;2397371000;;74418000;2471789000;2530468000;93809000;1514755000;1641659000;135000000;145347000;1787006000;1376012000;;;743462000;2530468000
MAA;744578;USD;2010;Q4;2010-12-31;2011-02-24;34307000;34488000;45942000;;;47456000;2057911000;;70681000;2128592000;2176048000;75814000;1500193000;1624963000;;10457000;1635420000;1142371000;;;540628000;2176048000
MAA;744578;USD;2009;Q4;2009-12-31;2010-08-05;28806000;29092000;13819000;;;14380000;1916575000;;55871000;1972446000;1986826000;1470826000;;1522009000;;11591000;1533600000;988932000;;;453226000;1986826000
SNPS;744723;USD;2017;Q4;2017-10-31;2017-12-14;150448000;155519000;1048356000;451144000;;1682593000;266014000;;3447807000;3713821000;5396414000;539657000;9924000;1614109000;134063000;502581000;2116690000;1623934000;-426208000;2143873000;3279724000;5396414000
SNPS;744723;USD;2016;Q4;2016-10-31;2016-12-12;151681000;155175000;1117315000;438873000;;1716938000;257035000;;3266392000;3523427000;5240365000;424144000;205000000;1714946000;0;330273000;2045219000;1646190000;-294052000;1947585000;3195146000;5240365000
SNPS;744723;USD;2015;Q4;2015-10-31;2015-12-14;155322000;158987000;964935000;385694000;;1468807000;263077000;;3313855000;3576932000;5045739000;405107000;205000000;1578353000;;333397000;1911750000;1612012000;-98375000;1725727000;3133989000;5045739000
SNPS;744723;USD;2014;Q4;2014-10-31;2014-12-15;156384000;159380000;985762000;326727000;;1504735000;249098000;;3021666000;3270764000;4775499000;428517000;30000000;1386759000;45000000;332570000;1719329000;1616163000;-49496000;1551592000;3056170000;4775499000
SNPS;744723;USD;2013;Q4;2013-10-31;2013-12-20;154369000;158211000;1022441000;256026000;;1447977000;197600000;;2713358000;2910958000;4358935000;365365000;30000000;1222919000;75000000;347739000;1570658000;1598786000;-106668000;1324854000;2788277000;4358935000
SNPS;744723;USD;2012;Q4;2012-10-31;2012-12-20;149917000;154066000;700382000;292668000;;1140656000;191243000;;2815757000;3007000000;4147656000;387775000;30000000;1252639000;105000000;351046000;1603685000;1586543000;-168090000;1098694000;2543971000;4147656000
SNPS;744723;USD;2011;Q4;2011-10-31;2011-12-16;143855000;147190000;1004074000;203124000;;1338055000;159517000;;1871272000;2030789000;3368844000;306765000;;1010320000;;257224000;1267544000;1522760000;-358032000;957517000;2101300000;3368844000
SNPS;744723;USD;2010;Q4;2010-10-31;2010-12-17;148326000;153268000;938561000;181102000;;1247755000;148580000;;1890206000;2038786000;3286541000;321199000;;921768000;;264591000;1186359000;1542868000;-197586000;770674000;2100182000;3286541000
SNPS;744723;USD;2009;Q4;2009-10-31;2010-09-08;145729000;149331000;1168326000;127010000;;1463800000;146910000;;1328144000;1475054000;2938854000;260603000;;814593000;;280095000;1094688000;1501635000;-228618000;574980000;1844166000;2938854000
SNPS;744723;USD;2018;Q4;2018-10-31;2018-12-17;149179000;158350000;723115000;554217000;122407000;1543797000;309310000;;4292867000;4602177000;6145974000;605784000;343769000;2102415000;125535000;558544000;2660959000;1646323000;-597682000;2543688000;3485015000;6145974000
IQV;744724;USD;2017;Q4;2017-12-31;2018-02-16;209200000;214200000;1005000000;2097000000;;3554000000;440000000;78000000;18785000000;19303000000;22857000000;2058000000;103000000;3156000000;10122000000;11457000000;14613000000;10782000000;-3374000000;538000000;8244000000;22857000000
IQV;744724;USD;2016;Q4;2016-12-31;2017-02-16;238600000;243900000;1238000000;1707000000;;3337000000;406000000;82000000;17383000000;17871000000;21208000000;1819000000;92000000;2705000000;7108000000;9643000000;12348000000;10602000000;-1000000000;-399000000;8860000000;21208000000
IQV;744724;USD;2015;Q4;2015-12-31;2016-02-11;120814000;123071000;977000000;1166000000;;2412000000;188000000;85000000;1241000000;1514000000;3926000000;941000000;49000000;1594000000;2419000000;2668000000;4262000000;9000000;;-462000000;-336000000;3926000000
IQV;744724;USD;2014;Q4;2014-12-31;2015-02-12;125661000;128692000;867358000;975255000;;2146083000;190297000;66011000;893562000;1149870000;3295953000;898081000;826000;1471900000;2282612000;2528065000;3999965000;143828000;;-788798000;-704012000;3295953000
IQV;744724;USD;2013;Q4;2013-12-31;2014-02-13;129187000;132863000;778143000;924205000;;1945688000;199578000;63276000;858255000;1121109000;3066797000;897583000;10433000;1482247000;2035586000;2252035000;3734282000;478144000;;-1145181000;-667485000;3066797000
IQV;744724;USD;2012;Q4;2012-12-31;2013-05-14;115671000;118092000;567728000;745373000;;1509994000;193999000;55099000;740061000;989159000;2499153000;752470000;55710000;1308997000;2366268000;2549200000;3858197000;4554000;;-1371772000;-1359044000;2499153000
IQV;744724;USD;2018;Q4;2018-12-31;2019-02-19;199300000;204100000;938000000;2394000000;;3874000000;434000000;142000000;18099000000;18675000000;22549000000;2395000000;100000000;3534000000;10907000000;12061000000;15595000000;10901000000;-4770000000;807000000;6954000000;22549000000
ROL;744726;USD;2017;Q4;2017-12-31;2018-02-26;326986500;326986500;107050000;97802000;14983000;262795000;134088000;;636780000;770868000;1033663000;127195000;;294569000;;85170000;379739000;299397000;;400483000;653924000;1033663000
ROL;744726;USD;2016;Q4;2016-12-31;2017-02-24;654048845;;142785000;88490000;13724000;290171000;133477000;;492890000;626367000;916538000;132324000;;276991000;;71002000;347993000;295244000;;343376000;568545000;916538000
ROL;744726;USD;2015;Q4;2015-12-31;2016-02-24;983030690;;134574000;79864000;12801000;269434000;121356000;;457861000;579217000;848651000;123400000;;252986000;;71636000;324622000;288515000;-200000;306892000;524029000;848651000
ROL;744726;USD;2014;Q4;2014-12-31;2015-02-25;983034731;;108372000;77854000;14078000;283958000;101669000;;422535000;524204000;808162000;121172000;;252679000;;92807000;345486000;281322000;-200000;247042000;462676000;808162000
ROL;744726;USD;2013;Q4;2013-12-31;2014-02-26;656908715;656389484;118216000;72849000;12251000;274442000;87215000;;377560000;464775000;739217000;115000000;;235792000;;65170000;300962000;199629000;0;270397000;438255000;739217000
ROL;744726;USD;2012;Q4;2012-12-31;2013-02-27;-658518442;-658581446;65082000;68920000;11847000;205992000;82263000;;404251000;486514000;692506000;109060000;;228416000;;109134000;337550000;191171000;;220752000;354956000;692506000
ROL;744726;USD;2011;Q4;2011-12-31;2012-02-28;-991528812;-992037312;46275000;61687000;11125000;175822000;76858000;;392970000;469828000;645650000;105565000;;225851000;;95802000;321653000;182805000;;189282000;323997000;645650000
ROL;744726;USD;2010;Q4;2010-12-31;2011-02-25;331114500;331380000;20913000;59389000;11899000;151021000;74013000;;393980000;467993000;619014000;106409000;;246441000;;74603000;321044000;174997000;;155463000;297970000;619014000
ROL;744726;USD;2009;Q4;2009-12-31;2010-07-30;333999000;334885500;9504000;;10208000;120530000;74644000;;371322000;445966000;566496000;89785000;;232753000;;69177000;301930000;171012000;;125681000;264566000;566496000
ROL;744726;USD;2018;Q4;2018-12-31;2019-03-01;327316500;327318000;115485000;104016000;15788000;286021000;136885000;;671218000;808103000;1094124000;132618000;0;299029000;0;83187000;382216000;412694000;;370292000;711908000;1094124000
SDPI;745554;USD;2017;Q4;2017-12-31;2018-03-23;24418917;24418917;2375179;2667042;1196813;6350564;8809348;;13515944;22325292;28675856;1565227;6101678;7666905;6706375;6706375;14373280;38932399;;-24629823;14302576;28675856
SDPI;745554;USD;2016;Q4;2016-12-31;2017-03-31;23808090;23808090;2241902;1038664;1167692;7028031;9068359;;16892115;25960474;32988505;1515518;3122984;4910717;13288701;14109358;19020075;38319548;;-24351118;13968430;32988505
SDPI;745554;USD;2015;Q4;2015-12-31;2016-03-30;17373658;17373658;1297002;1861002;1410794;4748248;14655502;;19342193;33997695;38745943;1450358;2855056;4860807;16559203;17710425;22571232;31396980;;-15222269;16174711;38745943
SDPI;745554;USD;2014;Q4;2014-12-31;2015-03-31;17329670;17329670;5792388;4403001;1219079;11894700;15963629;;29685004;45648633;57543333;2861467;11013222;15111718;11247584;12365404;27477122;30832901;;-766690;30066211;57543333
SDPI;745554;USD;2013;Q4;2013-12-31;2014-09-12;;;11256;2978666;96028;3329518;15048871;2187926;194935;17431732;20761250;723526;3574813;8693976;11810468;11810468;20504444;256806;;0;256806;20761250
SDPI;745554;USD;2018;Q4;2018-12-31;2019-03-13;24823007;22992310;4264767;2273189;1003623;7675186;8226009;;3737998;11964007;19639193;1353221;4578759;5931980;6296994;6296994;12228974;39465629;;-32055410;7410219;19639193
WGP;745556;USD;2017;Q4;2017-12-31;2018-02-16;;;79588000;160239000;;255210000;5730891000;826211000;1203999000;7761101000;8016311000;424426000;0;424426000;3492712000;3647006000;4071432000;1061125000;;;3944879000;8016311000
WGP;745556;USD;2016;Q4;2016-12-31;2017-02-23;;;359072000;223021000;;595591000;5049932000;854208000;1236366000;7140506000;7736097000;315387000;;315387000;3119461000;3309944000;3625331000;1048143000;;;4110766000;7736097000
PATK;745754;USD;2017;Q4;2017-12-31;2018-02-28;24800000;25226000;2767000;77784000;175270000;273953000;118486000;;474205000;592691000;866644000;120659000;15766000;136425000;338111000;359534000;495959000;171439000;;199180000;370685000;866644000
PATK;745754;USD;2016;Q4;2016-12-31;2017-02-28;22574000;22987500;6449000;38455000;120019000;172769000;85483000;;276698000;362181000;534950000;70327000;15766000;86093000;256811000;263409000;349502000;71959000;;113462000;185448000;534950000
PATK;745754;USD;2015;Q4;2015-12-31;2016-03-14;22964500;23233000;87000;38213000;89478000;133897000;67878000;;179809000;247687000;381584000;47212000;10714000;57926000;193142000;195061000;252987000;65991000;;62574000;128597000;381584000
PATK;745754;USD;2014;Q4;2014-12-31;2015-03-13;23550000;23565750;123000;32637000;71020000;110233000;57353000;;87975000;145328000;255561000;45142000;0;45142000;101054000;107651000;152793000;62228000;;40509000;102768000;255561000
PATK;745754;USD;2013;Q4;2013-12-31;2014-03-14;23972250;24075000;34000;22644000;56510000;83937000;42117000;;48133000;90250000;174187000;32411000;;32411000;55000000;59466000;91877000;60467000;;21789000;82310000;174187000
PATK;745754;USD;2012;Q4;2012-12-31;2013-03-29;24331500;22524750;434000;17858000;46992000;68521000;37069000;;37879000;74948000;143469000;29152000;;29152000;49716000;52909000;82061000;59806000;;1585000;61408000;143469000
PATK;745754;USD;2011;Q4;2011-12-31;2012-03-29;43777233;45095733;550000;14171000;27503000;44385000;22978000;;18407000;41385000;85770000;18850000;1000000;19850000;31954000;37078000;56928000;55535000;;-26510000;28842000;85770000
PATK;745754;USD;2010;Q4;2010-12-31;2011-08-09;21147750;22151250;1957000;10190000;22723000;37128000;23172000;;14517000;37689000;74817000;13832000;36233000;50065000;0;6616000;56681000;53946000;;-34980000;18136000;74817000
PATK;745754;USD;2018;Q4;2018-12-31;2019-02-28;23144000;23411000;6895000;82499000;272898000;385167000;177145000;;668919000;846064000;1231231000;149005000;8750000;157755000;621751000;664722000;822477000;186560000;;224874000;408754000;1231231000
CSOD;747052;USD;2017;Q4;2017-12-31;2018-02-27;57844000;57844000;563127000;154428000;;782115000;20817000;96949000;67309000;185075000;967190000;75165000;248025000;644238000;285168000;300832000;945070000;536957000;;-515054000;22120000;967190000
CSOD;747052;USD;2016;Q4;2016-12-31;2017-02-24;56311000;56311000;302091000;136657000;;493513000;23962000;41046000;65108000;130116000;623629000;72011000;0;346311000;238435000;250355000;596666000;476236000;;-453719000;26963000;623629000
CSOD;747052;USD;2015;Q4;2015-12-31;2016-02-26;54561000;54561000;244532000;104686000;;400425000;27021000;64247000;66574000;157842000;558267000;63065000;33000;303440000;229305000;247005000;550445000;394094000;;-386882000;7822000;558267000
CSOD;747052;USD;2014;Q4;2014-12-31;2015-02-27;53722000;53722000;282663000;84499000;;406405000;21424000;3938000;73888000;99250000;505655000;46213000;587000;230450000;225094000;239703000;470153000;336697000;;-301366000;35502000;505655000
CSOD;747052;USD;2013;Q4;2013-12-31;2014-02-26;52213000;52213000;309508000;67191000;;407451000;14436000;0;29468000;43904000;451355000;32325000;1424000;173274000;218575000;225186000;398460000;289312000;;-236467000;52895000;451355000
CSOD;747052;USD;2012;Q4;2012-12-31;2013-03-01;50406000;50406000;76442000;47528000;;141573000;7947000;;22314000;30261000;171834000;19835000;2559000;114038000;3063000;11148000;125186000;242772000;;-196041000;46648000;171834000
CSOD;747052;USD;2011;Q4;2011-12-31;2012-03-06;49060000;49060000;85409000;34110000;;126845000;3663000;;4854000;8517000;135362000;11873000;1882000;67089000;1465000;5813000;72902000;226921000;;-164651000;62460000;135362000
CSOD;747052;USD;2010;Q4;2010-12-31;2011-08-15;;;7067000;20876000;;32142000;3976000;;6776000;10752000;42894000;11110000;1383000;45998000;49984000;52038000;98036000;598000;;-97802000;-55142000;42894000
CSOD;747052;USD;2018;Q4;2018-12-31;2019-02-26;58668000;58668000;388328000;125300000;;573035000;77254000;1250000;155617000;234121000;807156000;80252000;;400423000;288967000;350826000;751249000;585393000;;-529962000;55907000;807156000
ZEN;747270;USD;2017;Q4;2017-12-31;2018-02-22;102032000;102032000;246946000;57096000;;343978000;59157000;97447000;90788000;247392000;591370000;56200000;;229347000;0;7839000;237186000;754599000;;-398043000;354184000;591370000
ZEN;747270;USD;2016;Q4;2016-12-31;2017-02-27;95866000;95866000;224867000;37343000;;279818000;62731000;75168000;57568000;195467000;475285000;43942000;;167218000;;8639000;175857000;624997000;-652000;-319720000;299428000;475285000
ZEN;747270;USD;2015;Q4;2015-12-31;2016-02-26;89199000;89199000;245640000;26168000;;283231000;56540000;22336000;60579000;139455000;422686000;33189000;;117399000;;11997000;129396000;512088000;-652000;-215921000;293290000;422686000
ZEN;747270;USD;2014;Q4;2014-12-31;2015-02-17;74030000;74030000;122469000;11523000;;139005000;41895000;9205000;15683000;66783000;205788000;24190000;10000;78149000;3911000;13933000;92082000;246755000;-652000;-131869000;113706000;205788000
ZEN;747270;USD;2013;Q4;2013-12-31;2014-08-07;22238000;22238000;63614000;7237000;;73859000;15431000;2225000;1221000;18877000;92736000;12951000;364000;42153000;23395000;25490000;67643000;18820000;-652000;-64454000;25093000;92736000
ZEN;747270;USD;2018;Q4;2018-12-31;2019-02-14;107433000;107433000;426731000;85280000;;572596000;75654000;393671000;195958000;665283000;1237879000;97520000;;342763000;458176000;478195000;820958000;951773000;;-529128000;416921000;1237879000
PRGS;748103;USD;2017;Q4;2017-11-30;2018-01-26;47491000;48471000;183609000;61210000;;263407000;42261000;;413050000;455311000;718718000;69661000;5819000;208018000;116090000;134616000;342634000;249836000;;145247000;376084000;718718000
PRGS;748103;USD;2016;Q4;2016-11-30;2017-01-30;48630000;46995000;249754000;65678000;;336053000;50105000;;368669000;418774000;754827000;59778000;15000000;203738000;120000000;144460000;348198000;239496000;;195694000;406629000;754827000
PRGS;748103;USD;2015;Q4;2015-11-30;2016-01-29;50434000;49691000;241279000;66459000;;323409000;54226000;;499488000;553714000;877123000;65314000;9375000;199916000;135000000;154743000;354659000;227930000;;319162000;522464000;877123000
PRGS;748103;USD;2014;Q4;2014-11-30;2015-01-29;50434000;51095000;283268000;68311000;;375607000;59351000;;267798000;327149000;702756000;60746000;0;153303000;0;6208000;159511000;209778000;;347193000;543245000;702756000
PRGS;748103;USD;2013;Q4;2013-11-30;2014-01-29;51712000;52639000;231440000;66784000;;337811000;57030000;24761000;262585000;344376000;682187000;68186000;;164579000;;3954000;168533000;205307000;;320006000;513654000;682187000
PRGS;748103;USD;2012;Q4;2012-11-30;2013-01-29;62859000;64678000;355217000;70793000;;526818000;63071000;26321000;268767000;358159000;884977000;110944000;;240154000;;6424000;246578000;300333000;;348830000;638399000;884977000
PRGS;748103;USD;2011;Q4;2011-11-30;2012-01-30;63076000;63975000;261416000;110927000;;407911000;66206000;33539000;356607000;456352000;864263000;80060000;357000;226144000;;13009000;239153000;309221000;;327542000;625110000;864263000
PRGS;748103;USD;2010;Q4;2010-11-30;2011-01-31;65568000;70238000;322396000;119273000;;483858000;58207000;39643000;355115000;452965000;936823000;98327000;388000;237676000;276000;10815000;248491000;347604000;;;688332000;936823000
PRGS;748103;USD;2009;Q4;2009-11-30;2010-10-12;60539000;62531000;224121000;98872000;;357619000;59625000;40714000;340892000;441231000;798850000;85323000;358000;226924000;664000;16474000;243398000;247265000;;;555452000;798850000
PRGS;748103;USD;2018;Q4;2018-11-30;2019-01-28;45054000;45401000;139513000;58450000;;228819000;30714000;;381076000;411790000;640609000;57005000;5819000;196018000;110270000;134509000;330527000;267053000;;71242000;310082000;640609000
STE;749030;USD;2017;Q4;2018-03-31;2018-05-30;84819000;85544000;201534000;528066000;205731000;989657000;1010524000;;3200153000;4210677000;5200334000;398462000;;398462000;1316001000;1584572000;1983034000;2048037000;;1146223000;3217300000;5200334000
STE;749030;USD;2016;Q4;2017-03-31;2017-05-26;84929000;85999000;282918000;483451000;197837000;1017802000;915908000;;2990745000;3906653000;4924455000;381583000;;381583000;1478361000;1732839000;2114422000;2085134000;;954155000;2810033000;4924455000
STE;749030;USD;2015;Q4;2016-03-31;2016-05-31;85906000;86368000;248841000;471523000;192792000;972525000;1064319000;;3309572000;4373891000;5346416000;400606000;;400606000;1567796000;1906918000;2307524000;2151719000;;939459000;3038892000;5346416000
STE;749030;USD;2014;Q4;2015-03-31;2016-02-09;59632000;60201000;167689000;325289000;160818000;720432000;493053000;;883806000;1376859000;2097291000;283331000;;283331000;621075000;740314000;1023645000;264853000;-320343000;1193791000;1073646000;2097291000
CDK;749032;USD;2018;Q4;2018-06-30;2018-08-14;131600000;131800000;804400000;374600000;;1367300000;131900000;;1509200000;1641100000;3008400000;334200000;45200000;548400000;2575500000;2807300000;3355700000;681400000;-1810700000;753000000;-347300000;3008400000
CDK;749032;USD;2017;Q4;2017-06-30;2017-08-08;142700000;144700000;726100000;372100000;;1278800000;135000000;;1469300000;1604300000;2883100000;333800000;46500000;552600000;2125200000;2387300000;2939900000;610200000;-1144700000;452700000;-56800000;2883100000
CDK;749032;USD;2016;Q4;2016-06-30;2016-08-09;154700000;155300000;219100000;365500000;;738700000;118600000;;1507700000;1626300000;2365000000;319400000;26800000;523400000;1190300000;1465400000;1988800000;642300000;-526600000;238300000;376200000;2365000000
CDK;749032;USD;2015;Q4;2015-06-30;2015-08-13;160500000;162100000;408200000;314600000;;885200000;100000000;;1533300000;1633300000;2518500000;299300000;13000000;498400000;971100000;1236000000;1734400000;688100000;-50700000;81200000;784100000;2518500000
CDK;749032;USD;2014;Q4;2014-06-30;2014-11-13;160600000;160600000;402800000;310700000;;918200000;82600000;;1597800000;1680400000;2598600000;302700000;0;497500000;0;291800000;789300000;0;0;0;1809300000;2598600000
SRPT;749127;USD;2018;Q4;2018-12-31;2019-02-28;68676000;68676000;1173912000;49044000;125445000;1426183000;97024000;107294000;11574000;215892000;1642075000;167924000;;173690000;420554000;436109000;609799000;2611301000;;-1578926000;1032276000;1642075000
SRPT;749127;USD;2017;Q4;2017-12-31;2018-03-01;63918000;63026000;1079060000;29468000;83605000;1228644000;43156000;21809000;14355000;79320000;1307964000;77449000;6175000;88332000;424876000;430415000;518747000;2006604000;;-1217008000;789217000;1307964000
SRPT;749127;USD;2016;Q4;2016-12-31;2017-02-28;54680000;54680000;317845000;5228000;12813000;373476000;37801000;4751000;8076000;50628000;424104000;60706000;10108000;75422000;6042000;11991000;87413000;1503131000;;-1166320000;336691000;424104000
SRPT;749127;USD;2015;Q4;2015-12-31;2016-02-25;44914000;44914000;192491000;3977000;;224543000;37344000;4470000;7425000;49239000;273782000;49287000;8429000;62294000;14969000;21141000;83435000;1089513000;;-899055000;190347000;273782000
SRPT;749127;USD;2014;Q4;2014-12-31;2015-02-26;41355000;41355000;210344000;2416000;;247796000;38501000;2063000;6673000;47237000;295033000;29774000;2590000;36867000;3738000;10513000;47380000;926773000;;-679025000;247653000;295033000
SRPT;749127;USD;2013;Q4;2013-12-31;2014-03-03;37660000;37660000;256965000;3530000;;270806000;15049000;25000;5689000;20763000;291569000;22681000;92000;35966000;1576000;8411000;44377000;790428000;;-543236000;247192000;291569000
SRPT;749127;USD;2012;Q4;2012-12-31;2013-03-15;26336000;26302000;187661000;4713000;;193908000;3397000;2775000;4913000;11085000;204993000;10273000;89000;78886000;1668000;-428823000;-349937000;554930000;;;554930000;204993000
SRPT;749127;USD;2011;Q4;2011-12-31;2012-03-13;22678000;20406000;39904000;3633000;;45184000;4265000;155000;4764000;9184000;54368000;11640000;85000;20601000;1757000;-307214000;-286613000;340981000;;;340981000;54368000
SRPT;749127;USD;2010;Q4;2010-12-31;2011-08-08;;;33589000;3224000;;39803000;2070000;123000;3980000;6173000;45976000;3326000;81000;45857000;1842000;-304710000;-258853000;304829000;;;304829000;45976000
WAB;749129;USD;2017;Q4;2017-12-31;2018-02-26;95219000;95909000;233401000;800619000;742634000;2265113000;573972000;;3740895000;4314867000;6579980000;1156389000;47225000;1573330000;1823303000;2178118000;3751448000;907939000;-827379000;2773300000;2828532000;6579980000
WAB;749129;USD;2016;Q4;2016-12-31;2017-02-28;90743000;91563000;398484000;667596000;658510000;2867631000;518376000;;3195011000;3713387000;6581018000;1060239000;129809000;1446639000;1762967000;2157554000;3604193000;871274000;-838950000;2553258000;2976825000;6581018000
WAB;749129;USD;2015;Q4;2015-12-31;2016-02-19;95346000;95836000;226191000;494975000;478574000;1540020000;353193000;;1336300000;1689493000;3229513000;557722000;433000;664776000;691805000;863398000;1528174000;470649000;-775124000;2280801000;1701339000;3229513000
WAB;749129;USD;2014;Q4;2014-12-31;2015-02-20;95612000;96673000;425849000;443464000;510949000;1637864000;339111000;;1326866000;1665977000;3303841000;625451000;792000;738802000;520403000;756741000;1495543000;449854000;-392262000;1909136000;1808298000;3303841000
WAB;749129;USD;2013;Q4;2013-12-31;2014-02-21;95217000;96480000;285760000;349458000;403229000;1333047000;276078000;;1212872000;1488950000;2821997000;511921000;421000;579400000;450288000;655430000;1234830000;416382000;-372969000;1576702000;1587167000;2821997000
WAB;749129;USD;2012;Q4;2012-12-31;2013-02-22;95505000;96900000;215766000;292786000;407039000;1092938000;244088000;;1014516000;1258604000;2351542000;469771000;43000;553059000;317853000;516466000;1069525000;382671000;-349388000;1297111000;1282017000;2351542000
WAB;749129;USD;2011;Q4;2011-12-31;2012-02-24;95432000;96468000;285615000;346281000;348174000;1055782000;222022000;;881149000;1103171000;2158953000;468114000;68000;541385000;395805000;569924000;1111309000;361576000;-309196000;1053706000;1047644000;2158953000
WAB;749129;USD;2010;Q4;2010-12-31;2011-02-25;95050000;95944000;236941000;258149000;253491000;801953000;206225000;;794903000;1001128000;1803081000;283903000;40068000;348374000;382007000;551320000;899694000;340523000;-290081000;887406000;903387000;1803081000
WAB;749129;USD;2009;Q4;2009-12-31;2010-08-05;94770000;95702000;188659000;208260000;239333000;689509000;201707000;;694619000;896326000;1585835000;227983000;32741000;305348000;359039000;501574000;806922000;330369000;-289137000;766221000;778913000;1585835000
WAB;749129;USD;2018;Q4;2018-12-31;2019-02-27;95966000;96273000;2342354000;801193000;844886000;4449667000;563737000;;3635830000;4199567000;8649234000;1209053000;64099000;1646690000;3792774000;4133469000;5780159000;915891000;-816145000;3021968000;2869075000;8649234000
SERV;749230;USD;2017;Q4;2017-12-31;2018-02-28;201704300;202152200;500000000;570000000;41000000;1241000000;237000000;22000000;4146000000;4405000000;5646000000;249000000;144000000;1173000000;2643000000;3305000000;4478000000;2323000000;-267000000;-895000000;1166000000;5644000000
SERV;749230;USD;2016;Q4;2016-12-31;2017-02-24;201555000;203943800;316000000;536000000;43000000;999000000;210000000;19000000;4158000000;4387000000;5386000000;242000000;59000000;1041000000;2772000000;3658000000;4699000000;2276000000;-182000000;-1405000000;686000000;5385000000
SERV;749230;USD;2015;Q4;2015-12-31;2016-02-26;202301500;204541000;320000000;487000000;40000000;933000000;160000000;57000000;3948000000;4165000000;5098000000;243000000;54000000;955000000;2698000000;3598000000;4553000000;2247000000;-122000000;-1560000000;544000000;5097000000
SERV;749230;USD;2014;Q4;2014-12-31;2015-03-02;200659200;206183300;408000000;441000000;42000000;970000000;136000000;88000000;3835000000;4059000000;5029000000;251000000;39000000;905000000;2987000000;3765000000;4670000000;2209000000;-122000000;-1720000000;359000000;5029000000
SERV;749230;USD;2013;Q4;2013-12-31;2014-08-05;136758800;136758800;511000000;394000000;39000000;1213000000;177000000;122000000;4393000000;4692000000;5905000000;268000000;39000000;972000000;3867000000;4910000000;5882000000;1524000000;-118000000;-1390000000;23000000;5905000000
SERV;749230;USD;2018;Q4;2018-12-31;2019-03-01;2244900;799800;224000000;186000000;45000000;516000000;201000000;466000000;3840000000;4507000000;5023000000;224000000;49000000;426000000;1727000000;2392000000;2818000000;2311000000;-267000000;156000000;2205000000;5023000000
MXWL;755086;USD;2017;Q4;2017-12-31;2018-02-16;37189000;37189000;50122000;31643000;32228000;116976000;28044000;;60359000;88403000;205379000;41828000;33000;48530000;35124000;50748000;99278000;341258000;;-247233000;106101000;205379000
MXWL;755086;USD;2016;Q4;2016-12-31;2017-03-01;31999000;31814000;25359000;20441000;32248000;82455000;26120000;;32299000;58419000;140874000;25333000;40000;29340000;43000;10712000;40052000;299526000;;-204104000;100822000;140874000
MXWL;755086;USD;2015;Q4;2015-12-31;2016-02-17;31567000;31567000;24382000;43172000;39055000;109602000;32324000;;30087000;62411000;172013000;40657000;42000;43765000;49000;9072000;52837000;294681000;;-180399000;119176000;172013000
MXWL;755086;USD;2014;Q4;2014-12-31;2015-02-12;29327000;29158000;24732000;43698000;44856000;115712000;39223000;;31665000;70888000;186600000;36359000;15549000;53722000;20000;5925000;59647000;280296000;;-158066000;126953000;186600000
MXWL;755086;USD;2013;Q4;2013-12-31;2014-02-20;28909000;28987000;30647000;29869000;44736000;107566000;44941000;;37580000;82521000;190087000;34404000;7914000;44251000;100000;5626000;49877000;274881000;;-151794000;140210000;190087000
MXWL;755086;USD;2012;Q4;2012-12-31;2013-08-01;28742000;29186000;28739000;33420000;41620000;107007000;36235000;;33230000;69465000;176472000;31924000;9452000;49033000;83000;2506000;51539000;270536000;;-158134000;124933000;176472000
MXWL;755086;USD;2011;Q4;2011-12-31;2012-02-16;27861000;27433000;29289000;27973000;33234000;93648000;28541000;;32557000;61098000;154746000;42443000;5431000;49673000;68000;4029000;53702000;255722000;;-165308000;101044000;154746000
MXWL;755086;USD;2010;Q4;2010-12-31;2011-08-08;26489000;26489000;39829000;27141000;19290000;96973000;20129000;;32709000;52838000;149811000;34194000;3511000;39527000;12608000;22261000;61788000;241134000;;-163870000;88023000;149811000
MXWL;755086;USD;2018;Q4;2018-12-31;2019-02-14;46037000;46037000;58028000;19966000;33645000;114456000;24377000;;24898000;49275000;163731000;23659000;438000;28376000;37969000;44764000;73140000;374390000;;-283503000;90591000;163731000
ESL;758715;USD;2017;Q4;2017-09-30;2017-11-21;29972000;30154000;307826000;430524000;477969000;1268709000;348634000;;1502670000;1851304000;3120013000;369184000;17424000;393792000;759424000;890945000;1284737000;744952000;-308514000;1655187000;1835276000;3120013000
ESL;758715;USD;2016;Q4;2016-09-30;2016-11-23;29409000;29691000;258520000;421511000;447095000;1172630000;338034000;;1518726000;1856760000;3029390000;371951000;16774000;399538000;853796000;1023987000;1423525000;709647000;-308514000;1542778000;1605865000;3029390000
ESL;758715;USD;2015;Q4;2015-09-30;2015-11-25;29133000;29487000;191355000;380748000;446768000;1128814000;309399000;;1562275000;1871674000;3000488000;380114000;13376000;410596000;861457000;1042101000;1452697000;688955000;-289780000;1447120000;1547791000;3000488000
ESL;758715;USD;2014;Q4;2014-09-30;2014-12-22;31890000;32496000;238144000;379889000;433595000;1169504000;319342000;;1704621000;2023963000;3193467000;379391000;12774000;408129000;609720000;887338000;1295467000;662148000;-30262000;1387508000;1898000000;3193467000
ESL;758715;USD;2013;Q4;2013-09-30;2013-12-20;31391000;31963000;179178000;383666000;447663000;1091715000;371197000;;1799200000;2170397000;3262112000;384506000;21279000;408092000;667859000;969268000;1377360000;610799000;0;1285090000;1884752000;3262112000
ESL;758715;USD;2012;Q4;2012-09-30;2012-12-21;30861000;31817000;160675000;383362000;409837000;1035693000;356401000;;1835023000;2191424000;3227117000;380611000;10610000;396346000;838060000;1210236000;1606582000;575409000;;1120356000;1620535000;3227117000
ESL;758715;USD;2011;Q4;2011-09-30;2011-12-23;30612000;31185000;185035000;369826000;402548000;1039313000;368416000;;1970857000;2339273000;3378586000;392228000;11595000;418361000;1020028000;1386307000;1804668000;557826000;;1007821000;1573918000;3378586000
ESL;758715;USD;2010;Q4;2010-09-30;2010-12-21;30153000;30726000;422120000;309242000;262373000;1076585000;273770000;;1237383000;1511153000;2587738000;302596000;12646000;324377000;598972000;847862000;1172239000;534780000;;874781000;1415499000;2587738000
ESL;758715;USD;2018;Q4;2018-09-30;2018-11-21;29445000;29759000;372406000;441696000;457226000;1303877000;314806000;;1418234000;1733040000;3036917000;385328000;17546000;403018000;654922000;790772000;1193790000;757669000;-351964000;1732327000;1843127000;3036917000
NDLS;759987;USD;2017;Q4;2018-01-31;2018-03-15;41075551;41075551;3361000;2434000;9929000;22058000;152593000;;10582000;163175000;185233000;43869000;0;43869000;57624000;105503000;149372000;172049000;-35000000;-101188000;35861000;185233000
NDLS;759987;USD;2016;Q4;2017-01-31;2017-03-02;27934926;27934926;1837000;5438000;11285000;25788000;173533000;;10140000;183673000;209461000;49033000;;49033000;84676000;134610000;183643000;124575000;-35000000;-63706000;25818000;209461000
NDLS;759987;USD;2015;Q4;2016-01-31;2016-03-01;27708419;26938439;1912000;4990000;10494000;25401000;203713000;;10847000;214560000;239961000;32914000;;32914000;67732000;113275000;146189000;120935000;-35000000;7971000;93772000;239961000
NDLS;759987;USD;2014;Q4;2015-01-31;2015-02-24;29801191;30987394;1906000;4557000;9415000;22776000;205573000;;10190000;215763000;238539000;24129000;;25831000;27136000;72593000;98424000;121227000;-2848000;21736000;140115000;238539000
NDLS;759987;USD;2013;Q4;2014-01-31;2014-03-07;29479201;31829189;968000;4229000;7223000;18333000;167614000;;1855000;169469000;187802000;23035000;;24165000;6312000;39164000;63329000;116942000;-2777000;10308000;124473000;187802000
NDLS;759987;USD;2012;Q4;2013-01-31;2013-08-09;23238984;23309933;581000;4566000;6042000;16154000;136287000;;4554000;140841000;156995000;21987000;750000;23760000;93731000;122828000;146588000;7817000;0;2614000;10407000;156995000
NDLS;759987;USD;2018;Q4;2019-01-31;2019-03-15;43922303;42187464;4655000;2391000;9646000;23351000;138774000;;9907000;148681000;172032000;32428000;719000;33147000;44183000;86204000;119351000;198816000;-35000000;-111135000;52681000;172032000
LOPE;760533;USD;2018;Q4;2018-12-31;2019-02-20;47714000;48426000;189348000;46830000;;309466000;111039000;;903512000;1014551000;1324017000;44050000;36468000;80518000;23437000;29902000;110420000;257333000;-125452000;1082169000;1213597000;1324017000
LOPE;760533;USD;2017;Q4;2017-12-31;2018-02-21;47345000;48386000;242745000;10908000;;374862000;922284000;;6427000;928711000;1303573000;89251000;6691000;238135000;59925000;79487000;317622000;233193000;-100694000;854176000;985951000;1303573000
LOPE;760533;USD;2016;Q4;2016-12-31;2017-02-16;46475000;47459000;108572000;9538000;;230068000;855528000;;6897000;862425000;1092493000;68538000;31636000;226794000;66616000;92013000;318807000;213074000;-89394000;650916000;773686000;1092493000
LOPE;760533;USD;2015;Q4;2015-12-31;2016-02-17;46036000;47340000;106400000;8298000;;214897000;667483000;;9602000;677085000;891982000;65919000;7322000;188534000;74040000;93197000;281731000;177670000;-69332000;502402000;610251000;891982000
LOPE;760533;USD;2014;Q4;2014-12-31;2015-02-18;45698000;47142000;166022000;7605000;;267045000;478170000;;10498000;488668000;755713000;65149000;6707000;178711000;80283000;100770000;279481000;159046000;-53770000;370991000;476232000;755713000
LOPE;760533;USD;2013;Q4;2013-12-31;2014-02-20;45038000;46722000;164244000;7217000;;263703000;339596000;;12801000;352397000;616100000;58885000;6696000;165623000;86990000;105633000;271256000;133393000;-48432000;259525000;344844000;616100000
LOPE;760533;USD;2012;Q4;2012-12-31;2013-02-19;44145000;45345000;105111000;34951000;;214174000;269162000;;11587000;280749000;494923000;59157000;6688000;152727000;93687000;108137000;260864000;102604000;-39136000;170814000;234059000;494923000
LOPE;760533;USD;2011;Q4;2011-12-31;2012-02-21;43974000;44526000;21189000;11815000;;115414000;189947000;;12486000;202433000;317847000;39744000;2209000;121505000;20575000;33049000;154554000;86180000;-23894000;101367000;163293000;317847000
LOPE;760533;USD;2010;Q4;2010-12-31;2011-05-09;45744000;46351000;33637000;17983000;;133125000;123999000;;17972000;141971000;275096000;40571000;3699000;122848000;22032000;24747000;147595000;77907000;-782000;50821000;127501000;275096000
ECYT;760760;USD;2017;Q4;2017-12-31;2018-02-27;48026168;48026168;97471427;273044;;98572803;2182399;;7067;2189466;100762269;4546180;;4546180;;731944;5278124;404503113;;-308954535;95484145;100762269
ECYT;760760;USD;2016;Q4;2016-12-31;2017-03-13;42290896;42290896;138207416;55074;;140255710;3205077;;33567;3238644;143494354;5562174;;5562174;;784817;6346991;390811120;;-253622561;137147363;143494354
ECYT;760760;USD;2015;Q4;2015-12-31;2016-03-08;41986541;41986541;173600454;8678;;174875574;3398398;;111605;3510003;178385577;6188993;;6188993;;850447;7039440;381160524;;-209734988;171346137;178385577
ECYT;760760;USD;2014;Q4;2014-12-31;2015-03-13;41812375;46076868;125069654;706403;;127038338;3970665;81761177;31194;85763036;212801374;6884996;;6884996;;912260;7797256;373613285;;-168465239;205004118;212801374
ECYT;760760;USD;2013;Q4;2013-12-31;2014-03-05;36148877;36148877;123281088;6353180;;133331530;3839426;25571659;114961;29526046;162857576;13898337;;73663457;;965398;74628855;262096746;;-173924716;88228721;162857576
ECYT;760760;USD;2012;Q4;2012-12-31;2012-05-11;35912074;35912074;175837689;5689067;;184824842;3166905;25540649;546313;29253867;214078709;10464378;;62470225;;52035206;114505431;255392807;;-155892278;99573278;214078709
ECYT;760760;USD;2011;Q4;2011-12-31;2012-03-28;36000834;36000834;128084725;0;;129756024;1107851;0;811229;1919080;131675104;5470002;;5470002;12833179;12833179;18303181;251978707;;-138600520;113371923;131675104
ECYT;760760;USD;2010;Q4;2010-12-31;2011-08-12;;;16872783;;;20050225;863008;;300985;1163993;21214218;2579265;4318078;7673034;11123311;20652724;28325758;1157884;;-98068907;-7111540;21214218
CNK;760762;USD;2013;Q4;2013-12-31;2014-02-28;114080000;114769000;599929000;81519000;13735000;729599000;1427190000;178853000;1808521000;3414564000;4144163000;370975000;23703000;395712000;2025453000;2646034000;3041746000;1079423000;-51946000;147764000;1102417000;4144163000
CNK;760762;USD;2012;Q4;2012-12-31;2013-02-28;113383000;114377000;742664000;57122000;12571000;845161000;1304958000;78123000;1634984000;3018065000;3863226000;302694000;20610000;338204000;1893571000;2430038000;2768242000;1064134000;-48482000;106111000;1094984000;3863226000
GWRS;761716;USD;2017;Q4;2017-12-31;2018-03-09;19631957;19642732;5248000;1528000;;9665000;213459000;;15444000;228903000;238568000;7573000;8000;8976000;114363000;214732000;223708000;14484000;0;376000;14860000;238568000
GWRS;761716;USD;2016;Q4;2016-12-31;2017-03-10;19590818;19561480;20498000;1471000;;24740000;200489000;;13590000;214079000;238819000;9393000;25000;10901000;114317000;212929000;223830000;19164000;;-4175000;14989000;238819000
GWRS;761716;USD;2015;Q4;2015-12-31;2016-06-09;18253793;18253793;11513000;1132000;;18715000;194152000;;22875000;217027000;235742000;6459000;1994000;10663000;102417000;205016000;215679000;21661000;;-1598000;20063000;235742000
GWRS;761716;USD;2018;Q4;2018-12-31;2019-03-07;21514019;21558872;12756000;1488000;;17334000;227055000;;18072000;245127000;262461000;8069000;47000;9576000;114507000;225014000;234590000;27872000;-1000;0;27871000;262461000
AAWW;762204;USD;2018;Q4;2018-12-31;2019-02-19;25592000;32856000;237125000;269320000;;629831000;4462235000;635000;442091000;4904961000;5534792000;552898000;264835000;817733000;2205005000;2649095000;3466828000;736341000;-204501000;1539956000;2067964000;5534792000
AAWW;762204;USD;2017;Q4;2017-12-31;2018-02-22;25283000;25619000;294413000;194478000;;587586000;4003101000;15371000;349404000;4367876000;4955462000;520583000;218013000;738596000;2008986000;2427010000;3165606000;716036000;-193732000;1271545000;1789856000;4955462000
AAWW;762204;USD;2016;Q4;2016-12-31;2017-02-23;25009000;25569000;128203000;166486000;;358070000;3540682000;27951000;320676000;3889309000;4247379000;380430000;184748000;565178000;1666663000;2164863000;2730041000;657378000;-183119000;1048072000;1517338000;4247379000
AAWW;762204;USD;2015;Q4;2015-12-31;2016-02-18;49480124;50050930;431048000;164308000;;651937000;3335196000;37604000;139666000;3512466000;4164403000;386416000;161811000;548227000;1739496000;2161993000;2710220000;625534000;-171844000;1006556000;1454183000;4164403000
AAWW;762204;USD;2014;Q4;2014-12-31;2015-02-12;-75219876;-75393492;316403000;162092000;;565181000;3172227000;120478000;149391000;3442096000;4007277000;294458000;181193000;475651000;1736747000;2113831000;2589482000;573419000;-145322000;999270000;1417795000;4007277000
AAWW;762204;USD;2013;Q4;2013-12-31;2014-02-13;25019000;25141000;332720000;132159000;;593953000;2828965000;130267000;165074000;3124306000;3718259000;259659000;157486000;417145000;1539139000;1978989000;2396134000;561763000;-125826000;892513000;1322125000;3718259000
AAWW;762204;USD;2012;Q4;2012-12-31;2013-02-13;26445000;26617000;419882000;127704000;;632995000;2211539000;140498000;167653000;2519690000;3152685000;173256000;154760000;328016000;1149282000;1536565000;1864581000;544698000;-44850000;798676000;1288104000;3152685000
AAWW;762204;USD;2011;Q4;2011-12-31;2012-02-15;26307000;26456000;195208000;93213000;;393837000;1748233000;135735000;113193000;1997161000;2390998000;202650000;70007000;272657000;680009000;976966000;1249623000;525945000;-41499000;668749000;1141375000;2390998000
AAWW;762204;USD;2010;Q4;2010-12-31;2011-08-02;103046792;104273886;595063000;75101000;;727432000;993923000;127094000;87653000;1208670000;1936102000;172846000;96197000;269043000;391036000;616969000;886012000;505567000;-32248000;572666000;1050090000;1936102000
BKS;763488;USD;2017;Q4;2017-04-30;2018-06-21;72653000;72653000;10769000;64562000;958196000;1098680000;255524000;;395364000;650888000;1749568000;719105000;;1042570000;158700000;295015000;1337585000;1749667000;-1121724000;-216236000;411983000;1749568000
BKS;763488;USD;2016;Q4;2016-04-30;2017-06-22;72056000;72483000;11993000;67294000;946909000;1128012000;276122000;;528787000;804909000;1932921000;756843000;;1108267000;64900000;250343000;1358610000;1741492000;-1121071000;-46425000;574311000;1932921000
BKS;763488;USD;2015;Q4;2015-04-30;2016-06-23;73680000;74140000;13838000;124917000;933723000;1178390000;298580000;;535812000;834392000;2012782000;840768000;;1193871000;47200000;215401000;1409272000;1738146000;-1110438000;-24349000;603510000;2012782000
BKS;763488;USD;2014;Q4;2014-04-30;2015-06-26;63200000;63422000;14646000;60265000;995738000;1612240000;341735000;;1158456000;1500191000;3112431000;811234000;;1472993000;;254021000;1727014000;1928095000;-1079716000;357512000;1385417000;3112431000
BKS;763488;USD;2013;Q4;2013-04-30;2014-06-27;-34554210;-52914210;340171000;143981000;1284976000;1980438000;490713000;;1066298000;1557011000;3537449000;1237695000;127250000;1721645000;383397000;962311000;2683956000;1395557000;-1069109000;344021000;853493000;3537449000
BKS;763488;USD;2012;Q4;2012-04-30;2013-07-29;89478990;89478990;160470000;149369000;1410769000;2047135000;584909000;;1100492000;1685401000;3732536000;1374434000;;1715470000;458627000;1109788000;2825258000;1383941000;-1063855000;410349000;907278000;3732536000
BKS;763488;USD;2011;Q4;2011-04-30;2012-06-27;88071390;69595110;54131000;169947000;1561841000;2007243000;622655000;;1144801000;1767456000;3774699000;1475342000;;1796704000;324200000;933451000;2730155000;1341000000;-1058282000;586188000;1044544000;3774699000
BKS;763488;USD;2010;Q4;2010-04-30;2011-06-29;87179400;86962140;59429000;150294000;1375362000;1747021000;704651000;;1144794000;1849445000;3596466000;1401096000;;1712188000;313100000;963781000;2675969000;1323353000;-1054192000;662966000;920497000;3596466000
BKS;763488;USD;2009;Q4;2009-04-30;2010-09-09;85060350;87451740;60965000;106576000;1370111000;1719477000;812034000;;1174175000;1986209000;3705686000;1624408000;100000000;1724408000;260400000;1077910000;2802318000;1286304000;-1052356000;681082000;903368000;3705686000
BKS;763488;USD;2018;Q4;2018-04-30;2019-06-19;73033000;73558000;9443000;61247000;923714000;1064211000;256790000;;384633000;641423000;1705634000;687091000;;902550000;203800000;358587000;1261137000;1753642000;-1122620000;-186823000;444497000;1705634000
GEL;767446;USD;2017;Q4;2017-12-31;2018-02-26;;;9041000;495449000;88653000;636033000;4866029000;381550000;1253869000;6501448000;7137481000;456264000;;456264000;3698118000;3966602000;4422866000;2017464000;;;2714615000;7137481000
GEL;767446;USD;2016;Q4;2016-12-31;2017-02-27;;;7029000;224682000;98587000;359569000;4214864000;408756000;719403000;5343023000;5702592000;260803000;;260803000;3091369000;3321739000;3582542000;2120050000;;;2120050000;5702592000
GEL;767446;USD;2015;Q4;2015-12-31;2016-02-26;;;10895000;219532000;43775000;306316000;3931979000;474392000;746912000;5153283000;5459599000;302136000;;302136000;2922054000;3136712000;3438848000;2020751000;;;2020751000;5459599000
GEL;767446;USD;2014;Q4;2014-12-31;2015-02-27;;;9462000;271529000;46829000;355366000;1631001000;628780000;595477000;2855258000;3210624000;363145000;;363145000;1581289000;1618276000;1981421000;1229203000;;;1229203000;3210624000
GEL;767446;USD;2013;Q4;2013-12-31;2014-02-27;;;8866000;368033000;85330000;535223000;1128744000;620247000;577988000;2326979000;2862202000;446553000;;446553000;1283572000;1317912000;1764465000;1097737000;;;1097737000;2862202000
GEL;767446;USD;2012;Q4;2012-12-31;2013-02-26;;;11282000;270925000;87050000;404034000;565281000;549235000;591114000;1705630000;2109664000;312651000;;312651000;850895000;880518000;1193169000;916495000;;;916495000;2109664000
GEL;767446;USD;2011;Q4;2011-12-31;2012-02-29;;;10817000;237989000;101124000;376104000;416925000;326947000;610868000;1354740000;1730844000;249428000;;249428000;659300000;688778000;938206000;792638000;;;792638000;1730844000
GEL;767446;USD;2010;Q4;2010-12-31;2011-08-08;;;5762000;171550000;55428000;252538000;265056000;343434000;645707000;1254197000;1506735000;206714000;;206714000;610000000;630757000;837471000;669264000;;;669264000;1506735000
GEL;767446;USD;2018;Q4;2018-12-31;2019-02-28;;;10300000;323462000;73531000;443279000;4417033000;355085000;1263674000;6035792000;6479071000;332834000;;332834000;3432463000;3704237000;4037071000;1680534000;;;2442000000;6479071000
ETE;767563;USD;2018;Q4;2018-12-31;2019-02-22;;;419000000;4009000000;1677000000;6750000000;66963000000;;14533000000;81496000000;88246000000;3493000000;2655000000;9310000000;43373000000;47587000000;56897000000;20601000000;;;31349000000;88246000000
SPXC;768069;USD;2018;Q4;2018-12-31;2019-02-15;43376000;44660000;68800000;269100000;128800000;598400000;184200000;;1274900000;1459100000;2057500000;340800000;49900000;470200000;331900000;1172400000;1642600000;1295900000;-475800000;-650100000;414900000;2057500000
SPXC;768069;USD;2017;Q4;2017-12-31;2018-02-21;42616000;45714000;124300000;267500000;143000000;632500000;186600000;;1221300000;1407900000;2040400000;453500000;7500000;461000000;349300000;1264700000;1725700000;1310300000;-503400000;-742300000;314700000;2040400000
SPXC;768069;USD;2016;Q4;2016-12-31;2017-02-24;41832000;43022000;99600000;251700000;145700000;527600000;195500000;;1189400000;1384900000;1912500000;443600000;32700000;476300000;323500000;1244600000;1720900000;1308400000;-520300000;-831600000;191600000;1912500000
SPXC;768069;USD;2015;Q4;2015-12-31;2016-02-26;41164000;41164000;97200000;305100000;161300000;782300000;205300000;;1191700000;1397000000;2179300000;508400000;31200000;654800000;340600000;1216200000;1871000000;2650600000;-3486300000;897800000;308300000;2179300000
SPXC;768069;USD;2014;Q4;2014-12-31;2015-02-23;-218880184;-223019522;237200000;473500000;167400000;2215100000;237900000;;3441300000;3679200000;5894300000;658500000;185600000;1609900000;547500000;2472500000;4082400000;2609000000;-3491500000;2628600000;1811900000;5894300000
SPXC;768069;USD;2013;Q4;2013-12-31;2014-02-21;-361716655;-365796689;691800000;1210400000;505900000;2733000000;696500000;;3426700000;4123200000;6856200000;1561400000;585600000;2174400000;1090000000;2509800000;4684200000;2576000000;-3008600000;2303100000;2172000000;6856200000
SPXC;768069;USD;2012;Q4;2012-12-31;2013-02-22;196957629;189488178;984100000;1311800000;522900000;3202500000;728800000;;3198800000;3927600000;7130100000;1705900000;42100000;1782900000;1649900000;3111700000;4894600000;2552600000;-2751600000;2138400000;2235500000;7130100000
SPXC;768069;USD;2011;Q4;2011-12-31;2012-02-24;200773760;201230425;551000000;1221200000;587200000;3289000000;649500000;;3453300000;4102800000;7391800000;1644800000;75500000;1962000000;1925600000;3192500000;5154500000;2495800000;-2510300000;2488300000;2237300000;7391800000
SPXC;768069;USD;2010;Q4;2010-12-31;2011-02-22;198331595;201440888;455400000;970100000;455400000;2802400000;494600000;;2696300000;3190900000;5993300000;1434900000;87100000;1732100000;1110500000;2157200000;3889300000;2447800000;-2516100000;2358600000;2104000000;5993300000
SPXC;768069;USD;2009;Q4;2009-12-31;2010-02-26;;;522900000;1044700000;559300000;2312600000;546300000;;2866100000;3412400000;5725000000;1501900000;150400000;1659900000;1128600000;2183600000;3843500000;2404700000;-2523300000;2203000000;1881500000;5725000000
SPXC;768069;USD;2008;Q4;2008-12-31;2009-08-12;;;475900000;1306000000;666800000;2838800000;500400000;;2798900000;3299300000;6138100000;1831800000;189300000;2045000000;1155400000;2068300000;4113300000;2366200000;-2416000000;2220500000;2024800000;6138100000
RGLS;768206;USD;2017;Q4;2017-12-31;2018-03-08;8719702;8719702;60074000;;;66736000;9708000;;1365000;11073000;77809000;10723000;19859000;32600000;;9993000;42593000;381208000;;-345858000;35216000;77809000
RGLS;768206;USD;2016;Q4;2016-12-31;2017-03-03;4408666;4408666;76111000;;;87474000;11830000;;1357000;13187000;100661000;13735000;0;13807000;19802000;30779000;44586000;329549000;;-273351000;56075000;100661000
RGLS;768206;USD;2015;Q4;2015-12-31;2016-02-23;4374108;4374108;114063000;;;134258000;5400000;;1425000;6825000;141083000;11438000;;12632000;0;4373000;17005000;315726000;;-191515000;124078000;141083000
RGLS;768206;USD;2014;Q4;2014-12-31;2015-02-19;3906914;3666488;159743000;;;164951000;3568000;;2961000;6529000;171480000;8698000;23397000;35192000;;4274000;39466000;267978000;;-135767000;132014000;171480000
RGLS;768206;USD;2013;Q4;2013-12-31;2014-02-28;3489914;3373224;114005000;;;117182000;3768000;;2115000;5883000;123065000;5482000;11279000;21649000;;7959000;29608000;172560000;;-79087000;93457000;123065000
RGLS;768206;USD;2012;Q4;2012-12-31;2013-02-19;2672363627;2672363627;98100000;;;98929000;3310000;;1279000;4589000;103518000;2317000;10134000;22902000;;18523000;41425000;122564000;;-60419000;62093000;103518000
RGLS;768206;USD;2011;Q4;2011-12-31;2012-11-19;29497383;29497383;38144000;;;38666000;3110000;;1105000;4215000;42881000;2115000;;12850000;10000000;28834000;41684000;1584000;;-43011000;1197000;42881000
RGLS;768206;USD;2018;Q4;2018-12-31;2019-03-18;8816085;8816085;13935000;;;19295000;7806000;;826000;8632000;27927000;4940000;16575000;26646000;;7135000;33781000;386869000;;-392723000;-5854000;27927000
LSTR;770173;USD;2017;Q4;2017-12-31;2018-02-23;41981000;42060000;291344000;631164000;;961203000;276011000;;115246000;391257000;1352460000;378220000;84293000;548643000;83062000;149940000;698583000;210276000;-1167600000;1611158000;653877000;1352460000
LSTR;770173;USD;2016;Q4;2016-12-31;2017-02-24;41779000;41928000;245457000;463102000;;737407000;272843000;;86341000;359184000;1096591000;227178000;81298000;380311000;93257000;173723000;554034000;200090000;-1167437000;1512993000;542557000;1096591000
LSTR;770173;USD;2015;Q4;2015-12-31;2016-02-19;42730000;42852000;163343000;462699000;;656118000;225927000;;109473000;335400000;991518000;223709000;78108000;369537000;81793000;155744000;525281000;196515000;-1116765000;1389975000;466237000;991518000
LSTR;770173;USD;2014;Q4;2014-12-31;2015-02-23;44769000;45015000;200951000;492642000;;732328000;202203000;;109681000;311884000;1044212000;264871000;69693000;410451000;76257000;145500000;555951000;189685000;-955613000;1255374000;488261000;1044212000
LSTR;770173;USD;2013;Q4;2013-12-31;2014-02-21;45688000;45876000;215241000;378732000;;682468000;177329000;;110899000;288228000;970696000;173717000;55347000;375660000;73938000;140555000;516215000;180477000;-899028000;1173044000;454481000;970696000
LSTR;770173;USD;2012;Q4;2012-12-31;2013-02-21;46463000;46611000;109812000;408787000;;591944000;158953000;;128524000;287477000;879421000;188981000;52663000;344339000;95125000;155628000;499967000;174645000;-839517000;1042956000;379454000;879421000
LSTR;770173;USD;2011;Q4;2011-12-31;2012-02-24;46766000;46897000;108844000;368377000;;551792000;142146000;;114511000;256657000;808449000;163307000;43117000;331113000;115130000;176759000;507872000;166378000;-813684000;947156000;300577000;808449000
LSTR;770173;USD;2010;Q4;2010-12-31;2011-02-23;48328000;48340000;67972000;307350000;;420917000;132649000;;130316000;262965000;683882000;137297000;47049000;278346000;99439000;154569000;432915000;169933000;-763182000;844132000;250967000;683882000
LSTR;770173;USD;2009;Q4;2009-12-31;2010-07-30;50405000;50599000;110044000;278854000;;426612000;116656000;;105524000;222180000;648792000;121030000;53504000;258635000;68313000;122006000;380641000;161924000;-660446000;766040000;268151000;648792000
LSTR;770173;USD;2018;Q4;2018-12-31;2019-02-22;40503000;40514000;239794000;691604000;;971429000;284032000;;125103000;409135000;1380564000;343623000;98900000;535818000;84864000;155613000;691431000;227531000;-1376111000;1841279000;689133000;1380564000
DOMO;770174;USD;2017;Q4;2018-01-31;2018-09-13;1628000;1628000;61972000;35484000;;113261000;14952000;;27142000;42094000;155355000;61549000;;128261000;46332000;55900000;184161000;35301000;;-757773000;-28808000;155353000
DOMO;770174;USD;2018;Q4;2019-01-31;2019-04-15;26938000;26938000;176973000;48421000;;246754000;12595000;;33283000;45878000;292632000;50748000;;139707000;97245000;108398000;248105000;956145000;;-912082000;44527000;292632000
DBD;770497;USD;2017;Q4;2017-12-31;2018-02-28;75700000;75700000;616600000;830100000;728900000;2500300000;364500000;96800000;2280500000;2741800000;5242100000;761100000;66700000;1796700000;1787100000;2451900000;4248600000;834700000;-567400000;393600000;993500000;5242100000
DBD;770497;USD;2016;Q4;2016-12-31;2017-02-24;75200000;74600000;716800000;835900000;737700000;2619600000;387000000;94700000;2169000000;2650700000;5270300000;733000000;106900000;1824500000;1691400000;2376900000;4201400000;832400000;-562400000;662700000;1068900000;5270300000
DBD;770497;USD;2015;Q4;2015-12-31;2016-02-29;65000000;66500000;353500000;413900000;369300000;1643600000;175300000;85200000;338300000;598800000;2242400000;358200000;32000000;955800000;606200000;851100000;1806900000;530400000;-560200000;760300000;435500000;2242400000
DBD;770497;USD;2014;Q4;2014-12-31;2015-02-17;64500000;65500000;462800000;403300000;374700000;1655500000;165700000;83600000;437300000;686600000;2342100000;358000000;25600000;1027800000;479800000;759500000;1787300000;517000000;-557200000;762200000;554800000;2342100000
DBD;770497;USD;2013;Q4;2013-12-31;2014-03-03;63964000;63964000;473697000;447239000;376462000;1555350000;160895000;82591000;384655000;628141000;2183491000;304244000;43791000;893736000;480242000;668940000;1562676000;483594000;-555252000;722743000;620815000;2183491000
DBD;770497;USD;2012;Q4;2012-12-31;2013-02-15;63244000;64154000;630678000;488373000;412996000;1814857000;184345000;77101000;516684000;778130000;2592987000;294787000;34212000;857344000;617534000;908821000;1766165000;455357000;-551189000;978345000;826822000;2592987000
DBD;770497;USD;2011;Q4;2011-12-31;2012-02-17;62560000;63270000;620773000;414969000;440900000;1732355000;192694000;74869000;517525000;785088000;2517443000;301818000;21722000;824217000;606154000;834966000;1659183000;423856000;-547737000;991210000;858260000;2517443000
DBD;770497;USD;2010;Q4;2010-12-31;2011-02-22;65689000;63795000;601781000;404501000;444575000;1714036000;203462000;76138000;526154000;805754000;2519790000;292803000;15038000;809765000;550368000;720211000;1529976000;404155000;-435922000;919296000;989814000;2519790000
DBD;770497;USD;2009;Q4;2009-12-31;2010-08-09;66320000;67038000;505868000;330982000;448243000;1588085000;204820000;73989000;687971000;966780000;2554865000;225430000;16915000;743091000;553008000;739748000;1482839000;385805000;-410153000;1011448000;1072026000;2554865000
DBD;770497;USD;2018;Q4;2018-12-31;2019-03-01;76100000;76100000;491900000;737200000;610100000;2203400000;304100000;22400000;1782000000;2108500000;4311900000;693800000;49500000;1568400000;2190000000;2772700000;4341100000;856000000;-570400000;-168300000;-29200000;4311900000
MTOR;772948;USD;2017;Q4;2017-09-30;2017-11-16;88300000;87000000;88000000;789000000;378000000;1298000000;474000000;;1010000000;1484000000;2782000000;622000000;288000000;1182000000;750000000;1305000000;2487000000;866000000;-136000000;83000000;295000000;2782000000
MTOR;772948;USD;2016;Q4;2016-09-30;2016-12-01;86800000;89200000;160000000;396000000;316000000;905000000;439000000;;1150000000;1589000000;2494000000;475000000;14000000;757000000;982000000;1923000000;2680000000;975000000;-136000000;-241000000;-186000000;2494000000
MTOR;772948;USD;2015;Q4;2015-09-30;2015-11-18;94900000;96000000;193000000;461000000;338000000;1042000000;419000000;;734000000;1153000000;2195000000;574000000;15000000;868000000;1036000000;1973000000;2841000000;964000000;-55000000;-814000000;-646000000;2195000000
MTOR;772948;USD;2014;Q4;2014-09-30;2014-11-20;97500000;97400000;247000000;610000000;379000000;1292000000;424000000;;769000000;1193000000;2485000000;680000000;7000000;1038000000;948000000;2032000000;3070000000;1015000000;0;-878000000;-585000000;2485000000
MTOR;772948;USD;2013;Q4;2013-09-30;2013-11-20;97300000;97300000;318000000;596000000;414000000;1384000000;417000000;;769000000;1186000000;2570000000;694000000;13000000;1046000000;1125000000;2346000000;3392000000;1011000000;;-1127000000;-822000000;2570000000
MTOR;772948;USD;2012;Q4;2012-09-30;2012-11-21;96400000;99900000;257000000;542000000;438000000;1298000000;417000000;;786000000;1203000000;2501000000;697000000;18000000;1028000000;1042000000;2455000000;3483000000;997000000;;-1105000000;-982000000;2501000000
MTOR;772948;USD;2011;Q4;2011-09-30;2011-11-23;94400000;96900000;217000000;712000000;460000000;1459000000;421000000;;783000000;1204000000;2663000000;841000000;84000000;1253000000;950000000;2371000000;3624000000;991000000;;-1157000000;-961000000;2663000000
MTOR;772948;USD;2010;Q4;2010-09-30;2011-03-03;93400000;105000000;343000000;579000000;382000000;1721000000;389000000;;769000000;1158000000;2879000000;670000000;0;1390000000;1029000000;2512000000;3902000000;978000000;;-1220000000;-1023000000;2879000000
MTOR;772948;USD;2018;Q4;2018-09-30;2018-11-16;85600000;95200000;115000000;588000000;477000000;1226000000;483000000;;1017000000;1500000000;2726000000;700000000;94000000;1084000000;730000000;1325000000;2409000000;889000000;-236000000;200000000;317000000;2726000000
SGMO;773304;USD;2017;Q4;2017-12-31;2018-03-01;85034000;85034000;243308000;3343000;;248397000;31066000;1012000;6266000;38344000;286741000;16514000;;44859000;24738000;53982000;98841000;683665000;;-495479000;187900000;286741000
SGMO;773304;USD;2016;Q4;2016-12-31;2017-02-28;70734000;70734000;142535000;4972000;;149580000;6557000;;1754000;8311000;157891000;9146000;;13291000;3945000;8405000;21696000;577086000;;-440911000;136195000;157891000
SGMO;773304;USD;2015;Q4;2015-12-31;2016-02-18;70169000;70169000;209000000;2521000;;212582000;2916000;;1737000;4653000;217235000;10977000;;20097000;;4699000;24796000;561692000;;-369253000;192439000;217235000
SGMO;773304;USD;2014;Q4;2014-12-31;2015-02-25;68679000;68679000;178962000;10368000;;190879000;1479000;47260000;3594000;52333000;243212000;11557000;;20882000;;15697000;36579000;535208000;;-328550000;206633000;243212000
SGMO;773304;USD;2013;Q4;2013-12-31;2014-02-24;61947000;61947000;92813000;3155000;;97274000;1406000;38663000;3495000;43564000;140838000;7574000;;10131000;;8997000;19128000;423831000;;-302133000;121710000;140838000
SGMO;773304;USD;2012;Q4;2012-12-31;2013-02-26;52972000;52972000;63547000;4129000;;68365000;1543000;12584000;41000;14168000;82533000;6486000;;8790000;;8847000;17637000;340379000;;-275509000;64896000;82533000
SGMO;773304;USD;2011;Q4;2011-12-31;2012-02-23;52498000;52498000;84132000;919000;;85692000;1603000;;41000;1644000;87336000;7187000;;7204000;;0;7204000;333365000;;-253245000;80132000;87336000
SGMO;773304;USD;2010;Q4;2010-12-31;2011-08-05;;;60285000;366000;;61314000;1673000;;12000;1685000;62999000;7011000;;7092000;;0;7092000;273408000;;-217495000;55907000;62999000
SGMO;773304;USD;2018;Q4;2018-12-31;2019-03-01;102438000;102438000;400133000;4673000;;410521000;78723000;;101151000;179874000;590395000;30947000;;78511000;27689000;144627000;223138000;930654000;;-562696000;367257000;590395000
CVGI;773452;USD;2017;Q4;2017-12-31;2018-03-12;30147000;28632000;52244000;108595000;99015000;274646000;64630000;;45112000;109742000;384388000;120552000;3191000;123743000;163758000;185903000;309646000;240174000;-9114000;-115083000;74742000;384388000
CVGI;773452;USD;2016;Q4;2016-12-31;2017-03-09;29773000;30146000;130160000;97793000;71054000;308948000;66041000;;53776000;119817000;428765000;106255000;0;106255000;233154000;254820000;361075000;237666000;-7753000;-113378000;67690000;428765000
CVGI;773452;USD;2015;Q4;2015-12-31;2016-03-11;29389000;29670000;92194000;130240000;75658000;308277000;70961000;;54804000;125765000;434042000;114853000;;114853000;232363000;253259000;368112000;235054000;-7039000;-122431000;65930000;434042000
CVGI;773452;USD;2014;Q4;2014-12-31;2015-03-16;29093000;29146000;70091000;139912000;83776000;300130000;73462000;;69335000;142797000;442927000;107512000;;107512000;250000000;276579000;384091000;232203000;-6622000;-129492000;58836000;442927000
CVGI;773452;USD;2013;Q4;2013-12-31;2014-03-17;28819000;28819000;72695000;119069000;80133000;287613000;78876000;;65952000;144828000;432441000;102565000;;102565000;250000000;269935000;372500000;229433000;-6095000;-137122000;59941000;432441000
CVGI;773452;USD;2012;Q4;2012-12-31;2013-03-11;28406000;28482000;68369000;114573000;88481000;286250000;83304000;;70111000;153415000;439665000;90932000;;90932000;250000000;282425000;373357000;224112000;-5264000;-124677000;66308000;439665000
CVGI;773452;USD;2011;Q4;2011-12-31;2012-03-13;55831233;56394233;87955000;130297000;79423000;306982000;76672000;;23230000;99902000;406884000;113199000;;113199000;250000000;280910000;394109000;219397000;-4059000;-174754000;12775000;406884000
CVGI;773452;USD;2010;Q4;2010-12-31;2011-08-03;27678000;28224000;42591000;91101000;66622000;211423000;59321000;;15463000;74784000;286207000;95346000;;95346000;164987000;190973000;286319000;215771000;-2851000;-193359000;-112000;286207000
AIMC;773555;USD;2017;Q4;2017-12-31;2018-02-23;29047000;29171000;51994000;135499000;145611000;358163000;191918000;;370576000;562494000;920657000;142108000;384000;142492000;275587000;381460000;523952000;223365000;;223204000;396705000;920657000
AIMC;773555;USD;2016;Q4;2016-12-31;2017-02-27;25711000;25740000;69118000;120319000;139840000;344187000;177043000;;348594000;525637000;869824000;127933000;43690000;171623000;325969000;414853000;586476000;168326000;;191108000;283348000;869824000
AIMC;773555;USD;2015;Q4;2015-12-31;2016-02-26;25551000;25484000;50320000;94720000;121156000;287156000;145413000;;199763000;345176000;632332000;101162000;3187000;104349000;231568000;285416000;389765000;124860000;;181539000;242567000;632332000
AIMC;773555;USD;2014;Q4;2014-12-31;2015-02-26;26655000;27288000;47503000;106458000;132736000;301561000;156366000;;218475000;374841000;676402000;104332000;15176000;119508000;240576000;297252000;416760000;139113000;;161061000;259642000;676402000
AIMC;773555;USD;2013;Q4;2013-12-31;2014-02-26;26818000;27010000;63604000;109084000;143665000;349205000;157535000;;228936000;386471000;735676000;123105000;16924000;140073000;261348000;325279000;465352000;154498000;;133231000;270324000;735676000
AIMC;773555;USD;2012;Q4;2012-12-31;2013-02-25;26737000;26992000;85154000;92933000;123776000;323756000;138094000;;171189000;309283000;633039000;96731000;9135000;105900000;238460000;293888000;399788000;152215000;;103200000;233251000;633039000
AIMC;773555;USD;2011;Q4;2011-12-31;2012-02-24;26580000;26880000;92515000;91859000;125970000;330640000;123464000;;175881000;299345000;629985000;101300000;688000;102106000;263361000;319483000;421589000;150261000;;83211000;208396000;629985000
AIMC;773555;USD;2010;Q4;2010-12-31;2011-08-09;26504000;26709000;72723000;67403000;88217000;242535000;105298000;;160269000;265567000;508102000;83440000;3393000;86892000;213109000;256458000;343350000;133887000;;45536000;164752000;508102000
AIMC;773555;USD;2018;Q4;2018-12-31;2019-03-01;64389000;66171000;169000000;259800000;231200000;704000000;364400000;;3268800000;3633200000;4337200000;319900000;17200000;337100000;1690900000;2151900000;2489000000;1687200000;;232600000;1848200000;4337200000
RA;774807;USD;2011;Q4;2011-06-30;2012-03-29;;;112300000;174400000;62300000;635700000;51100000;;877300000;928400000;1564100000;273900000;0;560500000;603800000;861000000;1421500000;594300000;-30700000;-422800000;142600000;1564100000
CALM;776100;USD;2018;Q4;2018-06-30;2018-07-23;48391000;48736000;331017000;85839000;168644000;587520000;425384000;;137543000;562927000;1150447000;104302000;3536000;107838000;2554000;86927000;194765000;54074000;-24966000;924918000;955682000;1150447000
CALM;776100;USD;2017;Q4;2017-06-30;2017-07-24;48663000;48532000;156026000;61261000;160692000;436206000;458184000;;138704000;596888000;1033094000;59853000;4826000;64679000;6113000;123922000;188601000;50683000;-23914000;816046000;844493000;1033094000
CALM;776100;USD;2016;Q4;2016-06-30;2016-07-18;48249000;48234000;389545000;62012000;154799000;626283000;392274000;;93208000;485482000;1111765000;67131000;16320000;83451000;9250000;110953000;194404000;47155000;-22272000;890440000;917361000;1111765000
CALM;776100;USD;2015;Q4;2015-06-30;2015-07-20;48141000;48498000;258628000;99013000;146260000;508964000;358790000;;60899000;419689000;928653000;91481000;10065000;101546000;40795000;122545000;224091000;44055000;-20482000;679969000;704562000;928653000
CALM;776100;USD;2014;Q4;2014-06-30;2014-07-28;48116000;48327000;209259000;82978000;146117000;445393000;314935000;;51333000;366268000;811661000;80434000;10216000;121101000;50877000;95815000;216916000;40852000;-20453000;572874000;594746000;811662000
CALM;776100;USD;2013;Q4;2013-06-30;2013-08-05;48074000;48272000;182888000;79352000;147993000;414881000;266008000;;64738000;330746000;745627000;71827000;10373000;130195000;54647000;97388000;227583000;39428000;-20572000;498711000;518045000;745628000
CALM;776100;USD;2012;Q4;2012-06-30;2012-08-06;47776000;47848000;260751000;58630000;117158000;442202000;222615000;;61499000;284114000;726316000;103724000;11458000;140656000;64762000;106332000;246988000;34027000;-20843000;466164000;479329000;726317000
CALM;776100;USD;2011;Q4;2011-06-30;2011-09-30;47728000;47892000;176429000;54774000;110021000;355041000;224887000;;60915000;285802000;640843000;71969000;11743000;107482000;76418000;114484000;221966000;33795000;-20929000;406361000;418878000;640844000
CALM;776100;USD;2019;Q4;2019-06-30;2019-07-22;48670000;48773000;319428000;71760000;172237000;567753000;455347000;;133178000;588525000;1156278000;73211000;1696000;74907000;858000;91565000;166472000;57608000;-25866000;954527000;989806000;1156278000
GHDX;776327;USD;2017;Q4;2017-12-31;2018-03-14;34868000;34868000;129575000;31161000;;174260000;46440000;;10917000;57357000;231617000;39193000;;39516000;;3810000;43326000;464640000;-30110000;-245945000;188291000;231617000
GHDX;776327;USD;2016;Q4;2016-12-31;2017-03-15;33374000;33374000;96989000;35179000;;145964000;45688000;;9462000;55150000;201114000;40944000;;41175000;;3834000;45009000;427105000;-30110000;-242088000;156105000;201114000
GHDX;776327;USD;2015;Q4;2015-12-31;2016-03-09;32477000;32477000;94943000;37164000;;142950000;39746000;;1921000;41667000;184617000;42033000;;42672000;;2410000;45082000;395062000;-30110000;-228169000;139535000;184617000
GHDX;776327;USD;2014;Q4;2014-12-31;2015-03-12;31802000;31802000;103660000;34916000;;148520000;21860000;;15541000;37401000;185921000;37795000;;38338000;;2070000;40408000;370499000;-30110000;-194861000;145513000;185921000
GHDX;776327;USD;2013;Q4;2013-12-31;2014-03-11;30824000;29161000;105350000;29446000;;144992000;18290000;;13752000;32042000;177034000;28954000;;29832000;;2221000;32053000;345348000;-30110000;-170269000;144981000;177034000
GHDX;776327;USD;2012;Q4;2012-12-31;2013-03-15;30610000;32357000;99065000;22253000;;130209000;14104000;;9421000;23525000;153734000;24723000;;25340000;;2068000;27408000;313918000;-30095000;-157512000;126326000;153734000
GHDX;776327;USD;2011;Q4;2011-12-31;2012-03-14;29653000;32234000;100474000;21077000;;128995000;9443000;;4560000;14003000;142998000;24047000;;26139000;;1500000;27639000;281150000;;-165761000;115359000;142998000
GHDX;776327;USD;2010;Q4;2010-12-31;2011-08-08;28908000;29737000;76818000;14306000;;97665000;10345000;;2851000;13196000;110861000;20030000;;21568000;;3183000;24751000;259727000;;-173607000;86110000;110861000
GHDX;776327;USD;2018;Q4;2018-12-31;2019-02-28;36241000;40280000;209794000;51531000;;274836000;39532000;4066000;15938000;59536000;334372000;59176000;;59776000;;4436000;64212000;506682000;-30110000;-206325000;270160000;334372000
MLP;776713;USD;2017;Q4;2017-12-31;2018-02-26;19012999;19012999;1029000;940000;;2340000;30679000;;11782000;42461000;44801000;1480000;;1847000;1235000;11810000;13657000;87830000;;-36432000;31144000;44801000
MLP;776713;USD;2016;Q4;2016-12-31;2017-02-24;18947716;18947716;602000;1503000;;2754000;25744000;;10385000;36129000;38883000;1619000;;2398000;6857000;18743000;21141000;87369000;;-47332000;17742000;38883000
MLP;776713;USD;2015;Q4;2015-12-31;2016-02-26;19436723;19436723;1087000;1528000;;3085000;32518000;;10996000;43514000;46599000;2189000;40565000;43859000;0;13679000;57538000;86874000;;-69146000;-10939000;46599000
MLP;776713;USD;2014;Q4;2014-12-31;2015-02-27;18782147;18782147;415000;1272000;;1857000;36066000;;11348000;47414000;49271000;2156000;2533000;5964000;47643000;58489000;64453000;86351000;;-75959000;-15182000;49271000
BRSS;778121;USD;2017;Q4;2017-12-31;2018-03-01;21700000;22100000;59000000;197800000;208100000;480200000;142900000;;29100000;172000000;652200000;153800000;5000000;158800000;309000000;346100000;504900000;54700000;-6600000;97300000;147300000;652200000
BRSS;778121;USD;2016;Q4;2016-12-31;2017-03-07;21600000;21800000;88200000;134000000;163700000;409600000;130400000;;42600000;173000000;582600000;135400000;4500000;139900000;311500000;347500000;487400000;45200000;-1500000;51200000;95200000;582600000
BRSS;778121;USD;2015;Q4;2015-12-31;2016-03-09;21400000;21500000;83500000;119600000;176300000;399200000;111100000;;46900000;158000000;557200000;128100000;1100000;129200000;342000000;367300000;496500000;37100000;-700000;22300000;60700000;557200000
BRSS;778121;USD;2014;Q4;2014-12-31;2015-03-16;21300000;21400000;44600000;152300000;189000000;420400000;103500000;;42400000;145900000;566300000;143500000;1000000;144500000;370400000;395800000;540300000;32700000;-400000;-10100000;26000000;566300000
BRSS;778121;USD;2013;Q4;2013-12-31;2014-03-19;21100000;21400000;10800000;171800000;190900000;432200000;88000000;;28500000;116500000;548700000;145300000;;145300000;380500000;406800000;552100000;30700000;;-38600000;-3400000;548700000
BRSS;778121;USD;2012;Q4;2012-12-31;2013-08-13;21070000;21070000;13900000;164300000;174400000;399500000;71100000;;32100000;103200000;502700000;133500000;;133500000;389500000;417000000;550500000;200000;;-48200000;-47800000;502700000
BRSS;778121;USD;2018;Q4;2018-12-31;2019-02-28;21600000;22200000;125500000;165600000;218200000;520600000;147800000;;22600000;170400000;691000000;154400000;4600000;159000000;305700000;344200000;503200000;62700000;-22600000;148800000;187800000;691000000
NEO;778404;USD;2018;Q4;2018-12-31;2019-02-26;93695000;104698000;9811000;76919000;8650000;103668000;60888000;;340459000;401347000;505015000;45827000;14171000;60925000;98130000;123647000;184572000;372280000;;-51258000;320443000;505015000
NEO;778404;USD;2017;Q4;2017-12-31;2018-03-13;80024000;80024000;12821000;60427000;7474000;85875000;36504000;;222075000;258579000;344454000;26076000;8989000;36471000;96435000;136021000;172492000;230110000;;-58422000;171962000;344454000
NEO;778404;USD;2016;Q4;2016-12-31;2017-03-14;78507000;78507000;12525000;55512000;6253000;78825000;34036000;;224257000;258293000;337118000;29380000;8733000;38113000;97436000;135282000;173395000;216183000;;-52460000;163723000;337118000
NEO;778404;USD;2015;Q4;2015-12-31;2016-03-15;60865000;60865000;23420000;48943000;5108000;82360000;34577000;;234350000;268927000;351287000;26055000;5134000;31189000;66245000;110588000;141777000;231573000;;-22063000;209510000;351287000
NEO;778404;USD;2014;Q4;2014-12-31;2015-03-03;60321000;62418000;33689000;20475000;2616000;58742000;15082000;;7282000;22364000;81106000;11399000;3224000;14623000;5257000;6078000;20701000;79811000;;-19406000;60405000;81106000
NEO;778404;USD;2013;Q4;2013-12-31;2014-02-24;48702000;53260000;4834000;18653000;2301000;27491000;9694000;;2731000;12425000;39916000;7255000;2786000;10041000;7576000;8164000;18205000;42249000;;-20538000;21711000;39916000
NEO;778404;USD;2012;Q4;2012-12-31;2013-02-21;45282000;54611000;1868000;14034000;1859000;18581000;8607000;;2883000;11490000;30071000;7088000;2212000;9300000;11555000;11555000;20855000;31787000;;-22571000;9216000;30071000
NEO;778404;USD;2011;Q4;2011-12-31;2012-03-12;43337000;43337000;2628000;7894000;1202000;13178000;6642000;;129000;6771000;19949000;5439000;2107000;7546000;6506000;6506000;14052000;28533000;;-22636000;5897000;19949000
NEO;778404;USD;2010;Q4;2010-12-31;2011-08-01;;;1097000;5236000;887000;8738000;4839000;;74000;4913000;13651000;3731000;1995000;5726000;4790000;4790000;10516000;24594000;;-21459000;3135000;13651000
RGNX;778666;USD;2017;Q4;2017-12-31;2018-03-06;31237000;31237000;160778000;473000;;167997000;13977000;15616000;1087000;30680000;198677000;14437000;;14437000;;1211000;15648000;371500000;;-187756000;183029000;198677000
RGNX;778666;USD;2016;Q4;2016-12-31;2017-03-07;26478000;26478000;89554000;1032000;;93371000;9324000;69412000;625000;79361000;172732000;9669000;;9669000;;1326000;10995000;276357000;;-114587000;161737000;172732000
MTEM;778777;USD;2017;Q4;2017-12-31;2018-03-30;27248657;27248657;58910000;;26623000;87037000;1952000;;1402000;3354000;90391000;5207000;2400000;10442000;1078000;2660000;13102000;141760000;;-64471000;77289000;90391000
MTEM;778777;USD;2016;Q4;2016-12-31;2017-03-27;-12446423;-12446423;1716000;;0;1843000;334000;;921000;1255000;3098000;2144000;2400000;13765000;3165000;3267000;17032000;568000;;-40373000;-13934000;3098000
MTEM;778777;USD;2015;Q4;2015-12-31;2016-03-10;6501168;7544973;48680000;;;53170000;333000;;166000;499000;53669000;3994000;;10828000;;1995000;12823000;370307000;;-329440000;40846000;53669000
MTEM;778777;USD;2014;Q4;2014-12-31;2015-03-03;5712611;6158657;58600000;;;66680000;557000;;1159000;1716000;68396000;5254000;;25974000;;66398000;92372000;349299000;;-373262000;-23976000;68396000
MTEM;778777;USD;2013;Q4;2013-12-31;2014-03-06;5387007;4930780;65669000;;;86009000;686000;16364000;1059000;18109000;104118000;4850000;;27016000;;100577000;127593000;328175000;;-351678000;-23475000;104118000
MTEM;778777;USD;2012;Q4;2012-12-31;2013-03-07;5121942;3513376;70848000;;;87650000;812000;;1059000;1871000;89521000;3165000;;17451000;;85923000;103374000;309399000;;-323263000;-13853000;89521000
MTEM;778777;USD;2011;Q4;2011-12-31;2012-03-15;4469008;4469008;20290000;;;20544000;543000;;1349000;1892000;22436000;4126000;;8591000;;9362000;17953000;256612000;;-252128000;4483000;22436000
MTEM;778777;USD;2010;Q4;2010-12-31;2011-08-04;;;14699000;;;15643000;271000;;290000;561000;16204000;1075000;;3514000;;7747000;11261000;231417000;;-226475000;4943000;16204000
MTEM;778777;USD;2018;Q4;2018-12-31;2019-03-29;36674328;36674328;97955000;;26623000;131486000;6851000;;1821000;8672000;140158000;6137000;;32509000;3254000;6743000;39252000;195610000;;-94704000;100906000;140158000
LC;778892;USD;2017;Q4;2017-12-31;2018-02-22;83243855;83243855;519292000;;;4325064000;101933000;;213834000;315767000;4640831000;414083000;;446183000;2954768000;3266891000;3713074000;1331404000;-19485000;-389419000;927757000;4640831000
LC;778892;USD;2016;Q4;2016-12-31;2017-02-28;79286987;76860749;802739000;;;5341880000;89263000;;131488000;220751000;5562631000;265966000;;265966000;4320895000;4320895000;4586861000;1230209000;-19485000;-234187000;975770000;5562631000
LC;778892;USD;2015;Q4;2015-12-31;2016-02-22;75741019;70550467;920742000;;;5595637000;55930000;;142067000;197997000;5793634000;180191000;;180191000;4571583000;4571583000;4751774000;1131749000;0;-88218000;1041860000;5793634000
TREE;780144;USD;2017;Q4;2017-12-31;2018-02-26;11989000;13873000;368550000;53444000;;438041000;36431000;;218987000;255418000;693459000;86433000;;147516000;238199000;251069000;398585000;1087724000;-85085000;-708354000;294874000;693459000
TREE;780144;USD;2016;Q4;2016-12-31;2017-02-28;11768000;12747000;91131000;41382000;;140623000;35462000;;147342000;182804000;323427000;54996000;;66707000;0;25285000;91992000;1018150000;-64085000;-722630000;231435000;323427000
TREE;780144;USD;2015;Q4;2015-12-31;2016-03-01;11933000;13176000;206975000;29873000;;245584000;9415000;;40782000;50197000;295781000;40626000;;54027000;;612000;54639000;1006827000;-15561000;-750124000;241142000;295781000
TREE;780144;USD;2014;Q4;2014-12-31;2015-03-16;11214000;9925000;86212000;13611000;;119659000;5257000;;14975000;20232000;139891000;26581000;;38636000;;4889000;43525000;909880000;-15343000;-798171000;96366000;139891000
TREE;780144;USD;2013;Q4;2013-12-31;2014-03-17;11023000;10320000;91667000;12850000;;132744000;5344000;;14556000;19900000;152644000;28195000;;60199000;;5437000;65636000;907274000;-12733000;-807533000;87008000;152644000
TREE;780144;USD;2012;Q4;2012-12-31;2013-04-01;10769000;10155000;80190000;11488000;;122272000;6155000;;14744000;20899000;143171000;22701000;;54366000;;5883000;60249000;903814000;-9412000;-811480000;82922000;143171000
TREE;780144;USD;2011;Q4;2011-12-31;2012-04-16;11047000;11047000;45541000;5474000;;296951000;8375000;;26014000;34389000;331340000;25784000;;280325000;;5544000;285869000;912108000;-8532000;-858105000;45471000;331340000
TREE;780144;USD;2010;Q4;2010-12-31;2011-08-15;11077000;11077000;68819000;3564000;;212282000;7598000;;62922000;70520000;282802000;30443000;;151333000;;29648000;180981000;908955000;-8532000;-798602000;101821000;282802000
TREE;780144;USD;2018;Q4;2018-12-31;2019-02-28;12711000;13543000;105102000;91072000;;234171000;23175000;;638769000;661944000;896115000;108264000;125000000;261953000;250943000;287954000;549907000;1134381000;-177691000;-610482000;346208000;896115000
ADRO;781554;USD;2017;Q4;2017-12-31;2018-03-01;77093830;77093830;326103000;989000;;350131000;31085000;23614000;40298000;94997000;445128000;19649000;;41401000;;166254000;207655000;519443000;;-283863000;237473000;445128000
ADRO;781554;USD;2016;Q4;2016-12-31;2017-03-01;67431652;60392748;347432000;1138000;;354764000;26384000;14474000;42989000;83847000;438611000;15580000;;30632000;;180759000;211391000;420904000;;-192000000;227220000;438611000
ADRO;781554;USD;2015;Q4;2015-12-31;2016-03-08;63482044;54030364;415654000;4846000;;424504000;3986000;15391000;37944000;57321000;481825000;16020000;;31066000;;189137000;220203000;362813000;;-100852000;261622000;481825000
ADRO;781554;USD;2014;Q4;2014-12-31;2015-05-28;362819;362819;119456000;3153000;;125221000;1053000;;188000;1241000;126462000;10788000;;44215000;;3581000;47796000;346000;;-61643000;78666000;126462000
ADRO;781554;USD;2018;Q4;2018-12-31;2019-02-27;79438302;79438302;266439000;12037000;;282976000;29157000;11434000;33937000;74528000;357504000;14517000;;30517000;;191676000;222193000;538903000;;-404532000;135311000;357504000
LOXO;781663;USD;2017;Q4;2017-12-31;2018-03-01;30015928;30015928;626200000;;;781807000;912000;;723000;1635000;783442000;26533000;;221570000;;183662000;405232000;666894000;;-288112000;378210000;783442000
LOXO;781663;USD;2016;Q4;2016-12-31;2017-03-07;21879772;21879772;139311000;;;141794000;248000;2499000;771000;3518000;145312000;15144000;;15144000;;0;15144000;269425000;;-139236000;130168000;145312000
LOXO;781663;USD;2015;Q4;2015-12-31;2016-03-15;18002553;18002553;153892000;;;156644000;88000;0;726000;814000;157458000;2853000;;2853000;;0;2853000;221459000;;-66838000;154605000;157458000
LOXO;781663;USD;2014;Q4;2014-12-31;2015-03-27;16671247;16671247;106292000;;;107776000;12000;6648000;23000;6683000;114459000;1787000;;1787000;;0;1787000;143662000;;-30962000;112672000;114459000
FGEN;781665;USD;2017;Q4;2017-12-31;2018-02-27;82382000;82382000;735718000;8452000;;748970000;129476000;10506000;9698000;149680000;898650000;69290000;;85960000;;264952000;350912000;1160919000;;-630657000;547738000;898650000
FGEN;781665;USD;2016;Q4;2016-12-31;2017-03-01;63352000;56912000;253179000;10448000;;266516000;123657000;71010000;8369000;203036000;469552000;57137000;;65125000;;229318000;294443000;626540000;;-469742000;175109000;469552000
FGEN;781665;USD;2015;Q4;2015-12-31;2016-02-29;61586000;52632000;181171000;15405000;;200564000;129020000;131720000;9270000;270010000;470574000;54453000;;67181000;;206568000;273749000;587267000;;-408062000;196825000;470574000
FGEN;781665;USD;2014;Q4;2014-12-31;2015-05-12;35040000;11281000;179819000;13453000;;198238000;132171000;144269000;8850000;285290000;483528000;53536000;;62754000;;180098000;242852000;546837000;;-322283000;240676000;483528000
FGEN;781665;USD;2018;Q4;2018-12-31;2019-02-27;85127000;85127000;621402000;63684000;;690015000;127198000;55820000;7565000;190583000;880598000;75262000;;89033000;;263095000;352128000;1227307000;;-715827000;528470000;880598000
BPMC;781830;USD;2017;Q4;2017-12-31;2018-02-21;40077000;40077265;673356000;;;685505000;24363000;;5869000;30232000;715737000;37517000;;42890000;;48877000;91767000;979828000;;-355589000;623970000;715737000
BPMC;781830;USD;2016;Q4;2016-12-31;2017-03-09;28459000;28457672;214159000;;;220425000;6188000;54059000;2123000;62370000;282795000;17086000;;28512000;1518000;41205000;69717000;420566000;;-207470000;213078000;282795000
BPMC;781830;USD;2015;Q4;2015-12-31;2016-03-11;27333848;27332304;162707000;;;170416000;6661000;;1821000;8482000;178898000;12742000;;18640000;4072000;16279000;34919000;278954000;;-134975000;143979000;178898000
BPMC;781830;USD;2014;Q4;2014-12-31;2015-06-11;1574609;1572681;47240000;;;48274000;1482000;;169000;1651000;49925000;6328000;;6764000;7703000;7732000;14496000;2824000;;-82206000;35429000;49925000
BPMC;781830;USD;2018;Q4;2018-12-31;2019-02-26;43997000;43997778;494012000;;;499787000;29627000;;10710000;40337000;540124000;56723000;;60323000;;60792000;121115000;1016734000;;-597545000;419009000;540124000
XNCR;781832;USD;2017;Q4;2017-12-31;2018-02-28;46974970;46974970;224131000;1142000;;230879000;7088000;139198000;13037000;159323000;390202000;12506000;;72650000;;1088000;73738000;571140000;;-252868000;316464000;390202000
XNCR;781832;USD;2016;Q4;2016-12-31;2017-03-01;42608028;46156306;130136000;8616000;;141653000;3105000;273340000;10465000;286910000;428563000;10637000;;106286000;;8323000;114609000;553355000;;-237960000;313954000;428563000
XNCR;781832;USD;2015;Q4;2015-12-31;2016-03-08;40899574;40899574;96430000;44000;;97675000;2310000;96891000;10034000;109235000;206910000;10034000;;43429000;;1049000;44478000;424533000;;-261585000;162432000;206910000
XNCR;781832;USD;2014;Q4;2014-12-31;2015-02-20;31433401;31433401;54649000;2966000;;57749000;899000;;9175000;10074000;67823000;3942000;;6196000;;2337000;8533000;303283000;;-243993000;59290000;67823000
XNCR;781832;USD;2013;Q4;2013-12-31;2014-05-15;9673418;49535737;77975000;59000;;78094000;307000;;8914000;9221000;87315000;4026000;9000;7479000;1000;6303000;13782000;301104000;;-227571000;73533000;87315000
XNCR;781832;USD;2018;Q4;2018-12-31;2019-02-26;56361472;54022550;294361000;10187000;;315727000;11813000;236108000;13084000;261005000;576732000;13459000;;53853000;;1198000;55051000;845929000;;-323277000;521681000;576732000
MRTX;782022;USD;2018;Q4;2018-12-31;2019-02-28;32578897;32578897;222790000;;;226660000;473000;;1321000;1794000;228454000;25775000;;26146000;;732000;26878000;751142000;;-559045000;201576000;228454000
ODFL;782146;USD;2017;Q4;2017-12-31;2018-02-27;82279726;82374903;127462000;394169000;;584653000;2404459000;;79312000;2483771000;3068424000;251100000;50000000;351049000;45000000;440521000;791570000;146597000;;2130257000;2276854000;3068424000
ODFL;782146;USD;2016;Q4;2016-12-31;2017-02-27;82368937;82438808;10171000;320087000;;382622000;2241402000;;72223000;2313625000;2696247000;241219000;0;288636000;104975000;556453000;845089000;143708000;;1707450000;1851158000;2696247000
ODFL;782146;USD;2015;Q4;2015-12-31;2016-02-29;84568691;84568691;11472000;310501000;;381730000;2023448000;;61326000;2084774000;2466504000;213997000;26488000;285402000;107317000;496465000;781867000;142842000;;1541795000;1684637000;2466504000
ODFL;782146;USD;2014;Q4;2014-12-31;2015-02-26;86153797;86153797;34787000;303170000;;403772000;1743245000;;59849000;1803094000;2206866000;177653000;35714000;255638000;120000000;457164000;712802000;143010000;;1351054000;1494064000;2206866000
ODFL;782146;USD;2013;Q4;2013-12-31;2014-02-28;86164917;86164917;30174000;248069000;;332979000;1543059000;;56051000;1599110000;1932089000;155455000;35715000;232122000;155714000;467885000;700007000;143017000;;1089065000;1232082000;1932089000
ODFL;782146;USD;2012;Q4;2012-12-31;2013-02-28;86164916;86164916;12857000;219039000;;275028000;1379305000;;58181000;1437486000;1712514000;145844000;38978000;225139000;201429000;461406000;686545000;143017000;;882952000;1025969000;1712514000
ODFL;782146;USD;2011;Q4;2011-12-31;2012-02-29;86164985;86164985;75850000;213481000;;331852000;1126950000;;54272000;1181222000;1513074000;129490000;39354000;204810000;229831000;451745000;656555000;143019000;;713500000;856519000;1513074000
ODFL;782146;USD;2010;Q4;2010-12-31;2011-02-28;83890417;83890417;5450000;172989000;;222582000;964216000;;53083000;1017299000;1239881000;98989000;37130000;170046000;234087000;401186000;571232000;94619000;;574030000;668649000;1239881000
ODFL;782146;USD;2009;Q4;2009-12-31;2010-08-06;83890520;83890520;4171000;136822000;;174175000;939495000;;45608000;985103000;1159278000;80760000;36676000;148125000;268856000;418153000;566278000;94621000;;498379000;593000000;1159278000
ODFL;782146;USD;2018;Q4;2018-12-31;2019-02-27;81487652;81577750;190282000;427569000;;706229000;2754943000;;84111000;2839054000;3545283000;303469000;;356732000;45000000;508068000;864800000;150299000;;2530184000;2680483000;3545283000
ANDE;783409;USD;2017;Q4;2017-07-31;2018-02-26;27523000;28069000;34919000;183238000;648703000;999211000;384677000;223239000;555227000;1163143000;2162354000;573150000;76205000;738716000;418339000;600739000;1339455000;224718000;-40312000;633496000;822899000;2162354000
ANDE;783409;USD;2016;Q4;2016-07-31;2017-03-01;28222000;28948000;62630000;194698000;682747000;1058126000;450052000;216931000;507740000;1174723000;2232849000;651474000;76545000;799776000;397065000;642376000;1442152000;223006000;-45383000;609206000;790697000;2232849000
ANDE;783409;USD;2015;Q4;2015-07-31;2016-02-29;27964000;27892000;63750000;170912000;747399000;1129522000;455260000;242107000;532212000;1229579000;2359101000;739112000;44776000;888037000;436208000;687325000;1575362000;222944000;-52902000;615151000;783739000;2359101000
ANDE;783409;USD;2014;Q4;2014-07-31;2015-03-02;28802000;29003000;114704000;183059000;795655000;1254447000;411476000;226857000;471912000;1110245000;2364692000;785433000;78581000;1027706000;298638000;512937000;1540643000;222885000;-9743000;644556000;824049000;2364692000
ANDE;783409;USD;2013;Q4;2013-07-31;2014-02-28;28028000;28278000;309085000;173930000;614923000;1221784000;387458000;291109000;373205000;1051772000;2273556000;817077000;51998000;992333000;375213000;556802000;1549135000;184476000;-10222000;548401000;724421000;2273556000
ANDE;783409;USD;2012;Q4;2012-07-31;2013-03-01;-13912250;-13785500;138218000;208877000;776677000;1297153000;358878000;190908000;335365000;885151000;2182304000;814756000;39364000;992807000;427243000;578052000;1570859000;181723000;-12559000;470628000;611445000;2182304000
ANDE;783409;USD;2011;Q4;2011-07-31;2012-02-27;-13924000;-13838500;20390000;167640000;760459000;1107222000;175087000;199061000;252753000;626901000;1734123000;595112000;103708000;794251000;238885000;401030000;1195281000;179559000;-14997000;402523000;538842000;1734123000
ANDE;783409;USD;2010;Q4;2010-07-31;2011-03-01;41341500;41735250;29219000;152227000;647189000;1138558000;151032000;175349000;234451000;560832000;1699390000;434948000;265624000;836743000;276825000;398088000;1234831000;177971000;-14058000;316317000;464559000;1699390000
ANDE;783409;USD;2009;Q4;2009-07-31;2010-08-06;;;145929000;137195000;407845000;786823000;132288000;157360000;207920000;497568000;1284391000;386617000;10935000;479121000;308026000;398994000;878115000;175573000;-15554000;258662000;406276000;1284391000
GPOR;785453;USD;2017;Q4;2017-12-31;2018-02-22;183266270;184673411;99557000;146773000;;365529000;5102177000;302112000;37934000;5442223000;5807752000;553609000;622000;586885000;2038321000;2119253000;2706138000;4418081000;;-1275928000;3101614000;5807752000
GPOR;785453;USD;2016;Q4;2016-12-31;2017-02-15;129549290;129549290;1275875000;136761000;;1604275000;2351126000;243920000;23824000;2618870000;4223145000;265124000;276000;384814000;1593599000;1654439000;2039253000;3948030000;;-1711080000;2183892000;4223145000
GPOR;785453;USD;2015;Q4;2015-12-31;2016-02-19;108609578;108169154;112974000;71872000;;331561000;2628403000;242393000;132377000;3003173000;3334734000;265128000;179000;316516000;946084000;979381000;1295897000;2825385000;;-731371000;2038837000;3334734000
GPOR;785453;USD;2014;Q4;2014-12-31;2015-02-27;85569672;85800899;142340000;103858000;;328349000;2890619000;369581000;30924000;3291124000;3619473000;371410000;168000;398723000;703396000;924454000;1323177000;1829458000;;493513000;2296296000;3619473000
GPOR;785453;USD;2013;Q4;2013-12-31;2014-02-28;81689526;82273211;458956000;58824000;;524177000;1703592000;440068000;25299000;2168959000;2693136000;190707000;159000;203941000;299028000;438957000;642898000;1813909000;;246110000;2050238000;2693136000
GPOR;785453;USD;2012;Q4;2012-12-31;2013-03-01;56758270;56796456;167088000;25615000;;229721000;953868000;381484000;13295000;1348647000;1578368000;110244000;150000;120896000;298888000;331064000;451960000;1036919000;;92918000;1126408000;1578368000
GPOR;785453;USD;2011;Q4;2011-12-31;2012-02-27;52432785;52898206;93897000;28019000;;129575000;468636000;86824000;6123000;561583000;691158000;43872000;141000;44633000;2142000;14175000;58808000;605140000;;24547000;632350000;691158000
GPOR;785453;USD;2010;Q4;2010-12-31;2011-08-05;44615356;45092573;2468000;14952000;;19725000;242131000;33021000;24816000;299968000;319693000;41155000;2417000;48927000;49500000;59710000;108637000;296699000;;-83875000;211056000;319693000
GPOR;785453;USD;2018;Q4;2018-12-31;2019-02-28;171307311;173346982;52297000;210200000;;316953000;5479405000;236121000;18557000;5734083000;6051036000;518380000;651000;539432000;2086765000;2183836000;2723268000;4229162000;;-845368000;3327768000;6051036000
DCPH;785694;USD;2017;Q4;2017-12-31;2018-03-28;32289855;32289855;196754000;;;198182000;838000;;75000;913000;199095000;13815000;;13815000;;1307000;15122000;379842000;;-195869000;183973000;199095000
DCPH;785694;USD;2016;Q4;2016-12-31;2018-03-28;;;57461000;;;58252000;514000;;179000;693000;58945000;4557000;;4557000;;1481000;6038000;5825000;;-145585000;52907000;58945000
DCPH;785694;USD;2018;Q4;2018-12-31;2019-03-14;37746208;37746208;293764000;;;301037000;13453000;1069000;;14522000;315559000;22204000;;22743000;;12835000;35578000;575704000;;-295723000;279981000;315559000
ATNX;785769;USD;2017;Q4;2017-12-31;2018-03-26;58274676;58274676;51037000;8468000;16561000;83758000;9651000;;47004000;56655000;140413000;42435000;1015000;45143000;475000;4548000;49691000;423865000;-7406000;-326276000;90722000;140413000
ATNX;785769;USD;2016;Q4;2016-12-31;2017-08-14;42090042;42090042;41753000;2777000;4240000;51923000;5810000;;48157000;53967000;105890000;26130000;766000;28019000;14498000;43202000;71221000;237623000;-7406000;-195106000;34669000;105890000
ATNX;785769;USD;2018;Q4;2018-12-31;2019-03-11;66996476;66996476;107423000;12951000;28787000;170819000;11447000;;48829000;60276000;231095000;50715000;961000;51676000;45803000;50650000;102326000;591133000;-7406000;-443716000;128769000;231095000
TGTX;785880;USD;2017;Q4;2017-12-31;2018-03-15;66753032;66753032;84717000;;;93318000;2677000;;1386000;4063000;97381000;27677000;128000;27957000;;2431000;30388000;422090000;-234000;-354863000;66993000;97381000
TGTX;785880;USD;2016;Q4;2016-12-31;2017-03-16;49283913;49283913;44885140;;;50864144;2370429;;1546974;3917403;54781547;16657184;68875;16878440;;2035305;18913745;272488959;-234337;-236386820;35867802;54781547
TGTX;785880;USD;2015;Q4;2015-12-31;2016-03-15;48229958;48229958;77227841;;;86873331;47122;25003032;1549716;26599870;113473201;10164540;211549;10528470;;1371435;11899905;259941559;-234337;-158133926;101573296;113473201
TGTX;785880;USD;2014;Q4;2014-12-31;2015-03-16;39011466;39011466;78775818;;;85215029;20357;0;1511504;1531861;86746890;4693625;275190;5121196;;1523816;6645012;175521495;-234337;-95185280;80101878;86746890
TGTX;785880;USD;2013;Q4;2013-12-31;2014-03-07;29533857;29533857;40485466;;;42303263;5718;4918897;884512;5809127;48112390;5487019;677778;6317178;64529;1740726;8057904;79692826;-234337;-39404003;40054486;48112390
TGTX;785880;USD;2012;Q4;2012-12-31;2013-03-21;19805771;19805771;16455995;;2797600;21273482;1164;0;799391;800555;22074037;1385908;677778;2216067;2479098;4307675;6523742;34560626;-84538;-18925793;15550295;22074037
TGTX;785880;USD;2011;Q4;2011-12-31;2012-03-14;3221715;3221715;9748491;;3902300;13737967;0;;799391;799391;14537358;728581;877778;1606359;3294797;3294803;4901162;10477176;0;-853074;9636196;14537358
TGTX;785880;USD;2018;Q4;2018-12-31;2019-03-01;78752865;78752865;68901000;;;69340000;2545000;;11731000;14276000;83616000;38635000;;38854000;0;20726000;59580000;552615000;-234000;-528345000;24036000;83616000
KPTI;786011;USD;2017;Q4;2017-12-31;2018-03-15;48731955;48731955;146469000;;;148423000;2185000;29396000;290000;31871000;180294000;27110000;;49467000;;1363000;50830000;625022000;;-495341000;129464000;180294000
GDOT;786096;USD;2017;Q4;2017-12-31;2018-02-27;50938000;54920000;931132000;35277000;;1321205000;97282000;141620000;637424000;876326000;2197531000;1057117000;;1335976000;58705000;97005000;1432981000;354840000;;410440000;764550000;2197531000
GDOT;786096;USD;2016;Q4;2016-12-31;2017-02-27;50367000;51794000;779362000;40150000;;1013436000;82621000;161740000;482547000;726908000;1740344000;760270000;;960798000;79720000;95813000;1056611000;358206000;;325708000;683733000;1740344000
GDOT;786096;USD;2015;Q4;2015-12-31;2016-02-29;50493000;50926000;821234000;42153000;;975291000;78877000;132433000;504847000;716157000;1691448000;689331000;;888274000;100686000;139852000;1028126000;379429000;;284108000;663322000;1691448000
GDOT;786096;USD;2014;Q4;2014-12-31;2015-03-02;46888000;47798000;770808000;48917000;;1009662000;77284000;73781000;453561000;604626000;1614288000;601845000;;830126000;121651000;155172000;985298000;383349000;;245693000;628990000;1614288000
GDOT;786096;USD;2013;Q4;2013-12-31;2014-03-03;36910000;37874000;539657000;46384000;;666073000;60473000;88498000;60430000;209401000;875474000;254520000;;435133000;0;38092000;473225000;199296000;;203000000;402249000;875474000
GDOT;786096;USD;2012;Q4;2012-12-31;2013-03-01;35006000;16909000;408834000;40441000;;530219000;58376000;79474000;57659000;195509000;725728000;229862000;;379407000;;18557000;397964000;158698000;;168960000;327764000;725728000
GDOT;786096;USD;2011;Q4;2011-12-31;2012-03-30;38984000;56103000;243680000;41307000;;336599000;27281000;14710000;47269000;89260000;425859000;54398000;;161654000;;11009000;172663000;131425000;;121741000;253196000;425859000
GDOT;786096;USD;2010;Q4;2010-12-31;2011-08-11;39254000;77337000;167503000;33412000;;249893000;18034000;2549000;15282000;35865000;285758000;17625000;;111508000;;9119000;120627000;95473000;;69658000;165131000;285758000
GDOT;786096;USD;2018;Q4;2018-12-31;2019-02-27;52764000;54685000;1114688000;40942000;;1384079000;120269000;181223000;601547000;903039000;2287118000;1044183000;;1337334000;;39972000;1377306000;380806000;;529143000;909812000;2287118000
ARLP;786231;USD;2017;Q4;2017-12-31;2018-02-23;;;6756000;181671000;60275000;281640000;1476656000;254362000;206713000;1937731000;2219371000;158050000;101013000;289634000;473028000;778251000;1067885000;1198078000;;;1151486000;2219371000
ARLP;786231;USD;2016;Q4;2016-12-31;2017-02-24;;;39782000;152032000;61051000;276672000;1585843000;138817000;191710000;1916370000;2193042000;124220000;177070000;326871000;484986000;772747000;1099618000;1126414000;;;1093424000;2193042000
ARLP;786231;USD;2015;Q4;2015-12-31;2016-02-26;;;33431000;122875000;121081000;314905000;1800275000;64509000;181597000;2046381000;2361286000;136555000;258780000;423081000;658640000;948842000;1371923000;1021335000;;;989363000;2361286000
ARLP;786231;USD;2014;Q4;2014-12-31;2015-02-27;;;24601000;184187000;83155000;340888000;1665206000;224611000;54354000;1944171000;2285059000;163243000;231305000;420895000;606874000;849117000;1270012000;1050429000;;;1015047000;2285059000
ARLP;786231;USD;2013;Q4;2013-12-31;2014-02-28;;;93654000;153662000;44214000;321910000;1614379000;130410000;55199000;1799988000;2121898000;146533000;38038000;212551000;848385000;1058110000;1270661000;860956000;;;851237000;2121898000
ARLP;786231;USD;2012;Q4;2012-12-31;2013-03-01;;;28283000;172724000;46660000;281312000;1529570000;88513000;56577000;1674660000;1955972000;160108000;19000000;208327000;791613000;1042199000;1250526000;747710000;;;705446000;1955972000
ARLP;786231;USD;2011;Q4;2011-12-31;2012-02-28;;;273528000;128643000;33837000;464154000;1181320000;40118000;45926000;1267364000;1731518000;150813000;18676000;194820000;688497000;912940000;1107760000;664218000;;;623758000;1731518000
ARLP;786231;USD;2010;Q4;2010-12-31;2011-02-28;73434422;73434422;339562000;112942000;31548000;503337000;949247000;;48694000;997941000;1501278000;110504000;18295000;154605000;704165000;890890000;1045495000;474504000;;;455783000;1501278000
ARLP;786231;USD;2018;Q4;2018-12-31;2019-02-22;;;244150000;174914000;59206000;500686000;1412358000;283403000;198301000;1894062000;2394748000;161294000;138722000;330871000;574599000;876190000;1207061000;1229268000;;;1187687000;2394748000
NK;786262;USD;2017;Q4;2017-12-31;2018-03-12;79315795;79315795;128152000;;;132458000;76726000;38100000;3156000;117982000;250440000;17132000;;20868000;1741000;10728000;31596000;717938000;;-498713000;218844000;250440000
NK;786262;USD;2016;Q4;2016-12-31;2017-03-15;82227844;82227844;198921000;;;205145000;18906000;87571000;5874000;112351000;317496000;9909000;;12553000;2025000;11525000;24078000;680765000;;-387063000;293418000;317496000
NK;786262;USD;2015;Q4;2015-12-31;2016-03-30;81314184;81314184;294218000;;;297540000;5523000;55135000;8651000;69309000;366849000;4660000;;6148000;0;4706000;10854000;606563000;;-250376000;355995000;366849000
NK;786262;USD;2014;Q4;2014-12-31;2015-09-10;14656075;14656075;59104000;145000;;59373000;211000;;1244000;1455000;60828000;1442000;265000;1884000;;521000;2405000;71161000;;-12741000;58420000;60825000
NK;786262;USD;2018;Q4;2018-12-31;2019-03-13;79180293;79180293;74149000;;;88772000;76885000;14201000;2092000;93178000;181950000;23897000;;27260000;5945000;8684000;35944000;741254000;;-594981000;146006000;181950000
SRCI;786501;USD;2017;Q4;2017-12-31;2018-02-21;222249623;222979866;48772000;86013000;;160035000;1876576000;;42953000;1919529000;2079564000;127085000;;202307000;538186000;568823000;771130000;1474514000;;-166080000;1308434000;2079564000
SRCI;786501;USD;2016;Q4;2016-12-31;2017-02-23;201174298;201174298;18615000;25728000;;54184000;908736000;;61193000;969929000;1024113000;70126000;;92240000;75614000;91134000;183374000;1149199000;;-308460000;840739000;1024113000
SRCI;786501;USD;2015;Q4;2015-12-31;2015-10-16;71609848;74372264;66499000;12527000;;99698000;526847000;;46071000;572918000;672616000;61103000;;74706000;78000000;91400000;166106000;595781000;;-89271000;506510000;672616000
SRCI;786501;USD;2014;Q4;2014-12-31;2014-10-30;77803725;78188576;34753000;16974000;;68240000;379400000;;902000;380302000;448542000;88789000;;103578000;37000000;63474000;167052000;265871000;;15619000;281490000;448542000
SRCI;786501;USD;2013;Q4;2013-12-31;2013-11-14;66557320;67338524;79481000;7361000;194000;91975000;197965000;;1296000;199261000;291236000;32971000;;41367000;37000000;46649000;88016000;216454000;;-13234000;203220000;291236000
SRCI;786501;USD;2012;Q4;2012-12-31;2012-12-13;51514032;53190574;19284000;3606000;178000;26468000;92702000;;1562000;94264000;120732000;11432000;;15592000;3000000;4027000;19619000;123928000;;-22815000;101113000;120732000
SRCI;786501;USD;2011;Q4;2011-12-31;2012-01-09;36020232;36020232;9490506;2185051;459592;14630958;48898064;;168863;49066927;63697885;13946413;;13946413;0;643459;14589872;84047594;;-34939581;49108013;63697885
SRCI;786501;USD;2018;Q4;2018-12-31;2019-02-20;242691152;240892289;49609000;100973000;;232440000;2518700000;;3574000;2522274000;2754714000;245109000;;353833000;734360000;814589000;1168422000;1492350000;;93942000;1586292000;2754714000
SCRH;786879;USD;2017;Q4;2017-12-31;2018-06-08;165186144;165186144;33457;73943;;119947;;;;;119947;105450;;155292;;35750;191042;6223303;;-6294398;-71095;119947
SCRH;786879;USD;2016;Q4;2016-12-31;2017-04-10;165186144;165186144;228842;46329;;287050;;;;;287050;26576;;77483;;51417;128900;6223303;;-6065153;158150;287050
SCRH;786879;USD;2015;Q4;2015-12-31;2016-03-31;165186144;165186144;515994;280119;;807550;;;;;807550;304909;;387909;;20500;408409;6223303;;-5824162;399141;807550
SCRH;786879;USD;2014;Q4;2014-12-31;2015-03-25;165186204;165186204;127253;324410;;521556;;;;;521556;140098;;206252;;0;206252;6223303;;-5907999;315304;521556
SCRH;786879;USD;2013;Q4;2013-12-31;2014-03-27;165186124;165186124;4522;188988;;343335;;;56929;56929;400264;130460;;473306;33148;61802;535108;6223303;;-6358147;-134844;400264
SCRH;786879;USD;2012;Q4;2012-12-31;2013-11-14;165186124;165186124;59139;71911;;270341;;;193924;193924;464265;157704;;572520;31535;227196;799716;6223303;;-6558754;-335451;464265
SCRH;786879;USD;2011;Q4;2011-12-31;2012-10-23;165186124;165186124;8930;112561;;254259;;;324251;324251;578510;82956;;628511;0;354540;983051;6193303;;-6597844;-404541;578510
SCRH;786879;USD;2010;Q4;2010-12-31;2011-08-15;;;23748;87731;;117821;;;88725;88725;206546;502353;;824714;;0;824714;6163303;;-6781471;-618168;206546
BLUE;787981;USD;2017;Q4;2017-12-31;2018-02-21;46621000;46621000;1290109000;;;1322769000;199606000;324193000;53999000;577798000;1900567000;12873000;;95612000;154749000;181523000;277135000;2541445000;;-913808000;1623432000;1900567000
BLUE;787981;USD;2016;Q4;2016-12-31;2017-02-22;38061000;38061000;704378000;;;724214000;156955000;180452000;56501000;393908000;1118122000;13664000;;74533000;120140000;174149000;248682000;1448263000;;-577674000;869440000;1118122000
BLUE;787981;USD;2015;Q4;2015-12-31;2016-02-25;36779000;36779000;517949000;;;523965000;82614000;347814000;47944000;478372000;1002337000;6334000;;40368000;61901000;111473000;151841000;1166954000;;-314167000;850496000;1002337000
BLUE;787981;USD;2014;Q4;2014-12-31;2015-02-25;29447000;29447000;473555000;;;479989000;15740000;18448000;42562000;76750000;556739000;2954000;;42978000;;22504000;65482000;638712000;;-147384000;491257000;556739000
BLUE;787981;USD;2013;Q4;2013-12-31;2014-03-05;24118000;24118000;206279000;;;211987000;10920000;;1483000;12403000;224390000;4359000;;34874000;;37849000;72723000;250342000;;-98675000;151667000;224390000
BLUE;787981;USD;2012;Q4;2012-12-31;2013-08-14;298000;-605000;67011000;;;67784000;1288000;;250000;1538000;69322000;2173000;;4628000;;601000;5229000;15270000;;-73354000;64093000;69322000
BLUE;787981;USD;2018;Q4;2018-12-31;2019-02-21;54775000;54775000;1385304000;;;1418997000;246622000;506123000;71102000;823847000;2242844000;17831000;;146431000;153319000;211343000;357774000;3387505000;;-1498808000;1885070000;2242844000
CTMX;789985;USD;2017;Q4;2017-12-31;2018-03-07;38400425;38400425;374110000;10139000;;388601000;4218000;;4825000;9043000;397644000;20588000;;61147000;;266601000;327748000;289455000;;-219465000;69896000;397644000
CTMX;789985;USD;2016;Q4;2016-12-31;2017-03-02;36437335;36437335;181938000;2159000;;188147000;4392000;;6589000;10981000;199128000;15420000;;35767000;;84882000;120649000;254872000;;-176366000;78479000;199128000
CTMX;789985;USD;2015;Q4;2015-12-31;2016-03-07;31343860;31343860;186711000;372000;;189754000;3481000;;3980000;7461000;197215000;9609000;;15739000;;55408000;71147000;243688000;;-117466000;126068000;197215000
CTMX;789985;USD;2014;Q4;2014-12-31;2015-11-23;1072577;1072577;64396000;1875000;;66753000;3018000;;3291000;6309000;73062000;3614000;1419000;11163000;1568000;63730000;74893000;1000;;-78138000;-1831000;73062000
CTMX;789985;USD;2018;Q4;2018-12-31;2019-02-27;45131119;45131119;436127000;97000;;445475000;6934000;;4699000;11633000;457108000;45195000;;97908000;;228317000;326225000;445957000;;-314981000;130883000;457108000
MGNX;790123;USD;2017;Q4;2017-12-31;2018-02-27;36857983;36857983;305121000;13643000;;322298000;49983000;;1602000;51585000;373883000;41032000;;49755000;;24890000;74645000;611639000;;-312340000;299238000;373883000
MGNX;790123;USD;2016;Q4;2016-12-31;2017-02-28;34854614;33453400;276996000;2764000;;283947000;17961000;7986000;1369000;27316000;311263000;20129000;;27302000;;15210000;42512000;561547000;;-292714000;268751000;311263000
MGNX;790123;USD;2015;Q4;2015-12-31;2016-02-29;34392320;32123914;339049000;1224000;;342384000;14841000;0;2044000;16885000;359269000;14675000;;24202000;;21730000;45932000;547528000;;-234186000;313337000;359269000
MGNX;790123;USD;2014;Q4;2014-12-31;2015-03-03;27874870;27874870;157591000;2935000;;165037000;6785000;;2064000;8849000;173886000;9599000;;27094000;;25506000;52600000;335351000;-19000;-214046000;121286000;173886000
MGNX;790123;USD;2013;Q4;2013-12-31;2014-03-20;23837703;3779231;116481000;2004000;;119862000;5035000;;885000;5920000;125782000;6753000;;28822000;;18046000;46868000;254705000;-58000;-175733000;78914000;125782000
MGNX;790123;USD;2012;Q4;2012-12-31;2013-11-12;1098669;-59905440;47743155;2046219;;50331858;3267796;;147246;3415042;53746900;4976150;;29728094;;32256114;61984208;164345635;-57742;-175472403;-8237308;53746900
MGNX;790123;USD;2018;Q4;2018-12-31;2019-02-26;42371572;42371572;232863000;29583000;;269124000;56712000;;6294000;63006000;332130000;37026000;;59940000;;29313000;89253000;733151000;;-490271000;242877000;332130000
GLYC;790345;USD;2017;Q4;2017-12-31;2018-03-06;34138680;34138680;123924738;;;127219622;1106899;;256684;1363583;128583205;8096749;;8174777;;707003;8881780;271978531;;-152277106;119701425;128583205
GLYC;790345;USD;2016;Q4;2016-12-31;2017-03-01;23110861;23110861;40041641;;;40520144;1056332;;811851;1868183;42388327;6265066;;6333617;;753579;7087196;154277442;;-118976311;35301131;42388327
GLYC;790345;USD;2015;Q4;2015-12-31;2016-02-29;19043234;17818248;46802560;;;47244370;521378;;696531;1217909;48462279;7746978;;7746978;;243647;7990625;127638127;;-87166473;40471654;48462279
GLYC;790345;USD;2014;Q4;2014-12-31;2015-03-16;18874933;17444265;55198923;;;56115172;452270;;696531;1148801;57263973;6363533;;6460545;;;6460545;125200403;;-74396975;50803428;57263973
GLYC;790345;USD;2013;Q4;2013-12-31;2014-05-09;1674084;-8524120;2310603;;;4883675;399799;;;399799;5283474;2175108;;2279299;;96756;2376055;66152102;;-63275409;2907419;5283474
GLYC;790345;USD;2018;Q4;2018-12-31;2019-03-06;43143272;43143272;209917595;;;212269119;957226;;1612927;2570153;214839272;8664383;;8763154;;611623;9374777;406015234;;-200550739;205464495;214839272
RCUS;790458;USD;2017;Q4;2017-12-31;2018-05-09;2218425;2218425;175703000;;;176869000;11230000;682000;1705000;13617000;190486000;6957000;;12726000;;23892000;36618000;948000;;-73234000;153868000;190486000
RCUS;790458;USD;2018;Q4;2018-12-31;2019-03-05;43612857;43612857;256544000;;;258948000;11107000;4383000;487000;15977000;274925000;9125000;;16935000;;23048000;39983000;357877000;;-122828000;234942000;274925000
ODT;790464;USD;2017;Q4;2017-12-31;2018-05-03;19435455;19435455;198105000;;;202946000;165000;;383000;548000;203494000;7512000;;7512000;;0;7512000;235274000;;-39292000;195982000;203494000
ODT;790464;USD;2018;Q4;2018-12-31;2019-02-22;24641777;24641777;139050000;;;139800000;1899000;;974000;2873000;142673000;18142000;;18208000;;461000;18669000;252256000;;-128252000;124004000;142673000
CRSP;791051;USD;2017;Q4;2017-12-31;2018-03-08;40518857;40518857;239758000;2626000;;248385000;18857000;;4104000;22961000;271346000;13347000;;14511000;;69003000;83514000;313258000;0;-125440000;187832000;271346000
CRSP;791051;USD;2016;Q4;2016-12-31;2017-03-10;32760650;32760650;315520000;3157000;;320188000;21027000;;3747000;24774000;344962000;20912000;;21998000;;90118000;112116000;289955000;0;-57083000;232846000;344962000
CRSP;791051;USD;2015;Q4;2015-12-31;2016-11-22;6522942;6522942;155961000;339000;;156840000;1328000;;1255000;2583000;159423000;10095000;;10155000;38336000;113871000;124026000;4817000;0;-33906000;35397000;159423000
CRSP;791051;USD;2018;Q4;2018-12-31;2019-02-25;51745740;51745740;456649000;88000;;466395000;18500000;;4121000;22621000;489016000;26323000;;27746000;;69075000;96821000;683829000;-57000;-291569000;392195000;489016000
GERN;793173;USD;2017;Q4;2017-12-31;2018-03-16;159339385;159339385;94686000;;;95970000;102000;14241000;;14343000;110313000;4814000;;6516000;;0;6516000;1089844000;;-985840000;103797000;110313000
GERN;793173;USD;2016;Q4;2016-12-31;2017-03-01;159147353;159147353;114845000;;;116112000;183000;13954000;;14137000;130249000;4502000;;7869000;;0;7869000;1080357000;;-957924000;122380000;130249000
GERN;793173;USD;2015;Q4;2015-12-31;2016-03-10;158378423;172371417;113772000;;;115892000;207000;32661000;;32868000;148760000;4306000;;6634000;;0;6634000;1070726000;;-928387000;142126000;148760000
GERN;793173;USD;2014;Q4;2014-12-31;2015-03-11;157145361;157145361;151441000;;;153406000;173000;18932000;;19105000;172511000;6783000;;41799000;;0;41799000;1059229000;;-928433000;130712000;172511000
GERN;793173;USD;2013;Q4;2013-12-31;2014-03-17;121661192;121661192;65224000;;;67057000;92000;;195000;287000;67344000;7126000;;7587000;;0;7587000;952534000;;-892763000;59757000;67344000
GERN;793173;USD;2012;Q4;2012-12-31;2013-03-15;105193247;105193247;95535000;;;98417000;974000;;410000;1384000;99801000;12125000;;14148000;;0;14148000;939997000;;-854384000;85653000;99801000
GERN;793173;USD;2011;Q4;2011-12-31;2012-03-07;132512339;132512339;121313000;;;125625000;1241000;32133000;1048000;34422000;160047000;9650000;;13444000;;0;13444000;932197000;;-785503000;146603000;160047000
GERN;793173;USD;2010;Q4;2010-12-31;2011-08-05;;;186571000;;;195017000;3088000;34415000;1064000;38567000;233584000;12292000;;40849000;;0;40849000;881481000;;-688650000;192735000;233584000
GERN;793173;USD;2018;Q4;2018-12-31;2019-03-07;186716807;186716807;163289000;;;166058000;59000;18582000;585000;19226000;185284000;4941000;;7551000;;0;7551000;1189380000;;-1011464000;177733000;185284000
RSLS;794492;USD;2017;Q4;2017-12-31;2018-04-02;10077;10077;10163208;488613;2817112;13936716;438621;;74329212;74767833;88704549;7043789;;7043789;1600;5293891;12337680;411125208;;-334759354;76366869;88704549
RSLS;794492;USD;2016;Q4;2016-12-31;2017-03-08;794;794;3310787;143692;1789578;5720681;200720;;1119405;1320125;7040806;4063121;;4063121;39119;39119;4102240;303879948;;-300941382;2938566;7040806
RSLS;794492;USD;2015;Q4;2015-12-31;2016-03-28;48;48;7927240;57928;1686324;10502987;326296;;757802;1084098;11587085;3768637;717391;4486028;3427608;3427608;7913636;281253987;;-277580538;3673449;11587085
RSLS;794492;USD;2014;Q4;2014-12-31;2015-03-13;31;31;11619167;2812;980519;13024171;481522;;879905;1361427;14385598;4745039;2976164;7721203;;0;7721203;258746186;;-252081791;6664395;14385598
RSLS;794492;USD;2013;Q4;2013-12-31;2014-03-27;28;28;23297479;17742;1127941;24989906;577095;;820767;1397862;26387768;4840061;4000000;8840061;2868330;2868330;11708391;240632448;;-225953071;14679377;26387768
RSLS;794492;USD;2012;Q4;2012-12-31;2013-03-07;19;19;22308781;52406;1271207;24404048;609672;;1082765;1692437;26096485;4537842;3000000;7537842;6683972;6683972;14221814;212047083;;-200172412;11874671;26096485
RSLS;794492;USD;2011;Q4;2011-12-31;2012-03-15;;;29493099;;1068623;31566521;630354;;288980;919334;32485855;7256627;2307162;9563789;2881161;2881161;12444950;196752522;;-176712309;20040905;32485855
RSLS;794492;USD;2010;Q4;2010-12-31;2011-08-05;;;30840560;;;37804129;741564;;141572;883136;38687265;3075051;921998;3997049;4983159;4983159;8980208;180422044;;-150714987;29707057;38687265
TWI;795301;USD;2017;Q4;2017-12-31;2018-02-23;59611000;59611000;143570000;226703000;339836000;783193000;421248000;;85671000;506919000;1290112000;195497000;43651000;372922000;407171000;493913000;866835000;531708000;-8606000;-44022000;423277000;1290112000
TWI;795301;USD;2016;Q4;2016-12-31;2017-03-15;53980000;53980000;147827000;179384000;272236000;729181000;437201000;;99514000;536715000;1265896000;148255000;97412000;366104000;408760000;502104000;868208000;479075000;-10119000;17214000;397688000;1265896000
TWI;795301;USD;2015;Q4;2015-12-31;2016-02-25;53728000;47925000;200188000;177389000;269791000;710001000;450020000;;110209000;560229000;1270230000;123154000;31222000;270097000;475443000;578276000;848373000;497008000;-12420000;49297000;421857000;1270230000
TWI;795301;USD;2014;Q4;2014-12-31;2015-02-26;53535000;53231000;201451000;199378000;331432000;835930000;527414000;;132380000;659794000;1495724000;146305000;26233000;301556000;496503000;604110000;905666000;513090000;-13897000;126007000;590058000;1495724000
TWI;795301;USD;2013;Q4;2013-12-31;2014-02-20;53474000;59551000;189360000;263053000;384920000;1007878000;638807000;;174546000;813353000;1821231000;176719000;75061000;386571000;497694000;636624000;1023195000;558637000;-15586000;207541000;798036000;1821231000
TWI;795301;USD;2012;Q4;2012-12-31;2013-02-27;47077000;58356000;189114000;297798000;366385000;996123000;568344000;;145768000;714112000;1710235000;180065000;145801000;467080000;441438000;610793000;1077873000;507199000;-16445000;173407000;632362000;1710235000
TWI;795301;USD;2011;Q4;2011-12-31;2012-02-23;42108000;65610000;129170000;189527000;190872000;564593000;334742000;;110951000;445693000;1010286000;76574000;11723000;175766000;317881000;437641000;613407000;380332000;-17338000;67053000;396879000;1010286000
TWI;795301;USD;2010;Q4;2010-12-31;2011-07-27;35127000;-15636000;239500000;89004000;118143000;481350000;248054000;;51476000;299530000;780880000;35281000;;92353000;373564000;416496000;508849000;300570000;-19324000;9744000;272031000;780880000
TWI;795301;USD;2018;Q4;2018-12-31;2019-03-07;59922000;59985000;81685000;241832000;395735000;779481000;384872000;;86903000;471775000;1251256000;212129000;51885000;375068000;409572000;486278000;861346000;519498000;-7831000;-29048000;389910000;1251256000
LGCY;795422;USD;2018;Q4;2018-12-31;2019-03-22;107340000;107340000;1098000;;;151092000;1316769000;;7070000;1323839000;1474931000;110113000;856646000;984650000;432923000;682912000;1667562000;25846000;;-218477000;-192631000;1474931000
LGCY;795422;USD;2017;Q4;2017-12-31;2018-10-31;100241000;100241000;1246000;;;112604000;1356317000;;24161000;1380478000;1493082000;94411000;0;144810000;1346769000;1619959000;1764769000;-271687000;;0;-271687000;1493082000
YEXT;795507;USD;2017;Q4;2017-12-31;2018-03-16;93644920;93644920;118341000;44656000;;180042000;11438000;;12009000;23447000;203489000;27416000;;118178000;;3858000;122036000;328444000;-11905000;-233450000;81453000;203489000
YEXT;795507;USD;2016;Q4;2016-12-31;2017-06-02;31186108;31186108;24420000;27646000;;61829000;11613000;;13023000;24636000;86465000;25633000;;83681000;5000000;9924000;93605000;52843000;-11905000;-166885000;-7140000;86465000
YEXT;795507;USD;2018;Q4;2018-12-31;2019-03-15;101466552;101466552;142776000;55341000;;230069000;11077000;;25982000;37059000;267128000;42651000;;179780000;;2799000;182579000;398991000;-11905000;-301109000;84549000;267128000
PGNX;795979;USD;2017;Q4;2017-12-31;2018-03-08;70462000;70462000;90642000;3972000;;96870000;4122000;;44965000;49087000;145957000;12914000;2445000;15359000;47242000;67145000;82504000;607813000;-2741000;-541586000;63453000;145957000
PGNX;795979;USD;2016;Q4;2016-12-31;2017-03-09;70105000;70429000;138909000;4864000;;148101000;4760000;;46125000;50885000;198986000;16357000;0;16357000;49453000;77867000;94224000;598161000;-2741000;-490573000;104762000;198986000
PGNX;795979;USD;2015;Q4;2015-12-31;2016-03-11;69875000;69875000;74103000;3543000;;83285000;2407000;;45559000;47966000;131251000;9544000;;9729000;0;30861000;40590000;594602000;-2741000;-501379000;90661000;131251000
PGNX;795979;USD;2014;Q4;2014-12-31;2015-03-16;69665000;66574000;119302000;109000;;121926000;2552000;;36559000;39111000;161037000;6570000;;6685000;;29443000;36128000;589917000;-2741000;-462267000;124909000;161037000
PGNX;795979;USD;2013;Q4;2013-12-31;2014-03-13;60996000;60996000;65860000;2879000;;70682000;2413000;2208000;39238000;43859000;114541000;6512000;;6627000;;28935000;35562000;548589000;-2741000;-466677000;78979000;114541000
PGNX;795979;USD;2012;Q4;2012-12-31;2013-03-15;37609000;37609000;58838000;6937000;;67467000;3399000;3240000;2202000;8841000;76308000;5640000;;6593000;;3147000;9740000;493674000;-2741000;-424105000;66568000;76308000
PGNX;795979;USD;2011;Q4;2011-12-31;2012-03-15;32997000;32984000;70105000;1516000;;72540000;4038000;3332000;200000;7570000;80110000;6331000;;6650000;;1659000;8309000;463484000;-2741000;-388674000;71801000;80110000
PGNX;795979;USD;2010;Q4;2010-12-31;2011-08-09;;;47918000;2283000;;52002000;5878000;3608000;1250000;10736000;62738000;9683000;;9795000;;1635000;11430000;453396000;-2741000;-399055000;51308000;62738000
PGNX;795979;USD;2018;Q4;2018-12-31;2019-03-15;84701000;84701000;137686000;3803000;;144129000;3944000;;21424000;25368000;169497000;10977000;5419000;16396000;39180000;52026000;68422000;713129000;-2741000;-609208000;101075000;169497000
ZIOP;795980;USD;2017;Q4;2017-12-31;2018-03-01;140794149;140794149;70946000;19000;;90783000;1211000;;13612000;14823000;105606000;14326000;;20856000;;37564000;58420000;615636000;;-712442000;47186000;105606000
ZIOP;795980;USD;2016;Q4;2016-12-31;2017-02-16;130526813;130526813;81053000;21000;;104884000;843000;;621000;1464000;106348000;9265000;;15809000;;42516000;58325000;580699000;;-657997000;48023000;106348000
ZIOP;795980;USD;2015;Q4;2015-12-31;2016-02-24;130108313;130108313;140717000;446000;;152521000;581000;;622000;1203000;153724000;10914000;;18123000;;48230000;66353000;580071000;;-492700000;87371000;153724000
ZIOP;795980;USD;2014;Q4;2014-12-31;2015-02-26;103442556;103442556;42803000;145000;;44087000;531000;;619000;1150000;45237000;9186000;;10826000;;570000;11396000;406453000;;-372612000;33841000;45237000
ZIOP;795980;USD;2013;Q4;2013-12-31;2014-03-03;94622060;94622060;68204000;145000;;70297000;801000;;656000;1457000;71754000;6779000;;7791000;;14580000;22371000;390214000;;-340831000;49383000;71754000
ZIOP;795980;USD;2012;Q4;2012-12-31;2013-03-18;81379378;81379378;73306000;58000;;80276000;1994000;;1134000;3128000;83404000;18025000;;18864000;;16095000;34959000;332169000;;-283724000;48445000;83404000
ZIOP;795980;USD;2011;Q4;2011-12-31;2012-02-29;68183904;68183904;104713000;79000;;106105000;1141000;;862000;2003000;108108000;12548000;;13363000;;23138000;36501000;259199000;;-187592000;71607000;108108000
ZIOP;795980;USD;2010;Q4;2010-12-31;2011-08-09;54014995;54014995;60392000;;;60816000;253000;;451000;704000;61520000;3569000;;3612000;;27355000;30967000;154367000;;-123814000;30553000;61520000
ZIOP;795980;USD;2009;Q4;2009-12-31;2011-08-01;;;48839000;;;49193000;255000;;288000;543000;49736000;3050000;;3095000;;18537000;21632000;119248000;;-91144000;28104000;49736000
ZIOP;795980;USD;2018;Q4;2018-12-31;2019-03-05;150978274;151784218;61729000;1864000;;84285000;1097000;;9669000;10766000;95051000;9470000;;9483000;;4000;9487000;651893000;;-566329000;85564000;95051000
CCXI;795982;USD;2017;Q4;2017-12-31;2018-03-12;48711000;53519000;127291000;51090000;;179830000;1210000;7929000;359000;9498000;189328000;9975000;;32937000;4676000;77124000;110061000;368602000;;-289200000;79267000;189328000
CCXI;795982;USD;2016;Q4;2016-12-31;2017-03-14;47903000;47903000;117764000;30205000;;148691000;905000;5997000;279000;7181000;155872000;9316000;;38335000;;67648000;105983000;357014000;;-307059000;49889000;155872000
CCXI;795982;USD;2015;Q4;2015-12-31;2016-03-14;44146000;44146000;71278000;;;72035000;949000;5011000;160000;6120000;78155000;5494000;;5494000;;154000;5648000;339659000;;-267096000;72507000;78155000
CCXI;795982;USD;2014;Q4;2014-12-31;2015-03-13;43383000;43383000;73357000;;;74329000;1208000;41263000;181000;42652000;116981000;8190000;;8190000;;185000;8375000;328483000;;-219791000;108606000;116981000
CCXI;795982;USD;2013;Q4;2013-12-31;2014-03-14;42877000;42877000;133313000;393000;;134302000;1399000;16561000;160000;18120000;152422000;6558000;;6558000;330000;556000;7114000;318146000;;-172862000;145308000;152422000
CCXI;795982;USD;2012;Q4;2012-12-31;2013-03-14;36348000;36348000;102694000;1156000;;104480000;1421000;16262000;160000;17843000;122323000;7017000;;10778000;901000;1199000;11977000;244549000;;-134189000;110346000;122323000
CCXI;795982;USD;2011;Q4;2011-12-31;2012-05-10;4358000;4358000;89490000;507000;;91319000;1541000;6596000;2095000;10232000;101551000;5228000;;8856000;11920000;16698000;25554000;170293000;;-94298000;75997000;101551000
CCXI;795982;USD;2018;Q4;2018-12-31;2019-03-11;50520000;50520000;176984000;2058000;;181384000;1536000;0;390000;1926000;183310000;13935000;;64396000;19689000;104176000;168572000;389449000;;-374497000;14738000;183310000
ARQL;795983;USD;2017;Q4;2017-12-31;2018-03-05;156501851;156501851;48036000;;;48583000;115000;;204000;319000;48902000;8259000;;9759000;14607000;16119000;25878000;548235000;;-534038000;23024000;48902000
ARQL;795983;USD;2016;Q4;2016-12-31;2017-03-09;278648366;278648366;31126000;;;31948000;180000;;252000;432000;32380000;8700000;;8700000;;0;8700000;528513000;;-504835000;23680000;32380000
ARQL;795983;USD;2015;Q4;2015-12-31;2016-02-29;125588255;125588255;38772000;;;39486000;266000;;252000;518000;40004000;6234000;;10825000;;0;10825000;511293000;;-482117000;29179000;40004000
ARQL;795983;USD;2014;Q4;2014-12-31;2015-03-04;187755765;187755765;59208000;;;61101000;133000;2058000;102000;2293000;63394000;6947000;;18277000;;4572000;22849000;508898000;;-468343000;40545000;63394000
ARQL;795983;USD;2013;Q4;2013-12-31;2014-03-05;-187119080;-187119080;74695000;;;75636000;1128000;20391000;1024000;22543000;98179000;8470000;1700000;21753000;232000;15800000;37553000;505511000;;-444952000;60626000;98179000
ARQL;795983;USD;2012;Q4;2012-12-31;2013-03-14;-176685716;-176685716;79271000;;;79615000;1992000;51328000;1258000;54578000;134193000;10163000;1700000;26647000;784000;26517000;53164000;501279000;;-420352000;81029000;134193000
ARQL;795983;USD;2011;Q4;2011-12-31;2012-03-01;53627000;53627000;68168000;;;72188000;2939000;40475000;1449000;44863000;117051000;11932000;1700000;48889000;1336000;38433000;87322000;439215000;;-409480000;29729000;117051000
ARQL;795983;USD;2010;Q4;2010-12-31;2011-08-04;;;80695000;;;81814000;3517000;2154000;1381000;7052000;88866000;16836000;1700000;46913000;1888000;56515000;103428000;384163000;;-398718000;-14562000;88866000
ARQL;795983;USD;2018;Q4;2018-12-31;2019-03-07;201490759;201482468;99558000;;;106403000;69000;;204000;273000;106676000;12948000;1667000;14615000;13093000;13093000;27708000;627083000;;-548020000;78968000;106676000
STML;795984;USD;2017;Q4;2017-12-31;2018-03-16;23540239;23540239;51719710;;;52188777;136672;14468414;212305;14817391;67006168;19742087;;19838913;;96826;19935739;251492077;;-204275690;47070429;67006168
STML;795984;USD;2016;Q4;2016-12-31;2017-03-16;17886284;17886284;46878964;;;47169711;22531;20714551;212305;20949387;68119098;9284514;;10253813;;142200;10396013;193565494;;-135742607;57723085;68119098
STML;795984;USD;2015;Q4;2015-12-31;2016-03-14;17559987;17559987;46039441;;;46691330;95661;51428632;;51524293;98215623;8632873;;9455477;;648190;10103667;185705248;;-97439602;88111956;98215623
STML;795984;USD;2014;Q4;2014-12-31;2015-03-16;12999811;12999811;53983364;;;55620172;230000;4644820;;4874820;60494992;4473842;;4473842;;607999;5081841;115605892;;-60195741;55413151;60494992
STML;795984;USD;2013;Q4;2013-12-31;2014-03-31;12813281;12813281;44200420;;;44692951;383333;40204912;;40588245;85281196;5013808;;5013808;;643000;5656808;111033929;;-31365766;79624388;85281196
STML;795984;USD;2012;Q4;2012-12-31;2013-06-12;3441995;3441995;2025338;;;2324427;;;2705184;2705184;5029611;5500735;;5500735;2006881;2037296;7538031;4660835;;-7169255;-2508420;5029611
STML;795984;USD;2018;Q4;2018-12-31;2019-03-15;29123132;29123132;60105856;;;63058852;222413;;212305;434718;63493570;21153062;;21218924;;72591;21291515;331346678;;-289088064;42202055;63493570
GTXI;796059;USD;2017;Q4;2017-12-31;2018-03-13;21589020;21589020;43899000;;;46077000;51000;;108000;159000;46236000;7975000;;7975000;;0;7975000;599898000;;-561637000;38261000;46236000
GTXI;796059;USD;2016;Q4;2016-12-31;2017-03-24;15721820;15529208;21869000;;;24298000;81000;;123000;204000;24502000;4611000;;4611000;;0;4611000;551089000;;-531198000;19891000;24502000
GTXI;796059;USD;2015;Q4;2015-12-31;2016-03-15;14037463;15553406;29256000;;;31889000;5000;;137000;142000;32031000;30172000;;30172000;;0;30172000;515333000;;-513474000;1859000;32031000
GTXI;796059;USD;2014;Q4;2014-12-31;2015-03-16;10927090;10927090;49295000;;;50151000;29000;;471000;500000;50651000;32792000;;32792000;;30000;32822000;512600000;;-494771000;17829000;50651000
GTXI;796059;USD;2013;Q4;2013-12-31;2014-03-12;6319026;6319026;14729000;;;15171000;112000;;322000;434000;15605000;4567000;;4567000;;354000;4921000;466044000;;-455360000;10684000;15605000
GTXI;796059;USD;2012;Q4;2012-12-31;2013-03-05;6281766;6281766;56089000;;;56815000;507000;;452000;959000;57774000;9495000;;9495000;;578000;10073000;460950000;;-413249000;47701000;57774000
GTXI;796059;USD;2011;Q4;2011-12-31;2012-03-02;6297144;6297144;74440000;981000;161000;76848000;1096000;;712000;1808000;78656000;5833000;;5833000;;949000;6782000;458048000;;-386174000;71874000;78656000
GTXI;796059;USD;2010;Q4;2010-12-31;2011-08-09;;;58631000;683000;171000;60360000;2040000;;1850000;3890000;64250000;3960000;;5305000;;7218000;12523000;404607000;;-352880000;51727000;64250000
GTXI;796059;USD;2018;Q4;2018-12-31;2019-03-18;24082436;24082436;20645000;;;21210000;;;752000;752000;21962000;4331000;;4331000;;0;4331000;1753000;;-31384000;17631000;21962000
ALCO;798086;USD;2017;Q4;2017-09-30;2017-12-11;8256000;8185000;3395000;4286000;36204000;66489000;349337000;;3356000;352693000;419182000;9973000;4550000;15983000;181926000;237830000;253813000;27110000;-6502000;140033000;165369000;419182000
ALCO;798086;USD;2016;Q4;2016-09-30;2016-12-06;8314000;8329000;6625000;4740000;58469000;71871000;379247000;;4327000;383574000;455445000;12895000;4493000;18678000;198026000;258504000;277182000;26571000;-4585000;151504000;178263000;455445000
ALCO;798086;USD;2015;Q4;2015-09-30;2015-12-10;8307000;8321000;5474000;3137000;58273000;70763000;381099000;;8226000;389325000;460088000;18220000;4788000;24134000;201558000;260443000;284577000;28211000;-3962000;146455000;175511000;460088000
ALCO;798086;USD;2014;Q4;2014-09-30;2014-12-12;7360000;7428000;31020000;8441000;25469000;125712000;126833000;;5035000;131868000;257580000;10852000;3455000;20670000;62443000;75059000;95729000;27533000;-650000;134968000;161851000;257580000
ALCO;798086;USD;2013;Q4;2013-09-30;2013-12-09;7306000;7379000;24843000;4266000;29403000;59795000;131071000;5086000;2888000;139045000;198840000;6715000;2000000;11491000;34000000;44613000;56104000;16873000;-2816000;128679000;142736000;198840000
ALCO;798086;USD;2012;Q4;2012-09-30;2012-12-05;7357000;7357000;13585000;3071000;27290000;51467000;122834000;5607000;5175000;133616000;185083000;8784000;3267000;17148000;36633000;40389000;57537000;16430000;-543000;111659000;127546000;185083000
ALCO;798086;USD;2011;Q4;2011-09-30;2011-12-14;7354000;7354000;2325000;2928000;22373000;29181000;128780000;10283000;11791000;150854000;180035000;5547000;3279000;11827000;53879000;57546000;69373000;16589000;-862000;94935000;110662000;180035000
ALCO;798086;USD;2010;Q4;2010-09-30;2011-08-09;7350000;7350000;12365000;4389000;18601000;37441000;124973000;12699000;13704000;151376000;188817000;3751000;1281000;7912000;72179000;75668000;83580000;16689000;-172000;88720000;105237000;188817000
ALCO;798086;USD;2018;Q4;2018-09-30;2018-12-06;8199000;8260000;25260000;2544000;41033000;79240000;340403000;;3779000;344182000;423422000;15310000;5275000;21498000;171759000;224329000;245827000;28542000;-7536000;151111000;177595000;423422000
TROV;798464;USD;2017;Q4;2017-12-31;2018-02-26;559652;559652;8225764;77095;;9468687;2426312;;389942;2816254;12284941;2279831;1331515;3945770;;1833064;5778834;179552233;;-173046186;6506107;12284941
TROV;798464;USD;2016;Q4;2016-12-31;2017-03-15;425559;426566;37893116;100460;;38950192;3826915;;1173304;5000219;43950411;5151901;2360109;7797256;14176359;16385016;24182272;167894054;;-148115202;19768139;43950411
TROV;798464;USD;2015;Q4;2015-12-31;2016-03-10;414307;420330;67493047;98736;;68381068;2690579;;374004;3064583;71445651;2944665;5225818;8201097;11246188;14543265;22744362;157588472;;-108887243;48701289;71445651
TROV;798464;USD;2014;Q4;2014-12-31;2015-03-12;262569;267254;27293798;56694;;27719751;840387;;336708;1177095;28896846;2589607;1898548;4488155;13053117;16059138;20547293;89741402;;-81391909;8349553;28896846
TROV;798464;USD;2013;Q4;2013-12-31;2014-03-17;263112;263112;25836937;78994;;26068720;750565;;336450;1087015;27155735;1810700;198166;2008866;322998;4754869;6763735;87435350;;-67043410;20392000;27155735
TROV;798464;USD;2012;Q4;2012-12-31;2013-04-01;208284;208284;10819781;168381;;11048203;254742;;362081;616823;11665026;730370;;730370;;8765628;9495998;57371564;;-55202632;2169028;11665026
TROV;798464;USD;2011;Q4;2011-12-31;2012-05-15;147911;147911;700374;99140;;842172;22504;;174581;197085;1039257;1429881;;1429881;;3840644;5270525;39367067;;-43598431;-4231268;1039257
TROV;798464;USD;2018;Q4;2018-12-31;2019-03-06;3876635;3876635;11453133;167755;;12765265;1304433;;102798;1407231;14172496;2478682;;2965318;;1122986;4088304;202275347;;-192191215;10084192;14172496
CLBS;798466;USD;2018;Q4;2018-12-31;2019-03-14;9862015;9862015;43053000;;;44106000;165000;;309000;474000;44580000;5619000;;5619000;;1507000;7126000;436443000;-708000;-397977000;37454000;44580000
SWM;803493;USD;2017;Q4;2017-12-31;2018-03-01;30428000;30593700;106900000;149400000;155200000;433100000;361900000;68500000;679000000;1109400000;1542500000;142000000;5100000;147100000;679100000;848700000;995800000;69400000;;566700000;546700000;1542500000
SWM;803493;USD;2016;Q4;2016-12-31;2017-02-24;30319100;30524400;107400000;115100000;119400000;364300000;307400000;63800000;438200000;809400000;1173700000;132800000;3000000;135800000;437400000;529600000;665400000;62300000;;585300000;508300000;1173700000
SWM;803493;USD;2015;Q4;2015-12-31;2016-02-26;30277600;30398400;186500000;119400000;112400000;444800000;308100000;67500000;469600000;845200000;1290000000;139800000;3300000;143100000;568200000;679000000;822100000;56700000;;552600000;467900000;1290000000
SWM;803493;USD;2014;Q4;2014-12-31;2015-02-27;30091300;30211600;290300000;93900000;108400000;519400000;362000000;67800000;235800000;665600000;1185000000;121200000;2300000;123500000;435600000;572500000;696000000;52800000;;512700000;489000000;1185000000
SWM;803493;USD;2013;Q4;2013-12-31;2014-02-28;31091300;31304500;272000000;107600000;132800000;537100000;393200000;63100000;233400000;689700000;1226800000;142100000;4200000;146300000;381200000;519100000;665400000;46400000;;520000000;561400000;1226800000
SWM;803493;USD;2012;Q4;2012-12-31;2013-03-01;30647700;31011600;151200000;95400000;111600000;382000000;401400000;61200000;42100000;504700000;886700000;122700000;4200000;126900000;151800000;248000000;374900000;44100000;-300000;483400000;511800000;886700000
SWM;803493;USD;2011;Q4;2011-12-31;2012-02-24;33457000;33742400;76500000;112300000;113800000;327000000;428800000;38700000;50700000;518200000;845200000;135800000;5000000;140800000;141000000;228500000;369300000;215500000;-132100000;417000000;475900000;845200000
SWM;803493;USD;2010;Q4;2010-12-31;2011-05-04;34955600;35777000;87300000;98900000;113800000;312800000;440800000;20500000;76300000;537600000;850400000;178000000;8700000;186700000;43100000;139500000;326200000;210700000;-24400000;336400000;524200000;850400000
SWM;803493;USD;2018;Q4;2018-12-31;2019-03-01;30581200;30723200;93800000;154600000;151500000;429200000;340300000;51900000;645100000;1037300000;1466500000;140200000;3300000;143500000;618800000;765100000;908600000;74200000;;608200000;557900000;1466500000
KKR;805180;USD;2017;Q4;2017-12-31;2018-02-23;481505811;520420944;42692993000;;;43303644000;;;2531075000;2531075000;45834719000;3654250000;;3978060000;21193859000;21193859000;25171919000;6722863000;;0;20662800000;45834719000
KKR;805180;USD;2016;Q4;2016-12-31;2017-02-24;;;35543425000;;;36006032000;;;2996865000;2996865000;39002897000;2981260000;;3340739000;18544075000;18544075000;21884814000;5457279000;;;17118083000;39002897000
KKR;805180;USD;2015;Q4;2015-12-31;2016-02-26;;;67825791000;;;68233202000;;;2809137000;2809137000;71042339000;2715350000;;2860157000;18714597000;18714597000;21574754000;5547182000;;;49467585000;71042339000
KKR;805180;USD;2014;Q4;2014-12-31;2015-02-27;;;62458481000;;;62708528000;;;3164217000;3164217000;65872745000;3199352000;;3330900000;10837784000;10837784000;14168684000;5419990000;;;51704061000;65872745000
KKR;805180;USD;2013;Q4;2013-12-31;2014-02-24;;;49130888000;;;49332571000;;;2094630000;2094630000;51427201000;2839926000;;2933777000;1908606000;1908606000;4842383000;2727909000;;;46584818000;51427201000
KKR;805180;USD;2012;Q4;2012-12-31;2013-02-22;;;42515486000;;;42725298000;;;1701055000;1701055000;44426353000;1824655000;;1897485000;1123414000;1123414000;3020899000;2008965000;;;41405454000;44426353000
KKR;805180;USD;2011;Q4;2011-12-31;2012-02-27;;;39269507000;;;39508940000;;;868705000;868705000;40377645000;1085217000;;1128279000;1564716000;1564716000;2692995000;1330887000;;;37684650000;40377645000
KKR;805180;USD;2010;Q4;2010-12-31;2011-08-05;;;37884365000;;;38081403000;;;309754000;309754000;38391157000;886108000;;904155000;1486960000;1486960000;2391115000;1324530000;;;36000042000;38391157000
KKR;805180;USD;2018;Q4;2018-12-31;2019-02-15;532878601;504491431;47353129000;;;48206683000;;;2536692000;2536692000;50743375000;2743990000;;3019574000;22341192000;22341192000;25360766000;8114748000;;91953000;25382609000;50743375000
ADIL;807531;USD;2017;Q4;2017-12-31;2018-09-10;3253522;-9106890;18248;;;27248;;;7298;7298;34546;342082;337628;1032099;;0;1032099;-593561;;-403992;-997553;34546
ADIL;807531;USD;2018;Q4;2018-12-31;2019-02-19;6665596;-8305405;3869043;;;4692550;;;6735;6735;4699285;257974;;257974;;0;257974;16476681;;-12035370;4441311;4699285
EFOI;807596;USD;2017;Q4;2017-12-31;2018-02-22;11859000;11859000;10761000;3595000;5718000;20895000;1097000;;159000;1256000;22151000;2278000;;2627000;;232000;2859000;127494000;;-108204000;19292000;22151000
EFOI;807596;USD;2016;Q4;2016-12-31;2017-02-23;11695000;11695000;16629000;5640000;9469000;32620000;2325000;;33000;2358000;34978000;4933000;;4933000;;107000;5040000;126876000;;-96937000;29938000;34978000
EFOI;807596;USD;2015;Q4;2015-12-31;2016-03-10;11652000;12212000;34640000;10110000;7732000;53222000;2429000;;51000;2480000;55702000;10212000;;10305000;;77000;10382000;125370000;;-80050000;45320000;55702000
EFOI;807596;USD;2014;Q4;2014-12-31;2015-03-12;9475000;9475000;7435000;2656000;6869000;18929000;456000;;111000;567000;19496000;8082000;939000;9607000;70000;116000;9723000;98134000;;-88830000;9773000;19496000
EFOI;807596;USD;2013;Q4;2013-12-31;2014-03-27;9130010;9130010;2860000;3348000;2510000;10777000;536000;;1495000;2031000;12808000;4925000;59000;5819000;4011000;4065000;9884000;85447000;;-82985000;2924000;12808000
EFOI;807596;USD;2012;Q4;2012-12-31;2013-03-27;15321240;15321240;1181000;5319000;2581000;10826000;1800000;;1727000;3527000;14353000;8144000;756000;11705000;1793000;1823000;13528000;80989000;;-80624000;825000;14353000
EFOI;807596;USD;2011;Q4;2011-12-31;2012-03-30;248460;248460;2136000;2738000;2429000;8829000;2105000;;2844000;4949000;13778000;7648000;855000;10731000;955000;1579000;12310000;75963000;;-74915000;1468000;13778000
EFOI;807596;USD;2010;Q4;2010-12-31;2011-08-15;;;4107000;5483000;2543000;13518000;2446000;;4410000;6856000;20374000;9525000;481000;11517000;1344000;2199000;13716000;75095000;;-68860000;6658000;20374000
EFOI;807596;USD;2018;Q4;2018-12-31;2019-04-01;12080000;12080000;6335000;2201000;8058000;17688000;610000;;194000;804000;18492000;4577000;;7240000;0;200000;7440000;128368000;;-117315000;11052000;18492000
KOPN;807728;USD;2017;Q4;2017-12-31;2018-03-23;72305824;72305824;68755684;3955123;5080797;79739496;5077043;;6505951;11582994;91322490;10687034;;12103513;;1839130;13942643;331895060;-17238669;-240121901;77379847;91322490
KOPN;807728;USD;2016;Q4;2016-12-31;2017-03-23;64145700;64145700;77197896;1664488;3302112;83394104;2976006;;1462162;4438168;87832272;9812946;;13365707;;246922;13612629;329291053;-42741551;-214042787;74219643;87832272
KOPN;807728;USD;2015;Q4;2015-12-31;2016-03-04;64645188;62681188;80710780;16487633;2512473;101156222;3496366;;1407498;4903864;106060086;8662278;;11276844;;298463;11575307;327319323;-42741551;-190608671;94484779;106060086
KOPN;807728;USD;2014;Q4;2014-12-31;2015-03-12;62733700;62733700;90858936;3758832;4081886;99924620;4589421;;18427373;23016794;122941414;11374453;;13242924;;311187;13554111;325377526;-42741551;-175915255;109387303;122941414
KOPN;807728;USD;2013;Q4;2013-12-31;2014-03-17;61570408;61570408;112729201;2388461;3078055;119608002;6034963;;20488758;26523721;146131723;9178650;;11239102;;329435;11568537;321257393;-42442932;-147703211;134563186;146131723
KOPN;807728;USD;2012;Q4;2012-12-31;2013-03-18;63752720;63752720;92485349;5254549;5789753;126967069;8486406;;40755327;49241733;176208802;10548633;;20176436;;946456;21122892;319665461;-34450978;-142993595;155085910;176208802
KOPN;807728;USD;2011;Q4;2011-12-31;2012-03-15;64066104;63065848;105418550;16510851;20468512;145736944;32369441;;15765831;48135272;193872216;20012329;;22479790;;1295670;23775460;316442423;-30995449;-124631665;170096756;193872216
KOPN;807728;USD;2010;Q4;2010-12-31;2011-08-04;64751252;65399289;110947390;14539664;21462871;152624762;32613961;;6857675;39471636;192096398;17315511;;20526406;;944617;21471023;314037597;-26580823;-127606200;170625375;192096398
KOPN;807728;USD;2018;Q4;2018-12-31;2019-03-14;73317330;73317330;37244363;3088360;4797238;49404025;2598842;5565499;1980745;10145086;59549111;9432432;;10367365;;1468925;11836290;336478099;-17238669;-272932143;47712821;59549111
SYRS;807944;USD;2018;Q4;2018-12-31;2019-03-07;33743593;33743593;99679000;;;101734000;3861000;;1171000;5032000;106766000;17202000;9000;19529000;375000;8651000;28180000;296134000;;-217545000;78586000;106766000
SYRS;807944;USD;2017;Q4;2017-12-31;2018-03-12;26390569;26390569;72049000;;;73159000;3938000;;1391000;5329000;78488000;12011000;47000;12413000;751000;751000;13164000;220632000;;-155266000;65324000;78488000
SYRS;807944;USD;2016;Q4;2016-12-31;2017-03-20;23825297;23825297;83593000;867000;;85508000;4850000;;965000;5815000;91323000;8530000;168000;9567000;1154000;1154000;10721000;181867000;;-101256000;80602000;91323000
SYRS;807944;USD;2015;Q4;2015-12-31;2016-08-15;2326723;2326723;35909000;;;36449000;4799000;;2383000;7182000;43631000;7539000;133000;7956000;1626000;1626000;9582000;5549000;;-53513000;34049000;43631000
EVLO;807946;USD;2017;Q4;2017-12-31;2018-05-31;3840717;3840717;38246000;;;38777000;3496000;;1515000;5011000;43788000;3610000;;3839000;9966000;10970000;14809000;1688000;;-56411000;28979000;43788000
EVLO;807946;USD;2018;Q4;2018-12-31;2019-02-15;32193296;32193296;147919000;;;151622000;6925000;;1320000;8245000;159867000;6484000;;9235000;12305000;13683000;22918000;250348000;;-113381000;136949000;159867000
RDFN;808089;USD;2017;Q4;2017-12-31;2018-02-22;82338841;82338841;208342000;13334000;3382000;240206000;22318000;;19431000;41749000;281955000;32574000;;35857000;0;10668000;46525000;364433000;;-129003000;235430000;281955000
RDFN;808089;USD;2016;Q4;2016-12-31;2017-09-08;14560808;-151705198;65779000;10625000;;93388000;19226000;;20863000;40089000;133477000;31431000;;32943000;;8852000;41795000;15000;;-563749000;91682000;133477000
RDFN;808089;USD;2018;Q4;2018-12-31;2019-02-14;89757350;75279602;432608000;15363000;22694000;496247000;25187000;0;21387000;46574000;542821000;39897000;4733000;46218000;113586000;124665000;170883000;542919000;;-170981000;371938000;542821000
DBX;808182;USD;2017;Q4;2017-12-31;2018-05-11;197500000;197500000;430000000;29300000;;518100000;341900000;;159900000;501800000;1019900000;217800000;102700000;738400000;71600000;178600000;917000000;533100000;;-1049700000;102900000;1019900000
DBX;808182;USD;2018;Q4;2018-12-31;2019-02-25;410400000;410400000;1089300000;28600000;;1210200000;310600000;;173300000;483900000;1694100000;278700000;73800000;837500000;89900000;179800000;1017300000;2337500000;;-1659500000;676800000;1694100000
BLCM;808260;USD;2017;Q4;2017-12-31;2018-03-13;33307740;33307740;98896000;320000;;101650000;25942000;1368000;6568000;33878000;135528000;9679000;31000;12156000;35077000;38724000;50880000;412262000;-5056000;-322512000;84648000;135528000
BLCM;808260;USD;2016;Q4;2016-12-31;2017-03-13;27044184;27044184;103772000;334000;;105610000;16504000;0;9923000;26427000;132037000;12986000;1808000;15113000;18577000;20350000;35463000;332346000;-5056000;-230733000;96574000;132037000
BLCM;808260;USD;2015;Q4;2015-12-31;2016-03-14;26481954;26481954;94061000;440000;;96890000;6882000;56304000;330000;63516000;160406000;7186000;13000;7445000;118000;944000;8389000;318867000;-5056000;-161492000;152017000;160406000
BLCM;808260;USD;2014;Q4;2014-12-31;2015-05-12;3928725;3928725;191602000;298000;;193222000;2427000;0;145000;2572000;195794000;3372000;0;3636000;0;522000;4158000;309636000;-5056000;-112944000;191636000;195794000
BLCM;808260;USD;2018;Q4;2018-12-31;2019-03-12;43525194;43525194;92999000;909000;;95295000;20878000;;5328000;26206000;121501000;12363000;40000;15804000;35923000;37219000;53023000;494226000;-5056000;-420548000;68478000;121501000
SURF;808799;USD;2017;Q4;2017-12-31;2018-05-29;2579906;2579906;63309000;;;71330000;7326000;;2798000;10124000;81454000;13058000;;23384000;;76867000;100251000;6877000;;-73945000;-18797000;81454000
SURF;808799;USD;2018;Q4;2018-12-31;2019-03-07;28041649;28041649;158835000;;;164601000;8226000;;1238000;9464000;174065000;12215000;;27177000;;44026000;71203000;169787000;;-66806000;102862000;174065000
MRSN;808876;USD;2017;Q4;2017-12-31;2018-03-28;23098020;23098020;114734000;784000;;117543000;2319000;10482000;371000;13172000;130715000;10014000;;31881000;;28840000;60721000;168021000;;-97878000;69994000;130715000
MRSN;808876;USD;2016;Q4;2016-12-31;2017-08-11;1290552;1290552;100297000;1051000;;102173000;2483000;;431000;2914000;105087000;5496000;;28386000;;37870000;66256000;3552000;;-59171000;38831000;105087000
MRSN;808876;USD;2018;Q4;2018-12-31;2019-03-08;23194146;23194146;70131000;459000;;74305000;2694000;;1503000;4197000;78502000;23102000;;69707000;;0;69707000;172969000;;-164166000;8795000;78502000
CRVS;808943;USD;2017;Q4;2017-12-31;2018-03-01;20676402;20676402;90055000;;;91234000;2672000;;869000;3541000;94775000;8969000;;8969000;;971000;9940000;208410000;;-123534000;84835000;94775000
CRVS;808943;USD;2016;Q4;2016-12-31;2017-03-10;20368662;20368662;134896000;;;136033000;3248000;;869000;4117000;140150000;5944000;;5944000;;1405000;7349000;200711000;;-67871000;132801000;140150000
CRVS;808943;USD;2015;Q4;2015-12-31;2016-05-05;455790;455790;94386000;;;95663000;1845000;;951000;2796000;98459000;3070000;;3070000;;710000;3780000;440000;;-31496000;94679000;98459000
CRVS;808943;USD;2018;Q4;2018-12-31;2019-03-07;29392577;29392577;114597000;;;115589000;2180000;;463000;2643000;118232000;7027000;;7027000;;869000;7896000;280843000;;-170473000;110336000;118232000
UMRX;808945;USD;2017;Q4;2017-12-31;2018-05-14;10194583;10194583;40961000;830000;;42379000;4108000;;2628000;6736000;49115000;4299000;;11190000;;9620000;20810000;2509000;;-51339000;28305000;49115000
UMRX;808945;USD;2018;Q4;2018-12-31;2019-03-28;30342823;30342823;78594000;1668000;;81002000;3251000;;1674000;4925000;85927000;6996000;;24945000;;748000;25693000;152305000;;-92059000;60234000;85927000
AVEO;809080;USD;2017;Q4;2017-12-31;2018-03-13;423415198;423415198;33525000;402000;;50183000;;;15000;15000;50198000;13215000;;32124000;18477000;58837000;90961000;546210000;;-586969000;-40763000;50198000
AVEO;809080;USD;2016;Q4;2016-12-31;2017-03-22;276871056;276871056;23348000;1027000;;26315000;;;970000;970000;27285000;9839000;;10349000;11879000;18859000;29208000;519987000;;-521916000;-1923000;27285000
AVEO;809080;USD;2015;Q4;2015-12-31;2016-03-15;58208000;57986000;34135000;4641000;;40376000;23000;;143000;166000;40542000;7584000;;12398000;7418000;10917000;23315000;512259000;;-495029000;17227000;40542000
AVEO;809080;USD;2014;Q4;2014-12-31;2015-03-06;54088000;54088000;52306000;2341000;;59128000;11295000;;239000;11534000;70662000;24268000;;40355000;8930000;9701000;50056000;500634000;;-480028000;20606000;70662000
AVEO;809080;USD;2013;Q4;2013-12-31;2014-03-13;51577000;51577000;118506000;984000;;128919000;14140000;;3287000;17427000;146346000;27884000;;31408000;8822000;45000000;76408000;497229000;;-427289000;69938000;146346000
AVEO;809080;USD;2012;Q4;2012-12-31;2013-03-11;43490000;43490000;160602000;20649000;;190681000;12867000;;3921000;16788000;207469000;36980000;;39130000;19228000;49401000;88531000;439217000;;-320260000;118938000;207469000
AVEO;809080;USD;2011;Q4;2011-12-31;2012-03-30;43213000;48543000;221128000;7210000;;234395000;5471000;54312000;872000;60655000;295050000;31744000;;34609000;15619000;36900000;71509000;429574000;;-205866000;223541000;295050000
AVEO;809080;USD;2010;Q4;2010-12-31;2011-08-09;34009000;34009000;140198000;391000;;145453000;4532000;;1063000;5595000;151048000;25134000;;42093000;17636000;37185000;79278000;308304000;;-236514000;71770000;151048000
AVEO;809080;USD;2018;Q4;2018-12-31;2019-03-14;124450000;155254000;24427000;3026000;;27935000;;;;;27935000;15705000;;18117000;15779000;37045000;55162000;567781000;;-595009000;-27227000;27935000
SRRA;809435;USD;2017;Q4;2017-12-31;2018-02-27;52463330;52463330;100348000;;;101725000;154000;;319000;473000;102198000;7472000;;7472000;;;7472000;718803000;;-624077000;94726000;102198000
SRRA;809435;USD;2016;Q4;2016-12-31;2017-03-02;30368096;30368096;109007000;;;110350000;400000;;223000;623000;110973000;7725000;;7725000;;0;7725000;685302000;;-582054000;103248000;110973000
SRRA;809435;USD;2015;Q4;2015-12-31;2016-03-03;30445337;30445337;150180000;;;151853000;566000;;349000;915000;152768000;7374000;;7397000;;0;7397000;679558000;;-534187000;145371000;152768000
SRRA;809435;USD;2014;Q4;2014-12-31;2015-08-21;1476270;1476270;39164000;;;39725000;214000;;626000;840000;40565000;2095000;;2195000;;1810000;4005000;2000;;-107807000;36560000;40565000
SRRA;809435;USD;2018;Q4;2018-12-31;2019-02-28;74566193;74566193;106046000;;;108752000;168000;;549000;717000;109469000;10099000;;10099000;4891000;4891000;14990000;771891000;;-677412000;94479000;109469000
IMDZ;809437;USD;2017;Q4;2017-12-31;2018-03-14;41856299;41856299;141107000;647000;684000;153143000;491000;;200000;691000;153834000;8520000;;14520000;;102000;14622000;375018000;;-235757000;139212000;153834000
IMDZ;809437;USD;2016;Q4;2016-12-31;2017-03-07;25441484;25441484;107255000;517000;607000;114081000;414000;;0;414000;114495000;9494000;;19263000;;56000;19319000;278938000;;-183738000;95176000;114495000
IMDZ;809437;USD;2015;Q4;2015-12-31;2016-03-15;20191137;20191137;112921000;972000;13000;115560000;585000;;;585000;116145000;7033000;;7111000;;41000;7152000;239201000;;-130208000;108993000;116145000
IMDZ;809437;USD;2014;Q4;2014-12-31;2015-03-31;17110944;17110944;75354000;1970000;25000;77982000;401000;;;401000;78383000;11904000;;11947000;;90000;12037000;157109000;;-90763000;66346000;78383000
IMDZ;809437;USD;2013;Q4;2013-12-31;2014-09-08;369186;369186;30387000;87000;17000;30670000;295000;;;295000;30965000;1948000;;1975000;;94000;2069000;778000;;-56612000;28896000;30965000
IMDZ;809437;USD;2018;Q4;2018-12-31;2019-03-13;48168024;48168024;95887000;705000;92000;100225000;535000;;200000;735000;100960000;8845000;;8845000;;110000;8955000;382522000;;-290515000;92005000;100960000
NLNK;809595;USD;2017;Q4;2017-12-31;2018-03-05;36838539;36838539;158708000;;;175466000;5091000;;140000;5231000;180697000;21723000;160000;22031000;111000;7109000;29140000;390158000;-1142000;-237459000;151557000;180697000
NLNK;809595;USD;2016;Q4;2016-12-31;2017-03-06;29184976;29184976;131490000;;;167912000;6835000;;0;6835000;174747000;37192000;232000;37905000;285000;7376000;45281000;295827000;-853000;-165508000;129466000;174747000
NLNK;809595;USD;2015;Q4;2015-12-31;2016-02-29;28731353;25030666;195620000;;;208142000;10400000;;;10400000;218542000;13281000;571000;14840000;368000;7928000;22768000;276898000;-771000;-80353000;195774000;218542000
NLNK;809595;USD;2014;Q4;2014-12-31;2015-03-16;27958148;40703052;190404000;;;223622000;7599000;;;7599000;231221000;11779000;192000;25021000;941000;9264000;34285000;237118000;-222000;-39960000;196936000;231221000
NLNK;809595;USD;2013;Q4;2013-12-31;2014-03-12;25917638;25917638;61291000;;;63970000;6587000;;;6587000;70557000;3603000;189000;3876000;1033000;8354000;12230000;194304000;0;-135977000;58327000;70557000
NLNK;809595;USD;2018;Q4;2018-12-31;2019-03-05;37230074;37230074;120738000;;;127072000;3727000;;140000;3867000;130939000;8694000;61000;8847000;43000;6949000;15796000;407572000;-1417000;-291012000;115143000;130939000
TOCA;809598;USD;2017;Q4;2017-12-31;2018-03-09;20082244;20082244;88725000;;;90629000;1217000;;227000;1444000;92073000;10071000;7200000;17330000;3625000;3661000;20991000;238045000;;-166929000;71082000;92073000
TOCA;809598;USD;2016;Q4;2016-12-31;2017-05-23;2202528;2202528;31245000;;;32461000;743000;;2147000;2890000;35351000;7103000;7200000;14382000;13639000;13847000;28229000;3583000;;-128000000;7122000;35351000
TOCA;809598;USD;2018;Q4;2018-12-31;2019-02-27;20458676;20458676;96086000;;;97748000;3973000;;1360000;5333000;103081000;16498000;;16498000;26201000;28438000;44936000;274052000;;-215884000;58145000;103081000
VSLR;809892;USD;2017;Q4;2017-12-31;2018-03-07;114907000;119639000;108452000;19665000;22597000;184763000;15078000;;2264088000;2279166000;2463929000;91566000;17751000;167600000;927563000;1312819000;1480419000;560939000;;213107000;983510000;2463929000
VSLR;809892;USD;2016;Q4;2016-12-31;2017-03-16;110223000;118809000;96586000;12658000;11285000;167212000;23199000;;1935945000;1959144000;2126356000;86188000;11415000;133690000;756204000;1196156000;1329846000;543450000;;5217000;796510000;2126356000
VSLR;809892;USD;2015;Q4;2015-12-31;2016-03-15;106569000;110364000;92213000;3636000;631000;113558000;48168000;;1447344000;1495512000;1609070000;94666000;5489000;116470000;425905000;713807000;830277000;531712000;;-12769000;778793000;1609070000
VSLR;809892;USD;2014;Q4;2014-12-31;2015-03-13;105356000;103025000;261649000;1837000;774000;281066000;13024000;;770234000;783258000;1064324000;84296000;3502000;94892000;111176000;227869000;322761000;503838000;;-25849000;741563000;1064324000
VSLR;809892;USD;2013;Q4;2013-12-31;2014-11-20;75000000;75851128;6038000;608000;;12584000;3640000;;281483000;285123000;297707000;54222000;1275000;57141000;43898000;86680000;143821000;75799000;;3034000;153886000;297707000
VSLR;809892;USD;2018;Q4;2018-12-31;2019-03-05;119688000;114585000;219591000;14207000;13257000;278256000;10730000;;2038269000;2048999000;2327255000;114309000;14076000;166430000;1203787000;1679041000;1845471000;575449000;;-279631000;481784000;2327255000
DOCU;810159;USD;2017;Q4;2018-01-31;2018-06-08;34422856;34422856;256867000;123750000;;418795000;63019000;;138159000;201178000;619973000;90299000;;373819000;0;37301000;411120000;160269000;;-502320000;208853000;619973000
DOCU;810159;USD;2018;Q4;2019-01-31;2019-03-26;170497919;170497919;769014000;174548000;;984521000;75832000;164220000;390844000;630896000;1615417000;118898000;;516313000;438932000;484742000;1001055000;1545105000;;-928778000;614362000;1615417000
COUP;811353;USD;2017;Q4;2018-01-31;2018-03-28;54891000;54891000;412903000;61366000;;488977000;5186000;;78287000;83473000;572450000;27985000;163010000;316709000;;15196000;331905000;445324000;;-204481000;240545000;572450000
COUP;811353;USD;2016;Q4;2017-01-31;2017-04-03;50094000;50094000;201721000;47614000;;261576000;4642000;;17646000;22288000;283864000;18665000;;108537000;;1435000;109972000;334368000;;-160476000;173892000;283864000
COUP;811353;USD;2015;Q4;2016-01-31;2016-12-09;18802389;18802389;92348000;27979000;;128013000;3775000;;8138000;11913000;139926000;15542000;;79412000;;1803000;81215000;16630000;;-122869000;58711000;139926000
COUP;811353;USD;2018;Q4;2019-01-31;2019-03-27;59813000;59813000;321419000;95274000;;434360000;10549000;;295155000;305704000;740064000;47277000;174615000;401859000;;24924000;426783000;567803000;;-254857000;313281000;740064000
ZEUS;815280;USD;2017;Q4;2017-12-31;2018-03-02;11386000;11379000;3009000;132737000;275307000;420136000;147648000;;36374000;184022000;604158000;110217000;930000;111147000;196235000;220428000;331575000;129453000;-337000;143467000;272583000;604158000
ZEUS;815280;USD;2016;Q4;2016-12-31;2017-03-02;11223000;11223000;2315000;101902000;254526000;364940000;155766000;;35362000;191128000;556068000;103073000;1825000;104898000;164599000;197780000;302678000;128619000;-609000;125380000;253390000;556068000
ZEUS;815280;USD;2015;Q4;2015-12-31;2016-02-25;11169000;11169000;1604000;92877000;206645000;308946000;166538000;;36396000;202934000;511880000;74370000;2690000;77060000;145800000;180125000;257185000;128129000;-699000;127335000;254695000;511880000
ZEUS;815280;USD;2014;Q4;2014-12-31;2015-02-26;11182000;11181000;2238000;123804000;311108000;458709000;177386000;;64653000;242039000;700748000;128447000;3530000;131977000;244090000;287990000;419967000;126339000;0;154991000;280781000;700748000
ZEUS;815280;USD;2013;Q4;2013-12-31;2014-02-27;11098000;11105000;3186000;115288000;286371000;417631000;190884000;;88834000;279718000;697349000;152543000;13090000;165633000;186179000;233100000;398733000;124118000;;174935000;298616000;697349000
ZEUS;815280;USD;2012;Q4;2012-12-31;2013-02-21;11047000;11027000;7782000;112841000;290023000;422377000;196327000;;87290000;283617000;705994000;127160000;15282000;142442000;226429000;273695000;416137000;122272000;;168164000;289857000;705994000
ZEUS;815280;USD;2011;Q4;2011-12-31;2012-02-23;10971000;10961000;7403000;122579000;277765000;420859000;193413000;;93227000;286640000;707499000;129913000;9662000;139575000;234554000;281348000;420923000;119816000;;166760000;286576000;707499000
ZEUS;815280;USD;2010;Q4;2010-12-31;2011-08-05;10911000;10924000;1492000;82859000;200606000;298809000;118234000;;12395000;130629000;429438000;102625000;0;102625000;55235000;65175000;167800000;118976000;;142662000;261638000;429438000
ZEUS;815280;USD;2018;Q4;2018-12-31;2019-02-15;11431000;11461000;9319000;175252000;368738000;562769000;159609000;;38362000;197971000;760740000;128427000;;128427000;302530000;325322000;453749000;130778000;-132000;176345000;306991000;760740000
ALRN;815574;USD;2017;Q4;2017-12-31;2018-04-02;14949139;14949139;50752000;;;51840000;154000;;694000;848000;52688000;4891000;;4891000;;0;4891000;184776000;;-136946000;47797000;52688000
ALRN;815574;USD;2016;Q4;2016-12-31;2017-08-10;432458;432458;20715000;;;21073000;107000;;841000;948000;22021000;4071000;;4071000;;11000;4082000;2536000;;-114342000;17939000;22021000
ALRN;815574;USD;2018;Q4;2018-12-31;2019-03-29;14745847;14745847;20695000;;;21775000;7290000;;1247000;8537000;30312000;5370000;;5370000;;5342000;10712000;188098000;;-168493000;19600000;30312000
MVIS;815811;USD;2018;Q4;2018-12-31;2019-03-06;187907927;347678836;13766000;476000;1109000;17649000;2993000;;2391000;5384000;23033000;8013000;21000;18188000;33000;728000;18916000;550233000;;-546116000;4117000;23033000
MVIS;815811;USD;2017;Q4;2017-12-31;2018-02-23;153583078;290931516;16966000;15000;4541000;23217000;3251000;;3299000;6550000;29767000;8927000;0;19074000;0;607000;19681000;528952000;;-518866000;10086000;29767000
MVIS;815811;USD;2016;Q4;2016-12-31;2017-03-06;56588000;;15139000;245000;1233000;17348000;1537000;;1221000;2758000;20106000;5899000;;7244000;;5388000;12632000;507317000;;-499843000;7474000;20106000
MVIS;815811;USD;2015;Q4;2015-12-31;2016-03-08;47318000;;7888000;1687000;862000;11075000;1669000;;1298000;2967000;14042000;5582000;;7704000;;6491000;14195000;483218000;;-483371000;-153000;14042000
MVIS;815811;USD;2014;Q4;2014-12-31;2015-03-16;44681000;44581000;8349000;669000;116000;9625000;894000;;1426000;2320000;11945000;4355000;;4585000;;488000;5073000;475701000;;-468829000;6872000;11945000
MVIS;815811;USD;2013;Q4;2013-12-31;2014-03-06;31919000;31883000;5375000;24000;49000;5784000;1065000;;1598000;2663000;8447000;4080000;;9662000;;481000;10143000;449013000;;-450709000;-1696000;8447000
MVIS;815811;USD;2012;Q4;2012-12-31;2013-03-14;25212000;;6850000;1115000;497000;9695000;1205000;;2038000;3243000;12938000;7042000;115000;7864000;20000;20000;7884000;442585000;;-437531000;5054000;12938000
MVIS;815811;USD;2011;Q4;2011-12-31;2012-03-09;15912000;;13075000;463000;4254000;18655000;2347000;;2868000;5215000;23870000;12454000;132000;12742000;139000;326000;13068000;425675000;;-414838000;10802000;23870000
MVIS;815811;USD;2010;Q4;2010-12-31;2011-07-28;12160500;;19426000;1116000;6075000;27624000;4169000;;3440000;7609000;35233000;11800000;125000;12006000;273000;1394000;13400000;400893000;;-379030000;21833000;35233000
CHJI;815913;USD;2016;Q4;2016-12-31;2017-03-31;64629559;;12512;;;13722;201006;;13711122;13912128;13925850;1205719;;1205719;1880311;2472721;3678440;16614401;-489258;-7926794;10247410;13925850
CHJI;815913;USD;2015;Q4;2015-12-31;2016-04-14;64629559;;13550;;;15425;246480;;16238703;16485183;16500608;1283682;;1283682;3219177;3729533;5013215;16552445;-489258;-7403166;11487393;16500608
CHJI;815913;USD;2014;Q4;2014-12-31;2015-03-30;64629559;;72156;;;152691;314480;;22933054;23247534;23400225;1558187;;1558187;3391992;5528231;7086418;16056935;-489258;-2902291;16313807;23400225
SIX;816466;USD;2017;Q4;2017-12-31;2018-02-20;84441000;88117000;77496000;72693000;24960000;221072000;1237957000;12821000;984826000;2235604000;2456676000;116479000;;297840000;2021178000;2169517000;2467357000;1088377000;;-1529608000;-10681000;2456676000
SIX;816466;USD;2016;Q4;2016-12-31;2017-02-23;91779000;95666000;137385000;69018000;24156000;278791000;1211255000;9218000;988408000;2208881000;2487672000;120393000;29161000;315952000;1624486000;1872334000;2188286000;1118498000;;-1237804000;299386000;2487672000
SIX;816466;USD;2015;Q4;2015-12-31;2016-02-18;91718000;104504000;99760000;63803000;21535000;227977000;1198154000;7211000;995098000;2200463000;2428440000;126422000;7506000;272058000;1498022000;1696445000;1968503000;1043999000;;-953225000;459937000;2428440000
SIX;816466;USD;2014;Q4;2014-12-31;2015-02-19;93204000;101162000;73884000;58823000;21099000;198511000;1218106000;4750000;995529000;2218385000;2416896000;112496000;6301000;231671000;1373605000;1523785000;1755456000;985640000;;-702116000;661440000;2416896000
SIX;816466;USD;2013;Q4;2013-12-31;2014-02-20;94976000;100618000;169310000;51609000;22172000;353858000;1231683000;4268000;1018005000;2253956000;2607814000;99327000;6269000;216810000;1394334000;1580098000;1796908000;844859000;;-438825000;810906000;2607814000
SIX;816466;USD;2012;Q4;2012-12-31;2013-02-27;106978000;107562000;629208000;29523000;22280000;763474000;1254629000;4214000;1034074000;2292917000;3056391000;87551000;6240000;181863000;1398966000;1547921000;1729784000;906058000;;27775000;1326607000;3056391000
SIX;816466;USD;2011;Q4;2011-12-31;2012-02-27;109974000;103388000;231427000;18461000;20973000;309529000;1291837000;10477000;1036335000;2338649000;2648178000;114169000;35296000;221749000;921940000;1218854000;1440603000;833478000;;-20088000;1207575000;2648178000
SIX;816466;USD;2018;Q4;2018-12-31;2019-02-20;84134000;86735000;44608000;116043000;28779000;241929000;1253682000;11277000;1010440000;2275399000;2517328000;139950000;;368360000;2063512000;2266790000;2635150000;1039739000;;-1611334000;-117822000;2517328000
ZGNX;816789;USD;2017;Q4;2017-12-31;2018-03-06;34138000;34138000;293503000;;;304703000;245000;;112665000;112910000;417613000;20471000;;20983000;;95109000;116092000;873561000;;-572040000;301521000;417613000
ZGNX;816789;USD;2016;Q4;2016-12-31;2017-03-10;24850000;24850000;91551000;12577000;7047000;119914000;1710000;;109881000;111591000;231505000;14575000;3267000;20310000;18824000;90439000;110749000;565979000;;-445223000;120756000;231505000
ZGNX;816789;USD;2015;Q4;2015-12-31;2016-03-15;24837000;24836750;155349000;1396000;12030000;184503000;9254000;;112065000;121319000;305822000;13618000;6321000;29986000;15899000;93076000;123062000;558276000;;-375516000;182760000;305822000
ZGNX;816789;USD;2014;Q4;2014-12-31;2015-03-11;18757625;18125875;42205000;6078000;11444000;77978000;10618000;;114239000;124857000;202835000;13915000;0;44237000;21703000;103319000;147556000;456939000;;-401660000;55279000;202835000
ZGNX;816789;USD;2013;Q4;2013-12-31;2014-03-07;15988125;15988125;72021000;6665000;9936000;92879000;13011000;;6614000;19625000;112504000;27439000;;58780000;28802000;35298000;94078000;428673000;;-410247000;18426000;112504000
ZGNX;816789;USD;2012;Q4;2012-12-31;2013-03-15;12630500;12630500;41228000;5643000;12886000;61725000;13561000;;5400000;18961000;80686000;23161000;;32654000;28481000;33559000;66213000;343864000;;-329391000;14473000;80686000
ZGNX;816789;USD;2011;Q4;2011-12-31;2012-03-12;8192125;8192125;56525000;4913000;16776000;80424000;14590000;;5626000;20216000;100640000;19721000;9758000;43367000;42070000;47961000;91328000;291317000;;-282005000;9312000;100640000
ZGNX;816789;USD;2010;Q4;2010-12-31;2011-08-12;;;49172000;4474000;18293000;74190000;15434000;;4644000;20078000;94268000;18623000;3519000;35564000;19934000;29970000;65534000;226836000;;-198102000;28734000;94268000
ZGNX;816789;USD;2018;Q4;2018-12-31;2019-02-28;42098000;42098000;514187000;0;;532730000;2870000;;112731000;115601000;648331000;26075000;;58375000;;67155000;125530000;1218752000;;-695954000;522801000;648331000
DS;816790;USD;2016;Q4;2016-12-31;2017-03-02;66773271;68896671;769394000;8047000;;861120000;217611000;19256000;73971000;310838000;1171958000;26249000;3699000;698222000;162802000;255669000;953891000;3173388000;;-3018072000;218067000;1171958000
WATT;816792;USD;2017;Q4;2017-12-31;2018-03-16;22285027;22285027;12795254;0;;13902348;1413917;;89180;1503097;15405445;3646715;;3646715;;0;3646715;185660179;;-173901449;11758730;15405445
WATT;816792;USD;2018;Q4;2018-12-31;2019-02-28;26186774;26186774;20106485;44550;;20788743;1219016;;2410;1221426;22010169;3639734;;3639734;;0;3639734;243112006;;-224741571;18370435;22010169
CALA;817563;USD;2017;Q4;2017-12-31;2018-03-08;35702000;35702000;163793000;1142000;;167667000;1759000;22361000;668000;24788000;192455000;10010000;;39027000;;3121000;42148000;300910000;;-150333000;150307000;192455000
CALA;817563;USD;2016;Q4;2016-12-31;2017-03-16;21061000;21061000;51781000;;;53561000;899000;;336000;1235000;54796000;4453000;;4453000;;437000;4890000;172421000;;-122502000;49906000;54796000
CALA;817563;USD;2015;Q4;2015-12-31;2016-03-15;18166000;18166000;69928000;;;72495000;931000;1997000;327000;3255000;75750000;3833000;;3833000;;129000;3962000;156355000;;-84498000;71788000;75750000
CALA;817563;USD;2014;Q4;2014-12-31;2015-03-27;17888000;17888000;101969000;;;103863000;861000;;46000;907000;104770000;4121000;;4121000;;283000;4404000;152220000;;-51854000;100366000;104770000
CALA;817563;USD;2013;Q4;2013-12-31;2014-11-14;160000;160000;33820000;;;34169000;559000;;116000;675000;34844000;1344000;;1344000;;31000;1375000;9329000;;-30142000;33469000;34844000
CALA;817563;USD;2018;Q4;2018-12-31;2019-03-07;38358000;38358000;136153000;1997000;;140252000;1464000;;1009000;2473000;142725000;14881000;;14881000;;1130000;16011000;322997000;;-196170000;126714000;142725000
CAKE;817638;USD;2017;Q4;2018-01-31;2018-02-28;45752000;46832000;6008000;19865000;42560000;208633000;935045000;;189382000;1124427000;1333060000;234000000;;397951000;10000000;321579000;719530000;800816000;-1532864000;1345666000;613530000;1333060000
CAKE;817638;USD;2016;Q4;2017-01-31;2017-03-02;47359000;48641000;53839000;15632000;34926000;221427000;910134000;;161758000;1071892000;1293319000;222897000;;376526000;;313586000;690112000;775084000;-1409889000;1238012000;603207000;1293319000
CAKE;817638;USD;2015;Q4;2016-01-31;2016-02-25;48808000;50419000;43854000;14159000;34010000;225396000;892191000;;115759000;1007950000;1233346000;206083000;;350226000;;294581000;644807000;711173000;-1263422000;1140788000;588539000;1233346000
CAKE;817638;USD;2014;Q4;2015-01-31;2015-03-02;49193000;51171000;58018000;15170000;33255000;224386000;828305000;;108685000;936990000;1161376000;322011000;;322011000;;282855000;604866000;654951000;-1158652000;1060211000;556510000;1161376000
CAKE;817638;USD;2013;Q4;2014-01-31;2014-02-27;51353000;53518000;61751000;10081000;35478000;225903000;795379000;;102832000;898211000;1124114000;264247000;;264247000;;282514000;546761000;603375000;-1015473000;989451000;577353000;1124114000
CAKE;817638;USD;2012;Q4;2013-01-31;2013-02-28;52947000;54928000;83569000;14558000;28836000;230207000;764418000;;97542000;861960000;1092167000;253034000;;253034000;;259407000;512441000;509008000;-831814000;902532000;579726000;1092167000
CAKE;817638;USD;2011;Q4;2012-01-31;2012-02-29;54817000;56227000;48211000;11334000;28210000;176395000;758503000;;87672000;846175000;1022570000;223240000;;223240000;;256577000;479817000;456198000;-730422000;816977000;542753000;1022570000
CAKE;817638;USD;2010;Q4;2011-01-31;2011-02-23;58449000;60367000;81619000;16184000;23036000;194962000;755468000;;86877000;842345000;1037307000;202705000;;202705000;;242265000;444970000;429376000;-558296000;721257000;592337000;1037307000
CAKE;817638;USD;2009;Q4;2010-01-31;2010-08-05;59437000;59656000;73715000;11352000;22202000;172227000;788402000;;86122000;874524000;1046751000;200461000;;200461000;100000000;330177000;530638000;387396000;-506208000;639544000;516113000;1046751000
CAKE;817638;USD;2018;Q4;2019-01-31;2019-03-04;44796000;45348000;26578000;20928000;38886000;195230000;913275000;79767000;125861000;1118903000;1314133000;244164000;;416500000;10000000;326574000;743074000;829643000;-1642140000;1384494000;571059000;1314133000
HEAR;817639;USD;2017;Q4;2017-12-31;2018-03-07;12346000;12346000;5247000;50534000;27518000;86766000;4677000;;2808000;7485000;94251000;17632000;;67550000;27625000;48858000;116408000;148094000;;-170048000;-22157000;94251000
HEAR;817639;USD;2016;Q4;2016-12-31;2017-03-08;12321000;12321000;6183000;54633000;21698000;86635000;4311000;;3854000;8165000;94800000;14574000;;66893000;28323000;48603000;115496000;146664000;;-166800000;-20696000;94800000
HEAR;817639;USD;2015;Q4;2015-12-31;2016-03-30;10631000;10631000;7114000;57192000;26146000;94903000;6859000;;70698000;77557000;172460000;22494000;;69183000;27539000;46625000;115808000;136736000;;-79618000;56652000;172460000
HEAR;817639;USD;2014;Q4;2014-12-31;2015-03-30;10539000;10539000;7908000;61059000;38400000;117597000;6722000;;122649000;129371000;246968000;37469000;;88857000;5769000;26925000;115782000;128126000;;3289000;131186000;246968000
HEAR;817639;USD;2013;Q4;2013-12-31;2014-02-10;6241270;6241270;6509000;48542000;49643000;113394000;7369000;;6544000;13913000;127307000;58636000;;111209000;10342000;26891000;138100000;-54018000;;18775000;-10793000;127307000
HEAR;817639;USD;2012;Q4;2012-12-31;2013-02-07;;;4650564;15333;430894;5136783;155502;;1301072;1456574;6593357;182007;;182007;;155822;337829;14140239;;-7884711;6255528;6593357
HEAR;817639;USD;2018;Q4;2018-12-31;2019-03-18;14281000;12914000;7078000;52797000;49472000;113816000;5856000;;2248000;8104000;121920000;17724000;;73597000;0;10827000;84424000;169435000;;-131463000;37496000;121920000
BTAI;818572;USD;2017;Q4;2017-12-31;2018-05-14;10296702;10296702;887000;;;890000;4000;;461000;465000;1355000;1897000;;2337000;;;2337000;3468000;;-4450000;-982000;1355000
BTAI;818572;USD;2018;Q4;2018-12-31;2019-03-12;15538797;15538797;42565000;;;43171000;327000;;51000;378000;43549000;4660000;;4660000;;;4660000;62609000;;-23720000;38889000;43549000
ALPN;819011;USD;2017;Q4;2017-12-31;2018-03-28;14066890;13057867;81240000;;;82548000;1089000;;1585000;2674000;85222000;575000;995000;1895000;4039000;4410000;6305000;88360000;0;-9384000;78917000;85222000
ALPN;819011;USD;2016;Q4;2016-12-31;2017-02-13;2247657;2247657;11819000;;;11855000;740000;;;740000;12595000;363000;;2404000;113000;113000;2517000;144000;;-1601000;10078000;12595000
ALPN;819011;USD;2015;Q4;2015-12-31;2016-03-08;1982145;1982145;87254000;;;87686000;;;223000;223000;87909000;4419000;;4419000;;0;4419000;232324000;;-148837000;83490000;87909000
ALPN;819011;USD;2018;Q4;2018-12-31;2019-03-18;13852839;13852839;52303000;;;53545000;1196000;;132000;1328000;54873000;5993000;2048000;8127000;2155000;2155000;10282000;90678000;0;-46074000;44591000;54873000
MACK;819013;USD;2018;Q4;2018-12-31;2019-03-06;16958953;16958953;71278000;;;76102000;2269000;;10172000;12441000;88543000;13677000;;14795000;14873000;14929000;29724000;582105000;;-523277000;58819000;88543000
OMED;819110;USD;2018;Q4;2018-12-31;2019-03-07;38630719;38626397;57345000;3026000;;62284000;623000;;2171000;2794000;65078000;8891000;;12644000;;4203000;16847000;410046000;;-361786000;48231000;65078000
OMED;819110;USD;2017;Q4;2017-12-31;2018-03-09;37967750;37967750;103091000;405000;;105205000;3275000;;1842000;5117000;110322000;10939000;;93132000;;65793000;158925000;403115000;;-452007000;-48603000;110322000
OMED;819110;USD;2016;Q4;2016-12-31;2017-03-09;37157405;37157405;184573000;2515000;;189583000;4471000;;1428000;5899000;195482000;35343000;;55853000;;162657000;218510000;389657000;;-412945000;-23028000;195482000
OMED;819110;USD;2015;Q4;2015-12-31;2016-03-10;30111449;30111449;157279000;70699000;;231255000;4825000;;1807000;6632000;237887000;30356000;;52641000;;181695000;234336000;313374000;;-309843000;3551000;237887000
OMED;819110;USD;2014;Q4;2014-12-31;2015-03-12;29839679;29839679;231966000;42000;;240810000;5104000;;1928000;7032000;247842000;19111000;;38546000;;132929000;171475000;300820000;;-224436000;76367000;247842000
OMED;819110;USD;2013;Q4;2013-12-31;2014-03-18;28765306;28765306;316194000;;;318744000;4641000;;10300000;14941000;333685000;26324000;;62017000;;153546000;215563000;292534000;;-174426000;118122000;333685000
OMED;819110;USD;2012;Q4;2012-12-31;2013-09-03;1069829;1069829;66239000;;;71385000;5462000;;2921000;8383000;79768000;4647000;;20129000;;21093000;41222000;4113000;;-148355000;38546000;79768000
USCR;819568;USD;2017;Q4;2017-12-31;2018-03-01;16415000;17731000;22581000;214221000;48085000;311685000;636268000;;328181000;964449000;1276134000;182490000;25951000;208441000;667385000;765551000;973992000;319034000;-24799000;-13784000;302142000;1276134000
USCR;819568;USD;2016;Q4;2016-12-31;2017-02-28;15461000;18955000;75774000;207292000;41979000;341289000;337412000;;266701000;604113000;945402000;187208000;16654000;261277000;432644000;495296000;756573000;249849000;-21724000;-39296000;188829000;945402000
USCR;819568;USD;2015;Q4;2015-12-31;2016-03-04;14488000;11720000;3925000;171256000;36726000;226289000;248123000;;207285000;455408000;681697000;166273000;9386000;243060000;266214000;304630000;547690000;201031000;-18867000;-48157000;134007000;681697000
ASYS;819674;USD;2018;Q4;2018-09-30;2018-12-07;14735000;14717000;58331000;20475000;24710000;124290000;16452000;0;8664000;25116000;149406000;25360000;374000;45143000;7960000;11173000;56316000;124458000;;-21394000;93090000;149406000
ASYS;819674;USD;2017;Q4;2017-09-30;2017-11-20;13903000;14239000;51121000;22519000;30210000;157113000;15792000;2615000;16103000;34510000;191623000;31489000;361000;85969000;8134000;15171000;101140000;125711000;;-26699000;90483000;191623000
ASYS;819674;USD;2016;Q4;2016-09-30;2016-11-30;13178000;13178000;27655000;17642000;23223000;82924000;15960000;3032000;16514000;35506000;118430000;24371000;1134000;38064000;9097000;15027000;53091000;111763000;;-35830000;65339000;118430000
ASYS;819674;USD;2015;Q4;2015-09-30;2015-11-19;13134000;13134000;25852000;14488000;23329000;85702000;17761000;2733000;19260000;39754000;125456000;25632000;919000;39371000;8448000;13438000;52809000;110322000;;-28822000;72647000;125456000
ASYS;819674;USD;2014;Q4;2014-09-30;2014-11-20;9846000;9846000;27367000;8896000;16760000;65425000;9752000;0;14727000;24479000;89904000;20608000;0;33136000;0;3180000;36316000;81982000;;-21051000;53588000;89904000
ASYS;819674;USD;2013;Q4;2013-09-30;2013-12-11;9544000;9544000;37197000;4829000;22001000;84195000;11066000;;15686000;26752000;110947000;25560000;;41334000;;2810000;44144000;79706000;;-8004000;66803000;110947000
ASYS;819674;USD;2012;Q4;2012-09-30;2012-12-07;9480000;9480000;46726000;7486000;25670000;101443000;12387000;;15192000;27579000;129022000;25730000;;42611000;;2360000;44971000;77472000;;12065000;84051000;129022000
ASYS;819674;USD;2011;Q4;2011-09-30;2011-11-17;9579000;9814000;67382000;14447000;37162000;174851000;12680000;;18334000;31014000;205865000;43059000;;80794000;;2740000;83534000;83301000;;35096000;122331000;205865000
ASYS;819674;USD;2010;Q4;2010-09-30;2011-08-09;9076000;9396000;56764000;9252000;24317000;116454000;9577000;;10070000;19647000;136101000;28676000;;50816000;;1042000;51858000;73011000;;12214000;84243000;136101000
ALRM;819790;USD;2017;Q4;2017-12-31;2018-02-28;47174419;49596764;96329000;40634000;14177000;163936000;23459000;;184246000;207705000;371641000;41211000;;44503000;71000000;94311000;138814000;321504000;;-88677000;232827000;371641000
ALRM;819790;USD;2016;Q4;2016-12-31;2017-03-16;46021948;48355053;140634000;29810000;10543000;190184000;20180000;;50881000;71061000;261245000;37114000;;39699000;6700000;30297000;69996000;309158000;;-117909000;191249000;261245000
ALRM;819790;USD;2015;Q4;2015-12-31;2016-02-29;46167856;42681597;128358000;21348000;6474000;161050000;15446000;;49599000;65045000;226095000;26790000;;29079000;6700000;26885000;55964000;298236000;-42000;-128063000;170131000;226095000
ALRM;819790;USD;2014;Q4;2014-12-31;2015-08-14;2472987;4183800;42572000;17259000;6852000;68602000;8130000;;44200000;52330000;120932000;21049000;;22748000;6700000;17572000;40320000;7194000;-42000;-128996000;80612000;120932000
ALRM;819790;USD;2018;Q4;2018-12-31;2019-03-01;48056621;52190751;146061000;49510000;22990000;228063000;27757000;;185165000;212922000;440985000;71914000;;75270000;67000000;88126000;163396000;341620000;;-64031000;277589000;440985000
CNS;820401;USD;2017;Q4;2017-12-31;2018-02-23;46410000;47364000;301558000;53854000;;361841000;15040000;;33244000;48284000;410125000;61262000;;74569000;;12225000;86794000;570997000;-153818000;-137972000;323331000;410125000
CNS;820401;USD;2016;Q4;2016-12-31;2017-02-24;46013000;46611000;225089000;46288000;;272956000;15964000;12689000;32119000;60772000;333728000;44708000;;54380000;;12681000;67061000;544333000;-144677000;-127957000;266667000;333728000
CNS;820401;USD;2015;Q4;2015-12-31;2016-02-26;45529000;45973000;176893000;44559000;;227556000;9783000;37169000;30814000;77766000;305322000;37283000;;49652000;;12560000;62212000;520352000;-136637000;-148096000;243110000;305322000
CNS;820401;USD;2014;Q4;2014-12-31;2015-02-27;44855000;45870000;174757000;43392000;;219954000;11189000;9509000;40069000;60767000;280721000;32441000;;39410000;;12723000;52133000;489752000;-117403000;-142786000;228588000;280721000
CNS;820401;USD;2013;Q4;2013-12-31;2014-03-14;44328000;45342000;163450000;40888000;;207244000;9824000;15668000;42190000;67682000;274926000;32789000;;46818000;;4344000;51162000;457615000;-105681000;-131366000;223764000;274926000
CNS;820401;USD;2012;Q4;2012-12-31;2013-03-15;43833000;44612000;128840000;44397000;;190854000;9103000;97155000;40203000;146461000;337315000;34681000;;67547000;;0;67547000;429847000;-97719000;-117889000;269768000;337315000
CNS;820401;USD;2011;Q4;2011-12-31;2012-03-15;43252000;44146000;162825000;39590000;;212858000;11200000;25304000;36871000;73375000;286233000;28285000;;50925000;;0;50925000;403035000;-89235000;-83063000;235308000;286233000
CNS;820401;USD;2010;Q4;2010-12-31;2011-05-10;85331400;86505063;197124000;32821000;;229945000;13242000;0;34399000;47641000;277586000;29350000;;42012000;;2209000;44221000;378535000;-82588000;-65553000;233365000;277586000
CNS;820401;USD;2018;Q4;2018-12-31;2019-03-01;46844000;47537000;317665000;50381000;;382286000;14106000;;84647000;98753000;481039000;62348000;;135708000;;8493000;144201000;602790000;-164417000;-208404000;336838000;481039000
GTHX;820499;USD;2017;Q4;2017-12-31;2018-02-21;28768773;28768773;103812000;;;104661000;510000;;;510000;105171000;11704000;;11704000;;79000;11783000;222514000;-8000;-129118000;93388000;105171000
GTHX;820499;USD;2016;Q4;2016-12-31;2017-08-09;1523870;1523870;47305000;;;47901000;311000;;;311000;48212000;5458000;;5625000;;0;5625000;;-8000;-64985000;42587000;48212000
GTHX;820499;USD;2018;Q4;2018-12-31;2019-02-28;37295048;37295048;369290000;;;370133000;1137000;;;1137000;371270000;12362000;;12362000;;88000;12450000;573234000;-8000;-214406000;358820000;371270000
WSTC;820561;USD;2016;Q4;2016-12-31;2017-02-16;83259000;84893000;183059000;369068000;;694295000;332451000;;2414092000;2746543000;3440838000;303752000;39709000;494609000;3129963000;3388078000;3882687000;2223465000;-87226000;-2490455000;-441849000;3440838000
WSTC;820561;USD;2015;Q4;2015-12-31;2016-02-18;83230000;84924000;182338000;373087000;;743172000;334844000;;2477201000;2812045000;3555217000;312169000;24375000;498372000;3318688000;3608983000;4107355000;2193278000;-65265000;-2607415000;-552138000;3555217000
WSTC;820561;USD;2014;Q4;2014-12-31;2015-02-19;84182000;85793000;115061000;355625000;;934998000;350030000;;2533047000;2883077000;3818075000;319777000;16246000;565224000;3642540000;3912492000;4477716000;2155948000;-5308000;-2772775000;-659641000;3818075000
WSTC;820561;USD;2013;Q4;2013-12-31;2014-02-20;84477000;85921000;230041000;357588000;;1028775000;331904000;;2135965000;2467869000;3496644000;297974000;11877000;496987000;3513470000;3739829000;4236816000;2132525000;-5308000;-2855189000;-740172000;3496644000
WSTC;820561;USD;2012;Q4;2012-12-31;2013-02-08;61908000;63467000;179111000;444411000;;761092000;364896000;;2322165000;2687061000;3448153000;339399000;25125000;457668000;3992531000;4240171000;4697839000;1720701000;-5308000;-2941948000;-1249686000;3448153000
WSTC;820561;USD;2011;Q4;2011-12-31;2012-02-14;87932000;164934000;93836000;413813000;;621786000;350855000;;2254877000;2605732000;3227518000;402875000;15425000;418300000;3500940000;3705631000;4123931000;1695968000;-3820000;-2556525000;-896413000;3227518000
PETS;820678;USD;2017;Q4;2018-03-31;2018-05-29;20374000;20422000;77936000;2292000;23337000;105235000;28741000;;860000;29601000;134836000;18109000;;18109000;;996000;19105000;9402000;;106320000;115731000;134836000
PETS;820678;USD;2016;Q4;2017-03-31;2017-05-23;20260000;20394000;58730000;1808000;20228000;81785000;30164000;;860000;31024000;112809000;18355000;;18355000;;1088000;19443000;6827000;;86530000;93366000;112809000
PETS;820678;USD;2015;Q4;2016-03-31;2016-05-24;60381729;60777503;37639000;1724000;25586000;67627000;20929000;;1723000;22652000;90279000;7084000;;7084000;;0;7084000;4891000;;78295000;83195000;90279000
PETS;820678;USD;2014;Q4;2015-03-31;2015-05-22;20045000;20144000;51204000;1931000;25068000;79583000;1569000;;1700000;3269000;82852000;7417000;;7417000;;0;7417000;3137000;;72343000;75435000;82852000
PETS;820678;USD;2013;Q4;2014-03-31;2014-05-27;-59595396;-60046828;33844000;1761000;35727000;74209000;1310000;;2856000;4166000;78375000;8093000;;8093000;;65000;8158000;1598000;;68647000;70217000;78375000
PETS;820678;USD;2012;Q4;2013-03-31;2013-05-28;19815000;19966000;33645000;1439000;31601000;68757000;2132000;;2290000;4422000;73179000;8997000;;8997000;;168000;9165000;20000;;63987000;64014000;73179000
PETS;820678;USD;2011;Q4;2012-03-31;2012-05-29;20080000;20175000;57148000;1572000;26217000;87607000;2597000;;860000;3457000;91064000;9391000;;9391000;;492000;9883000;20000;;81108000;81181000;91064000
PETS;820678;USD;2010;Q4;2011-03-31;2011-08-02;44695494;44940345;59776000;1985000;25140000;89604000;3433000;12390000;860000;16683000;106287000;8961000;;8961000;;321000;9282000;22000;;97115000;97005000;106287000
PETS;820678;USD;2018;Q4;2019-03-31;2019-05-28;20490000;20502000;100529000;2542000;21370000;126431000;27136000;;860000;27996000;154427000;18626000;;18626000;;1121000;19747000;12499000;;122172000;134680000;154427000
GOV;820761;USD;2013;Q4;2013-12-31;2014-02-19;13606500;;7663000;33350000;;68699000;1380927000;;182826000;1563753000;1632452000;;90727000;116693000;526084000;526084000;642777000;1106226000;;191913000;989675000;1632452000
GOV;820761;USD;2012;Q4;2012-12-31;2013-02-21;13243500;;5255000;28882000;;82832000;1311202000;;168100000;1479302000;1562134000;;93127000;116054000;418629000;418629000;534683000;1104529000;;137293000;1027451000;1562134000
GOV;820761;USD;2011;Q4;2011-12-31;2012-02-23;11785750;;3272000;29000000;;34008000;1198050000;;136517000;1334567000;1368575000;;95383000;120145000;356762000;356762000;476907000;935909000;;87333000;891668000;1368575000
GOV;820761;USD;2010;Q4;2010-12-31;2011-08-02;10142250;;2437000;19200000;;23185000;846447000;;81656000;928103000;951288000;;46428000;62212000;131679000;131679000;193891000;777318000;;41336000;757397000;951288000
FII;821505;USD;2018;Q4;2018-12-31;2019-02-22;96752000;96749000;167692000;60094000;;304101000;53229000;;1186353000;1239582000;1543683000;169975000;;181180000;135000000;322869000;504049000;367252000;-287337000;791823000;1039634000;1543683000
FII;821505;USD;2017;Q4;2017-12-31;2018-02-23;97072000;97073000;324127000;26033000;;437274000;37670000;;756466000;794136000;1231410000;122167000;;128849000;170000000;311183000;440032000;343378000;-278732000;697359000;791378000;1231410000
FII;821505;USD;2016;Q4;2016-12-31;2017-02-24;98265000;98266000;243077000;44804000;;359760000;39280000;;756067000;795347000;1155107000;154422000;;162538000;165750000;365423000;527961000;320982000;-255382000;529749000;627146000;1155107000
FII;821505;USD;2015;Q4;2015-12-31;2016-02-22;100078000;100081000;321447000;33524000;;395828000;35743000;;755632000;791375000;1187203000;144742000;;159208000;191250000;370289000;529497000;298579000;-191939000;545785000;657706000;1187203000
FII;821505;USD;2014;Q4;2014-12-31;2015-02-20;100641000;100644000;265485000;27965000;;342055000;38638000;;759826000;798464000;1140519000;136091000;;149321000;216750000;377849000;527170000;271020000;-165258000;505394000;613349000;1140519000
FII;821505;USD;2013;Q4;2013-12-31;2014-02-21;100760000;100763000;238702000;29320000;;339318000;40088000;;756391000;796479000;1135797000;184553000;;214205000;198333000;339731000;553936000;295958000;-751239000;1022608000;581861000;1135797000
FII;821505;USD;2012;Q4;2012-12-31;2013-02-22;100376000;100376000;207555000;24120000;;300062000;38912000;;751087000;789999000;1090061000;155927000;;181134000;276250000;404983000;586117000;273886000;-760022000;984505000;503944000;1090061000
FII;821505;USD;2011;Q4;2011-12-31;2012-02-24;100259000;100260000;322317000;21526000;;366511000;38228000;;746117000;784345000;1150856000;144162000;;178486000;318750000;429187000;607673000;253139000;-772481000;1069913000;543183000;1150856000
FII;821505;USD;2010;Q4;2010-12-31;2011-02-22;;;333641000;21228000;;373170000;38516000;;741818000;780334000;1153504000;189820000;;214352000;361250000;445437000;659789000;237532000;-778609000;1036571000;493715000;1153504000
FII;821505;USD;2009;Q4;2009-12-31;2010-07-28;;;121990000;8144000;;184787000;40027000;;687619000;727646000;912433000;135791000;;196998000;118556000;172707000;369705000;217009000;-795389000;1105073000;542728000;912433000
TXRH;821877;USD;2017;Q4;2017-12-31;2018-02-23;71137000;71805000;150918000;76496000;16306000;257081000;912147000;;161395000;1073542000;1330623000;173362000;9000;329998000;51981000;149234000;479232000;236619000;;602499000;851391000;1330623000
TXRH;821877;USD;2016;Q4;2016-12-31;2017-02-24;70570000;71587000;112944000;56127000;16088000;200259000;830054000;;149658000;979712000;1179971000;149802000;167000;279527000;52381000;142202000;421729000;219697000;;530723000;758242000;1179971000
TXRH;821877;USD;2015;Q4;2015-12-31;2016-02-26;70144000;71077000;59334000;45421000;15633000;133813000;751288000;;147605000;898893000;1032706000;155224000;144000;256642000;25550000;98882000;355524000;201093000;;468678000;677182000;1032706000
TXRH;821877;USD;2014;Q4;2014-12-31;2015-02-27;69495000;70380000;86122000;34023000;14256000;147726000;649637000;;145779000;795416000;943142000;136380000;129000;215971000;50693000;112215000;328186000;189238000;;419436000;614956000;943142000
TXRH;821877;USD;2013;Q4;2013-12-31;2014-02-28;70606000;71978000;94874000;25391000;11954000;145743000;586212000;;145689000;731901000;877644000;112886000;243000;175852000;50990000;107932000;283784000;215121000;;374190000;593860000;877644000
TXRH;821877;USD;2012;Q4;2012-12-31;2013-02-22;70088000;71595000;81746000;16416000;10909000;122472000;531654000;;137128000;668782000;791254000;105283000;338000;158662000;51264000;101855000;260517000;200036000;;327509000;530737000;791254000
TXRH;821877;USD;2011;Q4;2011-12-31;2012-02-24;69203000;70408000;78777000;11480000;10730000;111974000;497217000;;131479000;628696000;740670000;92010000;304000;136372000;61601000;108476000;244848000;206088000;;288425000;495822000;740670000
TXRH;821877;USD;2010;Q4;2010-12-31;2011-05-06;71907000;73527000;82215000;12563000;9197000;113922000;458983000;;129896000;588879000;702801000;72619000;274000;112058000;51906000;91361000;203419000;250946000;;247008000;499382000;702801000
TXRH;821877;USD;2018;Q4;2018-12-31;2019-02-22;71582000;72148000;210125000;92114000;18827000;345019000;956676000;;167581000;1124257000;1469276000;192900000;;385142000;2081000;123426000;508568000;257460000;;688337000;960708000;1469276000
CZR;821879;USD;2017;Q4;2017-12-31;2018-03-08;671000000;671000000;2558000000;494000000;39000000;3457000000;16154000000;;5825000000;21979000000;25436000000;1682000000;64000000;1884000000;18204000000;20255000000;22139000000;;;;3297000000;25436000000
CZR;821879;USD;2016;Q4;2016-12-31;2017-02-15;146000000;146000000;1540000000;160000000;20000000;5017000000;7446000000;;2460000000;9906000000;14923000000;975000000;89000000;7731000000;6749000000;8801000000;16532000000;8677000000;-29000000;-10309000000;-1609000000;14923000000
CZR;821879;USD;2015;Q4;2015-12-31;2016-02-29;145000000;149000000;1227000000;134000000;21000000;1959000000;7584000000;;2663000000;10247000000;12206000000;842000000;187000000;2016000000;6777000000;7957000000;9973000000;8191000000;-21000000;-7184000000;2233000000;12206000000
CRC;822165;USD;2017;Q4;2017-12-31;2018-02-27;42600000;42300000;20000000;277000000;56000000;483000000;5696000000;;28000000;5724000000;6207000000;732000000;;732000000;;6195000000;6927000000;4879000000;;-5670000000;-720000000;6207000000
CRC;822165;USD;2016;Q4;2016-12-31;2017-02-24;42400000;42400000;12000000;232000000;58000000;425000000;5885000000;;44000000;5929000000;6354000000;626000000;;726000000;;6185000000;6911000000;4861000000;;-5404000000;-557000000;6354000000
CRC;822165;USD;2015;Q4;2015-12-31;2016-02-29;38390000;38390000;12000000;200000000;58000000;438000000;6312000000;;303000000;6615000000;7053000000;505000000;;605000000;;7364000000;7969000000;4782000000;;-5683000000;-916000000;7053000000
CRC;822165;USD;2014;Q4;2014-12-31;2015-02-27;;;14000000;308000000;71000000;701000000;11685000000;;43000000;11728000000;12429000000;922000000;;922000000;;8896000000;9818000000;4752000000;;-2117000000;2611000000;12429000000
CRC;822165;USD;2013;Q4;2013-12-31;2014-10-31;;;0;30000000;75000000;254000000;14008000000;;35000000;14043000000;14297000000;689000000;;689000000;;13632000000;14321000000;;;;-24000000;14297000000
CRC;822165;USD;2018;Q4;2018-12-31;2019-02-27;48700000;;17000000;299000000;69000000;640000000;6455000000;;63000000;6518000000;7158000000;607000000;;607000000;;6042000000;6649000000;4987000000;;-5342000000;509000000;7158000000
NST;822439;USD;2017;Q4;2017-12-31;2018-02-26;317396843;318105194;38165000;925083000;223063000;2487099000;;24202882000;9530405000;33733287000;36220386000;2317167000;549631000;3589045000;11775889000;21545099000;25134144000;7909332000;-317771000;3561084000;11086242000;36220386000
NST;822439;USD;2016;Q4;2016-12-31;2017-02-23;317510248;318282128;30251000;847301000;328721000;2477672000;;21895152000;7680349000;29575501000;32053173000;2033021000;773883000;3638605000;8829354000;17702834000;21341439000;7919616000;-317771000;3175171000;10711734000;32053173000
NST;822439;USD;2015;Q4;2015-12-31;2016-02-26;317191305;318274723;23947000;775480000;336476000;2618786000;;20408919000;7552604000;27961523000;30580309000;1974599000;228883000;2989790000;8805574000;17238304000;20228094000;7931681000;-309977000;2797355000;10352215000;30580309000
NST;822439;USD;2014;Q4;2014-12-31;2015-02-25;316721279;318109811;38703000;856346000;349664000;2692465000;;19162066000;7885856000;27047922000;29740387000;1825056000;245583000;3134381000;8568429000;16629191000;19763572000;7902630000;-300467000;2448661000;9976815000;29740387000
NST;822439;USD;2013;Q4;2013-12-31;2014-02-25;315670290;316661244;43364000;765391000;303233000;2087049000;;18064701000;7643787000;25708488000;27795537000;1835251000;533346000;3275651000;7776833000;14908358000;18184009000;7858116000;-326537000;2125980000;9611528000;27795537000
NST;822439;USD;2012;Q4;2012-12-31;2013-02-28;314929366;315914391;45748000;792822000;267713000;2227295000;;17005339000;9070190000;26075529000;28302824000;1884546000;763338000;3643690000;7282295000;15422084000;19065774000;7845814000;-338624000;1802714000;9237050000;28302824000
NST;822439;USD;2011;Q4;2011-12-31;2012-02-07;177607225;178275190;77529000;488002000;248958000;1357472000;;10463376000;3826218000;14289594000;15647066000;950282000;331582000;1947682000;4727173000;9683758000;11631440000;2778148000;-346667000;1651875000;4015626000;15647066000
NST;822439;USD;2018;Q4;2018-12-31;2019-02-26;317379718;318130239;108068000;994055000;238042000;2292224000;;26492222000;9456810000;35949032000;38241256000;2029995000;837319000;4112882000;12832074000;22641557000;26754439000;7910614000;-317771000;3953974000;11486817000;38241256000
ARCB;822441;USD;2017;Q4;2017-12-31;2018-02-28;25611179;27328081;177173000;279074000;;522349000;591164000;;252128000;843292000;1365641000;339907000;61930000;402590000;206989000;311589000;714179000;319721000;-86064000;438379000;651462000;1365641000
ARCB;822441;USD;2016;Q4;2016-12-31;2017-02-28;25668078;26745366;171118000;260643000;;491097000;532526000;;258455000;790981000;1282078000;332032000;64143000;396175000;179530000;286848000;683023000;315600000;-80045000;386917000;599055000;1282078000
ARCB;822441;USD;2015;Q4;2015-12-31;2016-02-26;25972608;26430057;226570000;236097000;;513640000;483047000;;266222000;749269000;1262909000;319687000;44910000;364597000;167599000;309584000;674181000;309932000;-70535000;376827000;588728000;1262909000
ARCB;822441;USD;2014;Q4;2014-12-31;2015-03-02;26036309;26037737;202951000;228056000;;474769000;409850000;;243003000;652853000;1127622000;315526000;25256000;340782000;102474000;225957000;566739000;303322000;-57770000;338810000;560883000;1127622000
ARCB;822441;USD;2013;Q4;2013-12-31;2014-02-28;25787350;25787350;141260000;202540000;;381003000;394397000;;241926000;636323000;1017326000;278104000;31513000;309617000;81332000;187248000;496865000;296408000;-57770000;296735000;520461000;1017326000
ARCB;822441;USD;2012;Q4;2012-12-31;2013-02-28;25645631;25645631;119756000;180631000;;346805000;444028000;;243629000;687657000;1034462000;256664000;43044000;299708000;112941000;275755000;575463000;289984000;-57770000;284157000;458999000;1034462000
ARCB;822441;USD;2011;Q4;2011-12-31;2012-02-29;25482212;25481609;175255000;149665000;;409605000;415418000;;91197000;506615000;916220000;239409000;24262000;263671000;46750000;186934000;450605000;286679000;-57770000;295108000;465615000;916220000
ARCB;822441;USD;2010;Q4;2010-12-31;2011-02-23;25280717;25280717;141866000;145426000;;367003000;407246000;;86702000;493948000;860951000;219896000;14001000;233897000;42657000;147310000;381207000;281438000;-57770000;292129000;479744000;860951000
ARCB;822441;USD;2009;Q4;2009-12-31;2010-08-05;25067402;25067402;133193000;115459000;;345707000;428852000;;94987000;523839000;869546000;232952000;3603000;236555000;13373000;132095000;368650000;274930000;-57770000;327948000;500896000;869546000
ARCB;822441;USD;2018;Q4;2018-12-31;2019-02-28;25708239;26703740;296992000;297051000;;649226000;631188000;;258817000;890005000;1539231000;388584000;54075000;451318000;237600000;370231000;821549000;325999000;-95468000;501389000;717682000;1539231000
BSTC;822442;USD;2017;Q4;2017-12-31;2018-03-14;7183399;7310757;59307781;4655105;;66380515;;5745974;2869905;8615879;74996394;1002731;;2138848;;5340708;7479556;33475923;-7898200;41939115;67516838;74996394
BSTC;822442;USD;2016;Q4;2016-12-31;2017-03-16;7152757;7309180;49018226;3810792;;55399967;;3771380;5524933;9296313;64696280;738649;;1996635;;6417702;8414337;32952795;-7281701;30610849;56281943;64696280
BSTC;822442;USD;2015;Q4;2015-12-31;2016-03-14;6918589;7324503;33485417;2547920;;38351971;;3596541;3749601;7346142;45698113;611009;;838525;;49379;887904;31804708;-6233109;19238610;44810209;45698113
BSTC;822442;USD;2014;Q4;2014-12-31;2015-03-16;6612008;7212329;20711252;2938731;;25148810;;1250000;4628014;5878014;31026824;543696;;671212;;98757;769969;25066520;-4430643;9620978;30256855;31026824
BSTC;822442;USD;2013;Q4;2013-12-31;2014-03-07;6341328;6841224;12591824;5004418;;18273461;;0;4978783;4978783;23252244;634277;;781545;;138260;919805;20958451;-3601030;4975018;22332439;23252244
BSTC;822442;USD;2012;Q4;2012-12-31;2013-03-15;6381911;7022833;8503737;5082360;;13875801;;;4514463;4514463;18390264;512866;;724528;;207390;931918;20695331;-2926156;-310829;17458346;18390264
BSTC;822442;USD;2011;Q4;2011-12-31;2012-03-13;6351638;6345707;8196831;3236917;;13086503;;;3178570;3178570;16265073;601002;;1116239;;276520;1392759;20055727;-1891509;-3291904;14872314;16265073
BSTC;822442;USD;2010;Q4;2010-12-31;2011-08-09;6280480;6280480;7831822;1986125;;10095258;;;1423443;1423443;11518701;893083;;4104359;;713619;4817978;17746211;-1151958;-9893530;6700723;11518701
BSTC;822442;USD;2018;Q4;2018-12-31;2019-04-02;7279503;7357975;80883595;16518687;;98233962;;1099834;758246;1858080;100092042;2503522;;2503522;;0;2503522;36310184;-10898383;72176719;97588520;100092042
ESV;822750;USD;2018;Q4;2018-12-31;2019-02-28;108575000;108575000;604100000;344700000;;1309700000;12616200000;;97800000;12714000000;14023700000;210500000;;528500000;5010400000;5406400000;5934900000;7271200000;-72200000;874200000;8088800000;14023700000
ESV;822750;USD;2017;Q4;2017-12-31;2018-02-27;106825000;106825000;885400000;345400000;;1612000000;12873700000;;140200000;13013900000;14625900000;432600000;;758500000;4750700000;5137400000;5895900000;7239800000;-69000000;1532700000;8730000000;14625900000
ESV;822750;USD;2016;Q4;2016-12-31;2016-07-28;75175000;75175000;2602300000;361000000;;3279300000;10919300000;;175900000;11095200000;14374500000;145900000;331900000;854400000;4942600000;5265100000;6119500000;6433300000;-65800000;1864100000;8255000000;14374500000
ESV;822750;USD;2015;Q4;2015-12-31;2016-02-25;58100000;58050000;1301300000;582000000;;2285100000;11087800000;;237600000;11325400000;13610500000;224600000;0;775500000;5868600000;6317800000;7093300000;5578900000;-63800000;985300000;6517200000;13610500000
ESV;822750;USD;2014;Q4;2014-12-31;2015-03-02;57950000;57875000;1422100000;883300000;;2891000000;12534800000;;615000000;13149800000;16040800000;373200000;34800000;1102100000;5885600000;6715800000;7817900000;5541700000;-59000000;2720400000;8222900000;16040800000
ESV;822750;USD;2013;Q4;2013-12-31;2014-02-26;57850000;57875000;215600000;855700000;;1535200000;14311000000;;3626700000;17937700000;19472900000;341100000;47500000;1047300000;4718900000;5626700000;6674000000;5491300000;-45200000;7327300000;12798900000;19472900000
ESV;822750;USD;2012;Q4;2012-12-31;2013-02-22;57500000;57575000;487100000;811400000;;1723900000;13145600000;;3695800000;16841400000;18565300000;357800000;47500000;989700000;4798400000;5723500000;6713200000;5422600000;-31000000;6434700000;11852100000;18565300000
ESV;822750;USD;2011;Q4;2011-12-31;2012-02-24;57425000;57550000;430700000;851700000;;1681300000;12421900000;;3795600000;16217500000;17898800000;644400000;172500000;1332600000;4877600000;5681700000;7014300000;5276700000;-19100000;5613100000;10884500000;17898800000
ESV;822750;USD;2010;Q4;2010-12-31;2011-02-24;35325000;35275000;1050700000;214600000;;1436700000;5049900000;;564900000;5614800000;7051500000;163500000;17200000;349000000;240100000;737500000;1086500000;652200000;-8800000;5305000000;5965000000;7051500000
ESV;822750;USD;2009;Q4;2009-12-31;2010-02-25;35125000;35200000;1141400000;324600000;;1652800000;4477300000;60500000;556600000;5094400000;6747200000;159100000;17200000;484900000;257200000;755200000;1240100000;617700000;-2900000;4879200000;5507100000;6747200000
ESV;822750;USD;2008;Q4;2008-12-31;2009-07-23;34950000;34950000;789600000;482700000;;1400900000;3871300000;64200000;493700000;4429200000;5830100000;195800000;17200000;427900000;274300000;718600000;1146500000;1779400000;-1199500000;4114000000;4683600000;5830100000
AXGN;822853;USD;2018;Q4;2018-12-31;2019-02-26;-109554498;-109554498;116605000;15321000;11982000;150953000;8039000;;1181000;9220000;160173000;12998000;28000;13044000;35000;147000;13191000;297708000;;-150726000;146982000;160173000
AXGN;822853;USD;2017;Q4;2017-12-31;2018-02-28;33854285;33854285;36507000;11065000;7316000;55741000;2197000;;937000;3134000;58875000;8952000;735000;13719000;19810000;19974000;33693000;153511000;;-128329000;25182000;58875000
AXGN;822853;USD;2016;Q4;2016-12-31;2017-03-01;32582351;32582351;30014405;8052203;5458840;44037252;1494247;;828979;2323226;46360478;7002165;20899;11081369;20265745;20357960;31439329;132804972;;-117883823;14921149;46360478
AXGN;822853;USD;2015;Q4;2015-12-31;2016-02-29;30015824;30015824;25909500;4782989;3933960;35051374;970870;;678082;1648952;36700326;3695127;;3709245;24701693;24795490;28504735;111668270;;-103472679;8195591;36700326
AXGN;822853;USD;2014;Q4;2014-12-31;2015-03-05;18575753;18575753;8215791;2872308;3213620;14411088;619028;;1370673;1989701;16400789;2431194;;2445312;25085777;25201157;27646469;78870574;;-90116254;-11245680;16400789
AXGN;822853;USD;2013;Q4;2013-12-31;2014-03-06;17416697;17416697;20069750;1893699;3398438;25658606;381689;;1643975;2025664;27684270;2083942;;2098060;25363695;25449577;27547637;72542411;;-72405778;136633;27684270
AXGN;822853;USD;2012;Q4;2012-12-31;2013-03-12;;;13907401;1050089;3151109;18295855;108534;;1826174;1934708;20230563;1479752;;1479752;21580252;21580252;23060004;55019452;;-57848893;-2829441;20230563
AXGN;822853;USD;2011;Q4;2011-12-31;2012-03-15;;;8190781;797654;1760540;10882475;247824;;1364743;1612567;12495042;1585100;434734;2019834;4403737;4403737;6423571;54502406;;-48430935;6071471;12495042
XONE;823071;USD;2017;Q4;2017-12-31;2018-03-15;16105388;16105388;21848000;8647000;15430000;47965000;46797000;;798000;47595000;95560000;10372000;152000;18806000;1544000;1545000;20351000;173879000;;-89186000;75209000;95560000
XONE;823071;USD;2016;Q4;2016-12-31;2017-03-16;16002785;16002785;27825000;6447000;15838000;51599000;51134000;;1445000;52579000;104178000;7160000;204000;14735000;1654000;1663000;16398000;171276000;;-68761000;87780000;104178000
XONE;823071;USD;2015;Q4;2015-12-31;2016-03-22;14431319;14431319;19342000;9368000;19839000;51461000;54832000;;1623000;56455000;107916000;9641000;214000;16958000;1857000;1885000;18843000;156771000;;-54163000;89073000;107916000
XONE;823071;USD;2014;Q4;2014-12-31;2015-03-26;14417873;14417873;36202000;14238000;17014000;70592000;55298000;;7237000;62535000;133127000;10671000;478000;12051000;2114000;2531000;14582000;155046000;;-28298000;118545000;133127000
XONE;823071;USD;2013;Q4;2013-12-31;2014-03-20;14442426;14442426;98445000;9042000;12764000;123548000;32772000;;2115000;34887000;158435000;7142000;676000;8734000;2557000;3001000;11735000;153507000;;-6455000;146700000;158435000
XONE;823071;USD;2012;Q4;2012-12-31;2013-05-15;;;2802000;8413000;7485000;20243000;12467000;;365000;12832000;33075000;8324000;2948000;24925000;7618000;27093000;52018000;-21355000;;0;-18943000;33075000
XONE;823071;USD;2018;Q4;2018-12-31;2019-03-15;16234719;16234719;7592000;6393000;15930000;34203000;41906000;1351000;222000;43479000;77682000;10425000;144000;12912000;1891000;1995000;14907000;175376000;;-101853000;62775000;77682000
ANIK;823284;USD;2017;Q4;2017-12-31;2018-02-27;14557000;15070000;157256000;23825000;22035000;206327000;56183000;;20107000;76290000;282617000;13073000;;13073000;;6053000;19126000;68764000;;199511000;263491000;282617000
ANIK;823284;USD;2016;Q4;2016-12-31;2017-02-24;14549000;14969000;124761000;27598000;15983000;170440000;52296000;;17510000;69806000;240246000;8799000;;8799000;;8674000;17473000;61881000;;168209000;222773000;240246000
ANIK;823284;USD;2015;Q4;2015-12-31;2016-03-10;14903000;15302000;138458000;21652000;14938000;176433000;40108000;;19207000;59315000;235748000;17278000;;17278000;;7622000;24900000;81835000;;135662000;210848000;235748000
ANIK;823284;USD;2014;Q4;2014-12-31;2015-03-13;14804105;14649000;106906000;17152000;12407000;137836000;31669000;;23303000;54972000;192808000;5973000;;5973000;;8737000;14710000;77689000;;104904000;178098000;192808000
ANIK;823284;USD;2013;Q4;2013-12-31;2014-03-13;15748026;15408998;63333160;18736845;10996785;94591787;32938711;;28511383;61450094;156041881;9102068;;9282501;;11125349;20407850;70748924;;66584202;135634031;156041881
ANIK;823284;USD;2012;Q4;2012-12-31;2013-03-14;13330646;14385414;44067477;21462481;8283472;77384490;35112981;;29571580;64684561;142069051;9977551;1600000;14452618;8000000;18691299;33143917;65570083;;46009681;108925134;142069051
ANIK;823284;USD;2011;Q4;2011-12-31;2012-03-13;14024259;13741173;35777222;17307786;7302483;64137544;36469878;;32237012;68706890;132844434;10071756;1600000;14538423;9600000;23543233;38081656;63577738;;34252221;94762778;132844434
ANIK;823284;USD;2010;Q4;2010-12-31;2011-08-10;12650865;13789474;28201932;14819868;8949745;56322336;36981394;;35633138;72614532;128936868;15069940;1600000;19369940;11200000;24376782;43746722;61952381;;25785541;85190146;128936868
ANIK;823284;USD;2018;Q4;2018-12-31;2019-02-27;14200000;14785000;159014000;20775000;21300000;202943000;54111000;;21939000;76050000;278993000;11289000;;11289000;;4092000;15381000;50905000;;218233000;263612000;278993000
SATS;823480;USD;2017;Q4;2017-12-31;2018-02-22;118170308;120186664;3245617000;196840000;83595000;3715551000;3465471000;;1568992000;5034463000;8750014000;177037000;40631000;217668000;3594213000;4158739000;4376407000;3669461000;98162000;721316000;4373607000;8750014000
AB;823898;USD;2018;Q4;2018-12-31;2019-02-13;;;;;;;;1490701000;;1490701000;1490701000;;;644000;;0;644000;1557277000;;;1490057000;1490701000
AB;823898;USD;2017;Q4;2017-12-31;2018-02-13;;;;;;;;1544704000;;1544704000;1544704000;;;1154000;;0;1154000;1592187000;;;1543550000;1544704000
AB;823898;USD;2016;Q4;2016-12-31;2017-02-14;;;;;;;;1540508000;;1540508000;1540508000;;;619000;;0;619000;1593645000;;;1539889000;1540508000
AB;823898;USD;2015;Q4;2015-12-31;2016-02-11;;;;;;;;1576120000;0;1576120000;1576120000;;;274000;;0;274000;1621198000;;;1575846000;1576120000
DK;823947;USD;2016;Q4;2016-12-31;2017-08-07;61894028;61894028;689200000;265900000;392400000;1396900000;1103300000;360000000;119600000;1582900000;2979800000;496400000;84400000;935200000;748500000;862100000;1797300000;651200000;-160800000;522300000;1182500000;2979800000
IEX;824090;USD;2017;Q4;2017-12-31;2018-02-22;76284000;77595000;375950000;294166000;259724000;1004043000;258350000;;2137235000;2395585000;3399628000;360717000;258000;360975000;858788000;1152111000;1513086000;717808000;-799674000;2057915000;1886542000;3399628000
CLFD;824450;USD;2018;Q4;2018-09-30;2018-11-14;13391998;13454038;17478002;12821258;10050135;41091531;4744584;17974000;10418527;33137111;74228642;4980791;;5085726;;268040;5353766;55620225;;13254651;68874876;74228642
CLFD;824450;USD;2017;Q4;2017-09-30;2017-11-15;13450152;13450152;24473261;7237641;8453567;41143402;5434172;19816000;3100463;28350635;69494037;4243121;;4687197;;281720;4968917;55545016;;8980104;64525120;69494037
CLFD;824450;USD;2016;Q4;2016-09-30;2016-11-22;13494947;13689496;33541396;7999210;8373155;51112678;5780814;10703000;2998821;19482635;70595313;7345736;;7757515;;243755;8001270;57461778;;5132265;62594043;70595313
CLFD;824450;USD;2015;Q4;2015-09-30;2015-11-25;13250505;13607173;25996210;6010900;7182854;40753629;5689673;8290000;2894315;16873988;57627617;5037255;;6120142;;228345;6348487;56024907;;-4745777;51279130;57627617
CLFD;824450;USD;2014;Q4;2014-09-30;2014-11-26;13182863;13700717;24823493;5027856;5390342;38034383;2462250;8302000;3049265;13813515;51847898;5101264;;5101264;;0;5101264;56174419;;-9427785;46746634;51847898
CLFD;824450;USD;2013;Q4;2013-09-30;2013-11-21;12615921;13385064;15799957;7837543;5626764;34197203;1796812;6770000;3649324;12216136;46413339;6314202;;6314202;;21101;6335303;54938672;;-14860636;40078036;46413339
CLFD;824450;USD;2012;Q4;2012-09-30;2012-12-04;12466024;12973747;14785143;3022636;2971614;22744597;1107468;4572000;9316273;14995741;37740338;3016794;;3016794;;37643;3054437;54280381;;-19594480;34685901;37740338
CLFD;824450;USD;2011;Q4;2011-09-30;2011-11-30;12177043;13514860;13130027;3228864;2757151;20280285;986031;2707000;6328775;10021806;30302091;4011126;;4011126;;61794;4072920;53524845;;-27295674;26229171;30302091
CLFD;824450;USD;2010;Q4;2010-09-30;2011-07-29;12006417;12419613;7050587;3244379;1512306;11936351;1273107;3236163;4915340;9424610;21360961;2036309;;2036309;;78585;2114894;52709187;;-33463120;19246067;21360961
FF;824527;USD;2017;Q4;2017-12-31;2018-03-16;43717643;43729032;235326000;21973000;43754000;310358000;109735000;;5470000;115205000;425563000;32545000;;35281000;;38686000;73967000;281968000;;61195000;351596000;425563000
FF;824527;USD;2016;Q4;2016-12-31;2017-03-16;43596919;43601848;305418000;24359000;52093000;405282000;118152000;;5609000;123761000;529043000;137368000;;144049000;;52181000;196230000;281091000;;48182000;332813000;529043000
FF;824527;USD;2015;Q4;2015-12-31;2016-03-10;43474836;43510618;228716000;46319000;64957000;359824000;124330000;;4955000;129285000;489109000;37662000;;48553000;;46244000;94797000;279235000;;113022000;394312000;489109000
DF;824643;USD;2017;Q4;2017-12-31;2018-02-26;91065818;92078043;16512000;675826000;278063000;1019879000;1094064000;;389886000;1483950000;2503829000;671070000;1125000;672195000;912074000;1175687000;1847882000;660138000;;74219000;655947000;2503829000
DF;824643;USD;2016;Q4;2016-12-31;2017-02-22;90500214;91228441;17980000;669200000;284484000;1058630000;1163851000;;383746000;1547597000;2606227000;706981000;140806000;847787000;745245000;1147884000;1995671000;654535000;;45654000;610556000;2606227000
DF;824643;USD;2015;Q4;2015-12-31;2016-02-22;91330732;90255108;60734000;653156000;253326000;1077563000;1174137000;;268463000;1442600000;2520163000;741988000;1493000;761895000;833080000;1212764000;1974659000;680830000;;-49523000;545504000;2520163000
DF;824643;USD;2014;Q4;2014-12-31;2015-02-17;93909471;93909471;16362000;747630000;251831000;1180060000;1172596000;;416980000;1589576000;2769636000;774900000;698000;794451000;916481000;1347867000;2142318000;753316000;;-41015000;627318000;2769636000
DF;824643;USD;2013;Q4;2013-12-31;2014-02-24;94550330;97419167;16762000;752234000;262858000;1150698000;1216047000;;435300000;1651347000;2802045000;761288000;698000;781087000;896564000;1306643000;2087730000;792224000;;-20719000;714315000;2802045000
DF;824643;USD;2012;Q4;2012-12-31;2013-02-27;-21469895;-20001732;24657000;775818000;261265000;3980734000;1248637000;;468212000;1716849000;5697583000;913631000;10535000;2410387000;2311708000;2827568000;5237955000;1377668000;;-833897000;459628000;5697583000
DF;824643;USD;2011;Q4;2011-12-31;2012-02-27;-249029032;-249561940;115650000;872958000;384991000;2238708000;1936235000;;1580224000;3516459000;5755167000;1127717000;202292000;1524049000;3541635000;4329769000;5853818000;1088641000;;-992519000;-98651000;5755167000
DF;824643;USD;2010;Q4;2010-12-31;2011-03-01;204073165;205396984;92007000;891019000;425576000;1816216000;2113391000;;4027060000;6140451000;7956667000;1232876000;174250000;1440965000;3893275000;5001634000;6442599000;1063076000;;583102000;1514068000;7956667000
DF;824643;USD;2009;Q4;2009-12-31;2010-08-06;202358132;205355548;45190000;871833000;436061000;1647594000;2102253000;;4094094000;6196347000;7843941000;1225017000;248352000;1482414000;3980627000;4994295000;6476709000;1027311000;;491611000;1367232000;7843941000
DF;824643;USD;2018;Q4;2018-12-31;2019-02-28;91404394;91404394;24176000;589263000;255484000;912280000;1006182000;;200030000;1206212000;2118492000;699661000;1174000;700835000;905170000;1102925000;1803760000;662544000;;-260977000;314732000;2118492000
RKDA;824887;USD;2016;Q4;2016-12-31;2017-03-08;;2228691;50560000;349000;252000;52222000;508000;2498000;1346000;4352000;56574000;2359000;;3129000;25127000;31247000;34376000;173767000;;-151550000;22198000;56574000
FGP;825012;USD;2015;Q4;2015-07-31;2015-09-29;90997400;-247600500;7652000;196918000;96754000;365609000;965217000;;1106903000;2072120000;2437729000;83974000;145319000;409980000;1778065000;2023794000;2433774000;;;;3955000;2437729000
FGP;825012;USD;2014;Q4;2014-07-31;2014-09-29;81303800;-237339300;8289000;178602000;145969000;364931000;611787000;;595552000;1207339000;1572270000;69360000;160519000;355040000;1292214000;1216510000;1571550000;;;;720000;1572270000
FGP;825012;USD;2013;Q4;2013-07-31;2013-09-26;79219100;-237003100;6464000;131791000;117116000;280979000;589727000;;485322000;1075049000;1356028000;49128000;132054000;302284000;1106940000;1052775000;1355059000;;;;969000;1356028000
TITN;825306;USD;2017;Q4;2018-01-31;2018-04-06;21668000;21610000;53396000;60672000;472467000;599146000;151047000;;10115000;161162000;760308000;295965000;0;328289000;97397000;110164000;438453000;246509000;;77046000;321855000;760308000
TUSK;825691;USD;2017;Q4;2017-12-31;2018-02-28;44690000;45054000;5637000;243746000;17814000;314423000;425786000;;127034000;552820000;867243000;219988000;;219988000;99900000;139459000;359447000;508456000;;2001000;507796000;867243000
TUSK;825691;USD;2016;Q4;2016-12-31;2017-02-24;36000000;36000000;29239000;21169000;6124000;88939000;297487000;;115936000;413423000;502362000;29246000;;29246000;0;50335000;79581000;482320000;;-56323000;422781000;502362000
TUSK;825691;USD;2015;Q4;2015-12-31;2016-11-10;;;3074072;17797852;4755661;56140838;273026665;;121818067;394844732;450985570;30790175;;30790175;95000000;97032133;127822308;329090230;;0;323163262;450985570
TUSK;825691;USD;2018;Q4;2018-12-31;2019-03-18;44856867;45059000;67625000;337460000;21302000;449556000;508407000;;115128000;623535000;1073091000;233823000;;233823000;0;85216000;319039000;531368000;;226765000;754052000;1073091000
PYX;825788;USD;2017;Q4;2018-03-31;2018-06-07;9009000;9085000;264660000;285554000;698087000;1349603000;254281000;;362747000;617028000;1966631000;598930000;164000;638057000;920143000;1045746000;1683803000;473476000;;-156348000;282828000;1966631000
PYX;825788;USD;2016;Q4;2017-03-31;2017-06-14;8952000;8952000;473110000;239558000;678325000;1510076000;256511000;;205285000;461796000;1971872000;662006000;10046000;712750000;942959000;1052412000;1765162000;472349000;;-208784000;206710000;1971872000
PYX;825788;USD;2015;Q4;2016-03-31;2016-07-12;8894000;8898000;199720000;303907000;791340000;1490358000;277525000;;200315000;477840000;1968198000;644085000;356000;674826000;910214000;1018700000;1693526000;470830000;;-145856000;274672000;1968198000
PYX;825788;USD;2014;Q4;2015-03-31;2015-06-08;8853000;8853000;143849000;184772000;739563000;1225699000;237914000;;170593000;408507000;1634206000;504112000;2894000;584424000;738943000;855718000;1440142000;468564000;;-211388000;194064000;1634206000
PYX;825788;USD;2013;Q4;2014-03-31;2014-06-05;17534453;16428353;234778000;166453000;743669000;1293065000;261174000;;193774000;454948000;1748013000;410120000;4556000;500362000;900363000;999054000;1499416000;465682000;;-182054000;248597000;1748013000
PYX;825788;USD;2012;Q4;2013-03-31;2013-06-17;8745600;13402400;92026000;224222000;903947000;1464755000;270978000;;175846000;446824000;1911579000;571058000;6349000;620952000;830870000;948596000;1569548000;460914000;;-67329000;342031000;1911579000
PYX;825788;USD;2011;Q4;2012-03-31;2012-06-13;8716600;13347200;119743000;303090000;839902000;1477847000;259679000;;212319000;471998000;1949845000;589704000;7050000;649166000;821453000;970258000;1619424000;457497000;;-91342000;330421000;1949845000
PYX;825788;USD;2010;Q4;2011-03-31;2011-08-04;8681100;4038200;43506000;279904000;800365000;1317275000;237088000;;253967000;491055000;1808330000;413118000;784000;470415000;884371000;1021903000;1492318000;455409000;;-120793000;316012000;1808330000
PYX;825788;USD;2018;Q4;2019-03-31;2019-06-14;9070000;9070000;192043000;290097000;668171000;1238508000;276396000;;344371000;620767000;1859275000;630074000;332000;646842000;898386000;1020414000;1667256000;468936000;;-223884000;192019000;1859275000
ARNA;826177;USD;2017;Q4;2017-12-31;2018-03-14;39413000;39413000;247077000;2357000;;281280000;30131000;24242000;3622000;57995000;339275000;15622000;;72327000;57748000;59804000;132131000;1698547000;;-1490187000;207144000;339275000
ARNA;826177;USD;2016;Q4;2016-12-31;2017-03-15;24331400;24331400;90712000;573000;;119889000;35109000;;14012000;49121000;169010000;9559000;;63879000;61748000;64736000;128615000;1441739000;;-1398736000;40395000;169010000
ARNA;826177;USD;2015;Q4;2015-12-31;2016-02-29;24265300;24265300;156184000;4934000;9502000;174838000;71828000;;10126000;81954000;256792000;25493000;;49896000;65267000;153354000;203250000;1430941000;;-1376220000;53542000;256792000
ARNA;826177;USD;2018;Q4;2018-12-31;2019-02-28;49537000;49537000;445631000;5086000;;460725000;23114000;82412000;120652000;226178000;686903000;26635000;;29918000;49426000;50727000;80645000;2106965000;;-1500552000;606258000;686903000
YOGA;826179;USD;2017;Q4;2017-12-31;2018-04-03;16997393;16997393;22095216;;1212608;24452891;10418203;;36135227;46553430;71006321;5741703;;13052258;;3418886;16471144;111666748;;-57131571;54535177;71006321
YOGA;826179;USD;2016;Q4;2016-12-31;2017-09-22;75896;75896;1912421;;948194;4178752;8552674;;44416472;52969146;57147898;2666709;418750;7871104;6350320;20516182;28387286;67262;;-32699474;28760612;57147898
YOGA;826179;USD;2018;Q4;2018-12-31;2019-03-27;16490156;16490156;11447318;;1148449;13532524;10225944;;15283231;25509175;39041699;6707251;;14108148;;3975391;18083539;113276657;;-92318497;20958160;39041699
NVAX;826389;USD;2017;Q4;2017-12-31;2018-03-14;-28949125;-28949125;157303000;;;203311000;35987000;;63195000;99182000;302493000;40301000;;73675000;317763000;330550000;404225000;1023694000;-2450000;-1114359000;-101732000;302493000
NVAX;826389;USD;2016;Q4;2016-12-31;2017-02-27;13560;13560;235479000;;;287830000;40184000;;66287000;106471000;394301000;35271000;;66406000;316339000;333441000;399847000;938714000;-2450000;-929996000;-5546000;394301000
NVAX;826389;USD;2015;Q4;2015-12-31;2016-02-29;-12035582;-12035582;230656000;2320000;;287257000;32342000;;66439000;98781000;386038000;38623000;395000;76494000;0;16875000;93369000;954273000;-2450000;-650030000;292669000;386038000
NVAX;826389;USD;2014;Q4;2014-12-31;2015-02-27;-22739377;-22739377;168056000;7510000;;188158000;19737000;;68107000;87844000;276002000;32305000;603000;34116000;395000;12268000;46384000;731766000;-2450000;-493093000;229618000;276002000
NVAX;826389;USD;2013;Q4;2013-12-31;2014-03-12;33908135;33908135;133068000;1911000;;145001000;14251000;;75873000;90124000;235125000;16396000;877000;18122000;1004000;13769000;31891000;614991000;-2450000;-410146000;203234000;235125000
NVAX;826389;USD;2012;Q4;2012-12-31;2013-03-12;7262;7262;44111000;1011000;;50408000;11456000;6233000;34248000;51937000;102345000;10503000;215000;11675000;990000;10430000;22105000;440423000;-2450000;-358163000;80240000;102345000
NVAX;826389;USD;2011;Q4;2011-12-31;2012-03-14;5764;5764;18309000;1965000;;26109000;6857000;0;33610000;40467000;66576000;7173000;20000;7579000;300000;5148000;12727000;385123000;-2450000;-329656000;53849000;66576000
NVAX;826389;USD;2010;Q4;2010-12-31;2011-08-09;;;31676000;54000;;33337000;8206000;;33301000;41507000;74844000;9845000;80000;10266000;320000;3956000;14222000;372592000;-2450000;-310292000;60622000;74844000
NVAX;826389;USD;2018;Q4;2018-12-31;2019-03-18;36022651;36022651;92134000;;;119276000;28426000;;60276000;88702000;207978000;33929000;;45539000;319187000;330374000;375913000;1144813000;-2450000;-1299107000;-167935000;207978000
MN;826501;USD;2017;Q4;2017-12-31;2018-03-16;-50069693;-49777741;148666000;15337000;;168873000;5407000;;30900000;36307000;205180000;1612000;;44172000;;22648000;66820000;198791000;;-38424000;138360000;205180000
MN;826501;USD;2016;Q4;2016-12-31;2017-03-16;13289929;14143325;138289000;15434000;;165367000;5680000;;49552000;55232000;220599000;2053000;;47378000;;38743000;86121000;200308000;;-37383000;134478000;220599000
MN;826501;USD;2015;Q4;2015-12-31;2016-03-14;-54862081;-53946865;140158000;15807000;;176548000;6299000;;47949000;54248000;230796000;1141000;;54559000;;41457000;96016000;205908000;;-37149000;134780000;230796000
MN;826501;USD;2014;Q4;2014-12-31;2015-03-16;13211957;14023729;151907000;23704000;;202500000;7456000;;47517000;54973000;257473000;2906000;;66497000;;42265000;108762000;209421000;;-41087000;148711000;257473000
MN;826501;USD;2013;Q4;2013-12-31;2014-03-14;13478596;13973892;146571000;24140000;;201016000;5424000;;46164000;51588000;252604000;1476000;;63296000;;43519000;106815000;209124000;;-40544000;145789000;252604000
MN;826501;USD;2012;Q4;2012-12-31;2013-03-15;13583873;13583873;121406000;22962000;;165149000;4460000;;48571000;53031000;218180000;1231000;;50445000;;43989000;94434000;198253000;;-33392000;123746000;218180000
MN;826501;USD;2018;Q4;2018-12-31;2019-03-27;14746774;-112569136;150776000;11447000;;167444000;5649000;;29466000;35115000;202559000;1845000;;36276000;;20040000;56316000;198757000;;-38865000;146243000;202559000
BLDR;826504;USD;2017;Q4;2017-12-31;2018-03-01;113253000;116472000;57533000;631992000;601547000;1395868000;639303000;;970953000;1610256000;3006124000;785879000;12475000;798354000;1771945000;1831561000;2629915000;547902000;;-171693000;376209000;3006124000
BLDR;826504;USD;2016;Q4;2016-12-31;2017-03-01;111577000;116650000;14449000;569208000;541771000;1215981000;656101000;;1037805000;1693906000;2909887000;702874000;16217000;754697000;1785835000;1845570000;2600267000;528983000;;-219363000;309620000;2909887000
BLDR;826504;USD;2015;Q4;2015-12-31;2016-03-11;109537000;105302000;65063000;528544000;513045000;1194329000;734329000;;953380000;1687709000;2882038000;659252000;29153000;735238000;1922518000;1997605000;2732843000;512899000;;-363704000;149195000;2882038000
BLDR;826504;USD;2014;Q4;2014-12-31;2015-03-03;98447000;103352000;17773000;140064000;138156000;331540000;75679000;;166846000;242525000;574065000;142093000;30074000;172167000;344829000;361698000;533865000;381073000;;-340873000;40200000;574065000
BLDR;826504;USD;2013;Q4;2013-12-31;2014-02-28;96229000;93693000;54696000;143036000;123636000;331161000;49392000;;135286000;184678000;515839000;126356000;67000;126423000;353904000;374048000;500471000;374391000;;-359023000;15368000;515839000
BLDR;826504;USD;2012;Q4;2012-12-31;2013-03-01;95649000;95649000;131432000;117405000;108999000;379872000;44084000;;126885000;170969000;550841000;117175000;60000;117235000;360895000;385510000;502745000;364428000;;-316332000;48096000;550841000
BLDR;826504;USD;2011;Q4;2011-12-31;2012-03-02;;;146833000;76429000;77085000;321937000;48224000;;123633000;171857000;493794000;76077000;54000;76131000;297455000;316439000;392570000;360700000;;-259476000;101224000;493794000
BLDR;826504;USD;2010;Q4;2010-12-31;2011-07-29;;;103234000;59691000;63810000;235349000;57068000;;120387000;177455000;412804000;71150000;5301000;76451000;163801000;176848000;253299000;356143000;;-194481000;159505000;412804000
BLDR;826504;USD;2018;Q4;2018-12-31;2019-03-01;114911000;116371000;10127000;654170000;596896000;1373751000;670075000;;888483000;1558558000;2932309000;715694000;15565000;731259000;1545729000;1604712000;2335971000;561372000;;34966000;596338000;2932309000
SUP;826868;USD;2017;Q4;2017-12-31;2018-03-15;24873000;24768000;47110000;160167000;173999000;417383000;536686000;;597183000;1133869000;1551252000;191059000;4000000;195059000;679552000;910470000;1105529000;89755000;;393146000;445723000;1551252000
SUP;826868;USD;2016;Q4;2016-12-31;2017-03-03;25299000;25399000;58536000;99331000;82837000;254081000;227403000;;61272000;288675000;542756000;85964000;;85964000;;58566000;144530000;89916000;;433235000;398226000;542756000
SUP;826868;USD;2015;Q4;2015-12-31;2016-03-11;26260000;26231000;52986000;112588000;61769000;245820000;234646000;;59463000;294109000;539929000;73862000;;73862000;;52155000;126017000;88108000;;427517000;413912000;539929000
SUP;826868;USD;2014;Q4;2014-12-31;2015-03-12;26685000;26825000;66201000;102493000;74677000;276011000;255035000;;48864000;303899000;579910000;71962000;;71962000;;68942000;140904000;81473000;;438958000;439006000;579910000
SUP;826868;USD;2013;Q4;2013-12-31;2014-03-07;27456000;27562000;203051000;89623000;67193000;384218000;219892000;;49278000;269170000;653388000;99430000;;99430000;;70895000;170325000;75305000;;468121000;483063000;653388000
SUP;826868;USD;2012;Q4;2012-12-31;2013-03-12;27263000;27365000;207334000;98467000;71948000;404908000;147544000;;47149000;194693000;599601000;66578000;;66578000;;66118000;132696000;71819000;;457700000;466905000;599601000
SUP;826868;USD;2011;Q4;2011-12-31;2012-03-07;27142000;27183000;192921000;119895000;66933000;404283000;145747000;;43201000;188948000;593231000;68550000;;68550000;;64166000;132716000;68775000;;457340000;460515000;593231000
SUP;826868;USD;2010;Q4;2010-12-31;2011-08-05;;;151553000;116726000;74897000;381612000;167207000;;23623000;190830000;572442000;70538000;;70538000;;88422000;158960000;61675000;;407529000;413482000;572442000
SUP;826868;USD;2018;Q4;2018-12-31;2019-03-07;25022000;25570000;48214000;104649000;175578000;370421000;532767000;;548428000;1081195000;1451616000;175411000;3052000;178463000;661426000;741576000;920039000;87723000;;391037000;531577000;1451616000
SEDG;847001;USD;2018;Q4;2018-12-31;2019-02-28;45891768;47673966;310313000;173579000;141519000;678113000;119329000;74256000;92774000;286359000;964472000;182499000;;225718000;3510000;168028000;393746000;371799000;;191133000;570726000;964472000
SEDG;847001;USD;2017;Q4;2017-12-31;2018-02-20;43354680;46900577;240427000;109528000;82992000;476686000;51182000;103120000;10317000;164619000;641305000;112410000;;129754000;0;114084000;243838000;331906000;;66172000;397467000;641305000
GAMZ;847387;USD;2013;Q4;2013-12-31;2014-04-29;;;25856;;;25856;4787;;0;4787;30643;280187;363162;729872;;-319017;410855;-380212;;;-380212;30643
GAMZ;847387;USD;2012;Q4;2012-12-31;2013-02-25;;;0;;;0;0;;;0;0;4145;185994;190139;;-197032;-6893;6893;;;6893;0
CCE;849813;USD;2009;Q4;2009-12-31;2010-02-12;491000000;498000000;1036000000;2448000000;874000000;5170000000;6276000000;;4970000000;11246000000;16416000000;3273000000;886000000;4588000000;7891000000;10946000000;15534000000;3913000000;-112000000;-2449000000;882000000;16416000000
CCE;849813;USD;2008;Q4;2008-12-31;2009-07-30;485000000;485000000;722000000;2154000000;901000000;4583000000;6243000000;;4763000000;11006000000;15589000000;2907000000;1782000000;5074000000;7247000000;10524000000;15598000000;3772000000;-108000000;-3029000000;-9000000;15589000000
IPAR;853111;USD;2017;Q4;2017-12-31;2018-03-13;124595651;125126562;278242000;120749000;137058000;549278000;10330000;;218164000;228494000;777772000;142735000;24372000;167107000;36207000;40028000;207135000;66035000;-37475000;422570000;570637000;777772000
IPAR;853111;USD;2016;Q4;2016-12-31;2017-03-13;124196138;124608946;256030000;104819000;96977000;472125000;10076000;;200208000;210284000;682409000;120740000;21498000;142238000;53064000;56513000;198751000;63134000;-37475000;402714000;483658000;682409000
IPAR;853111;USD;2015;Q4;2015-12-31;2016-03-14;31012548;31123860;259814000;95082000;98346000;461575000;9333000;;216751000;226084000;687659000;108920000;22163000;131083000;76443000;80189000;211272000;62061000;-36817000;388434000;476387000;687659000
IPAR;853111;USD;2014;Q4;2014-12-31;2015-03-11;30946232;31060304;280290000;90124000;102326000;479715000;9187000;;115604000;124791000;604506000;103628000;0;103628000;0;2154000;105782000;60231000;-36464000;374121000;498724000;604506000
IPAR;853111;USD;2013;Q4;2013-12-31;2014-03-11;30824820;31029528;307327000;79932000;117347000;518234000;10444000;;135380000;145824000;664058000;126147000;;126147000;;2555000;128702000;57908000;-36016000;359459000;535356000;664058000
IPAR;853111;USD;2012;Q4;2012-12-31;2013-03-12;91667974;92084362;307335000;149340000;142614000;609688000;12289000;;137943000;150232000;759920000;256140000;;256140000;;3799000;259939000;54710000;-35404000;349672000;499981000;759920000
IPAR;853111;USD;2011;Q4;2011-12-31;2012-03-12;61047577;61351602;35856000;175223000;164077000;384076000;14525000;;117433000;131958000;516034000;181136000;4480000;185616000;;6068000;191684000;50914000;-34151000;228164000;324350000;516034000
IPAR;853111;USD;2018;Q4;2018-12-31;2019-03-01;125138072;125994978;261006000;136420000;160978000;569402000;9839000;;219926000;229765000;799167000;163822000;23155000;186977000;22906000;26444000;213421000;70001000;-37475000;448731000;585746000;799167000
IONS;855206;USD;2016;Q4;2016-12-31;2017-03-01;121347000;118958000;665223000;;7489000;797932000;92845000;;21690000;114535000;912467000;81319000;;133784000;587920000;679118000;812902000;1311351000;;-1181428000;99565000;912467000
IONS;855206;USD;2015;Q4;2015-12-31;2016-02-26;120207000;112170000;779183000;;6899000;837003000;90233000;;20664000;110897000;947900000;72525000;;148876000;463928000;598234000;747110000;1309227000;;-1094872000;200790000;947900000
SMPL;858017;USD;2018;Q4;2018-08-31;2018-10-24;70592442;76186338;111971000;36622000;30001000;185740000;2565000;;786300000;788865000;974605000;27615000;648000;30583000;190935000;271421000;302004000;615105000;;58294000;672601000;974605000
SMPL;858017;USD;2019;Q4;2019-08-31;2019-10-30;81847429;86888528;266341000;44240000;38085000;357607000;2456000;;781587000;784043000;1141650000;47356000;676000;48032000;190259000;256174000;304206000;734595000;-2145000;105830000;837444000;1141650000
HCCI;861202;USD;2018;Q4;2019-01-31;2013-02-27;23065000;23609000;43579000;51744000;33059000;135217000;163801000;;48804000;212605000;347822000;44774000;;50029000;29046000;43562000;93591000;197764000;;55819000;254231000;347822000
HCCI;861202;USD;2017;Q4;2018-01-31;2013-02-27;23103000;22994000;41889000;45491000;21639000;114914000;151431000;;48312000;199743000;314657000;37741000;;40431000;28744000;38300000;78731000;193869000;;41359000;235926000;314657000
HCCI;861202;USD;2016;Q4;2017-01-31;2013-02-27;22294000;22870000;36610000;47533000;18558000;108795000;154208000;;51304000;205512000;314307000;44025000;;54206000;56518000;61832000;116038000;185322000;;12227000;198269000;314307000
HCCI;861202;USD;2015;Q4;2016-01-31;2013-02-27;22174000;22672000;23608000;41592000;24774000;94784000;154537000;;52527000;207064000;301848000;36194000;;46511000;62778000;65504000;112015000;182780000;;6385000;189833000;301848000
HCCI;861202;USD;2014;Q4;2015-01-31;2013-02-27;19145000;18423000;21555000;49857000;30798000;116535000;159176000;;44108000;203284000;319819000;41758000;;53027000;73894000;79378000;132405000;181361000;;5135000;187414000;319819000
HCCI;861202;USD;2013;Q4;2014-01-31;2013-02-27;18373000;19054000;22632000;31172000;27307000;85776000;104474000;;25708000;130182000;215958000;23728000;;29364000;18052000;27290000;56654000;146227000;;12143000;159304000;215958000
HCCI;861202;USD;2012;Q4;2013-01-31;2013-02-27;18449000;18938000;47766000;23338000;27231000;102563000;90192000;;6356000;96548000;199111000;20119000;;24434000;19078000;25286000;49720000;141793000;;7598000;149391000;199111000
HCCI;861202;USD;2011;Q4;2012-01-31;2012-02-29;14372000;14899000;2186000;17047000;21260000;44474000;83058000;;6524000;89582000;134056000;25317000;;28932000;20838000;26571000;55503000;73209000;;5344000;78553000;134056000
HCCI;861202;USD;2010;Q4;2011-01-31;2011-08-01;14745000;14822000;21757000;13478000;11647000;49794000;37051000;;2727000;39778000;89572000;13213000;;14352000;0;1676000;16028000;69674000;;3870000;73544000;89572000
GLP;861498;USD;2014;Q4;2014-12-31;2015-03-13;;;5238000;457730000;336813000;959023000;825051000;;246743000;1071794000;2030817000;645183000;;707491000;360096000;687170000;1394661000;600194000;;;636156000;2030817000
VLRX;867483;USD;2017;Q4;2017-12-31;2018-02-28;371323;371323;25961000;3991000;8105000;39472000;5469000;;148000;5617000;45089000;11442000;0;13080000;0;36067000;49147000;469884000;-24000;-473921000;-4058000;45089000
VLRX;867483;USD;2016;Q4;2016-12-31;2017-02-21;80575;80575;9866000;3462000;9384000;24144000;10219000;;153000;10372000;34516000;10123000;;11746000;;59270000;71016000;387739000;0;-424239000;-36500000;34516000
VLRX;867483;USD;2015;Q4;2015-12-31;2016-04-14;-182003;-182003;2789000;3142000;10784000;18806000;12091000;;279000;12370000;31176000;13350000;26000;84378000;;143000;84521000;324527000;;-377872000;-53345000;31176000
VLRX;867483;USD;2018;Q4;2018-12-31;2019-03-06;3109806;3109806;47758000;6294000;6824000;62076000;6097000;;447000;6544000;68620000;13767000;123000;13890000;;40441000;54331000;534181000;-24000;-519871000;14289000;68620000
CASI;877522;USD;2017;Q4;2017-12-31;2018-03-29;65466230;65466230;43489935;;;43812428;1046514;;242023;1288537;45100965;5062097;0;5062097;1498754;1498754;6560851;499276387;-8034244;-452702029;38540114;45100965
CASI;877522;USD;2016;Q4;2016-12-31;2017-03-31;91135015;91135015;27092928;;;27448819;229591;;34485;264076;27712895;1315576;;1315576;1491278;5613544;6929120;470749846;-8034244;-441931827;20783775;27712895
CASI;877522;USD;2018;Q4;2018-12-31;2019-03-29;94810305;94810305;85117009;;282709;92564620;1750630;0;19094751;20845381;113410001;2374482;1499462;3873944;;73591;3947535;597664315;-8034244;-478941285;109462466;113410001
MC;878834;USD;2013;Q4;2013-12-31;2014-05-22;;;303024000;28784000;;342654000;5156000;80622000;15031000;100809000;443463000;118789000;;134093000;;308444000;442537000;;;;926000;443463000
CHDN;883031;USD;2016;Q4;2016-12-31;2017-02-28;49000000;49300000;45300000;56600000;;246000000;560600000;;1447800000;2008400000;2254400000;157000000;14200000;468100000;312800000;1101300000;1569400000;116500000;;569700000;685000000;2254400000
CHDN;883031;USD;2015;Q4;2015-12-31;2016-02-24;50700000;52800000;74500000;67800000;;219600000;573200000;;1484600000;2057800000;2277400000;168200000;16200000;640100000;171900000;1020100000;1660200000;134000000;;483800000;617200000;2277400000
CHDN;883031;USD;2014;Q4;2014-12-31;2015-02-25;51690000;53394000;67936000;75890000;;242530000;595315000;;1518408000;2113723000;2356253000;167056000;11250000;336249000;458318000;1320003000;1656252000;262280000;;437846000;700001000;2356253000
CHDN;883031;USD;2013;Q4;2013-12-31;2014-02-26;52113000;54144000;44708000;46572000;;160715000;585498000;;606048000;1191546000;1352261000;145449000;0;213206000;69191000;434266000;647472000;295955000;;408834000;704789000;1352261000
CHDN;883031;USD;2012;Q4;2012-12-31;2013-02-27;51531000;52170000;37177000;47152000;;147064000;542882000;;424391000;967273000;1114337000;138439000;209728000;406570000;0;63472000;470042000;274709000;;369586000;644295000;1114337000
CHDN;883031;USD;2011;Q4;2011-12-31;2012-03-12;50676000;54699000;27325000;49773000;;144462000;477356000;;326204000;803560000;948022000;139979000;0;173451000;127563000;190541000;363992000;260199000;;323831000;584030000;948022000
CHDN;883031;USD;2010;Q4;2010-12-31;2011-07-27;49068000;50679000;26901000;33307000;;169995000;507476000;;340248000;847724000;1017719000;123547000;;188551000;265117000;322954000;511505000;236503000;;269711000;506214000;1017719000
KONA;884107;USD;2015;Q4;2015-12-31;2016-03-03;11273000;11273000;9233000;1574000;1865000;13446000;87252000;;1146000;88398000;101844000;18830000;0;18830000;0;20323000;39153000;98296000;-1000000;-34605000;62691000;101844000
CUO;884109;USD;2018;Q4;2018-12-31;2019-03-28;1696000;1696000;594000;15321000;14806000;47342000;10431000;;17930000;28361000;75703000;13316000;;20190000;;6737000;26927000;2573000;-14928000;61131000;48776000;75703000
CUO;884109;USD;2017;Q4;2017-12-31;2018-03-29;1682000;1682000;507000;24227000;20359000;47051000;22824000;;12614000;35438000;82489000;8492000;;21874000;;6293000;28167000;2530000;-15195000;66987000;54322000;82489000
CUO;884109;USD;2016;Q4;2016-12-31;2017-03-31;1670000;1670000;301000;22359000;20645000;45883000;19606000;;12519000;32125000;78008000;7532000;;19751000;;6053000;25804000;2408000;-15373000;65169000;52204000;78008000
CUO;884109;USD;2015;Q4;2015-12-31;2016-04-01;1661000;1661000;547000;22715000;19646000;45116000;17639000;;13000000;30639000;75755000;7122000;;21467000;;5872000;27339000;2460000;-15527000;61483000;48416000;75755000
CUO;884109;USD;2014;Q4;2014-12-31;2015-04-03;1651000;1651000;675000;19855000;17476000;41325000;17720000;;12756000;30476000;71801000;5762000;;20784000;;4195000;24979000;2470000;-15718000;60070000;46822000;71801000
CUO;884109;USD;2013;Q4;2013-12-31;2014-03-28;1630000;1630000;924000;22600000;16212000;43234000;19009000;;9719000;28728000;71962000;5335000;;13035000;4408000;6863000;19898000;2458000;-15923000;65529000;52064000;71962000
CUO;884109;USD;2012;Q4;2012-12-31;2013-03-29;1634000;1634000;1734000;19761000;15847000;42173000;19357000;;10015000;29372000;71545000;4191000;;12715000;3408000;5986000;18701000;2458000;-16002000;66388000;52844000;71545000
CUO;884109;USD;2011;Q4;2011-12-31;2012-03-30;1623000;1623000;840000;18176000;17397000;44838000;21086000;;9947000;31033000;75871000;4320000;;12762000;11933000;13803000;26565000;2513000;-16206000;62999000;49306000;75871000
CUO;884109;USD;2010;Q4;2010-12-31;2011-08-16;1599000;1599000;1032000;19868000;16623000;41288000;23693000;;14580000;38273000;79561000;5837000;;15324000;10160000;13432000;28756000;2473000;-16615000;64947000;50805000;79561000
IOTS;884299;USD;2018;Q4;2018-12-31;2019-03-18;29559456;29559456;8630000;23211000;18635000;53473000;7085000;;76630000;83715000;137188000;21318000;141000;40766000;29418000;33680000;74446000;184161000;;-121284000;62742000;137188000
IOTS;884299;USD;2017;Q4;2017-12-31;2018-03-13;21321063;21321063;30078000;8668000;5814000;45605000;7183000;;8024000;15207000;60812000;9434000;926000;14474000;10908000;13388000;27862000;133089000;;-99844000;32950000;60812000
IOTS;884299;USD;2016;Q4;2016-12-31;2017-03-24;15351567;15351567;19719000;6111000;5182000;31579000;5962000;;8642000;14604000;46183000;7343000;6466000;17215000;9775000;12603000;29818000;110751000;;-94156000;16365000;46183000
IOTS;884299;USD;2015;Q4;2015-12-31;2016-03-30;10345436;10345436;23089000;6536000;7368000;39334000;909000;;9695000;10604000;49938000;11145000;5606000;17644000;7814000;7815000;25459000;107169000;;-82544000;24479000;49938000
IOTS;884299;USD;2014;Q4;2014-12-31;2015-12-10;551137;551137;5972000;1994000;7453000;17044000;1725000;;12678000;14403000;31447000;9282000;6476000;21634000;;1598000;23232000;3912000;;-74161000;8215000;31447000
AVT;884659;USD;2018;Q4;2018-06-30;2018-08-17;116950000;114302000;621125000;3641139000;3141822000;7610599000;522909000;;1463337000;1986246000;9596845000;2804081000;165380000;2969461000;1489219000;1942303000;4911764000;1644538000;;3235894000;4685081000;9596845000
AVT;884659;USD;2017;Q4;2017-06-30;2017-08-17;124209000;125062000;1117710000;3337624000;2824709000;7533808000;519575000;;1646206000;2165781000;9699589000;2403658000;50113000;2453771000;1729212000;2063750000;4517521000;1626571000;;3799363000;5182068000;9699589000
AVT;884659;USD;2016;Q4;2016-06-30;2016-08-12;127929000;129798000;1031478000;2769906000;2559921000;9003973000;453209000;;1782623000;2235832000;11239805000;1985665000;1152599000;4942493000;1339204000;1606026000;6548519000;1579790000;;3632271000;4691286000;11239805000
AVT;884659;USD;2015;Q4;2015-06-30;2015-08-07;135856000;137621000;932553000;5054307000;2482183000;8584901000;568779000;;1646273000;2215052000;10799953000;3941181000;331115000;4272296000;1646501000;1842636000;6114932000;1543918000;-458000;3582599000;4685021000;10799953000
AVT;884659;USD;2014;Q4;2014-06-30;2014-08-08;138430000;140429000;928971000;5220528000;2613363000;8954199000;534999000;;1761456000;2296455000;11250654000;4113738000;865088000;4978826000;1208951000;1381635000;6360461000;1493949000;-675000;3257407000;4890193000;11250654000
AVT;884659;USD;2013;Q4;2013-06-30;2013-08-09;137159000;139063000;1009343000;4868973000;2264341000;8356878000;492606000;;1625196000;2117802000;10474680000;3983254000;838190000;4821444000;1206993000;1364111000;6185555000;1458028000;-764000;2802966000;4289125000;10474680000
AVT;884659;USD;2012;Q4;2012-06-30;2012-08-10;144528000;146795000;1006864000;4607324000;2388642000;8254439000;461230000;;1452197000;1913427000;10167866000;3926248000;872404000;4798652000;1271985000;1463482000;6262134000;1406403000;-697000;2545858000;3905732000;10167866000
AVT;884659;USD;2011;Q4;2011-06-30;2011-09-09;152924000;154832000;675334000;4764293000;2596470000;8227207000;419173000;;1259189000;1678362000;9905569000;4234649000;243079000;4477728000;1273509000;1371771000;5849499000;1386044000;-695000;2293510000;4056070000;9905569000
AVT;884659;USD;2010;Q4;2010-06-30;2010-08-13;151959000;153577000;1092102000;3574541000;1812766000;6630168000;302583000;;849631000;1152214000;7782382000;3403066000;36549000;3439615000;1243681000;1333650000;4773265000;1358006000;-692000;1624441000;3009117000;7782382000
AVT;884659;USD;2009;Q4;2009-06-30;2009-11-24;151163000;149794000;943921000;2618697000;1411755000;5144252000;305682000;;823582000;1129264000;6273516000;2432566000;23294000;2455860000;946573000;1056799000;3512659000;1329623000;-931000;1214071000;2760857000;6273516000
AVT;884659;USD;2019;Q4;2019-06-30;2019-08-15;105614000;106437000;546105000;3168369000;3008424000;6876336000;452171000;;1236049000;1688220000;8564556000;2278038000;300538000;2578576000;1419922000;1845507000;4424083000;1677043000;;2767469000;4140473000;8564556000
CRTO;884751;USD;2018;Q4;2018-12-31;2019-03-01;66244133;67067894;364426000;473901000;;933851000;184013000;;479271000;663284000;1597135000;498979000;;605344000;;23900000;629244000;665482000;-79159000;387869000;967891000;1597135000
CRTO;884751;USD;2017;Q4;2017-12-31;2018-03-01;65942639;67793255;414111000;484101000;;991767000;161738000;;377795000;539533000;1531300000;493248000;;621005000;;12597000;633602000;593556000;0;300210000;897698000;1531300000
CRTO;884751;USD;2016;Q4;2016-12-31;2017-03-01;63866019;66251227;270317000;397244000;;742584000;108581000;;360021000;468602000;1211186000;436116000;;519791000;;81518000;601309000;490370000;;198355000;609877000;1211186000
CRTO;884751;USD;2015;Q4;2015-12-31;2016-05-04;62366351;65110153;353537000;261581000;;663414000;82482000;;95823000;178305000;841719000;304022000;;357840000;;4856000;362696000;427272000;;116076000;479023000;841719000
MELI;884834;USD;2018;Q4;2018-12-31;2019-02-28;45215024;45215024;901873000;395451000;4612000;1511123000;165614000;276136000;286646000;728396000;2239519000;1101068000;;1166224000;602228000;736595000;1902819000;224845000;;503432000;336700000;2239519000
MELI;884834;USD;2017;Q4;2017-12-31;2018-02-23;44157364;44157364;597692000;549298000;2549000;1286919000;114837000;34720000;236711000;386268000;1673187000;932204000;;968032000;312089000;379376000;1347408000;70705000;;537925000;325779000;1673187000
MELI;884834;USD;2016;Q4;2016-12-31;2017-02-24;44157361;44157361;487461000;333339000;1103000;869461000;124261000;153803000;219910000;497974000;1367435000;542904000;;576601000;301940000;361980000;938581000;138026000;;550641000;428854000;1367435000
MELI;884834;USD;2015;Q4;2015-12-31;2016-02-26;44156823;44156823;368993000;160374000;222000;545173000;81633000;187621000;189179000;458433000;1003606000;304716000;;322475000;294342000;341673000;664148000;137967000;;440770000;339458000;1003606000
MELI;884834;USD;2014;Q4;2014-12-31;2015-02-27;44153934;44125158;371954000;131834000;;532750000;91545000;205265000;137288000;434098000;966848000;260789000;;292623000;282184000;318437000;611060000;137689000;;353173000;355788000;966848000
MELI;884834;USD;2013;Q4;2013-12-31;2014-03-03;44153211;44153177;216878318;77930111;;326164235;131371909;45719737;89106892;266198538;592362773;206311499;;224165609;2489819;20713556;244879165;121606346;-1012216;310345448;347483608;592362773
MELI;884834;USD;2012;Q4;2012-12-31;2013-02-28;44150982;44142102;195183807;55653528;;275361175;37726222;85955584;79626295;203308101;478669276;150320704;;169531272;59493;15324378;184855650;120512910;;218083844;293813626;478669276
MELI;884834;USD;2011;Q4;2011-12-31;2012-02-28;44142175;44154567;142310297;40670776;;200245555;30877719;43933316;80874846;155685881;355931436;106670347;;118303525;136227;14448895;132752420;120496174;;135726188;223179016;355931436
MELI;884834;USD;2010;Q4;2010-12-31;2011-02-25;44131628;44141110;62173232;18769691;;101635208;20817712;78846281;68383822;168047815;269683023;76906893;;88394467;188846;9570286;97964753;120435753;;73681556;171718270;269683023
MELI;884834;USD;2009;Q4;2009-12-31;2010-08-06;44115036;44181367;64383587;8654179;;82135016;5948276;26627357;67904000;100479633;182614649;53695376;;60492892;0;7928520;68421412;120302118;;17656537;114193237;182614649
SWI;885119;USD;2014;Q4;2014-12-31;2015-02-23;75778000;76891000;250326000;50791000;;316087000;23614000;17423000;467908000;508945000;825032000;44456000;;199255000;;36918000;236173000;279660000;;322498000;588859000;825032000
SWI;885119;USD;2013;Q4;2013-12-31;2014-02-14;75120000;76170000;185300000;45694000;;242785000;9213000;11012000;443332000;463557000;706342000;25466000;;193794000;;28654000;222448000;236556000;;244385000;483894000;706342000
SWI;885119;USD;2012;Q4;2012-12-31;2013-02-19;74544000;76549000;228978000;32506000;;266660000;8342000;12823000;229570000;250735000;517395000;22434000;;120106000;;14475000;134581000;229352000;;154607000;382814000;517395000
SWI;885119;USD;2011;Q4;2011-12-31;2012-02-27;73214000;74846000;152395000;26965000;;182908000;7341000;;172159000;179500000;362408000;12434000;;89721000;;7740000;97461000;194452000;;73264000;264947000;362408000
SWI;885119;USD;2010;Q4;2010-12-31;2011-08-05;70518000;72799000;142003000;20255000;;176079000;6702000;;64696000;71398000;247477000;11293000;;67876000;;3992000;71868000;166044000;;10821000;175609000;247477000
MATX;885542;USD;2018;Q4;2018-12-31;2019-03-04;42800000;43000000;19600000;223700000;;318400000;1366600000;;745400000;2112000000;2430400000;328700000;42100000;370800000;814300000;1304300000;1675100000;329800000;;460000000;755300000;2430400000
MATX;885542;USD;2017;Q4;2017-12-31;2018-02-23;42600000;42900000;19800000;194600000;;266000000;1165700000;;819900000;1985600000;2251600000;255500000;30800000;286300000;826300000;1288100000;1574400000;321600000;;380500000;677200000;2251600000
MATX;885542;USD;2016;Q4;2016-12-31;2017-02-24;43100000;43600000;13900000;189500000;;274200000;949200000;;792100000;1741300000;2015500000;245800000;31800000;277600000;707100000;1243000000;1520600000;321900000;;196600000;494900000;2015500000
MATX;885542;USD;2015;Q4;2015-12-31;2016-02-26;43600000;44100000;25500000;192800000;;277900000;860300000;;531600000;1391900000;1669800000;275600000;22000000;297600000;407900000;921600000;1219200000;320500000;;177000000;450600000;1669800000
MATX;885542;USD;2014;Q4;2014-12-31;2015-02-27;43100000;43700000;293400000;197600000;;519500000;691200000;;191100000;882300000;1401800000;177400000;21600000;223500000;352000000;814500000;1038000000;307300000;;109800000;363800000;1401800000
MATX;885542;USD;2013;Q4;2013-12-31;2014-02-28;42700000;43100000;114500000;182300000;;348900000;735400000;;164000000;899400000;1248300000;173000000;12500000;200600000;273600000;709500000;910100000;294000000;;67700000;338200000;1248300000
MATX;885542;USD;2012;Q4;2012-12-31;2013-03-01;42500000;42900000;19900000;174700000;;234100000;762500000;;177700000;940200000;1174300000;165800000;16400000;193400000;302700000;701000000;894400000;284600000;;40800000;279900000;1174300000
MATX;885542;USD;2011;Q4;2011-12-31;2012-02-28;-3548250;-3473900;9800000;167700000;4200000;275000000;800500000;;1468800000;2269300000;2544300000;160300000;17500000;278700000;180100000;1143100000;1421800000;272300000;-10900000;953000000;1122500000;2544300000
MATX;885542;USD;2010;Q4;2010-12-31;2011-02-25;-92967800;-93019100;14000000;165000000;43000000;264000000;1651000000;122000000;458000000;2231000000;2495000000;207000000;136000000;353000000;386000000;1006000000;1359000000;257000000;-11000000;972000000;1136000000;2495000000
MATX;885542;USD;2009;Q4;2009-12-31;2010-11-05;85505500;86339700;16000000;172000000;79000000;307000000;1536000000;88000000;449000000;2073000000;2380000000;223000000;65000000;297000000;406000000;998000000;1295000000;243000000;-11000000;934000000;1085000000;2380000000
BKI;889703;USD;2018;Q4;2018-12-31;2019-02-22;147300000;148100000;;172300000;;266100000;177100000;;3210200000;3387300000;3653400000;133600000;52500000;239000000;1284200000;1627900000;1866900000;1585800000;-180700000;381100000;1786500000;3653400000
BKI;889703;USD;2017;Q4;2017-12-31;2018-02-23;151600000;235200000;;201800000;;280700000;179900000;;3195300000;3375200000;3655900000;116900000;55100000;231600000;1379000000;1715500000;1947100000;1593600000;-90100000;201400000;1708800000;3655900000
BKI;889703;USD;2016;Q4;2016-12-31;2017-02-24;-103600000;-101600000;;155800000;;339200000;173000000;;3249800000;3422800000;3762000000;116300000;63400000;227100000;1506800000;1595500000;1822600000;810800000;0;65700000;1939400000;3762000000
BKI;889703;USD;2015;Q4;2015-12-31;2016-02-26;;;;138700000;;360500000;152000000;;3191200000;3343200000;3703700000;94300000;43500000;178200000;1618000000;1680500000;1858700000;798900000;;19900000;1845000000;3703700000
BKI;889703;USD;2014;Q4;2014-12-31;2015-08-04;;;;132500000;;230900000;142400000;;3225000000;3367400000;3598300000;98600000;64400000;202800000;2070700000;2107800000;2310600000;1063800000;;-146700000;1287700000;3598300000
CMPR;889944;USD;2018;Q4;2018-06-30;2018-08-10;30821952;33506402;44227000;55621000;60602000;239296000;483664000;;929257000;1412921000;1652217000;339097000;59259000;481024000;870328000;991095000;1472119000;396297000;-685577000;452756000;180098000;1652217000
CMPR;889944;USD;2017;Q4;2017-06-30;2017-08-11;31200756;29878099;25697000;48630000;46563000;246001000;511947000;;921921000;1433868000;1679869000;302953000;28926000;449483000;954336000;1109762000;1559245000;361991000;-588365000;414771000;120624000;1679869000
CMPR;889944;USD;2016;Q4;2016-06-30;2016-08-12;31426501;34361280;85319000;32327000;18125000;200768000;493163000;;769938000;1263101000;1463869000;265669000;21717000;335863000;767026000;896629000;1232492000;335807000;-548549000;486482000;231377000;1463869000
CMPR;889944;USD;2015;Q4;2015-06-30;2015-08-14;32962260;34349893;110494000;32145000;18356000;216098000;467511000;;616186000;1083697000;1299795000;238701000;21057000;305678000;586880000;686960000;992638000;324896000;-412132000;435052000;307157000;1299795000
CMPR;889944;USD;2019;Q4;2019-06-30;2019-08-09;30635385;32431913;35279000;60646000;66310000;240300000;490755000;;1137321000;1628076000;1868376000;379811000;81277000;520749000;1054386000;1152633000;1673382000;411694000;-737447000;537422000;194994000;1868376000
TEUM;890308;USD;2018;Q4;2018-12-31;2019-03-18;95468455;84075599;6051709;15361594;;23927908;4553250;0;132560008;137113258;161041166;18290009;788187;20005976;212703;8970526;28976502;450990828;;-312625383;132064665;161041167
TEUM;890308;USD;2017;Q4;2017-12-31;2018-03-30;28815127;28815127;13537899;2058284;;16696328;4713710;3230208;685787;8629705;25326033;7228856;66000;7537842;2366658;2366658;9904500;321271437;;-299543213;15421533;25326033
TEUM;890308;USD;2016;Q4;2016-12-31;2017-03-29;7267150;7267149;931189;614670;;3194871;8708778;0;1141640;9850418;13045289;8330388;10813;9292992;8995519;13116828;22409820;280653362;;-287080234;-9364531;13045289
TEUM;890308;USD;2015;Q4;2015-12-31;2016-03-30;6456288;6394234;369250;1112032;;4016094;13051375;;8324917;21376292;25392386;7671575;310403;9241523;1450358;8097322;17338845;269470165;;-255635531;8053541;25392386
TEUM;890308;USD;2014;Q4;2014-12-31;2015-04-03;6123906;6123906;1904160;8877213;;15572989;17351626;;11313505;28665131;44238120;5917666;3226685;17957736;2715332;15667817;33625553;264359674;;-250629296;10612567;44238120
CVCO;890460;USD;2017;Q4;2018-03-31;2018-05-30;9039815;9247536;198632000;35043000;109152000;418593000;63355000;33573000;159259000;256187000;674780000;150285000;26044000;176329000;33768000;41345000;217674000;246287000;;209381000;457106000;674780000
CVCO;890460;USD;2016;Q4;2017-03-31;2017-06-13;8994232;9134535;143831000;29448000;93855000;356764000;56964000;30256000;163332000;250552000;607316000;133799000;6417000;140216000;51574000;72692000;212908000;244881000;;148141000;394408000;607316000
CVCO;890460;USD;2015;Q4;2016-03-31;2016-06-21;8913459;9067575;107906000;29113000;94813000;298719000;55072000;28948000;171096000;255116000;553835000;118827000;6262000;125089000;54909000;75520000;200609000;241751000;;110186000;353226000;553835000
CVCO;890460;USD;2014;Q4;2015-03-31;2015-06-10;8858970;9019712;103703000;26994000;75334000;265464000;44712000;24813000;167593000;237118000;502582000;94881000;6590000;101471000;60370000;80957000;182428000;238005000;;81645000;320154000;502582000
CVCO;890460;USD;2013;Q4;2014-03-31;2014-06-11;8821394;8928164;81238000;20766000;69729000;227846000;48227000;17165000;176001000;241393000;469239000;88806000;10187000;98993000;59865000;79813000;178806000;232169000;;57828000;290433000;469239000
CVCO;890460;USD;2012;Q4;2013-03-31;2013-06-11;6967240;7033957;54752000;18710000;68805000;194382000;46223000;10769000;193125000;250117000;444499000;76836000;10169000;87005000;72118000;88610000;175615000;135123000;;41590000;268884000;444499000
CVCO;890460;USD;2011;Q4;2012-03-31;2012-06-12;6890785;7012163;46471000;14871000;62246000;171014000;50064000;8825000;207431000;266320000;437334000;70227000;10728000;85505000;80747000;96945000;182450000;131658000;;36627000;254884000;437334000
CVCO;890460;USD;2010;Q4;2011-03-31;2011-08-09;-6528383799;-6739416090;76513000;6571000;16036000;147108000;35993000;0;86618000;122611000;269719000;29740000;0;65740000;0;17491000;83231000;129279000;;21390000;186488000;269719000
CVCO;890460;USD;2018;Q4;2019-03-31;2019-05-29;9097261;9233492;199990000;40701000;116203000;462049000;63484000;32137000;167546000;263167000;725216000;154486000;19522000;174008000;14618000;21620000;195628000;249538000;;280078000;529588000;725216000
CLDR;890662;USD;2016;Q4;2017-01-31;2017-06-09;36848463;36848463;234956000;101549000;;349702000;13104000;20710000;59028000;92842000;442544000;46844000;;239086000;;29527000;268613000;192797000;;-675997000;173931000;442544000
UFS;890747;USD;2016;Q4;2016-12-31;2017-02-24;62500000;62600000;125000000;613000000;759000000;1568000000;2825000000;;1287000000;4112000000;5680000000;678000000;75000000;753000000;1218000000;2251000000;3004000000;1964000000;;1211000000;2676000000;5680000000
VKTX;890836;USD;2018;Q4;2018-12-31;2019-03-13;71673177;71016461;301520000;;;302133000;;;179000;179000;302312000;4550000;;4550000;;12000;4562000;401091000;;-102918000;297750000;302312000
VKTX;890836;USD;2017;Q4;2017-12-31;2018-03-07;29970471;29970471;20575000;;;21851000;;;270000;270000;22121000;3808000;3451000;8657000;;0;8657000;94339000;;-80855000;13464000;22121000
VKTX;890836;USD;2016;Q4;2016-12-31;2017-03-21;20000045;20000045;13150560;;;13974829;;;560879;560879;14535708;2475904;3269582;6476534;;16307;6492841;68327026;;-60277267;8042867;14535708
VKTX;890836;USD;2015;Q4;2015-12-31;2016-03-08;5070526;5070526;14104049;;;15201648;;;237455;237455;15439103;2160423;;2160423;2151540;4553682;6714105;54277813;;-45545445;8724998;15439103
VKTX;890836;USD;2014;Q4;2014-12-31;2015-06-12;5251131;5251131;755857;;;773684;;;2269450;2269450;3043134;22154066;304274;22517082;1264114;2654583;25171665;12926;;-22141457;-22128531;3043134
SMA;893218;USD;2013;Q4;2014-01-31;2014-03-10;36374000;35845000;7362000;51813000;58879000;134177000;89993000;;291666000;381659000;515836000;45684000;6996000;52963000;166424000;178076000;231039000;289261000;;-9531000;284797000;515836000
SMA;893218;USD;2012;Q4;2013-01-31;2013-03-08;107832192;109087431;9815000;62593000;64437000;154014000;98046000;;353258000;451304000;605318000;47245000;11603000;59361000;201530000;231227000;290588000;287457000;;26267000;314730000;605318000
SMA;893218;USD;2011;Q4;2012-01-31;2012-03-15;106704914;108020989;18931000;51835000;84678000;172932000;103363000;;362570000;465933000;638865000;37327000;12954000;50320000;261224000;287146000;337466000;283075000;;17140000;301399000;638865000
SMA;893218;USD;2010;Q4;2011-01-31;2011-08-09;-106205196;-107262760;15067000;50457000;70373000;145686000;107879000;;196389000;304268000;449954000;34019000;5543000;39562000;89767000;114023000;153585000;279596000;;14248000;296369000;449954000
TVTY;895523;USD;2018;Q4;2018-12-31;2019-02-26;40620000;42592000;1933000;67139000;;78105000;16341000;;387633000;403974000;482079000;78760000;57000;81072000;30589000;32006000;113078000;347528000;-28182000;49655000;369001000;482079000
TVTY;895523;USD;2017;Q4;2017-12-31;2018-02-28;39670000;43751000;28440000;55113000;;223295000;10658000;;402210000;412868000;636163000;76333000;145959000;358633000;;5577000;364210000;349283000;-28182000;-49148000;271953000;636163000
TVTY;895523;USD;2016;Q4;2016-12-31;2017-03-06;38678000;39791000;1602000;50424000;;58111000;8331000;;478340000;486671000;544782000;78338000;46046000;132363000;164297000;223121000;355484000;341309000;-28182000;-119327000;189298000;544782000
TVTY;895523;USD;2015;Q4;2015-12-31;2016-03-04;36060000;38426000;233000;50608000;;134787000;9596000;;568541000;578137000;712924000;56808000;23308000;162190000;208289000;270144000;432334000;303723000;-28182000;9288000;280590000;712924000
TVTY;895523;USD;2014;Q4;2014-12-31;2015-03-13;35421000;38471000;1765000;126559000;;162701000;165696000;;483511000;649207000;811908000;124076000;20613000;170330000;231112000;336988000;507318000;292381000;-28182000;42439000;304590000;811908000
TVTY;895523;USD;2013;Q4;2013-12-31;2014-03-14;35068000;33916000;2584000;89484000;;119222000;158198000;;471591000;629789000;749011000;85347000;14340000;124416000;237582000;321905000;446321000;283279000;-28182000;48000000;302690000;749011000
TVTY;895523;USD;2012;Q4;2012-12-31;2013-03-15;33935000;34405000;1759000;108337000;;141809000;156494000;;449965000;606459000;748268000;90486000;11801000;128258000;278534000;341189000;469447000;251391000;-28182000;56541000;278821000;748268000
TVTY;895523;USD;2011;Q4;2011-12-31;2012-03-14;67198025;65705310;864000;97459000;;127531000;142188000;;439186000;581374000;708905000;86834000;3725000;118757000;266117000;324432000;443189000;247170000;-28182000;48517000;265716000;708905000
TVTY;895523;USD;2010;Q4;2010-12-31;2011-08-08;136413691;139503183;1064000;89108000;;125780000;130656000;;605253000;735909000;861689000;93244000;3935000;125233000;243425000;305615000;430848000;232558000;-4494000;206210000;430841000;861689000
STLR;895647;USD;2018;Q4;2018-12-31;2019-03-06;;;844000;3606000;;4722000;66000;;32093000;32159000;36881000;15352000;;19974000;;5703000;25677000;118065000;;-111820000;11204000;36881000
STLR;895647;USD;2017;Q4;2017-12-31;2018-02-12;;;308000;6206000;;6899000;128000;;26974000;27102000;34001000;14160000;;15204000;;10893000;26097000;110268000;;-102017000;7904000;34001000
KTOS;895821;USD;2018;Q4;2018-12-31;2019-02-28;103900000;108600000;182700000;64600000;46800000;494700000;67100000;;448300000;515400000;1010100000;119800000;;164700000;294200000;326100000;490800000;1244500000;;-724500000;519300000;1010100000
KTOS;895821;USD;2017;Q4;2017-12-31;2018-02-28;103600000;103600000;130500000;74200000;49000000;471400000;58000000;;494600000;552600000;1024000000;107500000;;188900000;293500000;323600000;512500000;1233700000;;-720800000;511500000;1024000000
KTOS;895821;USD;2016;Q4;2016-12-31;2017-02-27;65300000;65300000;69100000;229400000;55400000;373100000;49800000;;525700000;575500000;948600000;145400000;1000000;196500000;431000000;475700000;672200000;956200000;;-678100000;276400000;948600000
KTOS;895821;USD;2015;Q4;2015-12-31;2016-03-11;59100000;58100000;28500000;206800000;55600000;320400000;56200000;;526700000;582900000;903300000;122100000;1000000;172400000;444100000;476700000;649100000;873200000;;-617600000;254200000;903300000
KTOS;895821;USD;2014;Q4;2014-12-31;2015-03-13;57800000;57800000;33500000;217500000;47400000;373200000;61600000;;696400000;758000000;1131200000;123700000;1100000;226100000;655400000;680800000;906900000;863400000;;-637400000;224300000;1131200000
KTOS;895821;USD;2013;Q4;2013-12-31;2014-03-12;56900000;56900000;55700000;265800000;74600000;430300000;84800000;;701500000;786300000;1216600000;158200000;1300000;251000000;643400000;669800000;920800000;856000000;;-559400000;295800000;1216600000
KTOS;895821;USD;2012;Q4;2012-12-31;2013-03-12;56800000;56800000;49000000;271900000;94300000;455400000;85600000;;742900000;828500000;1283900000;184100000;1500000;278800000;648800000;681000000;959800000;847100000;;-522200000;324100000;1283900000
KTOS;895821;USD;2011;Q4;2011-12-31;2012-03-07;33700000;33700000;69600000;245300000;76600000;421000000;72500000;;722500000;795000000;1216000000;144400000;1600000;213800000;654300000;689600000;903400000;720600000;;-407800000;312600000;1216000000
KTOS;895821;USD;2010;Q4;2010-12-31;2011-08-04;18000000;18400000;10800000;125800000;25900000;183600000;28400000;;323700000;352100000;535700000;86700000;600000;118100000;226100000;247700000;365800000;553500000;;-383600000;169900000;535700000
AVGR;896087;USD;2018;Q4;2018-12-31;2019-03-06;2280700;2280700;16410000;1154000;3422000;21621000;2078000;;0;2078000;23699000;6712000;7486000;14198000;;41000;14239000;338345000;;-328885000;9460000;23699000
AVGR;896087;USD;2017;Q4;2017-12-31;2018-03-30;80700;80700;5389000;1127000;4295000;11451000;2950000;;687000;3637000;15088000;5733000;44744000;50477000;;301000;50778000;265637000;;-301327000;-35690000;15088000
AVGR;896087;USD;2016;Q4;2016-12-31;2017-03-15;57858;57858;36096000;3570000;8462000;48790000;4555000;;212000;4767000;53557000;7481000;41289000;48770000;;546000;49316000;256630000;;-252389000;4241000;53557000
AVGR;896087;USD;2015;Q4;2015-12-31;2016-03-08;31388;31388;43059000;2060000;5405000;51057000;2822000;;225000;3047000;54104000;7481000;;7481000;29565000;31034000;38515000;211850000;;-196261000;15589000;54104000
CBLK;896985;USD;2018;Q4;2018-12-31;2019-03-08;69630661;69630661;160638000;62555000;;245022000;14370000;;148345000;162715000;407737000;25332000;;179070000;;43113000;222183000;723121000;-6000;-537512000;185554000;407737000
CBLK;896985;USD;2017;Q4;2017-12-31;2018-06-07;10648981;10648981;36073000;60850000;;112514000;12459000;;146588000;159047000;271561000;21327000;;152436000;2766000;44490000;196926000;13440000;-6000;-273513000;74635000;271561000
CNSL;897291;USD;2015;Q4;2015-12-31;2016-02-29;50207000;50207000;15878000;68848000;;126408000;1093261000;105543000;813314000;2012118000;2138526000;105747000;10937000;144300000;1377892000;1743527000;1887827000;282243000;;-881000;250699000;2138526000
CNSL;897291;USD;2014;Q4;2014-12-31;2015-03-02;48361000;48361000;6679000;77536000;;134145000;1137478000;115376000;824844000;2077698000;2211843000;114293000;9849000;156075000;1341332000;1724939000;1881014000;357643000;;;330829000;2211843000
CNSL;897291;USD;2013;Q4;2013-12-31;2014-03-05;39791000;39791000;5551000;52033000;;87720000;885362000;113099000;661197000;1659658000;1747378000;81354000;9751000;117699000;1212134000;1477340000;1595039000;148834000;;;152339000;1747378000
CNSL;897291;USD;2012;Q4;2012-12-31;2013-03-12;39791000;39791000;17854000;57957000;;109289000;907672000;109750000;666776000;1684198000;1793487000;99554000;9596000;144177000;1208248000;1513205000;1657382000;177714000;;;136105000;1793487000
CNSL;897291;USD;2011;Q4;2011-12-31;2012-03-05;29621000;29621000;105704000;35492000;;161950000;338426000;98069000;595624000;1032119000;1194069000;52394000;8992000;85290000;875719000;1060967000;1146257000;80151000;;;47812000;1194069000
CNSL;897291;USD;2010;Q4;2010-12-31;2011-08-04;;;67654000;42012000;7972000;136250000;356057000;99105000;618134000;1073296000;1209546000;44151000;132000;75592000;883993000;1062079000;1137671000;98424000;;;71875000;1209546000
ECA;897579;USD;2018;Q4;2018-12-31;2019-02-28;952600000;952600000;1058000000;;;2676000000;8972000000;;3696000000;12668000000;15344000000;1491000000;500000000;2016000000;3698000000;5881000000;7897000000;6014000000;;435000000;7447000000;15344000000
ECA;897579;USD;2017;Q4;2017-12-31;2018-02-26;973300000;973300000;719000000;;;2271000000;8954000000;;4042000000;12996000000;15267000000;1422000000;0;1658000000;4197000000;6881000000;8539000000;6115000000;;-429000000;6728000000;15267000000
ECA;897579;USD;2016;Q4;2016-12-31;2017-02-27;972300000;972300000;834000000;;;1923000000;8139000000;;4591000000;12730000000;14653000000;1308000000;;1562000000;4198000000;6965000000;8527000000;6114000000;;-1198000000;6126000000;14653000000
UPWK;898008;USD;2018;Q4;2018-12-31;2019-03-07;103922322;103922322;129128000;22315000;;255882000;10815000;;124876000;135691000;391573000;121207000;5671000;127600000;18239000;20228000;147828000;387244000;;-143499000;243745000;391573000
UPWK;898008;USD;2017;Q4;2017-12-31;2018-11-08;33497839;33497839;21595000;30762000;;144126000;3514000;;127549000;131063000;275189000;103687000;10342000;114643000;23491000;25427000;140070000;92225000;;-123592000;135119000;275189000
MSA;898420;USD;2018;Q4;2018-12-31;2019-02-22;38488000;39127000;195201000;245032000;156602000;656623000;157940000;;793449000;951389000;1608012000;129753000;20063000;282060000;341311000;686433000;968493000;211806000;-298143000;935577000;639519000;1608012000
MSA;898420;USD;2017;Q4;2017-12-31;2018-02-22;38083000;38713000;134244000;244198000;153739000;622297000;157014000;;905515000;1062529000;1684826000;126438000;26680000;289279000;447832000;792969000;1082248000;194953000;-297834000;868675000;602578000;1684826000
MSA;898420;USD;2016;Q4;2016-12-31;2017-02-28;37596000;38213000;113759000;209514000;103066000;472806000;148678000;;732436000;881114000;1353920000;106503000;26666000;221410000;363836000;571298000;792708000;172681000;-289254000;901415000;561212000;1353920000
MSA;898420;USD;2015;Q4;2015-12-31;2016-02-29;37213000;37456000;105925000;232862000;125849000;504612000;155839000;;762412000;918251000;1422863000;117506000;6650000;251887000;458022000;653848000;905735000;157643000;-295070000;858553000;517128000;1422863000
PCMI;898543;USD;2018;Q4;2018-12-31;2019-03-14;12164000;12541000;6032000;463487000;61617000;539671000;69286000;15181000;96812000;181279000;720950000;420425000;3283000;520073000;29507000;47984000;568057000;138721000;-38536000;54021000;152893000;720950000
PCMI;898543;USD;2017;Q4;2017-12-31;2018-03-15;11898000;13190000;9113000;439658000;103471000;561575000;71551000;6509000;100617000;178677000;740252000;344241000;3362000;569294000;32892000;43332000;612626000;134663000;-38536000;31248000;127626000;740252000
PCMI;898543;USD;2016;Q4;2016-12-31;2017-03-16;12080000;13137000;7172000;358949000;80872000;469055000;56352000;4994000;99409000;160755000;629810000;339927000;11168000;474052000;18750000;27287000;501339000;127793000;-26934000;28251000;128471000;629810000
PCMI;898543;USD;2015;Q4;2015-12-31;2016-03-15;11884000;11325000;11176000;341018000;55386000;435697000;56774000;5404000;102298000;164476000;600173000;253104000;12912000;444862000;21454000;45796000;490658000;122948000;-23326000;10658000;109515000;600173000
PCMI;898543;USD;2014;Q4;2014-12-31;2015-03-16;37047290;38783101;8892000;199604000;50687000;279067000;74368000;5558000;30197000;110123000;389190000;148440000;3741000;215642000;22415000;40232000;255874000;120931000;-17472000;28916000;133316000;389190000
PCMI;898543;USD;2013;Q4;2013-12-31;2014-03-14;11772000;12189000;9992000;195749000;111444000;340507000;55793000;6804000;31718000;94315000;434822000;161106000;1167000;282912000;18247000;26148000;309060000;115816000;-15321000;23451000;125762000;434822000
PCMI;898543;USD;2012;Q4;2012-12-31;2013-03-18;11884000;12296000;6535000;190079000;68942000;282588000;48180000;1979000;32988000;83147000;365735000;133343000;812000;227196000;16750000;22428000;249624000;111966000;-13688000;15322000;116111000;365735000
PCMI;898543;USD;2011;Q4;2011-12-31;2012-03-15;12014000;12105000;9484000;207985000;79456000;310543000;44745000;2387000;35597000;82729000;393272000;154320000;1015000;265266000;11574000;17180000;282446000;108075000;-9733000;10228000;110826000;393272000
PCMI;898543;USD;2010;Q4;2010-12-31;2011-08-15;12136000;12405000;10711000;183944000;63583000;272058000;21851000;2319000;37863000;62033000;334091000;156130000;783000;219420000;4607000;7378000;226798000;104908000;-7176000;7096000;107293000;334091000
LGND;898544;USD;2018;Q4;2018-12-31;2019-02-28;21618000;26482000;718381000;55850000;7124000;870540000;36832000;0;353431000;390263000;1260803000;23383000;26433000;82249000;609864000;617640000;699889000;791135000;;-229197000;560914000;1260803000
LGND;898544;USD;2017;Q4;2017-12-31;2018-03-01;20559000;20634000;201661000;25596000;4373000;237021000;23738000;6438000;403824000;434000000;671021000;9636000;224529000;238868000;18859000;32365000;271233000;798226000;;-400924000;399788000;671021000
ALSK;899013;USD;2018;Q4;2018-12-31;2019-03-11;53192000;53499000;13485000;31472000;6737000;65497000;373180000;;16508000;389688000;455185000;40957000;2289000;47270000;168023000;238165000;285435000;161047000;;10439000;169750000;455185000
ALSK;899013;USD;2017;Q4;2017-12-31;2018-03-16;52142000;50782000;4354000;32535000;7046000;61864000;366113000;;14809000;380922000;442786000;36148000;17030000;57391000;168959000;230885000;288276000;159494000;;-3579000;154510000;442786000
ALSK;899013;USD;2016;Q4;2016-12-31;2017-03-16;51363000;52523000;21228000;25062000;4917000;59119000;366849000;;16392000;383241000;442360000;38180000;1973000;44320000;177626000;239164000;283484000;159989000;;752000;158876000;442360000
ALSK;899013;USD;2015;Q4;2015-12-31;2016-03-28;50421000;52937000;36001000;25225000;4674000;75792000;369322000;;18487000;387809000;463601000;51275000;3671000;59459000;185018000;250283000;309742000;157476000;;-1634000;153859000;463601000
ALSK;899013;USD;2014;Q4;2014-12-31;2015-03-16;49548000;48358000;31709000;30900000;4321000;83537000;356733000;252067000;37943000;646743000;730280000;54373000;15521000;97965000;413978000;497189000;595154000;154865000;;-14588000;135126000;730280000
ALSK;899013;USD;2013;Q4;2013-12-31;2014-03-27;48604000;71959000;43039000;34066000;10131000;102147000;352013000;266972000;26188000;645173000;747320000;55475000;14256000;93144000;442001000;518913000;612057000;152680000;;-11808000;135263000;747320000
ALSK;899013;USD;2012;Q4;2012-12-31;2013-03-01;45679000;32946000;18889000;39698000;9409000;85753000;410861000;2028000;116085000;528974000;614727000;56378000;21628000;86976000;533772000;562434000;649410000;144835000;;-170279000;-34683000;614727000
ALSK;899013;USD;2011;Q4;2011-12-31;2012-03-02;45233000;45191000;20490000;36986000;5412000;79360000;405237000;2060000;118451000;525748000;605108000;48919000;30930000;89067000;538624000;566964000;656031000;145084000;;-187688000;-50923000;605108000
ALSK;899013;USD;2010;Q4;2010-12-31;2011-08-01;;;15316000;36985000;6533000;78694000;410982000;2415000;128524000;541921000;620615000;62539000;5213000;77320000;548096000;563784000;641104000;166706000;;-188160000;-20489000;620615000
CMCO;899253;USD;2017;Q4;2018-03-31;2017-08-01;23031000;24163000;63021000;127806000;152886000;360295000;113079000;7673000;661399000;782151000;1142446000;146933000;60064000;206997000;303254000;527220000;734217000;269590000;;197897000;408229000;1142446000
CMCO;899253;USD;2016;Q4;2017-03-31;2017-05-31;21788000;22428000;77591000;111569000;130643000;340950000;113028000;7686000;652179000;772893000;1113843000;138391000;52568000;190959000;368751000;581534000;772493000;259079000;;179735000;341350000;1113843000
CMCO;899253;USD;2015;Q4;2016-03-31;2016-06-01;20104000;20650000;51603000;83812000;118049000;272729000;104790000;18186000;377146000;500122000;772851000;89271000;43246000;132517000;224386000;354025000;486542000;206883000;;174173000;286309000;772851000
CMCO;899253;USD;2014;Q4;2015-03-31;2015-05-28;19982000;20382000;63056000;80531000;103187000;274029000;91127000;19867000;181301000;292295000;566324000;83669000;13292000;96961000;113420000;200644000;297605000;203356000;;157811000;268719000;566324000
CMCO;899253;USD;2013;Q4;2014-03-31;2014-05-29;19754000;20043000;112309000;93223000;97576000;326552000;78687000;21941000;171494000;272122000;598674000;87707000;1588000;89295000;150705000;218093000;307388000;198744000;;133820000;291286000;598674000
CMCO;899253;USD;2012;Q4;2013-03-31;2013-05-29;58210234;59011912;121660000;80224000;94189000;313978000;65698000;23951000;163240000;252889000;566867000;83213000;1024000;84237000;151053000;242643000;326880000;192503000;;104191000;239987000;566867000
CMCO;899253;USD;2011;Q4;2012-03-31;2012-05-30;38481827;39069476;89473000;88642000;108055000;296619000;61709000;25393000;131686000;218788000;515407000;102704000;1205000;103909000;151889000;251032000;354941000;189453000;;25895000;160466000;515407000
CMCO;899253;USD;2010;Q4;2011-03-31;2011-07-27;76130853;76130673;80139000;77744000;90031000;262208000;59360000;24592000;132712000;216664000;478872000;93629000;1589000;95265000;152816000;221461000;316726000;185075000;;-1072000;162146000;478872000
CMCO;899253;USD;2018;Q4;2019-03-31;2019-05-29;23369000;23961000;71093000;129157000;146263000;362588000;87303000;7028000;604652000;698983000;1061571000;146278000;65000000;211278000;235320000;419134000;630412000;277752000;;236459000;431159000;1061571000
EGP;899359;USD;2018;Q4;2018-12-31;2019-02-14;36155000;36231000;374000;;;374000;2002230000;7870000;121231000;2131331000;2131705000;86563000;188461000;309676000;917326000;917326000;1227002000;1222551000;;;904703000;2131705000
EGP;899359;USD;2017;Q4;2017-12-31;2018-02-14;34421000;34449000;16000;;;16000;1829147000;8029000;116029000;1953205000;1953221000;64967000;199512000;293321000;908770000;908770000;1202091000;1061156000;;;751130000;1953221000
EGP;899359;USD;2016;Q4;2016-12-31;2017-02-15;32881000;32942000;522000;;;522000;1712731000;7681000;104830000;1825242000;1825764000;52701000;257505000;340070000;843828000;843828000;1183898000;949321000;;;641866000;1825764000
EGP;899359;USD;2015;Q4;2015-12-31;2016-02-17;32161000;32288000;48000;;;48000;1561994000;8004000;91858000;1661856000;1661904000;44181000;350285000;425079000;677624000;677624000;1102703000;887210000;;;559201000;1661904000
EGP;899359;USD;2014;Q4;2014-12-31;2015-02-17;31906000;32034000;11000;;;11000;1474420000;7884000;93509000;1575813000;1575824000;39439000;453776000;520808000;479401000;479401000;1000209000;874338000;;;575615000;1575824000
EGP;899359;USD;2013;Q4;2013-12-31;2014-02-14;30567000;30690000;8000;;;8000;1377213000;2764000;93427000;1473404000;1473412000;37104000;499793000;560755000;393952000;393952000;954707000;790538000;;;518705000;1473412000
EGP;899359;USD;2012;Q4;2012-12-31;2013-02-19;29503000;29619000;1258000;;;1258000;1271785000;2743000;78316000;1352844000;1354102000;28914000;607766000;656766000;206160000;206160000;862926000;731953000;;;491176000;1354102000
CYCC;899362;USD;2018;Q4;2018-12-31;2019-03-28;12384183;12384183;17504000;;;19787000;36000;;;36000;19823000;4451000;;4451000;;100000;4551000;365829000;;-349797000;15272000;19823000
CYCC;899362;USD;2017;Q4;2017-12-31;2018-03-30;11983402;11983402;23910000;;;25974000;29000;;;29000;26003000;4113000;;4113000;;124000;4237000;365069000;;-342509000;21766000;26003000
CYCC;899362;USD;2016;Q4;2016-12-31;2017-03-31;4260808;4260808;16520000;;;19617000;45000;;;45000;19662000;5259000;;5259000;;130000;5389000;350055000;;-335039000;14273000;19662000
CYCC;899362;USD;2015;Q4;2015-12-31;2016-03-29;2925396;2925396;20440000;;;24566000;198000;;;198000;24764000;5753000;;5753000;;176000;5929000;342590000;;-323159000;18835000;24764000
CYCC;899362;USD;2014;Q4;2014-12-31;2015-03-31;1918603;1918603;24189000;;;29000000;387000;;0;387000;29387000;7418000;;7418000;;281000;7699000;330985000;;-308817000;21688000;29387000
CYCC;899362;USD;2013;Q4;2013-12-31;2014-03-26;1596729;1589408;31146000;;;35173000;275000;;72000;347000;35520000;6976000;;6976000;;521000;7497000;317562000;;-289430000;28023000;35520000
CYCC;899362;USD;2012;Q4;2012-12-31;2013-04-01;706942;;16412000;;;18872000;129000;;353000;482000;19354000;7860000;;8980000;;355000;9335000;280220000;;-270250000;10019000;19354000
CYCC;899362;USD;2011;Q4;2011-12-31;2012-03-30;646287;;24449000;;;25831000;167000;;;167000;25998000;5900000;;5900000;;598000;6498000;276506000;;-257064000;19500000;25998000
CYCC;899362;USD;2010;Q4;2010-12-31;2011-08-12;547050;;29495000;;174000;31051000;408000;;;408000;31459000;5855000;;6535000;;0;6535000;266713000;;-241821000;24924000;31459000
LSI;901127;USD;2018;Q4;2018-12-31;2019-02-26;46544239;46647008;13560000;7805000;;22371000;3694258000;;175583000;3869841000;3892212000;87446000;12302000;108939000;1701820000;1701820000;1810759000;2372623000;;;2081453000;3892212000
LSI;901127;USD;2017;Q4;2017-12-31;2018-02-27;46406760;46543118;9167000;7331000;;17895000;3697096000;;161783000;3858879000;3876774000;92941000;12674000;114989000;1714089000;1714089000;1829078000;2363637000;;;2047696000;3876774000
LSI;901127;USD;2016;Q4;2016-12-31;2017-02-27;46205715;46598395;23685000;5469000;;30377000;3707604000;;120003000;3827607000;3857984000;75132000;13027000;110874000;1640525000;1640525000;1751399000;2349031000;;;2106585000;3857984000
LSI;901127;USD;2015;Q4;2015-12-31;2016-02-25;36108163;36329004;7020000;6805000;;14754000;2026507000;;77561000;2104068000;2118822000;47839000;1993000;72686000;825650000;825650000;898336000;1388710000;;;1220486000;2118822000
LSI;901127;USD;2014;Q4;2014-12-31;2015-02-24;33657507;33847215;8543000;5758000;;14884000;1766282000;;73634000;1839916000;1854800000;43551000;2127000;66309000;799000000;799000000;865309000;1156566000;;;989491000;1854800000
LSI;901127;USD;2013;Q4;2013-12-31;2014-02-27;31954271;32106854;9524000;5119000;;15526000;1498165000;;48184000;1546349000;1561875000;37741000;2254000;54226000;624000000;624000000;678226000;1066736000;-27175000;;883649000;1561875000
LSI;901127;USD;2012;Q4;2012-12-31;2013-02-27;30288007;30452957;7255000;3437000;;11548000;1417391000;;55371000;1472762000;1484310000;36564000;4251000;62910000;680000000;680000000;742910000;943920000;-27175000;;741400000;1484310000
LSI;901127;USD;2011;Q4;2011-12-31;2012-02-28;28005392;28077299;7321000;2938000;;10848000;1245873000;;86953000;1332826000;1343674000;31414000;4423000;52669000;621000000;621000000;673669000;862768000;-27175000;;670005000;1343674000
LSI;901127;USD;2010;Q4;2010-12-31;2011-02-25;27493983;27543476;5766000;2377000;;8396000;1148159000;;28986000;1177145000;1185541000;23991000;78954000;118398000;410000000;410000000;528398000;817274000;-27175000;;657143000;1185541000
LSI;901127;USD;2009;Q4;2009-12-31;2010-08-06;27229461;27249607;10710000;2346000;;13229000;1125483000;;46386000;1171869000;1185098000;22316000;81219000;120039000;400000000;400000000;520039000;815275000;-27175000;;665059000;1185098000
FIVN;901361;USD;2018;Q4;2018-12-31;2019-02-25;59548000;59548000;291819000;24797000;;334002000;25885000;;34779000;60664000;394666000;22215000;;47994000;196763000;203924000;251918000;294338000;;-151497000;142748000;394666000
FIVN;901361;USD;2017;Q4;2017-12-31;2018-03-01;56063000;51932000;68947000;19048000;;92835000;19888000;;15473000;35361000;128196000;17230000;336000;39518000;32594000;41840000;81358000;222259000;;-175421000;46838000;128196000
FIVN;901361;USD;2016;Q4;2016-12-31;2017-02-28;53140000;53140000;58122000;13881000;;75011000;14688000;;15540000;30228000;105239000;15712000;742000;34078000;32912000;40833000;74911000;196608000;;-166280000;30328000;105239000
FIVN;901361;USD;2015;Q4;2015-12-31;2016-03-03;50782000;50782000;58484000;10567000;;71235000;13225000;;14773000;27998000;99233000;16164000;7212000;48523000;17327000;24430000;72953000;180700000;;-154420000;26280000;99233000
FIVN;901361;USD;2014;Q4;2014-12-31;2015-03-10;49600000;49600000;78289000;8335000;;88584000;12571000;;15779000;28350000;116934000;18712000;3146000;32350000;35278000;42831000;75181000;170335000;;-128582000;41753000;116934000
FIVN;901361;USD;2013;Q4;2013-12-31;2014-05-14;5025000;5025000;17748000;6970000;;26369000;11607000;;18302000;29909000;56278000;14441000;1522000;25293000;19595000;33953000;59246000;34094000;;-90796000;-2968000;56278000
WDDD;901702;USD;2018;Q4;2018-12-31;2019-02-28;56934767;;3846120;;;3846120;;;;;3846120;3667983;773279;4441262;0;0;4441262;41776244;;-42371386;-595142;3846120
WDDD;901702;USD;2017;Q4;2017-12-31;2018-04-02;49368590;;168229;;;184227;;;;;184227;3636564;773279;4409843;575000;725000;5134843;39175085;;-44125701;-4950616;184227
WDDD;901702;USD;2016;Q4;2016-12-31;2017-04-17;113922624;;93378;;;93378;;;;;93378;4098633;773279;4871912;0;0;4871912;36600199;;-41378732;-4778533;93379
ZYNE;901704;USD;2018;Q4;2018-12-31;2019-03-11;17676012;17676012;59763773;;;66955480;371963;;;371963;67327443;9725782;;9725782;;;9725782;175493702;;-117892041;57601661;67327443
ZYNE;901704;USD;2017;Q4;2017-12-31;2018-03-12;13440595;13440595;62510277;;;68227582;164527;;662200;826727;69054309;7270746;;7442721;;662000;8104721;138930454;;-77980866;60949588;69054309
ZYNE;901704;USD;2016;Q4;2016-12-31;2017-03-27;9683877;9683877;30965791;;;36410692;143382;;200;143582;36554274;6132991;;6966966;;;6966966;75555870;;-45968562;29587308;36554274
ZYNE;901704;USD;2015;Q4;2015-12-31;2016-03-14;8885935;8885935;41513060;;;43415695;227646;;200;227846;43643541;3096392;;3937617;;0;3937617;62285979;;-22580055;39705924;43643541
ZYNE;901704;USD;2014;Q4;2014-12-31;2015-08-27;1473429;1473429;9330681;;;11594829;19642;;2200;21842;11616671;2025410;;3145535;;0;3145535;1977030;;-10028705;8471136;11616671
ZVO;901866;USD;2018;Q4;2018-12-31;2019-03-12;27145000;27751000;168375000;27015000;;232264000;16860000;;20368000;37228000;269492000;62792000;;126626000;8634000;15252000;141878000;205810000;-508188000;429992000;127614000;269492000
ZVO;901866;USD;2017;Q4;2017-12-31;2018-02-21;28091000;28576000;187163000;24174000;;254153000;10434000;;20049000;30483000;284636000;71165000;;141931000;0;19709000;161640000;202404000;-505764000;426356000;122996000;284636000
ZVO;901866;USD;2016;Q4;2016-12-31;2017-03-07;46375000;45663000;357236000;26457000;;431693000;12218000;;19465000;31683000;463376000;77866000;;152532000;;30138000;182670000;196495000;-337069000;421281000;280706000;463376000
ZVO;901866;USD;2015;Q4;2015-12-31;2016-03-08;45804000;45804000;301532000;24091000;;403275000;21742000;47770000;33979000;103491000;506766000;79196000;;167952000;;35164000;203116000;189497000;-337069000;451321000;303650000;506766000
ZVO;901866;USD;2014;Q4;2014-12-31;2015-03-10;45385000;48174000;219054000;21274000;;311384000;78219000;111557000;56935000;246711000;558095000;52416000;;160464000;;31750000;192214000;181350000;-337069000;521775000;365881000;558095000
ZVO;901866;USD;2013;Q4;2013-12-31;2014-03-17;53091000;54882000;278427000;22953000;;377615000;91425000;41062000;59910000;192397000;570012000;59485000;;192276000;;33198000;225474000;169452000;-337069000;512107000;344538000;570012000
ZVO;901866;USD;2012;Q4;2012-12-31;2013-03-12;54065000;55592000;345938000;54487000;;483518000;95966000;121738000;41191000;258895000;742413000;49228000;;224285000;;34932000;259217000;152323000;-135573000;466224000;483196000;742413000
ZVO;901866;USD;2011;Q4;2011-12-31;2012-03-07;51455000;55635000;287700000;62156000;;372509000;89667000;119507000;31953000;241127000;613636000;49166000;;234612000;;25376000;259988000;138037000;-134971000;351177000;353648000;613636000
ZVO;901866;USD;2010;Q4;2010-12-31;2011-08-02;52443000;58023000;279129000;58415000;;357258000;66542000;20000000;27425000;113967000;471225000;39971000;;213547000;;19437000;232984000;102021000;-42193000;178413000;238241000;471225000
SFIX;902273;USD;2018;Q4;2018-08-31;2018-10-03;97966617;102089413;297516000;;85092000;417006000;34169000;0;30410000;64579000;481585000;122819000;;142232000;;24281000;166513000;235312000;;79758000;315070000;481583000
SFIX;902273;USD;2017;Q4;2017-08-31;2017-12-20;25709006;21118382;110608000;;67592000;197762000;26733000;;32710000;59443000;257205000;90601000;;133918000;;19204000;153122000;27002000;;34858000;104082000;257204000
FIVE;902627;USD;2018;Q4;2019-01-31;2019-03-28;55992624;56461228;337160000;;243636000;642257000;301297000;0;8710000;310007000;952264000;253105000;;253105000;;84065000;337170000;353259000;;261835000;615094000;952264000
FIVE;902627;USD;2017;Q4;2018-01-31;2018-03-22;55436344;55813808;244627000;;187037000;479362000;180349000;27702000;8295000;216346000;695708000;164460000;;164460000;;72690000;237150000;346854000;;111704000;458558000;695708000
FIVE;902627;USD;2016;Q4;2017-01-31;2017-03-23;55034264;55302150;153879000;;154448000;339789000;138376000;10514000;11857000;160747000;500536000;116563000;;116563000;;52568000;169131000;322152000;;9253000;331405000;500536000
FIVE;902627;USD;2015;Q4;2016-01-31;2016-03-24;54575194;54836714;99416000;;148370000;264745000;119784000;0;8765000;128549000;393294000;102196000;;102196000;;46617000;148813000;307068000;;-62587000;244481000;393294000
FIVE;902627;USD;2014;Q4;2015-01-31;2015-03-26;54404037;54669484;63186000;;115652000;198957000;86998000;;8165000;95163000;294120000;79401000;;79401000;;40450000;119851000;294536000;;-120267000;174269000;294120000
FIVE;902627;USD;2013;Q4;2014-01-31;2014-03-26;53491825;53961326;50184000;;89377000;160899000;70381000;;774000;71155000;232054000;60242000;19500000;79742000;;35439000;115181000;285164000;;-168291000;116873000;232054000
FIVE;902627;USD;2012;Q4;2013-01-31;2013-03-29;53986529;53592936;56081000;;60831000;129676000;59040000;;944000;59984000;189660000;53784000;15000000;68784000;19500000;50132000;118916000;271177000;;-200433000;70744000;189660000
FIVE;902627;USD;2011;Q4;2012-01-31;2012-09-11;16078280;16080316;41293000;;38790000;92249000;42040000;;238000;42278000;134527000;49942000;0;49942000;250000;22489000;72431000;3853000;;-133612000;62096000;134527000
LDOS;902720;USD;2018;Q4;2019-01-31;2019-02-19;149000000;151000000;327000000;1877000000;;2839000000;237000000;;5694000000;5931000000;8770000000;1964000000;72000000;2059000000;3052000000;3400000000;5459000000;2966000000;;372000000;3311000000;8770000000
LDOS;902720;USD;2017;Q4;2018-01-31;2018-02-23;155000000;156000000;390000000;1831000000;;2674000000;232000000;;6084000000;6316000000;8990000000;2147000000;55000000;2202000000;3056000000;3405000000;5607000000;3344000000;;-7000000;3383000000;8990000000
LDOS;902720;USD;2016;Q4;2017-01-31;2017-02-24;151000000;154000000;376000000;1657000000;;2381000000;259000000;;6492000000;6751000000;9132000000;1954000000;62000000;2016000000;3225000000;3969000000;5985000000;3316000000;;-177000000;3147000000;9132000000
LDOS;902720;USD;2015;Q4;2016-01-31;2016-02-26;74000000;74000000;656000000;921000000;;1793000000;142000000;;1435000000;1577000000;3370000000;1037000000;2000000;1040000000;1079000000;1262000000;2302000000;1353000000;;-277000000;1068000000;3370000000
USM;903238;USD;2018;Q4;2018-12-31;2019-02-22;87000000;89000000;597000000;928000000;142000000;1812000000;2202000000;;3260000000;5462000000;7274000000;382000000;19000000;691000000;1605000000;2505000000;3196000000;1678000000;-65000000;2444000000;4078000000;7274000000
USM;903238;USD;2017;Q4;2017-12-31;2018-02-26;85000000;87000000;402000000;801000000;138000000;1483000000;2320000000;;3038000000;5358000000;6841000000;376000000;18000000;733000000;1622000000;2420000000;3153000000;1640000000;-120000000;2157000000;3688000000;6841000000
USM;903238;USD;2016;Q4;2016-12-31;2017-02-24;86000000;85000000;586000000;674000000;138000000;1558000000;2470000000;;3082000000;5552000000;7110000000;382000000;11000000;718000000;1618000000;2746000000;3464000000;1610000000;-136000000;2160000000;3646000000;7110000000
USM;903238;USD;2015;Q4;2015-12-31;2016-02-24;84000000;85000000;715000000;628000000;149000000;1672000000;2649000000;;2739000000;5388000000;7060000000;343000000;11000000;748000000;1629000000;2740000000;3488000000;1585000000;-157000000;2133000000;3572000000;7060000000
USM;903238;USD;2014;Q4;2014-12-31;2015-02-25;83213000;82361000;211513000;489913000;267068000;1279175000;2728217000;;2454917000;5183134000;6462309000;373007000;46000;856894000;1126860000;2291663000;3148557000;1560632000;-169139000;1910498000;3313752000;6462309000
USM;903238;USD;2013;Q4;2013-12-31;2014-02-28;84184000;85666000;392169000;497391000;238188000;1401191000;2856520000;;2187997000;5044517000;6445708000;472149000;166000;1006173000;878032000;2029402000;3035575000;1512803000;-164692000;2043095000;3410133000;6445708000
USM;903238;USD;2012;Q4;2012-12-31;2013-02-26;84566000;85203000;479034000;381206000;155886000;1196476000;3022588000;50305000;2318081000;5390974000;6587450000;401354000;92000;754999000;878858000;2036711000;2791710000;1500527000;-165724000;2399052000;3795740000;6587450000
USM;903238;USD;2011;Q4;2011-12-31;2012-02-27;84547000;85354000;551194000;377996000;127056000;1292843000;2790302000;30057000;2214774000;5035133000;6327976000;373330000;127000;722280000;880320000;1928774000;2651054000;1475415000;-152817000;2297363000;3676922000;6327976000
USM;903238;USD;2010;Q4;2010-12-31;2011-02-25;85519000;85879000;423501000;368670000;112279000;1092113000;2574522000;46033000;2162881000;4783436000;5875549000;330042000;101000;648484000;867941000;1686240000;2334724000;1456561000;-105616000;2135507000;3540825000;5875549000
USM;903238;USD;2009;Q4;2009-12-31;2010-08-05;86751000;87024000;294741000;368275000;152556000;1009117000;2601338000;;2138291000;4739629000;5748746000;358530000;76000;663977000;867522000;1643928000;2307905000;1444396000;-69616000;2013633000;3440841000;5748746000
ZAGG;903954;USD;2017;Q4;2017-12-31;2018-03-15;27993000;28975000;24989000;123220000;75046000;227802000;13444000;;79345000;92789000;320591000;112344000;13922000;184592000;0;0;184592000;96179000;-37637000;77805000;135999000;320591000
CWEN;904225;USD;2018;Q4;2018-12-31;2019-02-28;110000000;85000000;407000000;104000000;40000000;756000000;5245000000;1172000000;1327000000;7744000000;8500000000;146000000;535000000;704000000;5447000000;5572000000;6276000000;1898000000;;-58000000;2224000000;8500000000
CWEN;904225;USD;2017;Q4;2017-12-31;2018-03-01;101000000;51000000;148000000;95000000;39000000;482000000;5410000000;1178000000;1419000000;8007000000;8489000000;134000000;339000000;540000000;5659000000;5790000000;6330000000;1844000000;;-69000000;2159000000;8489000000
CWEN;904225;USD;2016;Q4;2016-12-31;2017-02-28;203000000;183000000;322000000;95000000;39000000;670000000;5554000000;1152000000;1586000000;8292000000;8962000000;109000000;323000000;505000000;5726000000;5858000000;6363000000;1880000000;;-2000000;2599000000;8962000000
ANDX;904346;USD;2015;Q4;2015-12-31;2016-02-25;;;16000000;139000000;;252000000;3681000000;58000000;1140000000;4879000000;5131000000;137000000;;246000000;2844000000;2902000000;3148000000;1899000000;;;1983000000;5131000000
ANDX;904346;USD;2014;Q4;2014-12-31;2015-02-24;;;19000000;122000000;;235000000;3343000000;57000000;1167000000;4567000000;4802000000;169000000;;290000000;2544000000;2589000000;2879000000;1488000000;;;1923000000;4802000000
AMED;904598;USD;2018;Q4;2018-12-31;2019-02-28;31939000;32974000;20229000;188972000;;224118000;29449000;;463551000;493000000;717118000;220864000;1612000;222476000;5775000;12009000;234485000;603702000;-241685000;119550000;482633000;717118000
AMED;904598;USD;2017;Q4;2017-12-31;2018-02-28;33898000;34451000;86363000;201196000;;311156000;31122000;;471204000;502326000;813482000;204424000;10638000;215062000;78203000;81994000;297056000;568815000;-53713000;204000;516426000;813482000
AMED;904598;USD;2016;Q4;2016-12-31;2017-03-01;33366000;33925000;30197000;166056000;;214910000;36999000;;482120000;519119000;734029000;176128000;5220000;181348000;87809000;91539000;272887000;537507000;-46774000;-30545000;461142000;734029000
AMED;904598;USD;2015;Q4;2015-12-31;2016-03-10;33201000;32243000;27502000;125010000;;175263000;42695000;;463757000;506452000;681715000;170193000;5000000;175193000;91630000;96086000;271279000;504325000;-26966000;-67806000;410436000;681715000
AMED;904598;USD;2014;Q4;2014-12-31;2015-03-04;32621000;33900000;8032000;99325000;;135558000;137455000;;396729000;534184000;669742000;147938000;12000000;162323000;104372000;109657000;271980000;481797000;-19860000;-64785000;397762000;669742000
AMED;904598;USD;2013;Q4;2013-12-31;2014-03-12;31683000;30890000;17303000;111133000;;205279000;159025000;;362102000;521127000;726406000;298512000;13904000;312416000;33000000;41511000;353927000;467923000;-18176000;-77561000;372479000;726406000
AMED;904598;USD;2012;Q4;2012-12-31;2013-03-12;30360000;29355000;14545000;169172000;;205788000;156709000;;368098000;524807000;730595000;163371000;35807000;204787000;66904000;71575000;276362000;450824000;-17116000;18617000;454233000;730595000
AMED;904598;USD;2011;Q4;2011-12-31;2012-02-28;29011000;28125000;48004000;148061000;;232016000;148536000;;477733000;626269000;858285000;176098000;33888000;221734000;111551000;116403000;338137000;432420000;-15770000;102205000;520148000;858285000
AMED;904598;USD;2010;Q4;2010-12-31;2011-02-22;28105000;28481000;120295000;141549000;;294050000;138554000;;867259000;1005813000;1299863000;164878000;37178000;216341000;144688000;203807000;420148000;407185000;-14022000;484669000;879715000;1299863000
AMED;904598;USD;2009;Q4;2009-12-31;2010-02-23;27606000;28290000;34485000;150269000;;218036000;91919000;;862396000;954315000;1172351000;169189000;44254000;229306000;170899000;206710000;436016000;363698000;-735000;372089000;736335000;1172351000
AMED;904598;USD;2008;Q4;2008-12-31;2009-07-28;-78983220;-80397388;2847000;175698000;;194350000;79258000;;796586000;875844000;1070194000;152701000;42632000;204627000;285942000;303449000;508076000;326147000;-617000;236252000;562118000;1070194000
IO;905324;USD;2018;Q4;2018-12-31;2019-02-07;14024000;14024000;33551000;26128000;14130000;125623000;13041000;;153888000;166929000;292552000;95580000;2228000;117732000;119513000;166996000;284728000;952766000;;-926092000;7824000;292552000
IO;905324;USD;2017;Q4;2017-12-31;2018-02-08;11921000;11740000;52056000;19478000;14508000;130989000;52153000;;117927000;170080000;301069000;90683000;40024000;139617000;116720000;130646000;270263000;903367000;;-854921000;30806000;301069000
IO;905324;USD;2016;Q4;2016-12-31;2017-02-09;11799000;11678000;52652000;20770000;15241000;111637000;67488000;;134091000;201579000;313216000;76792000;14581000;95082000;144209000;164736000;259818000;899316000;;-824679000;53398000;313216000
IO;905324;USD;2015;Q4;2015-12-31;2016-02-11;10894000;10893000;84933000;44365000;32721000;196763000;72027000;;166298000;238325000;435088000;89131000;7912000;103603000;175080000;219445000;323048000;894822000;-8551000;-759531000;112040000;435088000
IO;905324;USD;2014;Q4;2014-12-31;2015-02-17;10935665;10897379;173608000;114325000;51162000;375356000;69840000;;172061000;241901000;617257000;137346000;7649000;153257000;182945000;326749000;480006000;889394000;-6565000;-734409000;137251000;617257000
MD;905672;USD;2018;Q4;2018-12-31;2019-02-14;87586000;88031000;47414000;506723000;;659977000;90434000;69699000;5117371000;5277504000;5937481000;479165000;;502762000;1974281000;2346835000;2849597000;993525000;;2094359000;3087884000;5937481000
MD;905672;USD;2017;Q4;2017-12-31;2018-02-14;92594000;92996000;70492000;503999000;;627235000;123536000;80682000;5035825000;5240043000;5867278000;530024000;;531425000;1851423000;2269399000;2800824000;1018265000;;2048189000;3066454000;5867278000
MD;905672;USD;2016;Q4;2016-12-31;2017-02-10;92633000;93254000;66984000;495276000;;587128000;103068000;78975000;4570229000;4752272000;5339400000;426895000;;448949000;1683628000;2129684000;2578633000;975241000;;1785526000;2760767000;5339400000
MD;905672;USD;2015;Q4;2015-12-31;2016-02-11;92628000;93374000;60425000;444737000;;527769000;83634000;63288000;3872523000;4019445000;4547214000;416888000;;428771000;1262820000;1680597000;2109368000;927172000;;1510356000;2437846000;4547214000
MD;905672;USD;2014;Q4;2014-12-31;2015-02-09;97777000;98841000;53963000;352191000;;467052000;66048000;64082000;3011066000;3141196000;3608248000;405808000;;416273000;558308000;926409000;1342682000;887837000;;1376782000;2265566000;3608248000
MD;905672;USD;2013;Q4;2013-12-31;2014-02-12;99208000;100816000;37594000;285397000;;368125000;59911000;57511000;2523169000;2640591000;3008716000;326700000;;326792000;27143000;338936000;665728000;858965000;;1484023000;2342988000;3008716000
MD;905672;USD;2012;Q4;2012-12-31;2013-02-15;98044000;100022000;27864000;248066000;;359044000;59738000;47593000;2283962000;2391293000;2750337000;268237000;;268338000;144233000;446631000;714969000;788580000;;1246788000;2035368000;2750337000
MD;905672;USD;2011;Q4;2011-12-31;2012-02-29;96308000;98316000;22735000;230388000;;337273000;60530000;44991000;1829854000;1935375000;2272648000;254158000;;254301000;29327000;287331000;541632000;725135000;;1005881000;1731016000;2272648000
MD;905672;USD;2010;Q4;2010-12-31;2011-02-24;93832000;96006000;43632000;181395000;;296009000;42774000;27393000;1671470000;1741637000;2037646000;220936000;;221061000;146556000;369131000;590192000;659570000;;787884000;1447454000;2037646000
MD;905672;USD;2009;Q4;2009-12-31;2010-08-31;91824000;94094000;31883000;164444000;;292665000;43272000;28491000;1324922000;1396685000;1689350000;346470000;;346704000;50209000;152548000;499252000;604905000;;585193000;1190098000;1689350000
MRAM;906016;USD;2018;Q4;2018-12-31;2019-03-15;17121595;17121595;23379000;7522000;9097000;40686000;4286000;;73000;4359000;45045000;7638000;5977000;13615000;6509000;6509000;20124000;158914000;;-133993000;24921000;45045000
MRAM;906016;USD;2017;Q4;2017-12-31;2018-03-15;12666619;12666619;12950000;4041000;9837000;27418000;3946000;;73000;4019000;31437000;6668000;3987000;12375000;8178000;8178000;20553000;128423000;;-117539000;10884000;31437000
MRAM;906016;USD;2016;Q4;2016-12-31;2017-03-29;11185616;11185616;29727000;3170000;5069000;39502000;1920000;;50000;1970000;41472000;3313000;3884000;10383000;4218000;4218000;14601000;123310000;;-96439000;26871000;41472000
MRAM;906016;USD;2015;Q4;2015-12-31;2016-11-18;1167651;2552265;2307000;1909000;4176000;9146000;1654000;;161000;1815000;10961000;2917000;1175000;9344000;6739000;7405000;16749000;9301000;;-79731000;-5788000;10961000
JAKK;908372;USD;2018;Q4;2018-12-31;2019-03-18;23104000;524000;53282000;122278000;53880000;250143000;20902000;;71796000;92698000;342841000;87488000;27211000;144102000;139792000;147090000;291192000;218185000;-24000000;-127601000;51649000;342841000
JAKK;908372;USD;2017;Q4;2017-12-31;2018-03-16;22872000;22872000;64977000;142457000;58432000;282669000;23227000;;64453000;87680000;370349000;92061000;5000000;135758000;133497000;140078000;275836000;215836000;-24000000;-85233000;94513000;370349000
JAKK;908372;USD;2016;Q4;2016-12-31;2017-03-16;16504000;-6464000;86064000;173599000;75435000;353379000;22841000;7000000;81083000;110924000;464303000;90386000;10000000;116810000;203007000;212293000;329103000;177643000;-24000000;-2148000;135200000;464303000
JAKK;908372;USD;2015;Q4;2015-12-31;2016-03-15;20983000;92524000;102528000;163387000;60544000;382368000;18435000;7000000;91817000;117252000;499620000;110134000;;127401000;209166000;218813000;346214000;194764000;-28322000;-3391000;153406000;499620000
JAKK;908372;USD;2014;Q4;2014-12-31;2015-03-16;21616000;77633000;71745000;234516000;78827000;437593000;11096000;7000000;106093000;124189000;561782000;166871000;;191348000;215000000;225350000;416698000;202074000;-24000000;-26645000;145084000;561782000
JAKK;908372;USD;2013;Q4;2013-12-31;2014-03-17;23087000;10724000;117291000;101223000;46784000;320932000;11096000;7000000;110816000;128912000;449844000;115123000;38098000;184595000;100000000;116564000;301159000;200688000;;-48154000;148685000;449844000
JAKK;908372;USD;2012;Q4;2012-12-31;2013-03-15;22146000;15218000;189539000;105455000;59690000;406056000;15826000;7000000;125943000;148769000;554825000;114392000;70710000;219475000;94918000;128130000;347605000;202599000;;8836000;207220000;554825000
JAKK;908372;USD;2011;Q4;2011-12-31;2012-03-15;26399000;20337000;257472000;103637000;47019000;497485000;16186000;;101563000;117749000;615234000;79393000;;122833000;92188000;98810000;221643000;274558000;;123174000;393591000;615234000
JAKK;908372;USD;2010;Q4;2010-12-31;2011-08-01;;;278553000;122476000;43230000;512162000;16946000;;104298000;121244000;633406000;96505000;27000;124910000;89458000;96088000;220998000;302453000;-5641000;119884000;412408000;633406000
RWLK;908640;USD;2018;Q4;2018-12-31;2019-02-08;1955476;1955476;9546000;758000;2240000;13237000;626000;;1099000;1725000;14962000;2978000;1722000;5382000;6965000;7635000;13017000;154863000;;-152918000;1945000;14962000
RWLK;908640;USD;2017;Q4;2017-12-31;2018-03-08;1021016;1021016;14567000;1103000;3643000;20938000;840000;;1085000;1925000;22863000;2683000;6441000;9727000;8911000;9429000;19156000;134927000;;-131220000;3707000;22863000
RWLK;908640;USD;2016;Q4;2016-12-31;2017-02-17;609008;609008;23678000;1254000;3264000;29335000;1258000;;1170000;2428000;31763000;4443000;7495000;12398000;10518000;11105000;23503000;114752000;;-106492000;8260000;31763000
RWLK;908640;USD;2015;Q4;2015-12-31;2016-02-29;487147;487147;17869000;2146000;2534000;23776000;1328000;;470000;1798000;25574000;3695000;0;4343000;0;311000;4654000;94909000;;-73989000;20920000;25574000
ONS;908645;USD;2018;Q4;2018-09-30;2018-12-18;9560699;9560699;1717391;;;3302480;18489976;;491039;18981015;22283495;11924207;5199774;32042033;3551743;11051968;43094001;190762441;;-216307363;-20810506;22283495
ONS;908645;USD;2017;Q4;2017-09-30;2017-12-29;3214499;3214499;3185519;;;3904606;16088902;;740362;16829264;20733870;20643956;5006220;28737737;13410877;22722667;51460404;152564427;;-186215402;-30726534;20733870
ONS;908645;USD;2016;Q4;2016-09-30;2016-12-29;2966416;2966416;2351887;;;5678494;18658553;;1068887;19727440;25405934;13048091;6176202;20436854;2554540;10141985;30578839;142193370;;-147366275;-5172905;25405934
VRNS;908839;USD;2018;Q4;2018-12-31;2019-02-12;29518086;29518086;158915000;83223000;;259090000;17323000;;8565000;25888000;284978000;58611000;;146340000;;13268000;159608000;266971000;;-137968000;125370000;284978000
VRNS;908839;USD;2017;Q4;2017-12-31;2018-02-13;28001257;28001257;136557000;75596000;;226499000;11896000;;7243000;19139000;245638000;43088000;;116581000;;14415000;130996000;223896000;;-109390000;114642000;245638000
VRNS;908839;USD;2016;Q4;2016-12-31;2017-02-09;26742482;26742482;113808000;53861000;;171319000;9910000;;609000;10519000;181838000;29767000;;88245000;;10854000;99099000;189362000;;-106144000;82739000;181838000
VRNS;908839;USD;2015;Q4;2015-12-31;2016-02-12;25810304;25810304;106344000;47436000;;156402000;8265000;;477000;8742000;165144000;25641000;;71316000;;10241000;81557000;172352000;;-88434000;83587000;165144000
VRNS;908839;USD;2014;Q4;2014-12-31;2015-02-19;24914806;24914806;111695000;37869000;;152526000;3989000;;332000;4321000;156847000;19457000;;53210000;;8611000;61821000;162503000;;-67151000;95026000;156847000
VRNS;908839;USD;2013;Q4;2013-12-31;2014-05-08;3898194;3898194;13977000;28268000;;43773000;1856000;;1625000;3481000;47254000;13806000;;40397000;;6090000;46487000;4745000;;-47753000;767000;47254000
RIGL;909018;USD;2018;Q4;2018-12-31;2019-02-28;166961000;166961000;128537000;4077000;894000;136987000;1387000;;735000;2122000;139109000;23106000;;27734000;;1498000;29232000;1319235000;;-1209334000;109877000;139109000
RIGL;909018;USD;2017;Q4;2017-12-31;2018-03-06;144570000;144570000;115751000;;;117433000;875000;;803000;1678000;119111000;18053000;;18337000;;128000;18465000;1239582000;;-1138854000;100646000;119111000
RIGL;909018;USD;2016;Q4;2016-12-31;2017-03-07;99044000;99044000;74766000;;;76214000;1156000;;764000;1920000;78134000;16562000;;22588000;;519000;23107000;1115907000;;-1060862000;55027000;78134000
RIGL;909018;USD;2015;Q4;2015-12-31;2016-03-08;89050000;89050000;126276000;203000;;129024000;1613000;;1110000;2723000;131747000;15100000;;33796000;;6570000;40366000;1083071000;;-991646000;91381000;131747000
RIGL;909018;USD;2014;Q4;2014-12-31;2015-03-03;87797000;87797000;143159000;5750000;;150537000;2509000;;1089000;3598000;154135000;8972000;;14025000;;11864000;25889000;1068435000;;-940182000;128246000;154135000
RIGL;909018;USD;2013;Q4;2013-12-31;2014-03-04;87434000;87434000;211975000;5750000;;220075000;4455000;;1528000;5983000;226058000;9086000;;10294000;;7513000;17807000;1057478000;;-849274000;208251000;226058000
RIGL;909018;USD;2012;Q4;2012-12-31;2013-03-05;85352000;85352000;298241000;;;302458000;5826000;;1759000;7585000;310043000;11538000;;12204000;;8743000;20947000;1049261000;;-760247000;289096000;310043000
RIGL;909018;USD;2011;Q4;2011-12-31;2012-03-06;71543000;71543000;247640000;;;250233000;4882000;;1991000;6873000;257106000;11398000;;11527000;;9430000;20957000;897550000;;-661407000;236149000;257106000
RIGL;909018;USD;2010;Q4;2010-12-31;2011-08-02;52154000;52684000;177295000;;;179926000;4534000;;2235000;6769000;186695000;10571000;755000;11326000;;9238000;20564000;741603000;;-575434000;166131000;186695000
SHLX;909105;USD;2018;Q4;2018-12-31;2019-02-21;;;208000000;19000000;;284000000;742000000;885000000;3000000;1630000000;1914000000;42000000;;53000000;;1836000000;1889000000;;;;25000000;1914000000
SHLX;909105;USD;2017;Q4;2017-12-31;2018-02-28;;;137700000;17200000;;203600000;736500000;424700000;1700000;1162900000;1366500000;35500000;;54900000;;1288300000;1343200000;;;;23300000;1366500000
SHLX;909105;USD;2016;Q4;2016-12-31;2017-02-23;;;122100000;22700000;;182500000;733700000;386800000;900000;1121400000;1303900000;30100000;;44000000;;1238400000;1282400000;;;;21500000;1303900000
SHLX;909105;USD;2015;Q4;2015-12-31;2016-02-29;;;93000000;18800000;;130800000;392900000;191200000;;584100000;714900000;19900000;;26100000;;580400000;606500000;;;;108400000;714900000
SHLX;909105;USD;2014;Q4;2014-12-31;2015-03-25;;;150200000;18300000;;193000000;372200000;160700000;4200000;537100000;730100000;26900000;;46900000;;521300000;568200000;;;;161900000;730100000
SHLX;909105;USD;2013;Q4;2013-12-31;2014-12-09;;;0;4800000;;28700000;223500000;0;0;223500000;252200000;37700000;;37700000;;214500000;252200000;;;;0;252200000
SONS;909370;USD;2018;Q4;2018-12-31;2019-03-04;106669000;106669000;50978000;187853000;22602000;278435000;27042000;;651682000;678724000;957159000;129567000;;289654000;;77207000;366861000;1723587000;;-1136992000;590298000;957159000
SONS;909370;USD;2017;Q4;2017-12-31;2018-03-08;86878000;86500000;74297000;165156000;21303000;282219000;24780000;9031000;594853000;628664000;910883000;122231000;;242802000;;52660000;295462000;1684778000;;-1072426000;615421000;910883000
SONS;909370;USD;2016;Q4;2016-12-31;2018-03-08;49231000;49231000;93759000;53862000;18283000;177914000;11741000;32371000;86033000;130145000;308059000;33565000;;77069000;;11868000;88937000;1250793000;;-1037174000;219122000;308059000
RUSHA;909600;USD;2018;Q4;2018-12-31;2019-02-25;38519000;39002000;131726000;190650000;1339923000;1687944000;1184053000;;329353000;1513406000;3201350000;1275526000;161955000;1493295000;439218000;641127000;2134422000;370483000;-245842000;942287000;1066928000;3201350000
RUSHA;909600;USD;2017;Q4;2017-12-31;2018-03-01;39633000;41234000;124541000;183875000;1033294000;1375098000;1159595000;6375000;349071000;1515041000;2890139000;982599000;145139000;1172207000;466389000;677559000;1849766000;348498000;-120682000;812557000;1040373000;2890139000
RUSHA;909600;USD;2016;Q4;2016-12-31;2017-03-01;39332000;40311000;82026000;156199000;840304000;1111448000;1135805000;6231000;349563000;1491599000;2603047000;828763000;130717000;993130000;472503000;747092000;1740222000;309565000;-86882000;640428000;862825000;2603047000
RUSHA;909600;USD;2015;Q4;2015-12-31;2016-02-29;40382000;41179000;64847000;156977000;1061198000;1326586000;1172824000;6650000;345948000;1525422000;2852008000;1058884000;151024000;1247037000;496731000;760074000;2007111000;288724000;-43368000;599846000;844897000;2852008000
RUSHA;909600;USD;2014;Q4;2014-12-31;2015-03-02;40041000;41125000;191463000;170027000;1024104000;1427127000;923080000;6905000;318763000;1248748000;2675875000;1063275000;149065000;1274610000;429189000;636926000;1911536000;272910000;-41904000;533793000;764339000;2675875000
RUSHA;909600;USD;2013;Q4;2013-12-31;2014-03-03;39391000;40551000;217305000;103293000;802220000;1153436000;739663000;6628000;268071000;1014362000;2167798000;763345000;97243000;929175000;385538000;573242000;1502417000;243568000;-30821000;453836000;665381000;2167798000
RUSHA;909600;USD;2012;Q4;2012-12-31;2013-03-15;38770000;39999000;198773000;89615000;690953000;1006059000;622112000;6628000;246767000;875507000;1881566000;668563000;80030000;788446000;319634000;485174000;1273620000;223031000;-17948000;404619000;607946000;1881566000
RUSHA;909600;USD;2011;Q4;2011-12-31;2012-03-15;38059489;39271106;207775000;98160000;649626000;980005000;499667000;6628000;231401000;737696000;1717701000;717270000;63465000;790791000;264822000;395676000;1186467000;208967000;-17948000;342164000;531234000;1717701000
RUSHA;909600;USD;2010;Q4;2010-12-31;2011-08-09;37416812;38611720;168976000;43513000;321933000;558807000;445919000;7575000;155632000;609126000;1167933000;344779000;62279000;415029000;189850000;287985000;703014000;196138000;-17948000;286951000;464919000;1167933000
TWOU;909826;USD;2018;Q4;2018-12-31;2019-02-26;58002116;58002116;474772000;32636000;;521680000;52299000;;233375000;285674000;807354000;50648000;;68480000;;33865000;102345000;957689000;;-244166000;705009000;807354000
TWOU;909826;USD;2017;Q4;2017-12-31;2018-02-27;52382792;52382792;223370000;14174000;;248053000;49055000;;184954000;234009000;482062000;41646000;;58000000;;36230000;94230000;588342000;;-205836000;387832000;482062000
TWOU;909826;USD;2016;Q4;2016-12-31;2017-02-24;47087830;47087830;168730000;7860000;;184698000;15596000;;44026000;59622000;244320000;31215000;;48689000;;394000;49083000;371502000;;-176265000;195237000;244320000
TWOU;909826;USD;2015;Q4;2015-12-31;2016-03-10;45694313;45694313;183729000;975000;;192907000;3621000;;34513000;38134000;231041000;17949000;;32597000;;2655000;35252000;351370000;;-155581000;195789000;231041000
TWOU;909826;USD;2014;Q4;2014-12-31;2015-02-26;41026898;41026898;86929000;350000;;89988000;6755000;;16296000;23051000;113039000;11381000;;23768000;;1260000;25028000;216859000;;-128848000;88011000;113039000
TWOU;909826;USD;2013;Q4;2013-12-31;2014-05-12;7528251;7528251;7012000;1835000;;11191000;5231000;;12230000;17461000;28652000;6920000;;20211000;1571000;2418000;22629000;7825000;;-99849000;6023000;28652000
EB;909936;USD;2018;Q4;2018-12-31;2019-03-07;78763000;78763000;437892000;4069000;;545704000;44219000;;246961000;291180000;836884000;286843000;;308204000;95597000;113458000;421662000;718405000;-488000;-302695000;415222000;836884000
EB;909936;USD;2017;Q4;2017-12-31;2018-11-14;20550000;20550000;188986000;2885000;;276048000;42492000;;252297000;294789000;570837000;235638000;;246182000;114516000;146451000;392633000;83291000;-488000;-238617000;178204000;570837000
EAF;910562;USD;2018;Q4;2018-12-31;2019-02-22;;290412273;49880000;248286000;293717000;638051000;513705000;;353735000;867440000;1505491000;220804000;106323000;327127000;2050311000;2255133000;2582260000;822527000;;-1893496000;-1076769000;1505491000
EAF;910562;USD;2017;Q4;2017-12-31;2018-05-07;;302225923;13365000;116841000;174151000;349229000;512841000;;337033000;849874000;1199103000;132073000;16474000;151959000;322900000;433929000;585888000;854337000;;-261411000;613215000;1199103000
EAF;910562;USD;2016;Q4;2016-12-31;2017-02-27;;;11610000;80568000;156111000;269954000;508855000;;393467000;902322000;1172276000;83513000;8852000;112407000;356580000;482484000;594891000;854337000;;-269394000;577385000;1172276000
WMK;912450;USD;2018;Q4;2018-12-31;2019-03-14;26898443;26898443;106792000;57285000;280756000;469122000;887608000;;75281000;962889000;1432011000;243736000;;267213000;;141899000;409112000;9949000;-150857000;1163545000;1022899000;1432011000
WMK;912450;USD;2017;Q4;2017-12-31;2018-03-15;26898443;26898443;126058000;56265000;279509000;483314000;886243000;;72182000;958425000;1441739000;249655000;;274342000;34988000;174553000;448895000;9949000;-150857000;1127872000;992844000;1441739000
WMK;912450;USD;2016;Q4;2016-12-31;2017-03-16;26898443;26898443;92978000;96170000;276783000;483866000;878195000;;69243000;947438000;1431304000;250106000;;276166000;64476000;228416000;504582000;9949000;-150857000;1062778000;926722000;1431304000
WMK;912450;USD;2015;Q4;2015-12-31;2016-03-18;26898443;26898443;118304000;88083000;229399000;454650000;738985000;;42324000;781309000;1235959000;198260000;;221928000;0;142284000;364212000;9949000;-150857000;1007894000;871747000;1235959000
WMK;912450;USD;2014;Q4;2014-12-31;2015-03-13;26898443;26898443;106066000;70642000;239641000;434393000;716860000;;39866000;756726000;1191119000;179402000;;204798000;;141558000;346356000;9949000;-150857000;980842000;844763000;1191119000
WMK;912450;USD;2013;Q4;2013-12-31;2014-03-14;26898443;26898443;89810000;57193000;240452000;404748000;704985000;;38509000;743494000;1148242000;162612000;;193220000;;120969000;314189000;9949000;-150857000;971022000;834053000;1148242000
WMK;912450;USD;2012;Q4;2012-12-31;2013-03-14;26898443;26898443;103940000;53842000;245243000;413157000;638634000;;38649000;677283000;1090440000;154810000;;183409000;;111341000;294750000;9949000;-150857000;931579000;795690000;1090440000
WMK;912450;USD;2011;Q4;2011-12-31;2012-03-15;26898443;26898443;126740000;52410000;226191000;415562000;575003000;;38439000;613442000;1029004000;163390000;;191820000;;91298000;283118000;9949000;-150857000;881346000;745886000;1029004000
WMK;912450;USD;2010;Q4;2010-12-31;2011-08-04;;;134899000;53302000;231021000;428373000;525062000;;38646000;563708000;992081000;163081000;;194984000;;68970000;263954000;9949000;-150857000;864132000;728127000;992081000
BWXT;914354;USD;2018;Q4;2018-12-31;2019-02-25;97619550;98571422;33468000;;;542448000;439239000;7382000;666027000;1112648000;1655096000;254300000;14227000;377348000;753617000;1042047000;1419395000;116984000;-1037795000;1166762000;235701000;1655096000
BWXT;914354;USD;2017;Q4;2017-12-31;2018-02-27;99398096;;206338000;;;873090000;348629000;9301000;481319000;839249000;1712339000;240636000;27870000;528126000;481059000;898456000;1426582000;100097000;-814809000;990652000;285757000;1712339000
BWXT;914354;USD;2016;Q4;2016-12-31;2017-02-27;99259419;;140158000;;;693571000;299686000;9013000;577545000;886244000;1579815000;253881000;27370000;439876000;497724000;989529000;1429405000;23259000;-762169000;885117000;150410000;1579815000
BWXT;914354;USD;2015;Q4;2015-12-31;2016-02-24;105954347;107881141;158205000;;;647294000;268844000;6070000;453190000;728104000;1375398000;186680000;15000000;353780000;278259000;741983000;1095763000;23960000;-498346000;739350000;279635000;1375398000
BWXT;914354;USD;2014;Q4;2014-12-31;2015-02-25;62642523;62464766;128461000;;9926000;1473802000;307800000;7606000;1067728000;1383134000;2856936000;234428000;15000000;819636000;285000000;1023099000;1842735000;776609000;-423990000;642489000;1014201000;2856936000
BWXT;914354;USD;2013;Q4;2013-12-31;2014-02-26;-23417656;-23388771;356864000;;113058000;1437424000;447079000;4426000;720224000;1171729000;2609153000;548350000;4671000;927228000;225000;498984000;1426212000;748394000;-268971000;656916000;1182941000;2609153000
BWXT;914354;USD;2012;Q4;2012-12-31;2013-02-28;164863464;165684477;472316000;;124218000;1521086000;447021000;4090000;868158000;1319269000;2840355000;519257000;4062000;1079288000;430000;758151000;1837439000;714453000;-109809000;349063000;1002916000;2840355000
BWXT;914354;USD;2011;Q4;2011-12-31;2012-03-29;-164317357210;-165457462956;484014000;;107298000;1487076000;422291000;3775000;875969000;1302035000;2789111000;614192000;4653000;1154807000;633000;799331000;1954138000;678137000;-10059000;130890000;834973000;2789111000
BWXT;914354;USD;2010;Q4;2010-12-31;2011-08-08;163027985;164976439;391376000;;100932000;1209116000;418312000;74863000;798219000;1291394000;2500510000;497805000;4790000;981827000;855000;805158000;1786985000;1068584000;-2397000;96671000;713525000;2500510000
EVBG;914618;USD;2018;Q4;2018-12-31;2019-03-01;29685425;29685425;105519000;41107000;;162515000;4650000;;95015000;99665000;262180000;25392000;427000;120047000;94097000;99975000;220022000;194896000;;-147670000;42158000;262180000
EVBG;914618;USD;2017;Q4;2017-12-31;2018-03-12;28301155;28301155;145662000;31699000;;183461000;2796000;;50156000;52952000;236413000;15382000;;86962000;89481000;93460000;180422000;165023000;;-109252000;55991000;236413000
EVBG;914618;USD;2016;Q4;2016-12-31;2017-03-23;;27292264;60765000;17812000;;82883000;2923000;;22516000;25439000;108322000;11847000;;63783000;;2187000;65970000;132273000;;-89618000;42352000;108322000
EVBG;914618;USD;2015;Q4;2015-12-31;2016-11-14;12266092;12266092;8578000;15699000;;29620000;3620000;;20269000;23889000;53509000;11043000;2848000;53619000;14122000;15941000;69560000;62286000;;-78332000;-16051000;53509000
OMP;914862;USD;2018;Q4;2018-12-31;2019-03-01;;;6649000;2481000;;91375000;870425000;;2452000;872877000;964252000;93293000;;93293000;318000000;319514000;412807000;238630000;;;551445000;964252000
OMP;914862;USD;2017;Q4;2017-12-31;2018-02-28;;;883000;834000;;88313000;619580000;;2013000;621593000;709906000;70570000;;70570000;78000000;79316000;149886000;246574000;;;560020000;709906000
OMP;914862;USD;2016;Q4;2016-12-31;2017-11-09;;;0;667000;;18490000;431535000;;3000;431538000;450028000;76556000;;76556000;0;373472000;450028000;;;;;450028000
MARA;914944;USD;2018;Q4;2018-12-31;2019-03-25;6368346;6368346;2551171;;;3015177;1034575;;1144755;2179330;5194507;1235444;999106;2273633;;0;2273633;105462034;;-102090441;2920874;5194507
MARA;914944;USD;2017;Q4;2017-12-31;2018-04-16;2353436;2353436;14948529;6826;;15048210;10011;;0;10011;15058221;1961784;1763920;7670100;;;7670100;97114971;;-89276117;7388121;15058221
ENPH;917156;USD;2018;Q4;2018-12-31;2019-03-15;106935000;106935000;106237000;78938000;16267000;222302000;20998000;;96637000;117635000;339937000;77804000;28155000;147161000;81628000;185000000;332161000;353336000;;-346302000;7776000;339937000
ENPH;917156;USD;2017;Q4;2017-12-31;2018-04-02;85809000;85809000;29144000;65346000;25999000;130446000;26483000;;12218000;38701000;169147000;51194000;17429000;91741000;32322000;86532000;178273000;287257000;;-295727000;-9126000;169147000
ENPH;917156;USD;2016;Q4;2016-12-31;2017-03-16;61969000;61969000;17764000;61019000;31960000;117864000;31440000;;14272000;45712000;163576000;54633000;3032000;82772000;20768000;79504000;162276000;252127000;;-250535000;1300000;163576000
ENPH;917156;USD;2015;Q4;2015-12-31;2016-03-01;45525000;42263000;28452000;46099000;40800000;121768000;32118000;;11642000;43760000;165528000;44861000;0;72848000;0;51231000;124079000;224732000;;-183073000;41449000;165528000
ENPH;917156;USD;2014;Q4;2014-12-31;2015-03-04;43631000;37973000;42032000;45119000;21590000;114896000;30824000;;6472000;37296000;152192000;48352000;0;58706000;;46534000;105240000;208022000;;-160991000;46952000;152192000
ENPH;917156;USD;2013;Q4;2013-12-31;2014-03-04;42045000;42045000;38190000;32084000;16580000;90509000;24853000;;1307000;26160000;116669000;22143000;3507000;33365000;5170000;43098000;76463000;192916000;;-152939000;40206000;116669000
EVRI;917372;USD;2018;Q4;2018-12-31;2019-03-12;70217000;73865000;297532000;64387000;24403000;488940000;116288000;;943033000;1059321000;1548261000;129238000;8200000;471636000;1155016000;1185520000;1657156000;299024000;-176464000;-229457000;-108895000;1548261000
EVRI;917372;USD;2017;Q4;2017-12-31;2018-03-16;67927000;67927000;128586000;47782000;23967000;448408000;113519000;;975147000;1088666000;1537074000;134504000;8200000;460448000;1159643000;1217259000;1677707000;282163000;-176341000;-246202000;-140633000;1537074000
EVRI;917372;USD;2016;Q4;2016-12-31;2017-03-14;66076000;66076000;119051000;56651000;19068000;341639000;98439000;;968085000;1066524000;1408163000;94391000;10000000;343514000;1111880000;1172442000;1515956000;264846000;-176231000;-194299000;-107793000;1408163000
EVRI;917372;USD;2015;Q4;2015-12-31;2016-03-15;66008000;65139000;102030000;52382000;28738000;253783000;106308000;;1190294000;1296602000;1550385000;101512000;10000000;251331000;1129899000;1161634000;1412965000;258111000;-176189000;55180000;137420000;1550385000
EVRI;917372;USD;2014;Q4;2014-12-31;2015-03-16;65651000;66248000;89095000;37697000;27163000;246375000;106085000;;1354825000;1460910000;1707285000;104668000;10000000;233825000;1178787000;1241987000;1475812000;245772000;-176020000;160152000;231473000;1707285000
EVRI;917372;USD;2013;Q4;2013-12-31;2014-03-11;65718000;67315000;114254000;11658000;9413000;197971000;18710000;;310646000;329356000;527327000;53601000;1030000;199653000;101970000;109070000;308723000;231605000;-163840000;148012000;218604000;527327000
EVRI;917372;USD;2012;Q4;2012-12-31;2013-03-12;66716000;68174000;153020000;11571000;7126000;219655000;15441000;;318799000;334240000;553895000;51190000;121500000;355136000;;0;355136000;218077000;-145490000;123614000;198759000;553895000
EVRI;917372;USD;2011;Q4;2011-12-31;2012-03-12;66059000;66409000;55535000;16885000;7087000;175614000;15577000;;337876000;353453000;529067000;53382000;174000000;369209000;;0;369209000;204821000;-145228000;97925000;159858000;529067000
EVRI;917372;USD;2010;Q4;2010-12-31;2011-08-09;63983000;64530000;60636000;15211000;3845000;98721000;16648000;;343025000;359673000;458394000;46425000;208750000;314916000;;0;314916000;197133000;-145038000;88796000;143478000;458394000
MRNA;917766;USD;2018;Q4;2018-12-31;2019-03-13;;;1521427000;11686000;;1563006000;211977000;172990000;14176000;399143000;1962149000;110283000;;222803000;33489000;209105000;431908000;2538188000;;-1006627000;1530241000;1962149000
MRNA;917766;USD;2017;Q4;2017-12-31;2019-03-13;;;756029000;11881000;;783223000;139031000;145851000;16384000;301266000;1084489000;93440000;;191461000;15687000;267732000;459193000;71685000;;-621893000;625296000;1084489000
ESTC;917843;USD;2018;Q4;2018-04-30;2019-06-28;71789740;71789740;298000000;81274000;;429641000;5448000;;50649000;56097000;485738000;45337000;;203580000;;19146000;222726000;581889000;-369000;-317077000;263012000;485738000
ESTC;917843;USD;2017;Q4;2017-04-30;2018-12-12;32619098;32619098;50941000;53233000;;132228000;4536000;;46249000;50785000;183013000;29183000;;125112000;;10509000;135621000;62575000;-369000;-214774000;47392000;183013000
MMP;918211;USD;2018;Q4;2018-12-31;2019-02-15;;;218283000;129171000;185735000;646343000;5798181000;20844000;1282169000;7101194000;7747537000;400844000;59489000;676556000;4211380000;4427547000;5104103000;2763925000;;;2643434000;7747537000
MMP;918211;USD;2017;Q4;2017-12-31;2018-02-16;;;160840000;153340000;182345000;596611000;5552835000;27676000;1217253000;6797764000;7394375000;379272000;250974000;836510000;4273518000;4428212000;5264722000;2267231000;;;2129653000;7394375000
MMP;918211;USD;2016;Q4;2016-12-31;2017-02-17;;;14701000;131450000;134378000;370394000;5275741000;23870000;1102068000;6401679000;6772073000;290347000;0;481656000;4087192000;4198312000;4679968000;2193346000;;;2092105000;6772073000
MMP;918211;USD;2015;Q4;2015-12-31;2016-02-19;;;28731000;96594000;130868000;338854000;4819229000;20374000;863110000;5702713000;6041567000;290080000;250335000;713072000;3189287000;3306759000;4019831000;2118086000;;;2021736000;6041567000
MMP;918211;USD;2014;Q4;2014-12-31;2015-02-20;;;17063000;100176000;157762000;402667000;4329334000;28611000;740797000;5098742000;5501409000;283645000;0;536155000;2967019000;3097021000;3633176000;1949773000;;;1868233000;5501409000
MMP;918211;USD;2013;Q4;2013-12-31;2014-02-24;;;25235000;122757000;187224000;396733000;3916258000;2730000;505091000;4424079000;4820812000;265111000;249971000;638276000;2435316000;2535094000;3173370000;1666946000;;;1647442000;4820812000
ESCA;918449;USD;2018;Q4;2018-12-31;2019-02-22;14441000;14582000;2824000;40682000;39122000;87863000;15498000;;46166000;61664000;149527000;16703000;0;16703000;0;4503000;21206000;14439000;;113882000;128321000;149527000
ESCA;918449;USD;2017;Q4;2017-12-31;2018-02-27;14370000;14423000;1572000;39350000;35160000;80260000;14286000;;61559000;75845000;156105000;18292000;1250000;19542000;21871000;24893000;44435000;14372000;;99908000;111670000;156105000
ESCA;918449;USD;2016;Q4;2016-12-31;2017-02-28;14302000;14291000;1013000;35894000;33802000;75623000;13714000;;61424000;75138000;150761000;17168000;1250000;18418000;24189000;30630000;49048000;14305000;;91688000;101713000;150761000
ESCA;918449;USD;2015;Q4;2015-12-31;2016-02-23;14145000;14127000;1982000;38984000;25862000;72775000;14363000;;56599000;70962000;143737000;16721000;1810000;18531000;21526000;28726000;47257000;14180000;;85478000;96480000;143737000
ESCA;918449;USD;2014;Q4;2014-12-31;2015-02-25;13937000;13990000;3232000;32150000;23775000;68851000;11596000;;47434000;59030000;127881000;13960000;17786000;31746000;3360000;6356000;38102000;13998000;;77745000;89779000;127881000
ESCA;918449;USD;2013;Q4;2013-12-31;2014-02-25;13573000;13584000;1091000;38271000;18941000;81216000;10635000;;50123000;60758000;141974000;13576000;23263000;43679000;4946000;10340000;54019000;13657000;;69379000;87955000;141974000
ESCA;918449;USD;2012;Q4;2012-12-31;2013-02-26;39689715;40141014;2544000;33496000;30864000;70965000;12281000;;42494000;54775000;125740000;19220000;19070000;38309000;3500000;6974000;45283000;13427000;;62937000;80457000;125740000
ESCA;918449;USD;2011;Q4;2011-12-31;2012-03-05;12882000;13435000;3821000;26914000;29035000;64146000;11915000;;54054000;65969000;130115000;17703000;16947000;34650000;5000000;7900000;42550000;12884000;;71348000;87565000;130115000
ESCA;918449;USD;2010;Q4;2010-12-31;2011-08-09;;;1536000;25458000;22888000;55010000;19844000;;52699000;72543000;127553000;17886000;12992000;30878000;7500000;9645000;40523000;12780000;;70329000;87030000;127553000
REZI;918602;USD;2018;Q4;2018-12-31;2019-03-18;122031000;122531000;265000000;821000000;628000000;1809000000;300000000;;2863000000;3163000000;4972000000;1467000000;22000000;1489000000;1179000000;1950000000;3439000000;1720000000;;2000000;1533000000;4972000000
REZI;918602;USD;2017;Q4;2017-12-31;2018-11-13;121095000;121095000;56000000;779000000;465000000;1392000000;265000000;;2816000000;3081000000;4473000000;1087000000;;1147000000;;723000000;1870000000;0;;;2603000000;4473000000
AREX;919131;USD;2018;Q4;2018-12-31;2019-03-18;94851865;94851865;22000;6710000;;16225000;1068422000;;;1068422000;1084647000;16109000;;321584000;84486000;173818000;495402000;745076000;;-155831000;589245000;1084647000
AREX;919131;USD;2017;Q4;2017-12-31;2018-03-09;90365237;90365237;21000;9678000;;16700000;1082876000;;;1082876000;1099576000;17523000;;314342000;84185000;177818000;492160000;743336000;;-135920000;607416000;1099576000
AREX;919131;USD;2016;Q4;2016-12-31;2017-03-10;41709188;41709188;21000;9547000;;12494000;1092061000;;;1092061000;1104555000;17299000;;298065000;226653000;243538000;541603000;586513000;;-23561000;562952000;1104555000
AREX;919131;USD;2015;Q4;2015-12-31;2016-03-04;40603790;40603790;600000;11747000;;20438000;1154546000;;;1154546000;1174984000;24263000;;299256000;225839000;267761000;567017000;581031000;;26936000;607967000;1174984000
LTHM;920443;USD;2018;Q4;2018-12-31;2019-02-28;141708000;141708000;28300000;141400000;71800000;301300000;275700000;;83000000;358700000;660000000;120400000;;120400000;34000000;51700000;172100000;511200000;;25900000;487900000;660000000
LTHM;920443;USD;2017;Q4;2017-12-31;2018-11-06;123000000;123000000;1200000;122700000;49600000;206100000;220700000;;69400000;290100000;496200000;84200000;;86000000;0;455800000;541800000;0;;0;-45600000;496200000
PAYS;921205;USD;2015;Q4;2015-12-31;2016-03-30;42596951;;1389494;16742;;8724406;271967;;1267702;1539669;10264075;465318;174098;8744823;0;339183;9084006;6622019;-150000;-5200412;1180069;10264075
PAYS;921205;USD;2014;Q4;2014-12-31;2015-03-25;38377868;;3886968;86658;;11980383;206929;;770170;977099;12957482;1380599;325446;10178300;;0;10178300;5671555;-150000;-2790075;2779182;12957482
NX;921442;USD;2018;Q4;2018-10-31;2018-12-11;34506000;34579000;29003000;84014000;70730000;191043000;201370000;;350801000;552171000;743214000;101137000;1224000;102361000;209332000;245631000;347992000;255052000;-73029000;243904000;395222000;743214000
NX;921442;USD;2017;Q4;2017-10-31;2017-12-12;34495000;35600000;17455000;79411000;87529000;191801000;211131000;;370947000;582078000;773879000;85213000;21242000;106455000;218184000;260577000;367032000;256094000;-49875000;225704000;406847000;773879000
NX;921442;USD;2016;Q4;2016-10-31;2016-12-16;33952000;33376000;25526000;83625000;84335000;203974000;198497000;;377882000;576379000;780353000;103614000;10520000;114134000;259011000;298388000;412522000;254916000;-62367000;214047000;367831000;780353000
NX;921442;USD;2015;Q4;2015-10-31;2015-12-15;33654000;34621000;23125000;64080000;63029000;158226000;140672000;;266618000;407290000;565516000;85889000;2359000;88248000;53767000;81973000;170221000;251313000;-68107000;222138000;395295000;565516000
NX;921442;USD;2014;Q4;2014-10-31;2014-12-12;36996000;38052000;120384000;55193000;57358000;260429000;109487000;;147197000;256684000;517113000;74077000;199000;74276000;586000;21917000;96193000;249976000;-25667000;202319000;420920000;517113000
NX;921442;USD;2013;Q4;2013-10-31;2013-12-18;36941000;36384000;49734000;59460000;41679000;236283000;106821000;;228711000;335532000;571815000;72342000;162000;121868000;701000;33753000;155621000;248019000;-6881000;177456000;416194000;571815000
NX;921442;USD;2012;Q4;2012-10-31;2012-12-31;36737000;36211000;71255000;85644000;65904000;250870000;168877000;;169791000;338668000;589538000;127444000;368000;127812000;10860000;39899000;167711000;245522000;-11501000;193105000;421827000;589538000
NX;921442;USD;2011;Q4;2011-10-31;2011-12-20;36719000;38280000;89619000;81969000;55842000;245073000;158209000;;181647000;339856000;584929000;104397000;352000;104749000;12535000;42954000;147703000;242361000;-14636000;213143000;437226000;584929000
NX;921442;USD;2010;Q4;2010-10-31;2011-03-11;36833000;37012000;187178000;87007000;45200000;338623000;135517000;;117110000;252627000;591250000;114433000;327000;114790000;13643000;35028000;149818000;238458000;-5635000;210366000;441432000;591250000
HCSG;923327;USD;2018;Q4;2018-12-31;2019-03-18;74094000;74657000;102387000;341838000;41443000;508136000;12900000;43043000;128524000;184467000;692603000;133391000;;163391000;58904000;88432000;251823000;260193000;-9663000;190092000;440780000;692603000
HCSG;923327;USD;2017;Q4;2017-12-31;2018-02-23;73609000;74639000;82778000;378720000;42393000;527406000;13509000;15476000;119612000;148597000;676003000;148786000;;184168000;62454000;91883000;276051000;245113000;-9858000;163860000;399952000;676003000
HCSG;923327;USD;2016;Q4;2016-12-31;2017-02-24;73245000;73974000;91583000;271276000;37800000;414624000;13455000;7531000;92836000;113822000;528446000;100871000;;100871000;64080000;88733000;189604000;218406000;-10185000;130940000;338842000;528446000
HCSG;923327;USD;2015;Q4;2015-12-31;2016-02-19;72169000;72912000;102685000;214854000;36308000;365342000;13086000;2972000;99549000;115607000;480949000;96065000;;96065000;62510000;88428000;184493000;200032000;-11005000;106886000;296456000;480949000
HCSG;923327;USD;2014;Q4;2014-12-31;2015-02-19;71032000;72415000;87079000;198128000;35462000;334828000;12772000;5179000;116800000;134751000;469579000;117959000;;117959000;50514000;75790000;193749000;186751000;-11183000;100237000;275830000;469579000
HCSG;923327;USD;2013;Q4;2013-12-31;2014-02-21;70056000;70918000;75600000;189107000;32447000;309192000;11304000;5779000;99067000;116150000;425342000;99103000;;99103000;18325000;41096000;140199000;169048000;-11418000;127464000;285143000;425342000
HCSG;923327;USD;2012;Q4;2012-12-31;2013-02-21;68013000;68992000;90271000;140218000;28675000;267846000;10272000;1823000;51242000;63337000;331183000;67089000;;67664000;15712000;33949000;101613000;114195000;-11794000;127042000;229570000;331183000
HCSG;923327;USD;2011;Q4;2011-12-31;2012-02-23;66920000;67811000;69976000;130744000;25144000;232121000;9763000;1483000;46328000;57574000;289695000;44436000;;45387000;12358000;26582000;71969000;106422000;-15960000;126921000;217726000;289695000
HCSG;923327;USD;2010;Q4;2010-12-31;2011-02-18;-161500;-42500;83129000;108426000;20614000;221775000;6656000;5055000;44448000;56159000;277934000;39927000;;40531000;11845000;24324000;64855000;100831000;-18667000;130993000;213079000;277934000
HCSG;923327;USD;2009;Q4;2009-12-31;2010-07-23;65574000;66708000;83949000;104356000;16974000;212170000;4391000;4623000;44708000;53722000;265892000;34717000;;34717000;11302000;22401000;57118000;92797000;-19860000;135837000;208774000;265892000
IPHI;923419;USD;2018;Q4;2018-12-31;2019-02-28;44167582;44167582;407357000;61271000;33052000;511280000;70740000;;307853000;378593000;889873000;34692000;;64443000;447825000;458736000;523179000;536201000;;-169896000;366694000;889873000
IPHI;923419;USD;2017;Q4;2017-12-31;2018-02-28;42602826;42602826;405187000;67993000;31721000;517109000;60344000;;340053000;400397000;917506000;38225000;;60047000;421431000;446058000;506105000;484977000;;-74145000;411401000;917506000
IPHI;923419;USD;2016;Q4;2016-12-31;2017-03-01;41236704;44920895;394343000;49999000;32039000;499520000;44471000;;446604000;491075000;990595000;37904000;;66270000;396857000;461801000;528071000;459969000;;1976000;462524000;990595000
IPHI;923419;USD;2015;Q4;2015-12-31;2016-02-29;39302901;39302901;326660000;30418000;12628000;378875000;33624000;;92547000;126171000;505046000;22816000;;33978000;171701000;180398000;214376000;392655000;;-102741000;290670000;505046000
IPHI;923419;USD;2014;Q4;2014-12-31;2015-03-10;37099544;35464801;69274000;36914000;26650000;140499000;35498000;;102462000;137960000;278459000;22328000;;31876000;0;7409000;39285000;327512000;;-89190000;239174000;278459000
IPHI;923419;USD;2013;Q4;2013-12-31;2014-03-05;30182927;30182927;122557000;13073000;6767000;146097000;22460000;;13785000;36245000;182342000;13517000;;17084000;;5865000;22949000;225037000;;-66582000;159393000;182342000
IPHI;923419;USD;2012;Q4;2012-12-31;2013-03-07;28663159;28663159;121268000;13717000;4894000;144397000;13893000;;11784000;25677000;170074000;11480000;;13087000;;4022000;17109000;205298000;;-53404000;152965000;170074000
IPHI;923419;USD;2011;Q4;2011-12-31;2012-03-15;27768098;31069946;118979000;9358000;5716000;140085000;9566000;;22977000;32543000;172628000;8761000;;10690000;;3534000;14224000;190342000;;-32713000;158404000;172628000
IPHI;923419;USD;2010;Q4;2010-12-31;2011-08-09;13794875;17282336;110172000;10052000;5095000;130564000;7206000;;21187000;28393000;158957000;10284000;;13677000;;2594000;16271000;176530000;;-34644000;142686000;158957000
TLND;923420;USD;2018;Q4;2018-12-31;2019-02-28;;;;;;120659000;25725000;;72740000;98465000;219124000;42235000;208000;169508000;676000;25177000;194685000;248006000;;;24439000;219124000
TLND;923420;USD;2017;Q4;2017-12-31;2019-02-28;;;;;;152464000;3473000;;16861000;20334000;172798000;31707000;1188000;151496000;7000;22412000;173908000;218449000;;;-1110000;172798000
SNBR;925649;USD;2018;Q4;2018-12-31;2019-02-26;32411000;33430000;1612000;24795000;84882000;150857000;205631000;;113650000;319281000;470138000;164688000;199600000;488668000;;91020000;579688000;309000;;-109859000;-109550000;470138000
SNBR;925649;USD;2017;Q4;2017-12-31;2018-02-27;39627000;41397000;3651000;19312000;84298000;152491000;208646000;;110697000;319343000;471834000;148464000;24500000;306389000;;76289000;382678000;388000;;88768000;89156000;471834000
SNBR;925649;USD;2016;Q4;2016-12-31;2017-02-24;44501000;45369000;11609000;19705000;75026000;138327000;208367000;;110472000;318839000;457166000;120597000;0;225317000;;71529000;296846000;436000;;159884000;160320000;457166000
SNBR;925649;USD;2015;Q4;2015-12-31;2016-03-01;50045000;50833000;27561000;29002000;86600000;182391000;204376000;8553000;105577000;318506000;500897000;124503000;;224949000;;53609000;278558000;494000;;221859000;222339000;500897000
SNBR;925649;USD;2014;Q4;2014-12-31;2015-02-27;52776000;53633000;121604000;19693000;53535000;232595000;165453000;44441000;31698000;241592000;474187000;99459000;;187052000;;30228000;217280000;528000;;256413000;256907000;474187000
SNBR;925649;USD;2013;Q4;2013-12-31;2014-02-21;54486000;55226000;110382000;14979000;40152000;189539000;129542000;34632000;28052000;192226000;381765000;82824000;;137182000;;19363000;156545000;5931000;;219276000;225220000;381765000
SNBR;925649;USD;2012;Q4;2012-12-31;2013-02-21;55261000;56484000;139179000;16613000;35564000;210578000;79356000;38642000;13445000;131443000;342021000;73033000;;133061000;;15263000;148324000;34482000;;159195000;193697000;342021000
SNBR;925649;USD;2011;Q4;2011-12-31;2012-02-28;55426000;56849000;136275000;13844000;24851000;191195000;43850000;10042000;17570000;71462000;262657000;50141000;;119050000;;14216000;133266000;48265000;;81101000;129391000;262657000
SNBR;925649;USD;2010;Q4;2010-12-31;2011-08-01;54365000;55459000;76016000;9909000;19647000;116909000;32953000;0;20095000;53048000;169957000;42025000;;96856000;;15124000;111980000;37354000;;20623000;57977000;169957000
PLAN;925650;USD;2018;Q4;2019-01-31;2019-03-29;122064000;122064000;326863000;92597000;;448664000;43340000;;36765000;80105000;528769000;58752000;;208363000;;12928000;221291000;653750000;;-343236000;307478000;528769000
PLAN;925650;USD;2017;Q4;2018-01-31;2018-12-10;20408000;20408000;110898000;66061000;;198074000;18321000;;30352000;48673000;246747000;33102000;;134149000;;959000;135108000;325834000;;-212220000;111639000;246747000
ICHR;926863;USD;2018;Q4;2018-12-31;2019-03-08;22768702;22981881;43834000;40287000;121106000;211575000;41740000;;232174000;273914000;485489000;73856000;8750000;87754000;192117000;199409000;287163000;228360000;-89979000;59945000;198326000;485489000
ICHR;926863;USD;2017;Q4;2017-12-31;2018-03-13;25702231;26891933;68794000;49249000;154541000;278454000;34380000;;244850000;279230000;557684000;133616000;6490000;147221000;180247000;193701000;340922000;214700000;;2062000;216762000;557684000
ICHR;926863;USD;2016;Q4;2016-12-31;2017-05-12;5755840;6985528;50854000;26401000;70881000;157090000;12018000;;113383000;125401000;282491000;95085000;;101070000;37944000;39762000;140832000;196051000;;-54392000;141659000;282491000
CCMP;927135;USD;2018;Q4;2018-09-30;2018-11-13;25541287;27167018;352921000;75886000;71926000;522781000;111403000;;146789000;258192000;780973000;101154000;0;101154000;0;13127000;114281000;622534000;-432054000;471673000;666692000;780973000
CCMP;927135;USD;2017;Q4;2017-09-30;2017-11-15;25220465;25731068;397890000;64793000;71873000;550982000;106361000;;176757000;283118000;834100000;80275000;10938000;91213000;132997000;147850000;239063000;580973000;-387766000;397881000;595037000;834100000
CCMP;927135;USD;2016;Q4;2016-09-30;2016-11-16;24174465;24626041;287479000;62830000;72123000;436830000;106496000;;183904000;290400000;727230000;58229000;7656000;65885000;146961000;163697000;229582000;530874000;-373558000;330776000;497648000;727230000
CCMP;927135;USD;2015;Q4;2015-09-30;2015-11-18;24117603;24535379;354190000;49405000;70678000;494508000;93743000;;72223000;165966000;660474000;51894000;8750000;60644000;155313000;170866000;231510000;495706000;-344740000;284088000;428964000;660474000
CCMP;927135;USD;2014;Q4;2014-09-30;2014-11-19;23491590;24310140;284155000;60693000;64979000;427993000;100821000;;72353000;173174000;601167000;46698000;8750000;55448000;164063000;173717000;229165000;437298000;-302493000;227942000;372002000;601167000
CCMP;927135;USD;2013;Q4;2013-09-30;2013-11-20;22926593;23796264;226029000;54640000;63786000;362798000;111985000;;76809000;188794000;551592000;57283000;10938000;68221000;150937000;159929000;228150000;376236000;-247421000;177191000;323442000;551592000
CCMP;927135;USD;2012;Q4;2012-09-30;2012-11-20;21629632;22476192;178459000;53506000;66472000;317888000;125020000;;74917000;199937000;517825000;52280000;10939000;63219000;161894000;171015000;234234000;329811000;-206127000;129441000;283591000;517825000
CCMP;927135;USD;2011;Q4;2011-09-30;2011-11-22;22721272;23117416;302546000;52747000;56128000;430405000;130791000;;67033000;197824000;628229000;55540000;10000;55550000;2000;6325000;61875000;278388000;-171590000;435429000;566354000;628229000
CCMP;927135;USD;2010;Q4;2010-09-30;2010-11-23;22763000;22835000;254164000;57456000;51896000;381029000;115811000;;74916000;190727000;571756000;52034000;1296000;53330000;12000;4083000;57413000;228129000;-116091000;383767000;514343000;571756000
CCMP;927135;USD;2009;Q4;2009-09-30;2010-08-06;23118000;23186000;199952000;53538000;44940000;316852000;122782000;;75510000;198292000;515144000;38326000;1210000;39536000;1308000;4879000;44415000;213057000;-90327000;334309000;470729000;515144000
DLPH;928642;USD;2018;Q4;2018-12-31;2019-02-21;88490000;88620000;359000000;878000000;521000000;1931000000;1445000000;44000000;473000000;1962000000;3893000000;1334000000;43000000;1377000000;1488000000;2078000000;3455000000;408000000;;296000000;438000000;3893000000
DLPH;928642;USD;2017;Q4;2017-12-31;2018-02-26;88610000;88810000;338000000;1090000000;498000000;2058000000;1316000000;37000000;382000000;1735000000;3793000000;1376000000;20000000;1396000000;1515000000;2165000000;3561000000;432000000;;7000000;232000000;3793000000
DLPH;928642;USD;2016;Q4;2016-12-31;2018-02-26;88610000;88610000;101000000;;374000000;1402000000;1142000000;34000000;321000000;1497000000;2899000000;331000000;2000000;1082000000;6000000;635000000;1717000000;;;;1182000000;2899000000
TLRD;929181;USD;2018;Q4;2019-02-28;2019-03-29;50126000;50607000;55431000;73073000;830426000;1029642000;439172000;;351676000;790848000;1820490000;526976000;11619000;538595000;1153242000;1278264000;1816859000;505658000;;-468048000;3631000;1820490000
TLRD;929181;USD;2017;Q4;2018-02-28;2018-03-30;49255000;50119000;103607000;79783000;851931000;1113573000;460674000;;425708000;886382000;1999955000;436764000;7000000;443764000;1389808000;1553999000;1997763000;492140000;;-479166000;2192000;1999955000
TLRD;929181;USD;2016;Q4;2017-02-28;2017-03-24;48718000;49072000;70889000;65714000;955512000;1165717000;484165000;;447990000;932155000;2097872000;446541000;13379000;459920000;1582150000;1745570000;2205490000;471288000;;-538823000;-107618000;2097872000
TLRD;929181;USD;2015;Q4;2016-02-29;2016-03-25;48379000;47840000;29980000;63890000;1022504000;1259920000;521824000;;462575000;984399000;2244319000;493876000;42451000;536327000;1613473000;1808078000;2344405000;456250000;-2974000;-524876000;-100086000;2244319000
TLRD;929181;USD;2014;Q4;2015-02-28;2015-03-27;48041000;47225000;62261000;73266000;938336000;1243672000;566074000;;1698466000;2264540000;3508212000;480411000;11000000;491411000;1637686000;2047012000;2538423000;441389000;-3192000;537263000;969789000;3508212000
TLRD;929181;USD;2013;Q4;2014-02-28;2014-04-01;47410000;47854000;59252000;63153000;599486000;815097000;408162000;;331971000;740133000;1555230000;325289000;10000000;335289000;87500000;196792000;532081000;412519000;-3407000;572712000;1023149000;1555230000
TLRD;929181;USD;2012;Q4;2013-02-28;2013-04-03;50830000;51016000;156063000;63010000;556531000;855153000;389118000;;252076000;641194000;1496347000;129839000;;294183000;;92929000;387112000;386979000;-517894000;1190246000;1109235000;1496347000
TLRD;929181;USD;2011;Q4;2012-02-29;2012-03-28;51175000;51440000;125306000;56669000;572502000;825383000;355717000;;224852000;580569000;1405952000;281275000;;281275000;;92858000;374133000;363453000;-476749000;1095535000;1031819000;1405952000
TLRD;929181;USD;2010;Q4;2011-02-28;2011-03-30;52821000;53083000;136371000;60607000;486499000;764008000;332611000;;223699000;556310000;1320318000;266656000;;266656000;;69809000;336465000;342373000;-412761000;1002975000;983853000;1320318000
TLRD;929181;USD;2009;Q4;2010-02-28;2010-09-09;52304000;52466000;186018000;16745000;434881000;710376000;344746000;;179030000;523776000;1234152000;224035000;;224035000;43491000;105727000;329762000;328447000;-412626000;956032000;904390000;1234152000
FORM;931024;USD;2018;Q4;2018-12-31;2019-02-26;74108000;76891000;149003000;95333000;77706000;337820000;54054000;;336348000;390402000;728222000;67737000;29840000;104873000;;43185000;148058000;862971000;;-283587000;580164000;728222000
FORM;931024;USD;2017;Q4;2017-12-31;2018-02-27;70056000;76610000;140172000;81515000;67848000;305854000;46754000;;293966000;340720000;646574000;68740000;105671000;182768000;;5169000;187937000;843116000;;-387573000;458637000;646574000
FORM;931024;USD;2016;Q4;2016-12-31;2017-03-15;71259000;70843000;108905000;70225000;59806000;254709000;42663000;;321610000;364273000;618982000;64701000;12701000;86410000;125475000;131516000;217926000;833341000;;-428616000;401056000;618982000
FORM;931024;USD;2015;Q4;2015-12-31;2016-03-04;55259000;55259000;187589000;36725000;27223000;258018000;23853000;;60852000;84705000;342723000;39689000;0;43581000;0;4461000;48042000;718904000;;-422059000;294681000;342723000
FORM;931024;USD;2014;Q4;2014-12-31;2015-03-06;56473000;56473000;163837000;45152000;25548000;244274000;25498000;;74471000;99969000;344243000;41559000;;50070000;;4737000;54807000;711676000;;-420536000;289436000;344243000
FORM;931024;USD;2013;Q4;2013-12-31;2014-03-07;54610000;54610000;151091000;30189000;20707000;211651000;35190000;;93867000;129057000;340708000;30470000;270000;40799000;;5823000;46622000;695686000;;-401351000;294086000;340708000
FORM;931024;USD;2012;Q4;2012-12-31;2013-03-13;52746000;52746000;165788000;28919000;23616000;239172000;45515000;;110995000;156510000;395682000;38285000;913000;45387000;;11037000;56424000;681211000;;-343668000;339258000;395682000
FORM;931024;USD;2011;Q4;2011-12-31;2012-02-21;49928000;49928000;296691000;12662000;18092000;336975000;35132000;;10964000;46096000;383071000;23797000;0;28595000;;7824000;36419000;652024000;;-308122000;346652000;383071000
FORM;931024;USD;2010;Q4;2010-12-31;2011-08-03;;;347235000;28598000;25003000;416291000;37311000;;12452000;49763000;466054000;40887000;;45524000;;9329000;54853000;651315000;;-242141000;411201000;466054000
OLED;933165;USD;2017;Q4;2017-12-31;2018-02-22;46695800;46795924;420286000;52355000;36265000;519182000;56450000;14794000;189530000;260774000;779956000;48793000;;63824000;;57078000;120902000;611548000;-40158000;99126000;659054000;779956000
OLED;933165;USD;2016;Q4;2016-12-31;2017-02-23;44984316;45246887;328009000;24994000;17314000;385370000;27203000;14960000;200026000;242189000;627559000;27957000;;40206000;;58885000;99091000;604847000;-40158000;-25557000;528468000;627559000
OLED;933165;USD;2015;Q4;2015-12-31;2016-02-25;48549077;46818082;395494000;24729000;12748000;447684000;22407000;2187000;87134000;111728000;559412000;24236000;;34510000;;58137000;92647000;590367000;-40158000;-73627000;466765000;559412000
OLED;933165;USD;2014;Q4;2014-12-31;2015-02-26;46370324;46840653;288506000;22075000;37109000;370505000;19922000;3047000;96373000;119342000;489847000;24246000;;26823000;;14282000;41105000;581585000;-40158000;-88305000;448742000;489847000
OLED;933165;USD;2013;Q4;2013-12-31;2014-02-28;45996864;47260043;272610000;15657000;10595000;327048000;14893000;7417000;113396000;135706000;462754000;21295000;;23229000;;11839000;35068000;572869000;-10658000;-130159000;427686000;462754000
OLED;933165;USD;2012;Q4;2012-12-31;2013-02-27;46096430;48921737;243941000;8657000;11018000;267545000;11808000;1270000;104901000;117979000;385524000;17990000;;22299000;;12990000;35289000;565348000;-5202000;-204211000;350235000;385524000
OLED;933165;USD;2011;Q4;2011-12-31;2012-03-21;45716607;49664845;346089000;10727000;3843000;362304000;10884000;0;690000;11574000;373878000;13796000;;19517000;;12134000;31651000;561953000;0;-213871000;342227000;373878000
RGEN;933166;USD;2018;Q4;2018-12-31;2019-03-01;43881258;46713105;193822000;33151000;42263000;275739000;32180000;;466702000;498882000;774621000;26354000;103488000;129842000;;29211000;159053000;643029000;;-15568000;615568000;774621000
RGEN;933166;USD;2017;Q4;2017-12-31;2018-02-22;43709641;44561360;173759000;27738000;39004000;242782000;22417000;;478320000;500737000;743519000;25211000;0;25211000;99250000;126760000;151971000;629419000;;-31508000;591548000;743519000
RGEN;933166;USD;2016;Q4;2016-12-31;2017-02-23;33839000;34414113;141780000;16033000;24696000;184153000;14956000;;89804000;104760000;288913000;21075000;;21075000;95272000;99074000;120149000;242374000;;-59861000;168764000;288913000
RGEN;933166;USD;2015;Q4;2015-12-31;2016-02-25;32977760;33497108;71774000;11382000;17998000;103252000;13801000;1633000;27551000;42985000;146237000;18781000;;18781000;;4708000;23489000;202856000;;-71542000;122748000;146237000
RGEN;933166;USD;2014;Q4;2014-12-31;2015-03-17;33116934;33820649;58453000;8000000;12384000;80946000;14526000;3550000;29271000;47347000;128293000;10682000;;10682000;;5879000;16561000;198392000;;-80887000;111732000;128293000
RGEN;933166;USD;2013;Q4;2013-12-31;2014-03-14;31925365;32902550;61623203;11676950;11798638;86350599;12509223;12218602;7566480;32294305;118644904;11301171;;11301171;;3457631;14758802;190945194;;-89057422;103886102;118644904
RGEN;933166;USD;2012;Q4;2012-12-31;2013-03-15;31134696;31598736;40055016;13289273;11143695;66209451;9952461;9914855;10933396;30800712;97010163;10752228;;10752228;;2133339;12885567;187363203;;-105150577;84124596;97010163
AAC;939324;USD;2016;Q4;2016-12-31;2017-03-07;23058173;22989789;3964000;87334000;;96479000;141307000;;146098000;287405000;383884000;35897000;9445000;45342000;179661000;183754000;229096000;145987000;;19119000;154788000;383884000
CRAY;941302;USD;2018;Q4;2018-12-31;2019-02-12;40834000;40834000;228434000;87819000;80360000;420244000;35737000;;61151000;96888000;517132000;67355000;;129338000;;44415000;173753000;647045000;;-306874000;343379000;517132000
CRAY;941302;USD;2017;Q4;2017-12-31;2018-02-15;40312000;40312000;144323000;162034000;186307000;519643000;36623000;23367000;39124000;99114000;618757000;85224000;;165343000;;53117000;218460000;633408000;;-234026000;400297000;618757000
CRAY;941302;USD;2016;Q4;2016-12-31;2017-02-10;39977000;44693000;222962000;197941000;88254000;529163000;30620000;31050000;123739000;185409000;714572000;73006000;;156135000;;32961000;189096000;622604000;;-99910000;525476000;714572000
CRAY;941302;USD;2015;Q4;2015-12-31;2016-02-11;39539000;42680000;281585000;124719000;113655000;581286000;31079000;18317000;63493000;112889000;694175000;79368000;;166099000;;35566000;201665000;610279000;;-125411000;492510000;694175000
CRAY;941302;USD;2014;Q4;2014-12-31;2015-02-19;38927000;44638000;128922000;165113000;143632000;508562000;34793000;31089000;76990000;142872000;651434000;81038000;;146948000;;50632000;197580000;598390000;;-151039000;453854000;651434000
CRAY;941302;USD;2013;Q4;2013-12-31;2014-02-13;38250000;46026000;206681000;182527000;95129000;505336000;30278000;0;67752000;98030000;603366000;78920000;;170408000;;57371000;227779000;586243000;;-211509000;375587000;603366000
CRAY;941302;USD;2012;Q4;2012-12-31;2013-02-28;106337000;39569000;305628000;13440000;89796000;420687000;25543000;17577000;46507000;89627000;510314000;69275000;;137335000;;32433000;169768000;577938000;;-242573000;340546000;510314000
CRAY;941302;USD;2011;Q4;2011-12-31;2012-02-27;-101500000;39188000;50411000;72381000;97881000;237381000;16462000;0;29256000;45718000;283099000;55012000;;99648000;;16637000;116285000;564148000;;-403814000;166814000;283099000
CRAY;941302;USD;2010;Q4;2010-12-31;2011-07-28;34613000;38473000;57381000;106268000;49241000;222705000;17953000;;19970000;37923000;260628000;47432000;;97328000;;17479000;114807000;559058000;;-418143000;145821000;260628000
TBIO;941303;USD;2018;Q4;2018-12-31;2019-03-21;45466968;45466968;144103000;;;149602000;10245000;;127804000;138049000;287651000;11715000;2572000;14287000;103642000;148069000;162356000;371302000;;-246203000;125295000;287651000
TBIO;941303;USD;2017;Q4;2017-12-31;2018-08-09;7978183;7978183;58055000;;;63035000;6778000;;128734000;135512000;198547000;10482000;1296000;12085000;79713000;87081000;99166000;55214000;;-148808000;99381000;198547000
NGVC;941589;USD;2018;Q4;2018-09-30;2018-12-06;22343529;22343529;9398000;4738000;94228000;110954000;188768000;;7361000;196129000;307083000;78955000;736000;79691000;53598000;80666000;160357000;56259000;-1040000;91507000;146726000;307083000
NGVC;941589;USD;2017;Q4;2017-09-30;2017-12-07;22455071;22455071;6521000;4860000;93612000;108215000;184417000;;7359000;191776000;299991000;71013000;548000;71561000;61272000;94547000;166108000;55701000;-664000;78846000;133883000;299991000
NGVC;941589;USD;2016;Q4;2016-09-30;2016-12-08;22508075;22508075;4017000;3747000;86330000;97327000;178297000;;6622000;184919000;282246000;66063000;478000;66541000;58857000;88980000;155521000;55460000;-690000;71955000;126725000;282246000
NGVC;941589;USD;2015;Q4;2015-09-30;2015-12-10;22509183;22509183;2915000;2576000;74818000;82283000;145219000;;6422000;151641000;233924000;69545000;333000;69878000;27274000;48558000;118436000;55004000;0;60484000;115488000;233924000
NGVC;941589;USD;2014;Q4;2014-09-30;2014-12-11;22487622;22482256;5113000;2146000;58381000;67113000;120224000;;1648000;121872000;188985000;49657000;229000;49886000;21748000;40245000;90131000;54574000;;44280000;98854000;188985000
NGVC;941589;USD;2013;Q4;2013-09-30;2013-12-12;22597427;22416278;9281000;2401000;45472000;59865000;98910000;;1128000;100038000;159903000;38224000;174000;38398000;19648000;36972000;75370000;53726000;;30807000;84533000;159903000
NGVC;941589;USD;2012;Q4;2012-09-30;2013-01-31;22372184;22646599;18069000;1855000;37544000;58907000;64603000;974000;1178000;66755000;125662000;33815000;272000;34087000;5536000;18626000;52713000;52698000;;20255000;72949000;125662000
LKSD;941948;USD;2018;Q4;2018-12-31;2019-02-19;33300000;33000000;21000000;617000000;197000000;867000000;508000000;;379000000;887000000;1754000000;571000000;108000000;679000000;659000000;897000000;1576000000;828000000;-24000000;-42000000;178000000;1754000000
LKSD;941948;USD;2017;Q4;2017-12-31;2018-02-22;34900000;34600000;34000000;727000000;238000000;1046000000;576000000;;392000000;968000000;2014000000;645000000;123000000;768000000;699000000;998000000;1766000000;816000000;-2000000;-90000000;248000000;2014000000
LKSD;941948;USD;2016;Q4;2016-12-31;2017-02-23;32800000;34000000;95000000;667000000;193000000;976000000;608000000;;368000000;976000000;1952000000;531000000;52000000;583000000;742000000;1129000000;1712000000;770000000;0;1000000;240000000;1952000000
LKSD;941948;USD;2015;Q4;2015-12-31;2016-11-10;32400000;32400000;95000000;617000000;218000000;960000000;718000000;;333000000;1051000000;2011000000;492000000;2000000;494000000;3000000;240000000;734000000;0;;0;1277000000;2011000000
REI;942590;USD;2016;Q4;2016-12-31;2017-03-15;43905776;43905776;71086381;3453238;;75220915;210336124;;22040360;232376484;307597399;9099391;;9099391;;7957035;17056426;335246958;;-44705985;290540973;307597399
REI;942590;USD;2015;Q4;2015-12-31;2016-03-15;30466660;29415884;4431350;2507858;;8714491;241266527;;885227;242151754;250866245;11023269;;11333167;45900000;53301950;64635117;193299426;;-7068298;186231128;250866245
REI;942590;USD;2014;Q4;2014-12-31;2015-03-16;25762801;26822846;8622235;3616676;;15083298;152558162;;0;152558162;167641460;16241022;;16263051;0;8835879;25098930;140558057;;1984473;142542530;167641460
REI;942590;USD;2013;Q4;2013-12-31;2014-03-21;19087627;19087627;52350583;3888402;;56305036;55418382;;;55418382;111723418;6229490;;7231643;;1886061;9117704;109041741;;-6436027;102605714;111723418
INVA;942592;USD;2018;Q4;2018-12-31;2019-02-19;100983000;113304000;114908000;83286000;;199043000;160000;;348990000;349150000;548193000;5700000;;5700000;382855000;383441000;389141000;1257278000;;-1103692000;159052000;548193000
INVA;942592;USD;2017;Q4;2017-12-31;2018-02-23;105838000;118869000;129075000;70540000;;200369000;209000;;166759000;166968000;367337000;9742000;25000000;34742000;574362000;575302000;610044000;1259170000;-3263000;-1498748000;-242707000;367337000
INVA;942592;USD;2016;Q4;2016-12-31;2017-02-28;107997000;133445000;150433000;46847000;;198046000;368000;;180582000;180950000;378996000;11412000;7752000;20049000;708341000;711938000;731987000;1283162000;-3263000;-1632891000;-352991000;378996000
INVA;942592;USD;2015;Q4;2015-12-31;2016-02-24;115714000;115714000;187283000;26228000;;214325000;221000;;194386000;194607000;408932000;12606000;;13491000;250992000;738086000;751577000;1353047000;-3263000;-1692427000;-342645000;408932000
INVA;942592;USD;2014;Q4;2014-12-31;2015-02-27;114303000;114303000;240498000;10550000;;252182000;324000;42856000;226292000;269472000;521654000;12674000;;13756000;725636000;731247000;745003000;1453668000;-3263000;-1673667000;-223349000;521654000
INVA;942592;USD;2013;Q4;2013-12-31;2014-03-03;85565661;85565661;465125000;3181000;10406000;483198000;10238000;55374000;132445000;198057000;681255000;75115000;;84404000;287500000;297729000;382133000;1804163000;0;-1505203000;299122000;681255000
INVA;942592;USD;2012;Q4;2012-12-31;2013-02-26;31313574;20777484;248489000;1064000;7514000;261133000;9154000;95194000;3101000;107449000;368582000;23301000;;29966000;172500000;183588000;213554000;1489431000;;-1334502000;155028000;368582000
SAIA;942700;USD;2018;Q4;2018-12-31;2019-02-25;25792000;26148000;2194000;181612000;;213373000;893058000;;27312000;920370000;1133743000;78994000;18082000;209310000;104777000;228569000;437879000;254764000;;444481000;695864000;1133743000
SAIA;942700;USD;2017;Q4;2017-12-31;2018-02-22;25819000;26260000;4720000;170278000;;203249000;735780000;;28286000;764066000;967315000;57438000;14083000;166926000;118833000;217895000;384821000;246480000;;339500000;582494000;967315000
SAIA;942700;USD;2016;Q4;2016-12-31;2017-02-24;25086000;26034000;1539000;135083000;;166479000;604119000;;29772000;633891000;800370000;45149000;16762000;144944000;57042000;172348000;317292000;237871000;;248397000;483078000;800370000
SAIA;942700;USD;2015;Q4;2015-12-31;2016-02-26;24974000;25255000;124000;124222000;;158989000;539179000;;31025000;570204000;729193000;54754000;12432000;141380000;56540000;159924000;301304000;230618000;;200373000;427889000;729193000
SAIA;942700;USD;2014;Q4;2014-12-31;2015-02-27;24627000;25539000;4367000;128367000;;170176000;483640000;;13169000;496809000;666985000;42388000;9138000;130479000;73897000;169600000;300079000;223738000;;145357000;366906000;666985000
SAIA;942700;USD;2013;Q4;2013-12-31;2014-02-28;24248000;25385000;159000;117937000;;170253000;432226000;;14322000;446548000;616801000;50799000;7143000;140857000;69740000;171152000;312009000;213672000;;93366000;304792000;616801000
SAIA;942700;USD;2012;Q4;2012-12-31;2013-03-01;23865500;25089000;321000;106814000;;144163000;361704000;;13821000;375525000;519688000;43706000;22143000;141300000;38562000;123869000;265169000;206993000;;49739000;254519000;519688000
SAIA;942700;USD;2011;Q4;2011-12-31;2012-03-02;23695500;24115500;1317000;107436000;;142816000;324455000;;7615000;332070000;474886000;39783000;22143000;124348000;50714000;131237000;255585000;203809000;;17691000;219301000;474886000
SAIA;942700;USD;2010;Q4;2010-12-31;2011-08-03;23596500;24321000;29045000;94569000;;153496000;290938000;;7723000;298661000;452157000;37745000;17143000;105766000;72857000;140033000;245799000;202767000;;6318000;206358000;452157000
JCS;945747;USD;2018;Q4;2018-12-31;2019-03-08;9155884;9155884;11056426;13401042;16175616;42335092;10962239;;23833;10986072;53321164;11639770;;11639770;28267;28267;11668037;43138421;;-734001;41653127;53321164
JCS;945747;USD;2017;Q4;2017-12-31;2018-04-06;8968221;8968221;17994407;12183217;13984428;45466418;12624730;;55113;12679843;58146261;8960390;;8960390;15144;15144;8975534;42455435;;7328671;49170727;58146261
MGLN;945856;USD;2018;Q4;2018-12-31;2019-02-28;24045000;24193000;654890000;756059000;40818000;1547167000;150748000;3161000;1277980000;1431889000;2979056000;696980000;32274000;898893000;728608000;794860000;1693753000;1327180000;-1461002000;1419449000;1285303000;2979056000
MGLN;945856;USD;2017;Q4;2017-12-31;2018-03-01;23930000;25121000;709310000;660775000;40945000;1483353000;158638000;17287000;1297956000;1473881000;2957234000;595560000;119741000;892303000;740888000;788437000;1680740000;1275341000;-1397962000;1399495000;1276494000;2957234000
MGLN;945856;USD;2016;Q4;2016-12-31;2017-02-24;22525000;23558000;602001000;606764000;58995000;1319267000;172524000;7760000;944136000;1124420000;2443687000;481947000;413047000;1092850000;214686000;246348000;1339198000;1186803000;-1376197000;1289288000;1104489000;2443687000
MGLN;945856;USD;2015;Q4;2015-12-31;2016-02-29;23565000;25441000;571368000;428644000;50749000;1097682000;174745000;3826000;792807000;971378000;2069060000;476659000;110637000;724235000;238295000;272705000;996940000;1124526000;-1269391000;1211310000;1072120000;2069060000
MGLN;945856;USD;2014;Q4;2014-12-31;2015-02-26;25539000;26362000;479664000;353713000;39375000;1140323000;171916000;43293000;713411000;928620000;2068943000;489028000;24093000;585840000;254062000;343588000;929428000;1018767000;-1064963000;1179897000;1139515000;2068943000
MGLN;945856;USD;2013;Q4;2013-12-31;2014-03-03;27287000;28010000;379070000;238185000;49609000;989358000;172333000;32430000;565097000;769860000;1759218000;405846000;3005000;476267000;23720000;115912000;592179000;922799000;-866714000;1100493000;1167039000;1759218000
MGLN;945856;USD;2012;Q4;2012-12-31;2013-02-28;27507000;28022000;390591000;138253000;45727000;871418000;136548000;32563000;471604000;640715000;1512133000;316288000;;393202000;;101598000;494800000;848697000;-806561000;975232000;1017333000;1512133000
MGLN;945856;USD;2011;Q4;2011-12-31;2012-02-28;27660000;28235000;312809000;121606000;39567000;732709000;118022000;7956000;482480000;608458000;1341167000;263472000;;369550000;;126343000;495893000;804488000;-783269000;824205000;845274000;1341167000
MGLN;945856;USD;2010;Q4;2010-12-31;2011-02-25;33961000;34719000;526709000;106934000;27910000;858487000;111814000;94974000;484157000;690945000;1549432000;280325000;;389610000;559000;120807000;510417000;725759000;-381755000;694582000;1039015000;1549432000
MGLN;945856;USD;2009;Q4;2009-12-31;2010-07-30;34714000;34966000;359429000;114434000;;753588000;108219000;67523000;511711000;687453000;1441041000;264515000;;369164000;;121385000;490549000;614893000;-225820000;555923000;950492000;1441041000
CYIG;947023;USD;2017;Q4;2018-03-31;2018-06-29;29789168;29789168;25353360;174558;2383382;30065747;16793413;;63278939;80072352;110138099;1536980;;1982809;;;1982809;4352627;;94447937;108155290;110138099
CYIG;947023;USD;2016;Q4;2017-03-31;2017-06-29;29770220;29770220;10308622;1134967;5483040;18477966;14487135;;57321925;71809060;90287026;2985545;;2985545;;;2985545;4352627;;83061604;87301481;90287026
CYIG;947023;USD;2015;Q4;2016-03-31;2016-06-29;29720667;29720667;7639084;533262;2287312;10459658;12872997;;57946212;70819209;81278867;929316;;929316;;;929316;4678182;;72983301;80349551;81278867
CYIG;947023;USD;2014;Q4;2015-03-31;2015-07-13;29738206;29738206;13083532;95544;896843;14075919;12864161;;50217795;63081956;77157875;1748384;;1748384;;;1748384;4240108;;64566532;75409491;77157875
CYIG;947023;USD;2013;Q4;2014-03-31;2014-06-30;29663023;29663023;18624644;42049;1592703;20619134;13384995;;33215751;46600746;67219880;846131;;846131;;;846131;4209758;;55676059;66373749;67219880
CYIG;947023;USD;2012;Q4;2013-03-31;2013-07-01;30226101;30226101;29924188;135237;1296550;31376947;9409916;;17877435;27287351;58664298;1253523;;1253523;;;1253523;4209758;;48426955;57410775;58664298
CYIG;947023;USD;2011;Q4;2012-03-31;2012-07-11;73780610;73780610;22146240;115938;1978488;24261553;9663338;;19083493;28746831;53008384;5785495;;5785495;;5531892;11317387;36953423;;417285;41690997;53008384
CYIG;947023;USD;2010;Q4;2011-03-31;2011-09-12;;;6046804;;59183;21708245;9629558;;40771204;50400762;72109007;1913505;;1913505;0;0;1913505;36942312;;30232764;70195502;72109007
CYIG;947023;USD;2009;Q4;2010-03-31;2012-06-08;;;11911933;;324855;12328750;5033596;;12720776;17754372;30083122;3771207;;3771207;0;0;3771207;4167941;;20012077;26311915;30083122
PLNT;948485;USD;2018;Q4;2018-12-31;2019-03-01;85765700;86438808;289431000;38960000;5122000;388540000;114367000;;850509000;964876000;1353416000;87577000;12000000;131403000;1170210000;1604802000;1736205000;19742000;;-394410000;-382789000;1353416000
PLNT;948485;USD;2017;Q4;2017-12-31;2018-03-01;86704455;86809209;113080000;37272000;2692000;177001000;83327000;;832137000;915464000;1092465000;78300000;7185000;112030000;702703000;1117372000;1229402000;12128000;;-130966000;-136937000;1092465000
PLNT;948485;USD;2016;Q4;2016-12-31;2017-03-06;55162875;55163207;40393000;26873000;1802000;91225000;61238000;;848979000;910217000;1001442000;55769000;7185000;83273000;707111000;1132924000;1216197000;34477000;;-164062000;-214755000;1001442000
PLNT;948485;USD;2015;Q4;2015-12-31;2016-03-04;144869017;144679870;31430000;19079000;4557000;72945000;56139000;;570093000;626232000;699177000;40636000;5100000;66252000;484333000;634005000;700257000;362000;;-14032000;-1080000;699177000
PLNT;948485;USD;2014;Q4;2014-12-31;2015-11-13;;;43291000;19275000;3012000;75318000;49579000;2007000;475078000;526664000;601982000;35232000;3900000;60885000;378893000;389348000;450233000;146156000;;;151749000;601982000
DDS;949971;USD;2018;Q4;2019-02-28;2019-03-29;26483000;26483000;123509000;49853000;1528417000;1770532000;1586733000;;74104000;1660837000;3431369000;932321000;0;933535000;365569000;819453000;1752988000;950074000;-3716890000;4458006000;1678381000;3431369000
DDS;949971;USD;2017;Q4;2018-02-28;2018-03-30;28394000;28394000;187028000;38437000;1463561000;1739385000;1696276000;;247042000;1943318000;3682703000;887201000;162034000;1049235000;368309000;925313000;1974548000;947386000;-3589006000;4365219000;1708155000;3682703000
DDS;949971;USD;2016;Q4;2017-02-28;2017-03-24;33082000;33082000;346985000;48230000;1406403000;1837921000;1790267000;;259948000;2050215000;3888136000;886035000;90482000;976517000;530094000;1194202000;2170719000;944705000;-3369995000;4153844000;1717417000;3888136000
DDS;949971;USD;2015;Q4;2016-02-29;2016-03-23;36391000;36391000;202869000;47138000;1374505000;1668883000;1939832000;;255186000;2195018000;3863901000;747932000;3284000;751216000;620330000;1317380000;2068596000;942034000;-3123822000;3994211000;1795305000;3863901000
DDS;949971;USD;2014;Q4;2015-02-28;2015-03-25;41175000;41175000;403752000;56510000;1374481000;1888442000;2029171000;;252458000;2281629000;4170071000;799804000;840000;800644000;620704000;1350157000;2150801000;939230000;-2623822000;3734891000;2019270000;4170071000
DDS;949971;USD;2013;Q4;2014-02-28;2014-03-27;43926000;43926000;237134000;30840000;1345321000;1660156000;2134200000;;256383000;2390583000;4050739000;777527000;784000;778311000;621544000;1280231000;2058542000;936445000;-2333414000;3413240000;1992197000;4050739000
DDS;949971;USD;2012;Q4;2013-02-28;2013-03-28;47705000;47997000;124060000;31519000;1294581000;1491980000;2287015000;;269749000;2556764000;4048744000;765406000;1710000;767116000;622309000;1311453000;2078569000;933732000;-2031848000;3099566000;1970175000;4048744000
DDS;949971;USD;2011;Q4;2012-02-29;2012-03-22;50228000;51070000;224272000;28708000;1304124000;1591729000;2440266000;;274142000;2714408000;4306137000;791263000;79101000;870364000;623938000;1383754000;2254118000;830021000;-1846312000;3107344000;2052019000;4306137000
DDS;949971;USD;2010;Q4;2011-02-28;2011-03-23;61783000;62791000;343291000;25950000;1290147000;1701926000;2595514000;;76726000;2672240000;4374166000;779862000;51350000;831212000;708629000;1456234000;2287446000;806639000;-1355526000;2653437000;2086720000;4374166000
DDS;949971;USD;2009;Q4;2010-02-28;2010-09-02;;;341693000;63222000;1300680000;1749529000;2780837000;;75961000;2856798000;4606327000;765528000;3494000;769022000;770009000;1533202000;2302224000;783955000;-942001000;2484447000;2304103000;4606327000
GLW;261761;USD;2016;Q4;2016-12-31;2017-02-06;940000000;1189000000;5291000000;1481000000;1471000000;9048000000;12546000000;336000000;5969000000;18851000000;27899000000;2495000000;256000000;2751000000;3646000000;7188000000;9939000000;14541000000;-14152000000;16880000000;17960000000;27899000000
GLW;261761;USD;2015;Q4;2015-12-31;2016-02-12;1154000000;1389000000;4600000000;1372000000;1385000000;8269000000;12648000000;1975000000;5635000000;20258000000;28527000000;2242000000;572000000;2814000000;3890000000;6850000000;9664000000;14192000000;-9725000000;13832000000;18863000000;28527000000
GLW;261761;USD;2014;Q4;2014-12-31;2015-02-13;1275000000;1612000000;6068000000;1501000000;1322000000;10238000000;12766000000;1801000000;5258000000;19825000000;30063000000;2288000000;36000000;2324000000;3227000000;6087000000;8411000000;14292000000;-6727000000;13021000000;21652000000;30063000000
GLW;261761;USD;2013;Q4;2013-12-31;2014-02-10;1413000000;1426000000;5235000000;1253000000;1270000000;8891000000;9801000000;5537000000;4249000000;19587000000;28478000000;1725000000;21000000;1746000000;3272000000;5521000000;7267000000;13897000000;-4099000000;11320000000;21211000000;28478000000
GLW;261761;USD;2012;Q4;2012-12-31;2013-02-13;1471000000;1482000000;6144000000;1302000000;1051000000;9695000000;10625000000;4915000000;4140000000;19680000000;29375000000;1880000000;76000000;1956000000;3382000000;5886000000;7842000000;13971000000;-2773000000;9932000000;21533000000;29375000000
GLW;261761;USD;2011;Q4;2011-12-31;2012-02-13;3113998432;3154998409;5825000000;1082000000;975000000;8677000000;10671000000;4726000000;3774000000;19171000000;27848000000;2070000000;27000000;2097000000;2364000000;4622000000;6719000000;13859000000;-2024000000;9332000000;21129000000;27848000000
GLW;261761;USD;2010;Q4;2010-12-31;2011-02-10;1562000000;4697000000;6350000000;973000000;738000000;8859000000;8943000000;4372000000;3659000000;16974000000;25833000000;1929000000;57000000;1986000000;2262000000;4421000000;6407000000;13678000000;-1227000000;6881000000;19426000000;25833000000
GLW;261761;USD;2009;Q4;2009-12-31;2010-02-10;1553000000;6224000000;3583000000;753000000;579000000;5521000000;7995000000;3992000000;3787000000;15774000000;21295000000;1465000000;74000000;1539000000;1930000000;4161000000;5700000000;13515000000;-1207000000;3636000000;15595000000;21295000000
GLW;261761;USD;2008;Q4;2008-12-31;2009-07-29;;;2816000000;512000000;798000000;4619000000;8199000000;3056000000;3382000000;14637000000;19256000000;1974000000;78000000;2052000000;1527000000;3713000000;5765000000;13306000000;-1160000000;1940000000;13491000000;19256000000
GLW;261761;USD;2017;Q4;2017-12-31;2018-02-15;864000000;601000000;4317000000;1807000000;1712000000;8827000000;14017000000;340000000;4310000000;18667000000;27494000000;2830000000;379000000;3209000000;4749000000;8515000000;11724000000;14943000000;-16633000000;15930000000;15770000000;27494000000
GLW;261761;USD;2018;Q4;2018-12-31;2019-02-12;792000000;1043000000;2355000000;1940000000;2037000000;7034000000;14895000000;376000000;5200000000;20471000000;27505000000;3307000000;4000000;3311000000;5994000000;10308000000;13619000000;15069000000;-18870000000;16303000000;13886000000;27505000000
VTR;398980;USD;2016;Q4;2016-12-31;2017-02-14;354078000;357601000;286707000;;;422315000;20394754000;702021000;1647510000;22744285000;23166600000;991690000;;993152000;11127326000;11443967000;12437119000;13005516000;-47000;-2487695000;10729481000;23166600000
VTR;398980;USD;2015;Q4;2015-12-31;2016-02-12;332584000;336461000;53023000;;;223979000;19625220000;857112000;1555607000;22037939000;22261918000;860244000;;894584000;11206996000;11545378000;12439962000;11686417000;-2567000;-2111958000;9821956000;22261918000
VTR;398980;USD;2014;Q4;2014-12-31;2015-02-13;367878371;371142701;55348000;;;2682441000;16772990000;802881000;907601000;18483472000;21165913000;812839000;;1050812000;10844351000;11188688000;12239500000;10193962000;-511000;-1526388000;8926413000;21165913000
VTR;398980;USD;2013;Q4;2013-12-31;2014-02-18;402707664;406113659;94816000;;;179473000;18075586000;376229000;1100206000;19552021000;19731494000;1055864000;;1055864000;9364992000;9615159000;10671023000;10153080000;-221917000;-1126541000;9060471000;19731494000
VTR;398980;USD;2012;Q4;2012-12-31;2013-02-19;258141473;260205498;67908000;;;173821000;17111532000;635002000;1059645000;18806179000;18980000000;1042721000;;1042721000;8413646000;8673361000;9716082000;9994866000;-221165000;-777927000;9263918000;18980000000
VTR;398980;USD;2011;Q4;2011-12-31;2012-02-22;253747211;256052929;45807000;;;122397000;15913732000;212577000;1023204000;17149513000;17271910000;1123291000;;1123291000;6429116000;6689838000;7813129000;9665823000;-747000;-412181000;9458781000;17271910000
VTR;398980;USD;2010;Q4;2010-12-31;2011-03-01;137254591;138604920;21812000;;;60752000;5279519000;149263000;268487000;5697269000;5758021000;226439000;;226439000;2900044000;3141377000;3367816000;2616234000;-748000;-255628000;2390205000;5758021000
VTR;398980;USD;2009;Q4;2009-12-31;2010-02-19;137031287;137363178;107397000;;;147229000;5129107000;131887000;208022000;5469016000;5616245000;208419000;;208419000;2670101000;2923766000;3132185000;2612199000;-647000;-165710000;2484060000;5616245000
VTR;398980;USD;2008;Q4;2008-12-31;2009-08-05;125215467;125287275;176812000;;;232678000;5172939000;123289000;242512000;5538740000;5771418000;190129000;;197186000;3136998000;3394497000;3591683000;2299950000;-457000;-117806000;2179735000;5771418000
VTR;398980;USD;2017;Q4;2017-12-31;2018-02-09;355941000;359048000;81355000;;;288577000;20588380000;1346359000;1731225000;23665964000;23954541000;1276510000;;1337712000;11276062000;11526154000;12863866000;13142086000;-42000;-2240698000;11090675000;23954541000
VTR;398980;USD;2018;Q4;2018-12-31;2019-02-08;356402000;359996000;72277000;;;136918000;20093657000;495869000;1858111000;22447637000;22584555000;1185697000;;1185902000;10733699000;10938918000;12124820000;13165653000;0;-2930214000;10459735000;22584555000
OMC;251397;USD;2018;Q4;2018-12-31;2019-02-12;224600000;224900000;3657900000;7666100000;1161500000;13726900000;694400000;120900000;10074800000;10890100000;24617000000;12623300000;507700000;15270200000;4384100000;5995600000;21265800000;773400000;-4013900000;7016100000;3351200000;24617000000
OMC;251397;USD;2017;Q4;2017-12-31;2018-02-15;231300000;232400000;3796400000;8083800000;1110600000;14116000000;690900000;120300000;10004000000;10815200000;24931200000;12841300000;11800000;15108900000;4912900000;6487700000;21596600000;872900000;-3505400000;6210600000;3334600000;24931200000
OMC;251397;USD;2016;Q4;2016-12-31;2017-02-09;236500000;238000000;3022800000;7510800000;1125400000;12722000000;674800000;120400000;9648200000;10443400000;23165400000;11663300000;28800000;14010900000;4920500000;6293300000;20304200000;842900000;-3002100000;5677200000;2861200000;23165400000
OMC;251397;USD;2015;Q4;2015-12-31;2016-02-09;242700000;243300000;2619700000;7220900000;1122700000;11980500000;692700000;136600000;9300900000;10130200000;22110700000;11095500000;1006600000;14219600000;3564200000;4833800000;19053400000;919500000;-7629900000;10178200000;3057300000;22110700000
OMC;251397;USD;2014;Q4;2014-12-31;2015-02-10;248900000;249200000;2390300000;6524700000;1166600000;11079700000;708000000;148200000;9492500000;10348700000;21428400000;9978400000;7600000;12061100000;4542100000;5860300000;17921400000;878200000;-6986900000;9576900000;3507000000;21428400000
OMC;251397;USD;2013;Q4;2013-12-31;2014-02-12;258700000;259300000;2728700000;6632600000;1288000000;11652300000;737400000;131800000;9577200000;10446400000;22098700000;9601100000;6300000;12277700000;4033400000;5551100000;17828800000;876700000;-6063900000;8961200000;4269900000;22098700000
OMC;251397;USD;2012;Q4;2012-12-31;2013-02-19;264300000;262200000;2698900000;6958200000;1008400000;11661400000;723800000;155200000;9611500000;10490500000;22151900000;9528200000;6800000;11875800000;4448500000;6121400000;17997200000;896200000;-5700300000;8394400000;4154700000;22151900000
OMC;251397;USD;2011;Q4;2011-12-31;2012-02-17;276600000;278900000;1805000000;6632000000;1017500000;10421500000;682900000;184200000;9216800000;10083900000;20505400000;9285300000;10200000;11671000000;3182900000;4652500000;16323500000;1103100000;-5131200000;7724100000;4181900000;20505400000
OMC;251397;USD;2010;Q4;2010-12-31;2011-02-24;290400000;292500000;2300000000;5977200000;707600000;10194100000;653300000;299100000;8419600000;9372000000;19566100000;8914000000;51600000;11023100000;3124600000;4448800000;15471900000;1331500000;-4697100000;7052500000;4094200000;19566100000
OMC;251397;USD;2009;Q4;2009-12-31;2010-02-19;308800000;313100000;1594800000;5574100000;607600000;8788500000;677300000;299400000;8155500000;9132200000;17920700000;8203200000;37100000;10082500000;2220600000;3170700000;13253200000;1467800000;-3730400000;6465400000;4667500000;17920700000
OMC;251397;USD;2008;Q4;2008-12-31;2009-08-06;;;1112400000;5775500000;672000000;8564900000;719600000;297300000;7736600000;8753500000;17318400000;7886700000;18900000;9754200000;3054300000;3810800000;13565000000;1688600000;-3778100000;5859600000;3753400000;17318400000
WWE;641925;USD;2017;Q4;2017-12-31;2018-02-08;77119000;78635000;297444000;65245000;8332000;390982000;160917000;27367000;35241000;223525000;614507000;77738000;4638000;138194000;208858000;223354000;361548000;422979000;;-172391000;252959000;614507000
WWE;641925;USD;2016;Q4;2016-12-31;2017-02-09;76409000;78054000;267140000;53155000;6531000;349306000;172276000;24957000;54364000;251597000;600903000;70360000;6121000;133134000;196604000;228026000;361160000;404151000;;-167303000;239743000;600903000
WWE;641925;USD;2015;Q4;2015-12-31;2016-02-12;75907000;76671000;102376000;58437000;6167000;179758000;142986000;22278000;64123000;229387000;409145000;70001000;4440000;131593000;17135000;68235000;199828000;370402000;;-164096000;209317000;409145000
WWE;641925;USD;2014;Q4;2014-12-31;2015-02-18;75489000;75489000;115413000;40088000;4735000;197221000;146351000;7200000;31782000;185333000;382554000;57578000;4345000;100575000;21575000;76118000;176693000;354461000;;-151828000;205861000;382554000
WWE;641925;USD;2013;Q4;2013-12-31;2014-02-24;75105000;75527000;109387000;59552000;2874000;200197000;160270000;8299000;9696000;178265000;378462000;47882000;4251000;82245000;25385000;30269000;112514000;347725000;;-85289000;265948000;378462000
WWE;641925;USD;2012;Q4;2012-12-31;2013-03-01;74754000;75382000;152374000;50716000;1770000;234532000;132184000;5220000;9447000;146851000;381383000;48954000;0;77565000;0;9092000;86657000;342510000;;-51815000;294726000;381383000
WWE;641925;USD;2011;Q4;2011-12-31;2012-03-01;73419000;74223000;155761000;56741000;1658000;239743000;120404000;10156000;8321000;138881000;378624000;46283000;1262000;69254000;359000;14227000;83481000;339159000;;-47278000;295143000;378624000
WWE;641925;USD;2010;Q4;2010-12-31;2011-05-09;75170000;75450000;166947000;52051000;2087000;259069000;137248000;15037000;4375000;156660000;415729000;42919000;1169000;72411000;1621000;26570000;98981000;337332000;;-23728000;316748000;415729000
WWE;641925;USD;2018;Q4;2018-12-31;2019-02-07;78036000;94163000;359143000;78925000;7753000;474008000;169120000;30196000;26975000;226291000;700299000;120158000;5118000;174449000;208786000;209613000;384062000;416061000;;-101326000;316237000;700299000
CODA;511749;USD;2017;Q4;2017-10-31;2018-01-30;9131065;9531065;6851539;1418114;3652249;15257511;5213281;;3589281;8802562;24060073;1501202;;4117108;6066402;6115545;10232653;52848787;;-36982937;13827420;24060073
CODA;511749;USD;2016;Q4;2016-10-31;2017-06-14;12907962;6936534;5601767;3274204;2598925;15149121;3840500;;3845899;7686399;22835520;2190542;;3502077;9178930;9178930;12681007;52814549;;-40322600;10154513;22835520
CODA;511749;USD;2018;Q4;2018-10-31;2019-02-01;10432023;10232023;7512422;3326623;3823243;18122307;5246183;;5368121;10614304;28736611;1673602;;3241211;1059544;1108450;4349661;58610019;;-31994406;24386950;28736611
BR;143497;USD;2017;Q4;2017-06-30;2017-08-10;117000000;119400000;271100000;589500000;;989600000;198100000;;1962100000;2160200000;3149800000;662500000;;744900000;1102100000;1401100000;2146000000;989200000;-1398900000;1469400000;1003900000;3149900000
BR;143497;USD;2016;Q4;2016-06-30;2016-08-09;118200000;121000000;727700000;453400000;;1289100000;112200000;;1471400000;1583600000;2872700000;485400000;124800000;692900000;890700000;1134400000;1827300000;902800000;-1116900000;1297800000;1045500000;2872800000
BR;143497;USD;2015;Q4;2015-06-30;2015-08-07;119000000;122700000;324100000;444500000;;861400000;97300000;;1409400000;1506700000;2368100000;436300000;0;508900000;689400000;931400000;1440300000;857100000;-1040400000;1132000000;927800000;2368100000
BR;143497;USD;2014;Q4;2014-06-30;2014-08-07;120400000;124400000;347600000;424800000;;880600000;88300000;;1223200000;1311500000;2192100000;422900000;;484400000;524100000;746000000;1230400000;812300000;-834800000;973900000;961700000;2192100000
BR;143497;USD;2013;Q4;2013-06-30;2013-08-08;120400000;124000000;266000000;442400000;;807000000;80900000;;1130300000;1211200000;2018200000;420300000;;469500000;524500000;732700000;1202200000;784600000;-784100000;811300000;816000000;2018200000
BR;143497;USD;2012;Q4;2012-06-30;2012-08-09;125000000;127700000;320500000;370700000;;777400000;79000000;;1131200000;1210200000;1987600000;362800000;;410300000;524400000;726800000;1137100000;740900000;-580000000;686100000;850500000;1987600000
BR;143497;USD;2011;Q4;2011-06-30;2011-08-12;123500000;126900000;241500000;406600000;;751400000;83100000;;1069500000;1152600000;1904000000;349300000;400000000;782700000;124300000;324000000;1106700000;668900000;-529900000;642200000;797300000;1904000000
BR;143497;USD;2010;Q4;2010-06-30;2010-11-04;135000000;137700000;412600000;354300000;;992400000;87400000;;714600000;802000000;1794400000;352500000;;486400000;324100000;500900000;987300000;589300000;-327700000;546900000;807100000;1794400000
BR;143497;USD;2018;Q4;2018-06-30;2018-08-07;117200000;120600000;263900000;615000000;;991100000;204100000;;2109500000;2313600000;3304700000;671000000;;777300000;1053400000;1433000000;2210300000;1050100000;-1630800000;1727000000;1094400000;3304700000
BR;143497;USD;2019;Q4;2019-06-30;2019-08-06;115200000;117900000;273200000;664000000;;1042400000;189000000;;2649300000;2838300000;3880700000;711700000;0;802600000;1470400000;1950600000;2753200000;1110900000;-1999800000;2087700000;1127600000;3880800000
EXPE;112653;USD;2017;Q4;2017-12-31;2018-02-09;152275000;160216000;3315000000;1866000000;;5540000000;1575000000;845000000;10556000000;12976000000;18516000000;3834000000;500000000;7879000000;3749000000;4486000000;12365000000;9163000000;-4822000000;331000000;6151000000;18516000000
EXPE;112653;USD;2016;Q4;2016-12-31;2016-10-28;150625000;159248000;1869124000;1343247000;;3450251000;1394904000;520058000;10412333000;12327295000;15777546000;3226890000;0;6127198000;3159336000;3957245000;10084443000;8794321000;-4510655000;129034000;5693103000;15777546000
EXPE;112653;USD;2015;Q4;2015-12-31;2015-10-30;134197000;138293000;1710038000;1082406000;;2976261000;1064259000;642802000;10802353000;12509414000;15485675000;3353171000;;5926017000;3183140000;3971413000;9897430000;8696531000;-4054909000;507666000;5588245000;15485675000
EXPE;112653;USD;2014;Q4;2014-12-31;2014-10-31;127640000;136171000;1758480000;778334000;;2924489000;553126000;286882000;5256041000;6096049000;9020538000;2363151000;;4186615000;1746787000;2380121000;6566736000;5921161000;-3998120000;;2453802000;9020538000
EXPE;112653;USD;2013;Q4;2013-12-31;2013-10-31;131276000;141168000;1346543000;614735000;;2219287000;480702000;250626000;4788866000;5520194000;7739481000;1904316000;;3294381000;1249412000;1821244000;5115625000;5802160000;-3465675000;-209218000;2623856000;7739481000
EXPE;112653;USD;2012;Q4;2012-12-31;2012-10-26;135086000;140795000;1938143000;461531000;;2642266000;409373000;224231000;3856876000;4490480000;7132746000;1855369000;;3010075000;1249345000;1719810000;4729885000;5675095000;-2952790000;-442068000;2402861000;7132746000
EXPE;112653;USD;2011;Q4;2011-12-31;2011-11-07;133650000;136987000;1337953000;339427000;;2274429000;320282000;289348000;3621199000;4230829000;6505258000;1284694000;;2553357000;1249281000;1646734000;4200091000;5474672000;-2535219000;-722239000;2305167000;6505258000
EXPE;112653;USD;2010;Q4;2010-12-31;2010-10-29;137979500;141175500;1116530000;275846000;;1707555000;246317000;226268000;4476782000;4949367000;6656922000;1148496000;;1895347000;1249221000;2024872000;3920219000;6117071000;-2241191000;-1194533000;2736703000;6656922000
EXPE;112653;USD;2009;Q4;2009-12-31;2010-07-30;144447500;148031500;688393000;307817000;;1225049000;236820000;48262000;4427025000;4712107000;5937156000;1138548000;;1835057000;895086000;1352373000;3187430000;6034533000;-1739198000;-1616033000;2749726000;5937156000
EXPE;112653;USD;2018;Q4;2018-12-31;2019-02-08;148469000;153969000;2471000000;2151000000;;5197000000;1877000000;778000000;10181000000;12836000000;18033000000;3369000000;0;8060000000;3717000000;4292000000;12352000000;9549000000;-5742000000;517000000;5681000000;18033000000
KORS;38287;USD;2017;Q4;2018-03-31;2017-05-31;159944133;161827489;163100000;290500000;660700000;1262100000;583200000;;2213700000;2796900000;4059000000;760300000;200000000;960300000;674400000;1077200000;2037500000;831100000;-3015900000;4152000000;2021500000;4059000000
KORS;38287;USD;2016;Q4;2017-03-31;2016-06-01;177162309;179786890;227700000;265800000;549300000;1164700000;591500000;;653400000;1244900000;2409600000;432700000;133100000;565800000;0;248800000;814600000;767800000;-2654900000;3560300000;1595000000;2409600000
KORS;38287;USD;2015;Q4;2016-03-31;2015-05-27;199839223;203206767;978900000;363400000;519900000;1989700000;562900000;;132000000;694900000;2684600000;326300000;;326300000;0;117300000;443600000;636700000;-497700000;2168800000;2241000000;2684600000
KORS;38287;USD;2014;Q4;2015-03-31;2014-05-28;203387341;206973550;971194000;298006000;426938000;1777169000;350678000;;89126000;439804000;2216973000;308370000;;308370000;;102472000;410842000;527213000;-2447000;1287738000;1806131000;2216973000
KORS;38287;USD;2013;Q4;2014-03-31;2013-05-29;200054347;203759347;472511000;206454000;266894000;989189000;242113000;;58263000;300376000;1289565000;164248000;;164248000;;78071000;242319000;424454000;;626253000;1047246000;1289565000
KORS;38287;USD;2012;Q4;2013-03-31;2013-05-29;191184170;196855405;106354000;127226000;187413000;464063000;170755000;;39607000;210362000;674425000;142332000;;165006000;;53182000;218188000;228321000;;228651000;456237000;674425000
KORS;38287;USD;2018;Q4;2019-03-31;2019-05-29;150801610;152083636;172000000;383000000;953000000;1729000000;615000000;;4306000000;4921000000;6650000000;912000000;630000000;1542000000;1936000000;2672000000;4214000000;1011000000;-3223000000;4707000000;2436000000;6650000000
DOW;378129;USD;2017;Q4;2017-12-31;2018-02-15;;;6192000000;7338000000;8376000000;27244000000;23812000000;6846000000;22038000000;52696000000;79940000000;13141000000;1236000000;14377000000;19765000000;38554000000;52931000000;6553000000;0;28050000000;27009000000;79940000000
DOW;378129;USD;2016;Q4;2016-12-31;2017-02-09;1106000000;1025300000;6607000000;4666000000;7363000000;23659000000;23486000000;7424000000;24942000000;55852000000;79511000000;11697000000;907000000;12604000000;20456000000;39678000000;52282000000;7369000000;-1659000000;30338000000;27229000000;79511000000
DOW;378129;USD;2015;Q4;2015-12-31;2016-02-12;1105300000;1218900000;8577000000;4078000000;6871000000;23941000000;17854000000;7697000000;18446000000;43997000000;67938000000;10120000000;995000000;11115000000;16215000000;30640000000;41755000000;8043000000;-6155000000;28425000000;26183000000;67938000000
DOW;378129;USD;2014;Q4;2014-12-31;2015-02-13;1146900000;1161000000;5654000000;4685000000;8101000000;24255000000;18051000000;7260000000;19121000000;44432000000;68687000000;10543000000;933000000;11581000000;18741000000;33550000000;45131000000;7953000000;-4233000000;23045000000;23556000000;68687000000
DOW;378129;USD;2013;Q4;2013-12-31;2014-02-14;1190200000;1491600000;5940000000;4935000000;8303000000;24977000000;17454000000;7407000000;19663000000;44524000000;69501000000;10698000000;1140000000;11971000000;16820000000;29450000000;41421000000;6982000000;-307000000;21407000000;28080000000;69501000000
DOW;378129;USD;2012;Q4;2012-12-31;2013-02-15;1175500000;1180800000;4318000000;5074000000;8476000000;23684000000;17520000000;6999000000;21402000000;45921000000;69605000000;10330000000;1068000000;11493000000;19919000000;36098000000;47591000000;6289000000;0;18495000000;22014000000;69605000000
DOW;378129;USD;2011;Q4;2011-12-31;2012-02-15;1154600000;1149800000;5446000000;4900000000;7577000000;23422000000;17299000000;7057000000;21446000000;45802000000;69224000000;10215000000;3290000000;13634000000;18310000000;32152000000;45786000000;5624000000;0;19087000000;23438000000;69224000000
DOW;378129;USD;2010;Q4;2010-12-31;2011-02-18;1132700000;1150200000;7039000000;4616000000;7087000000;24130000000;17668000000;6383000000;21407000000;45458000000;69588000000;10569000000;3222000000;13896000000;20605000000;33050000000;46946000000;5217000000;-239000000;17736000000;22642000000;69588000000
DOW;378129;USD;2009;Q4;2009-12-31;2010-02-19;1112900000;1127400000;2846000000;5656000000;6847000000;19542000000;18141000000;5995000000;22340000000;46476000000;66018000000;9806000000;3221000000;13105000000;19152000000;31789000000;44894000000;4819000000;-557000000;16704000000;21124000000;66018000000
DOW;378129;USD;2008;Q4;2008-12-31;2009-08-03;924400000;930900000;2800000000;3782000000;6036000000;16060000000;14294000000;5725000000;9395000000;29414000000;45474000000;9206000000;3814000000;13108000000;8042000000;18286000000;31394000000;3325000000;-2438000000;17013000000;14080000000;45474000000
DOW;378129;USD;2018;Q4;2018-12-31;2019-02-11;;;2769000000;8246000000;9260000000;25263000000;23662000000;6865000000;21588000000;52115000000;77378000000;13110000000;645000000;13755000000;19254000000;35654000000;49409000000;7042000000;;29808000000;27969000000;77378000000
DTE;378131;USD;2015;Q4;2015-12-31;2016-02-10;179000000;179000000;37000000;1276000000;323000000;2575000000;18034000000;;8053000000;26087000000;28662000000;1029000000;972000000;2528000000;8760000000;17339000000;19867000000;4123000000;;4794000000;8795000000;28662000000
DTE;378131;USD;2014;Q4;2014-12-31;2015-02-13;177000000;177000000;48000000;1504000000;292000000;3012000000;16820000000;;8067000000;24887000000;27899000000;1181000000;672000000;2577000000;8343000000;16980000000;19557000000;3904000000;;4578000000;8342000000;27899000000
DTE;378131;USD;2013;Q4;2013-12-31;2014-02-14;178000000;176000000;52000000;1542000000;265000000;2806000000;15800000000;;7329000000;23129000000;25935000000;1168000000;1029000000;3189000000;7109000000;14792000000;17981000000;3907000000;;4150000000;7954000000;25935000000
DTE;378131;USD;2012;Q4;2012-12-31;2013-02-20;172000000;171000000;65000000;1336000000;234000000;2915000000;14684000000;;8740000000;23424000000;26339000000;1048000000;1057000000;2768000000;6712000000;16160000000;18928000000;3587000000;;3944000000;7411000000;26339000000
DTE;378131;USD;2011;Q4;2011-12-31;2012-02-16;169000000;166000000;68000000;1317000000;219000000;3196000000;13746000000;;9067000000;22813000000;26009000000;976000000;945000000;2628000000;6708000000;16328000000;18956000000;3417000000;;3750000000;7053000000;26009000000
DTE;378131;USD;2010;Q4;2010-12-31;2011-02-18;168000000;171000000;65000000;1351000000;202000000;3167000000;12992000000;;8737000000;21729000000;24896000000;935000000;1075000000;2749000000;6446000000;15380000000;18129000000;3440000000;;3431000000;6767000000;24896000000
DTE;378131;USD;2009;Q4;2009-12-31;2010-02-23;164000000;164000000;52000000;1438000000;200000000;2877000000;12431000000;;8887000000;21318000000;24195000000;925000000;998000000;2645000000;6577000000;15234000000;17879000000;3257000000;;3168000000;6316000000;24195000000
DTE;378131;USD;2008;Q4;2008-12-31;2009-08-28;163000000;163000000;86000000;1666000000;206000000;3328000000;12231000000;;9031000000;21262000000;24590000000;1104000000;1106000000;3013000000;6809000000;15539000000;18552000000;3175000000;;2985000000;6038000000;24590000000
DTE;378131;USD;2016;Q4;2016-12-31;2017-02-09;179000000;176000000;92000000;1522000000;356000000;2762000000;19730000000;;9549000000;29279000000;32041000000;1323000000;513000000;2437000000;11269000000;20105000000;22542000000;4030000000;;5114000000;9499000000;32041000000
DTE;378131;USD;2017;Q4;2017-12-31;2018-02-16;179000000;179000000;66000000;1758000000;380000000;3081000000;20721000000;;9965000000;30686000000;33767000000;1440000000;730000000;2812000000;12185000000;20965000000;23777000000;3989000000;;5643000000;9990000000;33767000000
DTE;378131;USD;2018;Q4;2018-12-31;2019-02-07;181000000;181000000;71000000;1789000000;405000000;3260000000;21650000000;;11378000000;33028000000;36288000000;1628000000;2108000000;4438000000;12134000000;21133000000;25571000000;4245000000;;6112000000;10717000000;36288000000
LANC;253076;USD;2017;Q4;2017-06-30;2017-08-24;27396000;27447000;143104000;69922000;76376000;301146000;180671000;;234588000;415259000;716405000;76623000;;76623000;;63805000;140428000;115174000;-736932000;1206671000;575977000;716405000
LANC;253076;USD;2016;Q4;2016-06-30;2016-08-24;27359000;27398000;118080000;66006000;76097000;267827000;169595000;;197310000;366905000;634732000;73003000;;73003000;;48131000;121134000;110677000;-736066000;1150337000;513598000;634732000
LANC;253076;USD;2015;Q4;2015-06-30;2015-08-28;27317000;27339000;182202000;62437000;77899000;330210000;172311000;;199635000;371946000;702156000;74644000;;74644000;;46594000;121238000;107767000;-735911000;1219119000;580918000;702156000
LANC;253076;USD;2014;Q4;2014-06-30;2014-08-28;27283000;27324000;211539000;57808000;74516000;367291000;168674000;;102665000;271339000;638630000;69072000;;69072000;;40961000;110033000;104789000;-735342000;1167211000;528597000;638630000
LANC;253076;USD;2013;Q4;2013-06-30;2013-08-29;27277000;27316000;123385000;56337000;67809000;326058000;168074000;;125832000;293906000;619964000;69061000;;77177000;;41565000;118742000;102622000;-732222000;1139213000;501222000;619964000
LANC;253076;USD;2012;Q4;2012-06-30;2012-08-29;27220000;27255000;191636000;73326000;109704000;391739000;184130000;;106766000;290896000;682635000;72671000;;72671000;;45697000;118368000;100015000;-731613000;1208027000;564267000;682635000
LANC;253076;USD;2011;Q4;2011-06-30;2011-09-27;27390000;27414000;132266000;63762000;111885000;333196000;185282000;;103611000;288893000;622089000;76156000;;76156000;;28394000;104550000;97197000;-723298000;1150683000;517539000;622089000
LANC;253076;USD;2010;Q4;2010-06-30;2010-11-09;28175000;28207000;100890000;67766000;121509000;317399000;166097000;;102957000;269054000;586453000;77953000;;77953000;;23592000;101545000;94885000;-680195000;1080015000;484908000;586453000
LANC;253076;USD;2018;Q4;2018-06-30;2018-08-27;27415000;27467000;205752000;72960000;90861000;378877000;190813000;;234801000;425614000;804491000;93767000;;93767000;;58442000;152209000;119232000;-738034000;1279343000;652282000;804491000
LANC;253076;USD;2019;Q4;2019-06-30;2019-08-27;27445000;27519000;196288000;75691000;86072000;368569000;247044000;;289786000;536830000;905399000;119706000;;119706000;;58820000;178526000;122844000;-745445000;1359782000;726873000;905399000
CE;109593;USD;2015;Q4;2015-12-31;2016-02-05;146855486;150255244;997000000;706000000;682000000;2787000000;3609000000;;2190000000;5799000000;8586000000;677000000;513000000;1550000000;2468000000;4207000000;5757000000;136000000;-1031000000;3621000000;2829000000;8586000000
CE;109593;USD;2014;Q4;2014-12-31;2015-02-06;153368353;156626297;812000000;801000000;782000000;2698000000;3733000000;;2365000000;6098000000;8796000000;762000000;137000000;1338000000;2586000000;4380000000;5718000000;103000000;-611000000;3491000000;3078000000;8796000000
CE;109593;USD;2013;Q4;2013-12-31;2014-02-07;157344677;157897553;1025000000;867000000;804000000;3182000000;3425000000;;2411000000;5836000000;9018000000;817000000;177000000;1545000000;2887000000;4774000000;6319000000;53000000;-361000000;3011000000;2699000000;9018000000
CE;109593;USD;2012;Q4;2012-12-31;2013-02-08;159541102;160300281;1012000000;827000000;711000000;2839000000;3350000000;;2811000000;6161000000;9000000000;687000000;168000000;1355000000;2930000000;5915000000;7270000000;731000000;-905000000;1993000000;1730000000;9000000000
CE;109593;USD;2011;Q4;2011-12-31;2012-02-10;156464665;158986206;746000000;871000000;712000000;2703000000;3269000000;;2546000000;5815000000;8518000000;685000000;144000000;1385000000;2873000000;5792000000;7177000000;627000000;-860000000;2424000000;1341000000;8518000000
CE;109593;USD;2010;Q4;2010-12-31;2011-02-11;155798583;164557730;818000000;827000000;610000000;2668000000;3017000000;;2596000000;5613000000;8281000000;690000000;228000000;1542000000;2990000000;5813000000;7355000000;574000000;-829000000;1851000000;926000000;8281000000
CE;109593;USD;2009;Q4;2009-12-31;2010-02-12;144128658;170314217;1257000000;721000000;522000000;2856000000;2797000000;80000000;2679000000;5556000000;8412000000;721000000;242000000;1607000000;3259000000;6219000000;7826000000;522000000;-781000000;1505000000;586000000;8412000000
CE;109593;USD;2008;Q4;2008-12-31;2009-10-27;143470347;155863462;682000000;631000000;577000000;2286000000;2470000000;94000000;2316000000;4880000000;7166000000;547000000;233000000;1369000000;3300000000;5613000000;6982000000;495000000;-781000000;1047000000;184000000;7166000000
CE;109593;USD;2016;Q4;2016-12-31;2017-02-10;141856788;142874457;668000000;801000000;720000000;2472000000;3577000000;;2308000000;5885000000;8357000000;637000000;118000000;1077000000;2890000000;4259000000;5336000000;157000000;-1531000000;4320000000;3021000000;8357000000
CE;109593;USD;2017;Q4;2017-12-31;2018-02-09;135768010;136290829;608000000;986000000;900000000;2792000000;3762000000;;2984000000;6746000000;9538000000;879000000;326000000;1559000000;3315000000;4680000000;6239000000;175000000;-2031000000;4920000000;3299000000;9538000000
CE;109593;USD;2018;Q4;2018-12-31;2019-02-07;131195612;133475149;470000000;1017000000;1046000000;2874000000;3719000000;;2720000000;6439000000;9313000000;875000000;561000000;1779000000;2970000000;4155000000;5934000000;233000000;-2849000000;5847000000;3379000000;9313000000
BRX;108186;USD;2017;Q4;2017-12-31;2018-02-12;304917000;306038000;56938000;232111000;;342888000;8560421000;28006000;222611000;8811038000;9153926000;6245578000;;6245578000;;0;6245578000;3333512000;;;2908348000;9153926000
BRX;108186;USD;2016;Q4;2016-12-31;2017-02-13;304339000;317136000;51402000;178216000;;281085000;8842004000;25573000;171023000;9038600000;9319685000;6392525000;;6392525000;;0;6392525000;3327917000;;;2927160000;9319685000
BRX;108186;USD;2015;Q4;2015-12-31;2016-02-29;298899000;324423000;69528000;180486000;;291476000;9052165000;23001000;131365000;9206531000;9498007000;6577705000;;6577705000;;0;6577705000;3273237000;;;2920302000;9498007000
BRX;108186;USD;2014;Q4;2014-12-31;2015-02-19;272391000;273683000;60595000;182424000;;296183000;9253015000;20315000;112400000;9385730000;9681913000;6701610000;;6701610000;;0;6701610000;3226907000;;;2980303000;9681913000
BRX;108186;USD;2013;Q4;2013-12-31;2014-03-12;213947000;213947000;113915000;178505000;;367877000;9647558000;22104000;134377000;9804039000;10171916000;6690818000;;6865929000;;0;6865929000;2545987000;;;3305987000;10171916000
BRX;108186;USD;2012;Q4;2012-12-31;2013-12-03;175974000;-15000;103098000;156944000;;350202000;9098130000;24883000;130514000;9253527000;9603729000;7131468000;;7305908000;;0;7305908000;1748093000;;;2297821000;9603729000
BRX;108186;USD;2018;Q4;2018-12-31;2019-02-11;299192000;299762000;41745000;228297000;;279062000;7749650000;30243000;183466000;7963359000;8242421000;5406322000;;5406322000;;0;5406322000;3236314000;;;2836099000;8242421000
DWDP;546332;USD;2017;Q4;2017-12-31;2018-02-15;1144235070;1153528200;14394000000;11314000000;16992000000;49893000000;36247000000;8580000000;97444000000;142271000000;192164000000;22113000000;4015000000;26128000000;30056000000;64109000000;90237000000;81280000000;-1000000000;29211000000;101927000000;192164000000
DWDP;546332;USD;2016;Q4;2016-12-31;2017-11-06;543820200;408897720;6607000000;4666000000;7363000000;23659000000;23486000000;7424000000;24942000000;55852000000;79511000000;11697000000;907000000;12604000000;20456000000;39678000000;52282000000;7369000000;-1659000000;30338000000;27229000000;79511000000
DWDP;546332;USD;2018;Q4;2018-12-31;2019-02-11;1122010230;1127369760;13616000000;12376000000;16621000000;49603000000;35848000000;8382000000;94197000000;138427000000;188030000000;21913000000;2802000000;24715000000;37662000000;67136000000;91851000000;81984000000;-5421000000;30536000000;96179000000;188030000000
UNP;367644;USD;2016;Q4;2016-12-31;2017-02-03;819200000;822600000;1337000000;1258000000;717000000;3596000000;50389000000;;1733000000;52122000000;55718000000;2882000000;758000000;3640000000;14249000000;32146000000;35786000000;7198000000;-18581000000;32587000000;19932000000;55718000000
UNP;367644;USD;2015;Q4;2015-12-31;2016-02-05;850400000;853800000;1391000000;1356000000;736000000;4130000000;48866000000;;1604000000;50470000000;54600000000;2612000000;594000000;3206000000;13607000000;30692000000;33898000000;7193000000;-15529000000;30233000000;20702000000;54600000000
UNP;367644;USD;2014;Q4;2014-12-31;2015-02-06;885600000;890000000;1586000000;1611000000;712000000;4401000000;46272000000;;1699000000;47971000000;52372000000;3303000000;461000000;3764000000;10952000000;27419000000;31183000000;7096000000;-12064000000;27367000000;21189000000;52372000000
UNP;367644;USD;2013;Q4;2013-12-31;2014-02-07;916300000;921300000;1432000000;1414000000;653000000;3990000000;43749000000;;1992000000;45741000000;49731000000;3086000000;705000000;3791000000;8872000000;24715000000;28506000000;6984000000;-8910000000;23901000000;21225000000;49731000000
UNP;367644;USD;2012;Q4;2012-12-31;2013-02-08;937600000;944000000;1063000000;1331000000;660000000;3614000000;41997000000;;1542000000;43539000000;47153000000;2923000000;196000000;3119000000;8801000000;24157000000;27276000000;5499000000;-6707000000;22271000000;19877000000;47153000000
UNP;367644;USD;2011;Q4;2011-12-31;2012-02-03;961200000;969200000;1217000000;1401000000;614000000;3727000000;39934000000;;1435000000;41369000000;45096000000;3108000000;209000000;3317000000;8697000000;23201000000;26518000000;5417000000;-5293000000;19508000000;18578000000;45096000000
UNP;367644;USD;2010;Q4;2010-12-31;2011-02-04;987000000;997400000;1086000000;1184000000;534000000;3432000000;38253000000;;1403000000;39656000000;43088000000;2713000000;239000000;2952000000;9003000000;22373000000;25325000000;5370000000;-4027000000;17154000000;17763000000;43088000000
UNP;367644;USD;2009;Q4;2009-12-31;2010-02-05;1006554000;1012510000;1850000000;666000000;475000000;3680000000;37202000000;;1302000000;38504000000;42184000000;2470000000;212000000;2682000000;9636000000;22701000000;25383000000;5352000000;-2924000000;15027000000;16801000000;42184000000
UNP;367644;USD;2008;Q4;2008-12-31;2009-07-24;1006344000;1013122000;1249000000;594000000;450000000;2813000000;35701000000;;1208000000;36909000000;39722000000;2560000000;320000000;2880000000;8607000000;21395000000;24275000000;5331000000;-2993000000;13813000000;15447000000;39722000000
UNP;367644;USD;2017;Q4;2017-12-31;2018-02-09;783500000;787200000;1365000000;1493000000;749000000;4006000000;51605000000;;2195000000;53800000000;57806000000;3139000000;800000000;3939000000;16144000000;29011000000;32950000000;7254000000;-22574000000;41317000000;24856000000;57806000000
UNP;367644;USD;2018;Q4;2018-12-31;2019-02-08;729300000;733000000;1333000000;1755000000;742000000;4163000000;52679000000;;2305000000;54984000000;59147000000;3160000000;1466000000;4626000000;20925000000;34098000000;38724000000;7228000000;-30674000000;45284000000;20423000000;59147000000
RICK;100383;USD;2017;Q4;2017-09-30;2018-02-14;9718000;9718000;9922000;3187000;2149000;26242000;148410000;;125232000;273642000;299884000;13671000;17440000;31111000;106912000;133548000;164659000;63550000;;69195000;135225000;299884000
RICK;100383;USD;2016;Q4;2016-09-30;2016-12-13;9549000;10019000;11327000;4365000;2019000;29387000;141073000;;105601000;246674000;276061000;17087000;9950000;27037000;95936000;119685000;146722000;64649000;;62106000;129339000;276061000
RICK;100383;USD;2015;Q4;2015-09-30;2015-12-14;10652000;9713000;8634000;2154000;2368000;16935000;134150000;;115714000;249864000;266799000;13154000;9469000;22623000;84880000;115690000;138313000;69832000;;52682000;128486000;266799000
RICK;100383;USD;2014;Q4;2014-09-30;2014-12-15;10174000;11872000;10560000;1060000;1879000;23351000;113962000;;101829000;215791000;239142000;11393000;12315000;39194000;58037000;86649000;125843000;66828000;;43370000;113299000;239142000
RICK;100383;USD;2013;Q4;2013-09-30;2013-12-16;9504000;8992000;11193000;1382000;1472000;20660000;98629000;;103811000;202440000;223100000;7048000;8830000;28913000;69762000;97072000;125985000;61601000;;32130000;97115000;223100000
RICK;100383;USD;2012;Q4;2012-09-30;2012-12-14;9634000;9639000;6579000;1743000;1260000;14708000;79940000;;97745000;177685000;192393000;6163000;6603000;22853000;56925000;81928000;104781000;61308000;;22939000;87612000;192393000
RICK;100383;USD;2011;Q4;2011-09-30;2011-12-14;9816000;8971000;10213000;779000;1174000;19659000;65892000;;67826000;133718000;153377000;3981000;5494000;17691000;30060000;55464000;73155000;61542000;;15361000;80222000;153377000
RICK;100383;USD;2010;Q4;2010-09-30;2011-08-09;10150000;9160000;18599000;662000;1082000;27765000;56786000;;63820000;120606000;148371000;4997000;7883000;18699000;34803000;56419000;75118000;62424000;;7515000;73253000;148371000
RICK;100383;USD;2018;Q4;2018-09-30;2018-12-31;9719000;9719000;17726000;7320000;2353000;36802000;172403000;;120527000;292930000;329732000;14798000;19047000;33845000;121580000;142555000;176400000;64309000;;88906000;153332000;329732000
GSIT;48159;USD;2016;Q4;2017-03-31;2016-06-10;22141000;22141000;49935000;6349000;9211000;68272000;7689000;12898000;13736000;34323000;102595000;8678000;;10474000;;5677000;16151000;21851000;;64655000;86444000;102595000
GSIT;48159;USD;2015;Q4;2016-03-31;2015-06-11;23343000;22756000;55112000;7478000;7174000;71962000;8653000;11148000;14767000;34568000;106530000;6912000;;9242000;;7419000;16661000;25072000;;64770000;89869000;106530000
GSIT;48159;USD;2014;Q4;2015-03-31;2014-06-11;27544000;26200000;80932000;8238000;8185000;102507000;9683000;28819000;668000;39170000;141677000;9314000;;11837000;;1462000;13299000;56427000;;71918000;128378000;141677000
GSIT;48159;USD;2013;Q4;2014-03-31;2013-06-04;81080904;84289084;67259000;10241000;13809000;96254000;10774000;35495000;3322000;49591000;145845000;7782000;;10859000;;2803000;13662000;54031000;;78107000;132183000;145845000
GSIT;48159;USD;2012;Q4;2013-03-31;2012-06-04;27847000;28501000;58678000;10579000;16725000;94090000;12806000;33497000;2724000;49027000;143117000;9833000;;12503000;;1835000;14338000;54430000;;74261000;128779000;143117000
GSIT;48159;USD;2011;Q4;2012-03-31;2011-08-04;-83459948;-87541260;51985000;15042000;21380000;93982000;13545000;30938000;3452000;47935000;141917000;10428000;;15676000;;1561000;17237000;57092000;;67505000;124680000;141917000
GSIT;48159;USD;2017;Q4;2018-03-31;2018-06-01;21333000;21333000;58365000;5279000;5547000;71271000;8172000;7923000;12174000;28269000;99540000;7404000;;7404000;;5321000;12725000;27412000;;59545000;86815000;99540000
GSIT;48159;USD;2018;Q4;2019-03-31;2019-06-13;22166000;27216000;61841000;7339000;5685000;77365000;9001000;8997000;10860000;28858000;106223000;8733000;;8733000;;4335000;13068000;33484000;;59708000;93155000;106223000
WHR;104227;USD;2016;Q4;2016-12-31;2017-02-13;75200000;76200000;1085000000;2711000000;2623000000;7339000000;3810000000;;8004000000;11814000000;19153000000;5807000000;560000000;7662000000;3876000000;5763000000;13425000000;2783000000;-2924000000;7314000000;5728000000;19153000000
WHR;104227;USD;2015;Q4;2015-12-31;2016-02-16;78100000;79100000;772000000;2530000000;2619000000;6874000000;3774000000;;8362000000;12136000000;19010000000;5784000000;508000000;7744000000;3470000000;5592000000;13336000000;2752000000;-2399000000;6722000000;5674000000;19010000000
WHR;104227;USD;2014;Q4;2014-12-31;2015-02-26;78400000;79800000;1026000000;2768000000;2740000000;8098000000;3981000000;;7923000000;11904000000;20002000000;6255000000;234000000;8403000000;3544000000;5803000000;14206000000;2665000000;-2149000000;6209000000;5796000000;20002000000
WHR;104227;USD;2013;Q4;2013-12-31;2014-02-18;78400000;80400000;1380000000;2005000000;2408000000;7022000000;3041000000;;5481000000;8522000000;15544000000;5016000000;607000000;6794000000;1846000000;3716000000;10510000000;2562000000;-2124000000;5784000000;5034000000;15544000000
WHR;104227;USD;2012;Q4;2012-12-31;2013-02-19;78800000;80600000;1168000000;2038000000;2354000000;6827000000;3034000000;;5535000000;8569000000;15396000000;4809000000;510000000;6510000000;1944000000;4519000000;11029000000;2421000000;-1777000000;5147000000;4367000000;15396000000
WHR;104227;USD;2011;Q4;2011-12-31;2012-02-22;76800000;79600000;1109000000;2105000000;2354000000;6422000000;3102000000;;5657000000;8759000000;15181000000;4892000000;361000000;6297000000;2129000000;4604000000;10901000000;2307000000;-1822000000;4922000000;4280000000;15181000000
WHR;104227;USD;2010;Q4;2010-12-31;2011-02-14;152899924;155899923;1368000000;2278000000;2792000000;7315000000;3134000000;;5135000000;8269000000;15584000000;4757000000;312000000;6149000000;2195000000;5115000000;11264000000;2262000000;-1823000000;4680000000;4320000000;15584000000
WHR;104227;USD;2009;Q4;2009-12-31;2010-07-20;75200000;76800000;1380000000;2500000000;2197000000;7025000000;3117000000;;4952000000;8069000000;15094000000;4415000000;378000000;5941000000;2502000000;5393000000;11334000000;2172000000;-1833000000;4193000000;3760000000;15094000000
WHR;104227;USD;2017;Q4;2017-12-31;2018-02-13;71500000;72500000;1196000000;2665000000;2988000000;7930000000;4033000000;;8075000000;12108000000;20038000000;6324000000;376000000;8505000000;4392000000;6405000000;14910000000;2851000000;-3674000000;7352000000;5128000000;20038000000
WHR;104227;USD;2018;Q4;2018-12-31;2019-02-12;64000000;62300000;1498000000;2210000000;2533000000;7898000000;3414000000;;7035000000;10449000000;18347000000;6004000000;947000000;9189000000;4046000000;5953000000;15142000000;2880000000;-4827000000;6933000000;3205000000;18347000000
MAS;255010;USD;2016;Q4;2016-12-31;2017-02-09;320000000;327000000;1191000000;917000000;712000000;2934000000;1060000000;;1143000000;2203000000;5137000000;1458000000;;1460000000;2995000000;3780000000;5240000000;318000000;;-381000000;-103000000;5137000000
MAS;255010;USD;2015;Q4;2015-12-31;2016-02-12;333000000;335000000;1716000000;853000000;687000000;3328000000;1027000000;;1309000000;2336000000;5664000000;1399000000;;2403000000;2403000000;3203000000;5606000000;330000000;;-300000000;58000000;5664000000
MAS;255010;USD;2014;Q4;2014-12-31;2015-02-13;297562000;300148000;1685000000;820000000;712000000;3620000000;1046000000;;2542000000;3588000000;7208000000;1406000000;;2211000000;2919000000;3869000000;6080000000;345000000;;690000000;1128000000;7208000000
MAS;255010;USD;2013;Q4;2013-12-31;2014-02-14;207376000;206272000;1544000000;1004000000;765000000;3468000000;1252000000;;2237000000;3489000000;6957000000;1680000000;;1686000000;3421000000;4484000000;6170000000;365000000;;79000000;787000000;6957000000
MAS;255010;USD;2012;Q4;2012-12-31;2013-02-15;397162000;394886000;1351000000;933000000;726000000;3217000000;1326000000;;2332000000;3658000000;6875000000;1611000000;;1862000000;3422000000;4479000000;6341000000;365000000;;-102000000;534000000;6875000000
MAS;255010;USD;2011;Q4;2011-12-31;2012-02-21;394886000;393748000;1656000000;914000000;769000000;3429000000;1567000000;;2301000000;3868000000;7297000000;1552000000;;2363000000;3222000000;4192000000;6555000000;413000000;;38000000;742000000;7297000000
MAS;255010;USD;2010;Q4;2010-12-31;2011-02-18;399438000;396024000;1715000000;888000000;732000000;3464000000;1737000000;;2939000000;4676000000;8140000000;1421000000;;1487000000;4032000000;5071000000;6558000000;391000000;;720000000;1582000000;8140000000
MAS;255010;USD;2009;Q4;2009-12-31;2010-04-30;399438000;399438000;1413000000;983000000;743000000;3451000000;1981000000;;3743000000;5724000000;9175000000;1417000000;;1781000000;3604000000;4577000000;6358000000;392000000;;1871000000;2817000000;9175000000
MAS;255010;USD;2008;Q4;2008-12-31;2009-08-25;;;1028000000;999000000;941000000;3300000000;2136000000;;4047000000;6183000000;9483000000;1476000000;;1547000000;3915000000;4955000000;6502000000;351000000;;2162000000;2981000000;9483000000
MAS;255010;USD;2017;Q4;2017-12-31;2018-02-08;311000000;316000000;1302000000;1021000000;796000000;3215000000;1129000000;;1144000000;2273000000;5488000000;1512000000;;1628000000;2969000000;3684000000;5312000000;310000000;;-305000000;176000000;5488000000
MAS;255010;USD;2018;Q4;2018-12-31;2019-02-07;300000000;300000000;559000000;1153000000;946000000;2766000000;1223000000;;1404000000;2627000000;5393000000;1676000000;;1684000000;2971000000;3640000000;5324000000;294000000;;-278000000;69000000;5393000000
MANH;105128;USD;2015;Q4;2015-12-31;2016-02-05;72916000;73658000;128760000;97379000;;236911000;21176000;;74156000;95332000;332243000;58428000;;127185000;;9566000;136751000;728000;;207070000;195492000;332243000
MANH;105128;USD;2014;Q4;2014-12-31;2015-02-05;74202000;75066000;124438000;86828000;;229861000;17265000;;71044000;88309000;318170000;63847000;;122815000;;13332000;136147000;741000;;191305000;182023000;318170000
MANH;105128;USD;2013;Q4;2013-12-31;2014-02-06;76008000;77400000;132956000;71136000;;218738000;14342000;;64748000;79090000;297828000;50376000;;104188000;;12054000;116242000;764000;;188604000;181586000;297828000
MANH;105128;USD;2012;Q4;2012-12-31;2013-02-22;77612000;79864000;103047000;62102000;;181507000;15650000;;64656000;80306000;261813000;43206000;;91141000;;9163000;100304000;785000;;165427000;161509000;261813000
MANH;105128;USD;2011;Q4;2011-12-31;2012-02-23;79764000;83956000;98259000;56264000;;174514000;13321000;855000;70910000;85086000;259600000;38241000;;88123000;;9397000;97520000;204000;;166989000;162080000;259600000
MANH;105128;USD;2010;Q4;2010-12-31;2011-07-29;84256000;89752000;125158000;47419000;;188980000;14833000;1711000;74940000;91484000;280464000;41408000;;86382000;;10282000;96664000;704000;;184152000;183800000;280464000
MANH;105128;USD;2016;Q4;2016-12-31;2017-02-03;70783000;71249000;95615000;100285000;;207018000;17424000;;72698000;90122000;297140000;54186000;;117643000;;10131000;127774000;702000;;184558000;169366000;297140000
MANH;105128;USD;2017;Q4;2017-12-31;2018-02-09;68572000;68893000;125522000;92231000;;228073000;15493000;;71429000;86922000;314995000;49187000;;124255000;;15784000;140039000;678000;;186117000;174956000;314995000
MANH;105128;USD;2018;Q4;2018-12-31;2019-02-08;65164000;65564000;100566000;100108000;;215382000;14318000;;77450000;91768000;307150000;63370000;;145264000;;14739000;160003000;649000;;163359000;147147000;307150000
HON;105257;USD;2017;Q4;2017-12-31;2018-02-09;791799833;802442023;10817000000;8866000000;4613000000;26002000000;5926000000;667000000;26875000000;33468000000;59470000000;13552000000;5309000000;18861000000;12573000000;23939000000;42800000000;7170000000;-15914000000;27481000000;16670000000;59470000000
HON;105257;USD;2016;Q4;2016-12-31;2016-10-21;786880053;802638914;9363000000;8177000000;4366000000;23058000000;5793000000;587000000;24708000000;31088000000;54146000000;12738000000;3593000000;16331000000;12182000000;18265000000;34596000000;6739000000;-13366000000;28710000000;19550000000;54146000000
HON;105257;USD;2015;Q4;2015-12-31;2016-02-12;809422059;818966883;5455000000;8075000000;4420000000;20053000000;5789000000;517000000;22957000000;29263000000;49316000000;11857000000;6514000000;18371000000;5554000000;12237000000;30608000000;6335000000;-11664000000;26147000000;18708000000;49316000000
HON;105257;USD;2014;Q4;2014-12-31;2015-02-13;822008640;832812122;6959000000;7960000000;4405000000;22191000000;5383000000;465000000;17412000000;23260000000;45451000000;12136000000;2637000000;14773000000;6046000000;12675000000;27448000000;5996000000;-9995000000;23115000000;18003000000;45451000000
HON;105257;USD;2013;Q4;2013-12-31;2014-02-14;824316180;835853879;6422000000;7929000000;4293000000;21164000000;5278000000;393000000;18600000000;24271000000;45435000000;12153000000;2028000000;14181000000;6801000000;13508000000;27689000000;5640000000;-9374000000;20383000000;17746000000;45435000000
HON;105257;USD;2012;Q4;2012-12-31;2013-02-15;825784614;835434326;4634000000;7429000000;4235000000;17598000000;5001000000;623000000;18631000000;24255000000;41853000000;11944000000;1101000000;13045000000;6395000000;15593000000;28638000000;5316000000;-8801000000;17799000000;13215000000;41853000000
HON;105257;USD;2011;Q4;2011-12-31;2012-02-17;812358927;822847745;3698000000;7228000000;4264000000;16134000000;4804000000;494000000;18376000000;23674000000;39808000000;11601000000;674000000;12275000000;6881000000;16631000000;28906000000;5115000000;-8948000000;16083000000;10902000000;39808000000
HON;105257;USD;2010;Q4;2010-12-31;2011-02-11;;830504582;2650000000;6841000000;3822000000;15486000000;4724000000;616000000;17008000000;22348000000;37834000000;10645000000;889000000;11724000000;5755000000;15323000000;27047000000;4935000000;-8299000000;15097000000;10787000000;37834000000
HON;105257;USD;2009;Q4;2009-12-31;2010-02-12;;807114519;2801000000;6274000000;3446000000;13936000000;4847000000;579000000;16631000000;22057000000;35993000000;9786000000;1361000000;11147000000;6246000000;15875000000;27022000000;4781000000;-8995000000;14023000000;8971000000;35993000000
HON;105257;USD;2008;Q4;2008-12-31;2010-02-12;;;2065000000;6129000000;3848000000;13263000000;4934000000;670000000;16623000000;22227000000;35490000000;9779000000;2510000000;12289000000;5865000000;15932000000;28221000000;4952000000;-10206000000;16250000000;7269000000;35490000000
HON;105257;USD;2018;Q4;2018-12-31;2019-02-08;645503473;654214368;10910000000;7508000000;4326000000;24362000000;5296000000;742000000;27373000000;33411000000;57773000000;12466000000;6458000000;18924000000;9756000000;20484000000;39408000000;7410000000;-19771000000;33978000000;18365000000;57773000000
EA;372651;USD;2016;Q4;2017-03-31;2016-05-27;306000000;362000000;4532000000;359000000;;5199000000;434000000;;2085000000;2519000000;7718000000;876000000;;2415000000;990000000;1243000000;3658000000;1052000000;;3027000000;4060000000;7718000000
EA;372651;USD;2015;Q4;2016-03-31;2016-05-27;307000000;333000000;3834000000;233000000;;4354000000;439000000;;2257000000;2696000000;7050000000;799000000;161000000;2418000000;989000000;1236000000;3654000000;1352000000;;2060000000;3396000000;7050000000
EA;372651;USD;2014;Q4;2015-03-31;2015-05-21;311000000;335000000;3021000000;362000000;36000000;3720000000;459000000;;1968000000;2427000000;6147000000;862000000;602000000;2747000000;0;364000000;3111000000;2130000000;;904000000;3036000000;6147000000
EA;372651;USD;2013;Q4;2014-03-31;2014-05-21;303000000;315000000;2365000000;327000000;56000000;3138000000;510000000;;2068000000;2578000000;5716000000;900000000;0;2390000000;580000000;904000000;3294000000;2356000000;;29000000;2422000000;5716000000
EA;372651;USD;2012;Q4;2013-03-31;2013-05-22;330000000;;1680000000;312000000;42000000;2325000000;548000000;;2197000000;2745000000;5070000000;873000000;;1917000000;559000000;886000000;2803000000;2177000000;;21000000;2267000000;5070000000
EA;372651;USD;2011;Q4;2012-03-31;2012-05-25;329000000;;1849000000;366000000;59000000;2609000000;568000000;;2314000000;2882000000;5491000000;1072000000;;2120000000;539000000;913000000;3033000000;2362000000;;-77000000;2458000000;5491000000
EA;372651;USD;2010;Q4;2011-03-31;2011-05-24;;;2237000000;335000000;77000000;3032000000;513000000;;1383000000;1896000000;4928000000;996000000;;2001000000;;363000000;2364000000;2498000000;;-153000000;2564000000;4928000000
EA;372651;USD;2009;Q4;2010-03-31;2010-05-28;;;1996000000;206000000;100000000;2585000000;537000000;;1524000000;2061000000;4646000000;808000000;;1574000000;;343000000;1917000000;2378000000;;123000000;2729000000;4646000000
EA;372651;USD;2008;Q4;2009-03-31;2009-08-10;;;2520000000;116000000;217000000;3120000000;354000000;;1204000000;1558000000;4678000000;875000000;;1136000000;;408000000;1544000000;2145000000;;800000000;3134000000;4678000000
EA;372651;USD;2017;Q4;2018-03-31;2018-05-23;307000000;337000000;5331000000;385000000;;6004000000;453000000;;2127000000;2580000000;8584000000;869000000;;2491000000;992000000;1498000000;3989000000;660000000;;4062000000;4595000000;8584000000
EA;372651;USD;2018;Q4;2019-03-31;2019-05-24;299000000;303000000;5445000000;623000000;;6381000000;448000000;;2128000000;2576000000;8957000000;1165000000;;2265000000;994000000;1361000000;3626000000;3000000;;5358000000;5331000000;8957000000
WSTL;543789;USD;2016;Q4;2017-03-31;2017-05-26;15432000;15432000;21778000;12075000;12511000;47773000;1984000;;15784000;17768000;65541000;8436000;;11966000;;1401000;13367000;416577000;-35335000;-329676000;52174000;65541000
WSTL;543789;USD;2015;Q4;2016-03-31;2016-05-24;15212000;15212000;29724000;16361000;13498000;61483000;3977000;;20571000;24548000;86031000;14099000;;17237000;;2110000;19347000;414985000;-35174000;-313735000;66684000;86031000
WSTL;543789;USD;2014;Q4;2015-03-31;2015-05-22;15071250;15071250;37932000;11845000;16205000;69531000;3603000;;26200000;29803000;99334000;9587000;;14347000;;3248000;17595000;413633000;-35066000;-297436000;81739000;99334000
WSTL;543789;USD;2013;Q4;2014-03-31;2014-05-23;14777000;15320250;51377000;15831000;24056000;94929000;2681000;;64709000;67390000;162319000;16268000;;20166000;;3511000;23677000;410774000;-34206000;-238534000;138642000;162319000
WSTL;543789;USD;2012;Q4;2013-03-31;2013-05-24;14538250;14538250;112582000;6689000;12223000;135798000;1081000;;5558000;6639000;142437000;8079000;;8079000;;3281000;11360000;407227000;-33848000;-242910000;131077000;142437000
WSTL;543789;USD;2011;Q4;2012-03-31;2012-05-25;16114750;15178500;135287000;5710000;9906000;161669000;1197000;;34560000;35757000;197426000;6470000;;6470000;;4592000;11062000;405790000;-21173000;-198872000;186364000;197426000
WSTL;543789;USD;2010;Q4;2011-03-31;2011-07-29;17135750;17767250;86898000;24252000;12955000;150742000;3250000;;47395000;50645000;201387000;33099000;;34387000;;7719000;42106000;403024000;-3854000;-240854000;159281000;201387000
WSTL;543789;USD;2017;Q4;2018-03-31;2018-05-25;15542000;15920000;27742000;8872000;9222000;46652000;1601000;;12206000;13807000;60459000;5231000;;7084000;;1080000;8164000;417847000;-35907000;-329645000;52295000;60459000
WSTL;543789;USD;2018;Q4;2019-03-31;2019-05-31;15329000;15329000;25457000;6865000;9801000;43829000;1298000;;3770000;5068000;48897000;5880000;;7097000;;620000;7717000;419013000;-37135000;-340698000;41180000;48897000
LITE;183087;USD;2018;Q4;2018-06-30;2018-08-28;62900000;62300000;711500000;197100000;153600000;1127200000;306900000;;147400000;454300000;1581500000;191900000;0;214000000;334200000;405600000;619600000;753300000;;166400000;961900000;1581500000
LITE;183087;USD;2017;Q4;2017-06-30;2017-08-29;61200000;58800000;555300000;166300000;145200000;930300000;273500000;;29100000;302600000;1232900000;161600000;;184200000;317500000;394100000;578300000;694600000;;-83200000;654600000;1232900000
LITE;183087;USD;2016;Q4;2016-06-30;2016-09-02;59400000;59200000;157100000;170500000;100600000;489500000;183400000;;53400000;236800000;726300000;161600000;;173700000;0;19400000;193100000;467800000;;20200000;533200000;726300000
LITE;183087;USD;2015;Q4;2015-06-30;2015-09-25;58800000;58800000;14500000;150500000;99700000;310800000;143200000;;58600000;201800000;512600000;110800000;;122200000;;377900000;500100000;0;;0;12500000;512600000
LITE;183087;USD;2014;Q4;2014-06-30;2015-09-25;58800000;58800000;19900000;136500000;96500000;286000000;136500000;;69600000;206100000;492100000;125400000;;136900000;;19600000;156500000;312900000;;;335600000;492100000
LITE;183087;USD;2019;Q4;2019-06-30;2019-08-27;76700000;74900000;768500000;238000000;228800000;1332800000;433300000;;950500000;1383800000;2716600000;249800000;5000000;294000000;835900000;925500000;1219500000;1360900000;;129100000;1497100000;2716600000
HUN;447408;USD;2018;Q4;2018-12-31;2019-02-12;235000000;237000000;340000000;1254000000;1134000000;2958000000;3064000000;;1931000000;4995000000;7953000000;1515000000;96000000;1611000000;2224000000;3593000000;5204000000;3987000000;-427000000;292000000;2749000000;7953000000
HUN;447408;USD;2017;Q4;2017-12-31;2018-02-23;239400000;245400000;470000000;1256000000;1073000000;5979000000;3098000000;;1167000000;4265000000;10244000000;1533000000;40000000;3265000000;2258000000;3608000000;6873000000;3892000000;-150000000;161000000;3371000000;10244000000
HUN;447408;USD;2016;Q4;2016-12-31;2016-10-28;236500000;240900000;385000000;1168000000;918000000;3555000000;3034000000;;2600000000;5634000000;9189000000;1261000000;50000000;1778000000;4122000000;5944000000;7722000000;3450000000;-150000000;-325000000;1467000000;9189000000
HUN;447408;USD;2015;Q4;2015-12-31;2015-10-27;239000000;240300000;257000000;1420000000;1692000000;3834000000;4446000000;;1540000000;5986000000;9820000000;1747000000;170000000;1917000000;4625000000;6274000000;8191000000;3410000000;-135000000;-528000000;1629000000;9820000000
HUN;447408;USD;2014;Q4;2014-12-31;2014-10-27;243100000;247100000;860000000;1665000000;2025000000;5039000000;4423000000;;1461000000;5884000000;10923000000;2014000000;267000000;2332000000;4854000000;6640000000;8972000000;3388000000;-50000000;-493000000;1951000000;10923000000
HUN;447408;USD;2013;Q4;2013-12-31;2013-10-29;-1910700000;-1905100000;520000000;1542000000;1741000000;4159000000;3824000000;;1205000000;5029000000;9188000000;1839000000;277000000;2159000000;3633000000;4900000000;7059000000;3307000000;-50000000;-687000000;2129000000;9188000000
HUN;447408;USD;2012;Q4;2012-12-31;2012-11-02;-6171600000;-6251600000;387000000;1534000000;1819000000;4119000000;3745000000;;1020000000;4765000000;8884000000;1855000000;288000000;2181000000;3414000000;4807000000;6988000000;3266000000;-50000000;-687000000;1896000000;8884000000
HUN;447408;USD;2011;Q4;2011-12-31;2011-11-02;2358000000;2426000000;554000000;1529000000;1539000000;3946000000;3622000000;;1089000000;4711000000;8657000000;1607000000;212000000;1826000000;3730000000;5055000000;6881000000;3230000000;-50000000;-947000000;1776000000;8657000000
HUN;447408;USD;2010;Q4;2010-12-31;2010-11-04;2364000000;2274000000;966000000;1413000000;1396000000;4008000000;3605000000;;1101000000;4706000000;8714000000;1515000000;519000000;2053000000;3627000000;4811000000;6864000000;3188000000;;-1090000000;1850000000;8714000000
HUN;447408;USD;2009;Q4;2009-12-31;2010-08-05;2339000000;2389000000;1745000000;1018000000;1184000000;4140000000;3516000000;;970000000;4486000000;8626000000;1378000000;431000000;1811000000;3781000000;4950000000;6761000000;3157000000;;-1015000000;1865000000;8626000000
CMI;120498;USD;2016;Q4;2016-12-31;2017-02-13;167753640;168146464;1380000000;;2675000000;7707000000;3800000000;;3504000000;7304000000;15011000000;3236000000;288000000;4325000000;1568000000;3512000000;7837000000;2145000000;-4489000000;11040000000;7174000000;15011000000
CMI;120498;USD;2015;Q4;2015-12-31;2016-02-12;175350324;175627312;1811000000;;2707000000;7947000000;3745000000;;3442000000;7187000000;15134000000;2978000000;63000000;3803000000;1576000000;3581000000;7384000000;2167000000;-3735000000;10322000000;7750000000;15134000000
CMI;120498;USD;2014;Q4;2014-12-31;2015-02-17;181250272;181717180;2394000000;;2866000000;9055000000;3686000000;;3023000000;6709000000;15764000000;3148000000;109000000;4021000000;1577000000;3650000000;7671000000;2126000000;-2844000000;9545000000;8093000000;15764000000
CMI;120498;USD;2013;Q4;2013-12-31;2014-02-18;185777528;186171364;2849000000;;2381000000;8639000000;3156000000;;2933000000;6089000000;14728000000;2556000000;68000000;3368000000;1672000000;3490000000;6858000000;2083000000;-2195000000;8406000000;7870000000;14728000000
CMI;120498;USD;2012;Q4;2012-12-31;2013-02-20;188347284;188774816;1616000000;;2221000000;7167000000;2724000000;;2657000000;5381000000;12548000000;2285000000;77000000;3136000000;698000000;2438000000;5574000000;2040000000;-1830000000;7343000000;6974000000;12548000000
CMI;120498;USD;2011;Q4;2011-12-31;2012-02-21;190488844;191191512;1761000000;;2141000000;7091000000;2288000000;;2289000000;4577000000;11668000000;2620000000;125000000;3657000000;658000000;2180000000;5837000000;1979000000;-1587000000;6038000000;5831000000;11668000000
CMI;120498;USD;2010;Q4;2010-12-31;2011-02-24;195696620;196293628;1362000000;;1977000000;6289000000;2041000000;;2072000000;4113000000;10402000000;2373000000;82000000;3260000000;709000000;2146000000;5406000000;1909000000;-964000000;4445000000;4996000000;10402000000
CMI;120498;USD;2009;Q4;2009-12-31;2010-02-26;198483992;198580496;1120000000;;1341000000;5003000000;1886000000;;1927000000;3813000000;8816000000;1747000000;37000000;2432000000;637000000;2364000000;4796000000;1824000000;-731000000;3575000000;4020000000;8816000000
CMI;120498;USD;2008;Q4;2008-12-31;2009-07-30;194533480;196622192;503000000;;1783000000;4713000000;1841000000;;1965000000;3806000000;8519000000;1872000000;39000000;2639000000;629000000;2400000000;5039000000;1732000000;-720000000;3288000000;3480000000;8519000000
CMI;120498;USD;2017;Q4;2017-12-31;2018-02-14;165401280;166283460;1567000000;;3166000000;8928000000;3927000000;;5220000000;9147000000;18075000000;4305000000;418000000;5677000000;1588000000;4234000000;9911000000;2203000000;-4905000000;11464000000;8164000000;18075000000
CMI;120498;USD;2018;Q4;2018-12-31;2019-02-11;158691324;159293388;1525000000;;3759000000;9818000000;4096000000;;5148000000;9244000000;19062000000;4353000000;879000000;6384000000;1597000000;4419000000;10803000000;2266000000;-6028000000;12917000000;8259000000;19062000000
ALX;87732;USD;2017;Q4;2017-12-31;2018-02-12;5116001;5116001;307536000;2693000;;395972000;754324000;35156000;446943000;1236423000;1632395000;1283049000;;1288440000;;0;1288440000;36750000;-368000;302543000;343955000;1632395000
ALX;87732;USD;2016;Q4;2016-12-31;2017-02-13;5114714;5114714;288926000;3056000;;377734000;780814000;37918000;254764000;1073496000;1451230000;1094559000;;1098385000;;0;1098385000;36362000;-374000;308995000;352845000;1451230000
ALX;87732;USD;2015;Q4;2015-12-31;2016-02-16;5113104;5113104;259349000;4014000;;348670000;803939000;43191000;252008000;1099138000;1447808000;1083420000;;1094928000;;0;1094928000;35912000;-374000;304340000;352880000;1447808000
ALX;87732;USD;2014;Q4;2014-12-31;2015-02-17;5111225;5111225;252813000;2213000;;339628000;783902000;44646000;250216000;1078764000;1418392000;1063083000;;1069993000;;0;1069993000;35312000;-374000;299004000;348399000;1418392000
ALX;87732;USD;2013;Q4;2013-12-31;2014-02-24;5109742;5109742;347718000;2925000;;440687000;734201000;31522000;251314000;1017037000;1457724000;1077409000;;1124143000;;0;1124143000;34918000;-374000;297515000;333581000;1457724000
ALX;87732;USD;2012;Q4;2012-12-31;2013-02-26;5108025;5108025;353396000;1953000;;445744000;750966000;31206000;253894000;1036066000;1481810000;1099537000;;1149657000;;0;1149657000;34525000;-375000;296797000;332153000;1481810000
ALX;87732;USD;2011;Q4;2011-12-31;2012-02-27;5107001;5107001;511619000;2552000;;602940000;770447000;0;397920000;1168367000;1771307000;1115509000;;1408062000;;0;1408062000;36974000;-375000;322201000;363245000;1771307000
ALX;87732;USD;2010;Q4;2010-12-31;2011-08-01;5105936;5105936;420220000;4224000;;510011000;893059000;;276230000;1169289000;1679300000;1288021000;;1335524000;;0;1335524000;36674000;-375000;304055000;343776000;1679300000
ALX;87732;USD;2018;Q4;2018-12-31;2019-02-11;5117366;5117366;283056000;4075000;;293570000;730270000;23166000;434251000;1187687000;1481257000;1192423000;;1196165000;;0;1196165000;37144000;-368000;248443000;285092000;1481257000
TWTR;30388;USD;2018;Q4;2018-12-31;2019-02-21;760719000;776325000;6209401000;788700000;;7111036000;885078000;;2166458000;3051536000;10162572000;550937000;965374000;1516311000;1755316000;1840667000;3356978000;8324978000;;-1454073000;6805594000;10162572000
TWTR;30388;USD;2017;Q4;2017-12-31;2018-02-23;742176000;742176000;4403102000;664268000;;5321884000;773715000;;1316878000;2090593000;7412477000;498302000;84976000;583278000;1708768000;1781981000;2365259000;7750526000;;-2671729000;5047218000;7412477000
TWTR;30388;USD;2016;Q4;2016-12-31;2016-11-01;714291000;714291000;3774579000;650650000;;4652196000;783901000;;1434268000;2218169000;6870365000;503173000;80848000;584021000;1605804000;1681409000;2265430000;7224538000;;-2550350000;4604935000;6870365000
TWTR;30388;USD;2015;Q4;2015-12-31;2016-02-29;682907000;682907000;3495348000;638694000;;4381792000;735299000;;1325348000;2060647000;6442439000;417873000;88166000;506039000;1514790000;1568353000;2074392000;6507090000;;-2093477000;4368047000;6442439000
TWTR;30388;USD;2014;Q4;2014-12-31;2015-03-02;639753000;639753000;3621878000;418454000;;4255853000;557019000;;770210000;1327229000;5583082000;281474000;112320000;393794000;1494970000;1562885000;1956679000;5208873000;;-1572446000;3626403000;5583082000
TWTR;30388;USD;2013;Q4;2013-12-31;2014-05-08;364661000;364661000;2234054000;247328000;;2574679000;332662000;;458899000;791561000;3366240000;138304000;87126000;225430000;110520000;190804000;416234000;3944955000;;-994626000;2950006000;3366240000
CSS;702391;USD;2017;Q4;2018-03-31;2018-06-05;9118000;9043000;58560000;63083000;102436000;236041000;52126000;;77021000;129147000;365188000;59112000;228000;59340000;40228000;52153000;111493000;60347000;-146903000;339088000;253695000;365188000
CSS;702391;USD;2016;Q4;2017-03-31;2017-06-07;9085000;9182000;67624000;48814000;105258000;232489000;35764000;;70941000;106705000;339194000;36163000;220000;36383000;456000;8657000;45040000;59467000;-148057000;382807000;294154000;339194000
CSS;702391;USD;2015;Q4;2016-03-31;2016-05-25;9061000;9251000;79733000;45144000;73022000;210691000;27053000;;72182000;99235000;309926000;33805000;0;33805000;0;4631000;38436000;57627000;-150105000;364030000;271490000;309926000
CSS;702391;USD;2014;Q4;2015-03-31;2015-05-22;9342000;9515000;106274000;42052000;65491000;225052000;25493000;;58928000;84421000;309473000;35005000;;35005000;;4213000;39218000;55869000;-141990000;356467000;270255000;309473000
CSS;702391;USD;2013;Q4;2014-03-31;2014-05-28;9297000;9412000;98062000;44243000;59252000;219444000;27063000;;47028000;74091000;293535000;31402000;;31635000;;4684000;36319000;53587000;-143821000;347469000;257216000;293535000
CSS;702391;USD;2012;Q4;2013-03-31;2013-05-31;9466000;9455000;87108000;43133000;62598000;210434000;27956000;;50790000;78746000;289180000;34733000;;35377000;;4825000;40202000;51354000;-140800000;338464000;248978000;289180000
CSS;702391;USD;2011;Q4;2012-03-31;2012-06-04;9713000;9711000;66135000;45026000;71671000;202051000;29582000;;54931000;84513000;286564000;36367000;;38757000;;4604000;43361000;51853000;-137546000;328921000;243203000;286564000
CSS;702391;USD;2010;Q4;2011-03-31;2011-08-05;9730000;9742000;48577000;42411000;69093000;192314000;32345000;;62264000;94609000;286923000;42524000;66000;46500000;0;4764000;51264000;52781000;-137139000;320024000;235659000;286923000
CSS;702391;USD;2018;Q4;2019-03-31;2019-05-31;8834000;8834000;17100000;53835000;96231000;179865000;50920000;;54810000;105730000;285595000;61447000;26455000;87902000;13000;7762000;95664000;62391000;-150538000;277613000;189931000;285595000
CUZ;446395;USD;2017;Q4;2017-12-31;2018-02-07;105064750;106880500;148929000;14420000;;220165000;3617822000;101414000;265218000;3984454000;4204619000;137909000;;286280000;1093228000;1093228000;1379508000;4035126000;-148373000;;2825111000;4204619000
CUZ;446395;USD;2016;Q4;2016-12-31;2017-02-21;74188302;76177262;35687000;27683000;;79004000;3599130000;179397000;314076000;4092603000;4171607000;109278000;;276447000;1380920000;1380920000;1657367000;3811177000;-148373000;;2514240000;4171607000
CUZ;446395;USD;2015;Q4;2015-12-31;2016-02-10;8301359;8311040;2003000;10828000;;24381000;2240500000;102577000;227862000;2570939000;2595320000;71739000;;193095000;718810000;718810000;911905000;1942480000;-134630000;;1683415000;2595320000
CUZ;446395;USD;2014;Q4;2014-12-31;2015-02-12;-8340377;-8268188;0;10732000;;15774000;2294945000;100498000;256113000;2651556000;2667330000;76240000;;201528000;792344000;792344000;993872000;1941055000;-86840000;;1673458000;2667330000
CUZ;446395;USD;2013;Q4;2013-12-31;2014-02-13;67595860;67719847;975000;11778000;;40117000;1885171000;107082000;240836000;2233089000;2273206000;76668000;;184140000;630094000;630094000;814234000;1614187000;-86840000;;1458972000;2273206000
CUZ;446395;USD;2012;Q4;2012-12-31;2013-02-13;36880968;36888761;176892000;9972000;;191733000;737048000;97868000;97593000;932509000;1124242000;34751000;;55879000;425410000;425410000;481289000;797684000;-86840000;;642954000;1124243000
CUZ;446395;USD;2011;Q4;2011-12-31;2012-03-20;36741039;36741039;4858000;11359000;;21783000;963304000;160587000;89861000;1213752000;1235535000;29682000;;55935000;539442000;539442000;595377000;795107000;-86840000;;640159000;1235536000
CUZ;446395;USD;2010;Q4;2010-12-31;2011-08-15;;;7599000;48395000;63403000;137912000;1021998000;167108000;44264000;1233370000;1371282000;32388000;;54633000;509509000;509509000;564142000;791513000;-86840000;;807141000;1371283000
CUZ;446395;USD;2018;Q4;2018-12-31;2019-02-06;105096750;106794000;2547000;13821000;;16516000;3699791000;161907000;268082000;4129780000;4146296000;110159000;;262570000;1062570000;1062570000;1325140000;4036916000;-148473000;;2821156000;4146296000
COR;82753;USD;2018;Q4;2018-12-31;2019-02-08;36331930;36443946;2599000;18464000;;211367000;1492421000;;149879000;1642300000;1853667000;144994000;;385365000;1133669000;1133669000;1519034000;491677000;;;334633000;1853667000
COR;82753;USD;2017;Q4;2017-12-31;2018-02-09;33897641;34086035;5247000;28875000;;127106000;1348076000;;150461000;1498537000;1625643000;126146000;;263925000;943074000;943074000;1206999000;457833000;;;418644000;1625643000
COR;82753;USD;2016;Q4;2016-12-31;2017-02-10;33456356;33885728;4429000;25125000;;29554000;1274273000;;147476000;1421749000;1451303000;114368000;;151781000;694742000;702436000;854217000;438865000;;;597086000;1451303000
COR;82753;USD;2015;Q4;2015-12-31;2016-02-12;28838928;29243233;6854000;12235000;;19089000;1010916000;;132538000;1143454000;1162543000;103887000;;132604000;395700000;403634000;536238000;390501000;;;626305000;1162543000
COR;82753;USD;2014;Q4;2014-12-31;2015-02-13;21307796;22127501;10662000;10290000;;20952000;930570000;;123082000;1053652000;1074604000;64818000;;84023000;323255000;332240000;416263000;275250000;;;658341000;1074604000
COR;82753;USD;2013;Q4;2013-12-31;2014-02-14;-165133351;-170060788;5313000;10339000;;15652000;892821000;;108021000;1000842000;1016494000;126032000;;137610000;180931000;190577000;328187000;267674000;;;688307000;1016494000
COR;82753;USD;2012;Q4;2012-12-31;2013-02-25;-533285196;-542402600;8130000;9901000;;18031000;724075000;;103226000;827301000;845332000;110374000;;121691000;8539000;12868000;134559000;259216000;;;710773000;845332000
COR;82753;USD;2011;Q4;2011-12-31;2012-02-24;200109730;199177150;6628000;6562000;;22481000;674168000;;111577000;785745000;808226000;155686000;;167632000;16872000;20407000;188039000;256387000;;-23545000;620187000;808226000
TMUS;515267;USD;2016;Q4;2016-12-31;2017-02-14;825016152;810824578;5500000000;1896000000;1111000000;14217000000;20943000000;;30731000000;51674000000;65891000000;7277000000;354000000;9022000000;27432000000;38633000000;47655000000;38846000000;-1000000;-20610000000;18236000000;65891000000
TMUS;515267;USD;2015;Q4;2015-12-31;2016-02-17;816696283;838726469;7580000000;1788000000;1295000000;14890000000;20000000000;;27523000000;47523000000;62413000000;8219000000;182000000;9528000000;26061000000;36328000000;45856000000;38666000000;0;-22108000000;16557000000;62413000000
TMUS;515267;USD;2014;Q4;2014-12-31;2015-02-19;807472451;840390411;5315000000;1865000000;1085000000;13984000000;16245000000;;26424000000;42669000000;56653000000;7595000000;87000000;8776000000;21873000000;32214000000;40990000000;38503000000;0;-22841000000;15663000000;56653000000
TMUS;515267;USD;2013;Q4;2013-12-31;2014-02-25;765056703;780773643;5891000000;2148000000;586000000;12228000000;15349000000;;22376000000;37725000000;49953000000;4766000000;244000000;5808000000;19945000000;29900000000;35708000000;37330000000;0;-23088000000;14245000000;49953000000
TMUS;515267;USD;2012;Q4;2012-12-31;2013-03-01;535286077;535286077;394000000;2678000000;457000000;5541000000;12807000000;;15274000000;28081000000;33622000000;5094000000;0;5592000000;13655000000;21915000000;27507000000;29197000000;0;-23123000000;6115000000;33622000000
TMUS;515267;USD;2011;Q4;2011-12-31;2012-02-29;1601527327;1595313458;2243254000;78023000;239648000;2743593000;4017999000;6319000;2715020000;6739338000;9482931000;512346000;33460000;816723000;4711021000;5738608000;6555331000;1784309000;-6832000;1159418000;2927600000;9482931000
TMUS;515267;USD;2010;Q4;2010-12-31;2011-03-01;177414164;179214077;1171393000;58056000;161049000;1593885000;3659445000;16700000;2648550000;6324695000;7918580000;521788000;21996000;802420000;3757287000;4574584000;5377004000;1686797000;-1914000;858108000;2541576000;7918580000
TMUS;515267;USD;2009;Q4;2009-12-31;2010-08-09;176198806;177118502;1154313000;51536000;147401000;1491391000;3252213000;6319000;2636094000;5894626000;7386017000;558366000;19326000;797469000;3625949000;4300406000;5097875000;1634789000;0;664693000;2288142000;7386017000
TMUS;515267;USD;2017;Q4;2017-12-31;2018-02-08;837515951;875878038;1219000000;1915000000;1566000000;8915000000;22196000000;;39452000000;61648000000;70563000000;8710000000;1612000000;11515000000;26707000000;36489000000;48004000000;38629000000;-4000000;-16074000000;22559000000;70563000000
TMUS;515267;USD;2018;Q4;2018-12-31;2019-02-07;849006336;865023178;1203000000;1769000000;1084000000;8281000000;23359000000;;40828000000;64187000000;72468000000;7941000000;841000000;10267000000;26706000000;37483000000;47750000000;38010000000;-6000000;-12954000000;24718000000;72468000000
ACF;748227;USD;2018;Q4;2018-12-31;2019-02-06;;;4883000000;;;58124000000;43810000000;1355000000;6631000000;51796000000;109920000000;1954000000;42835000000;49586000000;48153000000;48675000000;98261000000;8058000000;;4667000000;11659000000;109920000000
SYK;105030;USD;2016;Q4;2016-12-31;2017-02-09;374600000;379100000;3384000000;1967000000;2030000000;7861000000;1569000000;;11005000000;12574000000;20435000000;1997000000;228000000;3148000000;6686000000;7737000000;10885000000;1469000000;;8842000000;9550000000;20435000000
SYK;105030;USD;2015;Q4;2015-12-31;2016-02-11;374200000;378300000;4079000000;1662000000;1639000000;7943000000;1199000000;;7081000000;8280000000;16223000000;2024000000;768000000;3502000000;3230000000;4210000000;7712000000;1358000000;;7792000000;8511000000;16223000000
SYK;105030;USD;2014;Q4;2014-12-31;2015-02-12;378600000;383400000;5000000000;1572000000;1588000000;8684000000;1098000000;;7497000000;8595000000;17279000000;2983000000;727000000;4461000000;3246000000;4223000000;8684000000;1290000000;;7559000000;8595000000;17279000000
SYK;105030;USD;2013;Q4;2013-12-31;2014-02-13;378400000;382700000;3980000000;1518000000;1422000000;8335000000;1081000000;;6327000000;7408000000;15743000000;1867000000;25000000;2657000000;2739000000;4039000000;6696000000;1198000000;;7617000000;9047000000;15743000000
SYK;105030;USD;2012;Q4;2012-12-31;2013-02-27;380200000;382400000;4285000000;1430000000;1265000000;8148000000;948000000;;4110000000;5058000000;13206000000;926000000;16000000;1876000000;1746000000;2733000000;4609000000;1136000000;;7332000000;8597000000;13206000000
SYK;105030;USD;2011;Q4;2011-12-31;2012-02-13;381800000;383400000;3418000000;1417000000;1283000000;7207000000;888000000;;4051000000;4939000000;12146000000;1025000000;17000000;1840000000;1751000000;2623000000;4463000000;1060000000;;6479000000;7683000000;12146000000
SYK;105030;USD;2010;Q4;2010-12-31;2011-02-18;394500000;400700000;4380000000;1252000000;1057000000;7632000000;798000000;;2465000000;3263000000;10895000000;827000000;25000000;1605000000;996000000;2116000000;3721000000;1003000000;;6017000000;7174000000;10895000000
SYK;105030;USD;2009;Q4;2009-12-31;2010-02-26;397900000;400400000;2954800000;1147100000;943000000;5851200000;947600000;;2272500000;3220100000;9071300000;748700000;18000000;1441000000;;1035200000;2476200000;939700000;;5397400000;6595100000;9071300000
SYK;105030;USD;2008;Q4;2008-12-31;2009-09-03;399400000;402800000;2195600000;1129500000;952700000;4979300000;963800000;;1660200000;2624000000;7603300000;799700000;20500000;1462100000;;734500000;2196600000;852400000;;4389500000;5406700000;7603300000
SYK;105030;USD;2017;Q4;2017-12-31;2018-02-08;374500000;381100000;2793000000;2198000000;2465000000;7993000000;1975000000;;12229000000;14204000000;22197000000;1842000000;632000000;3485000000;6590000000;8732000000;12217000000;1533000000;;8986000000;9980000000;22197000000
SYK;105030;USD;2018;Q4;2018-12-31;2019-02-07;374400000;380200000;3699000000;2332000000;2955000000;9733000000;2291000000;;15205000000;17496000000;27229000000;1913000000;1373000000;4807000000;8486000000;10692000000;15499000000;1596000000;;10765000000;11730000000;27229000000
FLXS;248318;USD;2017;Q4;2017-06-30;2017-08-22;7820000;7878000;46832000;42362000;99397000;195250000;70661000;;4134000;74795000;270045000;16758000;;37195000;;2090000;39285000;34008000;;198465000;230760000;270045000
FLXS;248318;USD;2016;Q4;2016-06-30;2016-08-24;7675000;7642000;36780000;44618000;85904000;176443000;64124000;;6329000;70453000;246896000;11023000;;33357000;;3889000;37246000;30959000;;180919000;209650000;246896000
FLXS;248318;USD;2015;Q4;2015-06-30;2015-08-28;7468000;7769000;1282000;45101000;113842000;167002000;64770000;;12847000;77617000;244619000;18329000;11904000;51320000;;6552000;57872000;26307000;;162176000;186747000;244619000
FLXS;248318;USD;2014;Q4;2014-06-30;2014-08-28;7329000;7400000;22176000;38536000;97940000;165410000;31900000;;12903000;44803000;210213000;15818000;;36766000;;6712000;43478000;22757000;;145234000;166735000;210213000
FLXS;248318;USD;2013;Q4;2013-06-30;2013-08-23;7106000;7380000;10934000;36075000;92417000;149201000;32145000;;11193000;43338000;192539000;13927000;;35502000;;5800000;41302000;17722000;;134606000;151237000;192539000
FLXS;248318;USD;2012;Q4;2012-06-30;2012-08-22;6857000;7079000;13970000;33601000;82689000;135593000;29867000;;16212000;46079000;181672000;12973000;;31849000;;10381000;42230000;15382000;;125699000;139442000;181672000
FLXS;248318;USD;2011;Q4;2011-06-30;2011-10-24;6711000;6985000;17889000;31451000;73680000;128353000;21387000;;14937000;36324000;164677000;9899000;;27670000;;8434000;36104000;13409000;;115699000;128573000;164677000
FLXS;248318;USD;2018;Q4;2018-06-30;2018-09-06;7862000;7872000;43701000;41253000;96204000;189634000;90725000;;3934000;94659000;284293000;21420000;;40929000;;1666000;42595000;34189000;;209553000;241698000;284293000
FLXS;248318;USD;2019;Q4;2019-06-30;2019-09-13;7904000;7826000;22247000;38157000;93659000;165967000;79238000;;9082000;88320000;254287000;21911000;;44164000;;4696000;48860000;35415000;;170004000;205427000;254287000
FAST;339017;USD;2015;Q4;2015-12-31;2016-02-05;578960100;579880748;129019000;468375000;913263000;1664776000;818889000;;48797000;867686000;2532462000;311116000;62050000;373166000;302950000;358007000;731173000;4920000;;1842772000;1801289000;2532462000
FAST;339017;USD;2014;Q4;2014-12-31;2015-02-05;592066372;593603586;114496000;462077000;869224000;1583265000;763889000;;11948000;775837000;2359102000;285353000;90000000;375353000;0;68532000;443885000;36703000;;1886350000;1915217000;2359102000
FAST;339017;USD;2013;Q4;2013-12-31;2014-02-06;593504534;595287494;58957000;414331000;784068000;1408461000;654850000;;12473000;667323000;2075784000;239832000;0;239832000;;63255000;303087000;72815000;;1688781000;1772697000;2075784000
FAST;339017;USD;2012;Q4;2012-12-31;2013-02-07;592941734;594735866;79965000;372159000;715383000;1286656000;516427000;;12749000;529176000;1815832000;204174000;;204174000;;51298000;255472000;64402000;;1477601000;1560360000;1815832000
FAST;339017;USD;2011;Q4;2011-12-31;2012-02-09;590471978;592470766;144841000;338594000;646152000;1236138000;435601000;;13209000;448810000;1684948000;187818000;;187818000;;38154000;225972000;19809000;;1424371000;1458976000;1684948000
FAST;339017;USD;2010;Q4;2010-12-31;2011-02-09;589722848;589127824;169760000;270133000;557369000;1085698000;363419000;5152000;14014000;382585000;1468283000;162185000;;162185000;;23586000;185771000;5837000;;1258183000;1282512000;1468283000
FAST;339017;USD;2009;Q4;2009-12-31;2010-02-09;591355760;591355760;189252000;214169000;508405000;982364000;335004000;6238000;3752000;344994000;1327358000;119509000;;119509000;;17006000;136515000;1807000;;1175641000;1190843000;1327358000
FAST;339017;USD;2008;Q4;2008-12-31;2009-07-24;;;86743000;244940000;564247000;975403000;324182000;846000;3718000;328746000;1304149000;147993000;;147993000;;13897000;161890000;3044000;;1134244000;1142259000;1304149000
FAST;339017;USD;2016;Q4;2016-12-31;2017-02-06;578151288;578474826;112700000;499700000;993000000;1720800000;899700000;;48400000;948100000;2668900000;265200000;10500000;275700000;379500000;460100000;735800000;40300000;;1940100000;1933100000;2668900000
FAST;339017;USD;2017;Q4;2017-12-31;2018-02-05;574958660;575095970;116900000;607800000;1092900000;1935700000;893600000;;81200000;974800000;2910500000;348000000;3000000;351000000;412000000;462600000;813600000;11400000;;2110600000;2096900000;2910500000
FAST;339017;USD;2018;Q4;2018-12-31;2019-02-06;572155062;572509168;167200000;714300000;1278700000;2316200000;924800000;;80500000;1005300000;3321500000;434400000;3000000;437400000;497000000;581400000;1018800000;5900000;;2341600000;2302700000;3321500000
NWE;342218;USD;2016;Q4;2016-12-31;2017-02-17;48329584;48670558;5079000;159556000;49206000;280195000;4214892000;;1004234000;5219126000;5499321000;284681000;302790000;613832000;1817684000;3209262000;3823094000;1384791000;-95769000;396919000;1676227000;5499321000
NWE;342218;USD;2015;Q4;2015-12-31;2016-02-11;48107400;48777517;11980000;154410000;53458000;286660000;4059499000;;918536000;4978035000;5264695000;258499000;231711000;571200000;1794508000;3093321000;3664521000;1376809000;-93948000;325909000;1600174000;5264695000
NWE;342218;USD;2014;Q4;2014-12-31;2015-02-12;43490708;44280248;20362000;163479000;55094000;350885000;3758008000;;865050000;4623058000;4973943000;288843000;269570000;614582000;1690261000;2881578000;3496160000;1314349000;-92558000;264758000;1477783000;4973943000
NWE;342218;USD;2013;Q4;2013-12-31;2014-02-19;38644408;38555251;16557000;174913000;55609000;320956000;2690128000;;704176000;3394304000;3715260000;274570000;142612000;463588000;1184992000;2221002000;2684590000;910607000;-91744000;209091000;1030670000;3715260000
NWE;342218;USD;2012;Q4;2012-12-31;2013-02-14;37225708;37683690;9822000;143695000;54161000;303128000;2435590000;;746815000;3182405000;3485533000;276294000;124546000;449265000;1086636000;2102236000;2551501000;849626000;-90702000;172791000;934032000;3485533000
NWE;342218;USD;2011;Q4;2011-12-31;2012-02-16;36271852;36698940;5928000;147151000;59532000;290199000;2213267000;;706972000;2920239000;3210438000;270674000;172096000;475954000;937967000;1875372000;2351326000;817098000;-90273000;128631000;859112000;3210438000
NWE;342218;USD;2010;Q4;2010-12-31;2011-02-11;36217492;35988082;6234000;143304000;50701000;303054000;2117977000;;616638000;2734615000;3037669000;278942000;7854000;303969000;1096068000;1913353000;2217322000;814276000;-90427000;87984000;820347000;3037669000
NWE;342218;USD;2009;Q4;2009-12-31;2010-07-29;36524448;;4344000;143759000;47305000;264827000;1964121000;;566184000;2530305000;2795132000;258050000;982493000;1270165000;41693000;737943000;2008108000;807922000;-90228000;59605000;787024000;2795132000
NWE;342218;USD;2017;Q4;2017-12-31;2018-02-13;48907120;48984980;8473000;182282000;52432000;296359000;4358265000;;766293000;5124558000;5420917000;295207000;321689000;632238000;1815629000;2989764000;3622002000;1445711000;-96376000;458352000;1798915000;5420917000
NWE;342218;USD;2018;Q4;2018-12-31;2019-02-12;50335029;50960944;7860000;162373000;50815000;277685000;4521318000;;845373000;5366691000;5644376000;303835000;2298000;347009000;2122260000;3354985000;3701994000;1499609000;-95546000;548253000;1942382000;5644376000
MDLZ;378190;USD;2016;Q4;2016-12-31;2017-02-24;3109998431;3139998413;1741000000;2611000000;2469000000;8838000000;8229000000;5585000000;38886000000;52700000000;61538000000;7799000000;3982000000;14417000000;13217000000;21906000000;36323000000;31847000000;-16713000000;21149000000;25215000000;61538000000
MDLZ;378190;USD;2015;Q4;2015-12-31;2016-02-19;1590000000;1611000000;1870000000;2634000000;2609000000;9235000000;8362000000;5387000000;39859000000;53608000000;62843000000;7368000000;841000000;10922000000;14557000000;23821000000;34743000000;31760000000;-14462000000;20700000000;28100000000;62843000000
MDLZ;378190;USD;2014;Q4;2014-12-31;2015-02-20;1678000000;1697000000;1631000000;3802000000;3480000000;11750000000;9827000000;662000000;44532000000;55021000000;66771000000;8292000000;2835000000;14007000000;13821000000;24911000000;38918000000;31651000000;-11112000000;14529000000;27853000000;66771000000
MDLZ;378190;USD;2013;Q4;2013-12-31;2014-03-03;1745000000;1761000000;2622000000;4463000000;3743000000;13174000000;10247000000;;49094000000;59341000000;72515000000;8706000000;2597000000;14354000000;14482000000;25629000000;39983000000;31396000000;-9553000000;13419000000;32532000000;72515000000
MDLZ;378190;USD;2012;Q4;2012-12-31;2013-02-25;1779000000;1798000000;4475000000;;3741000000;15673000000;10010000000;;49794000000;59804000000;75477000000;8164000000;3851000000;14870000000;15574000000;28191000000;43061000000;31548000000;-7157000000;10551000000;32416000000;75477000000
MDLZ;378190;USD;2011;Q4;2011-12-31;2012-02-27;1772000000;1780000000;1974000000;;5706000000;16202000000;13813000000;;63822000000;77635000000;93837000000;9753000000;3836000000;18445000000;23095000000;40064000000;58509000000;31318000000;-7476000000;18012000000;35328000000;93837000000
MDLZ;378190;USD;2010;Q4;2010-12-31;2011-02-28;1751000000;1754000000;2481000000;;5310000000;16221000000;13792000000;;65276000000;79068000000;95289000000;9216000000;1865000000;15893000000;26859000000;43454000000;59347000000;31231000000;-8126000000;16619000000;35942000000;95289000000
MDLZ;378190;USD;2009;Q4;2009-12-31;2010-02-25;1481000000;1490000000;2101000000;;3775000000;12454000000;10693000000;;43567000000;54260000000;66714000000;7122000000;966000000;11491000000;18024000000;29251000000;40742000000;23611000000;-8416000000;14636000000;25972000000;66714000000
MDLZ;378190;USD;2008;Q4;2008-12-31;2009-08-05;;;1244000000;;3881000000;11461000000;9917000000;;41795000000;51712000000;63173000000;6127000000;1662000000;11044000000;18589000000;29773000000;40817000000;23563000000;-8714000000;13440000000;22356000000;63173000000
MDLZ;378190;USD;2017;Q4;2017-12-31;2018-02-09;1497000000;1511000000;761000000;2691000000;2557000000;7839000000;8677000000;6345000000;40248000000;55270000000;63109000000;8154000000;4680000000;15793000000;12972000000;21125000000;36918000000;31915000000;-18555000000;22749000000;26191000000;63109000000
MDLZ;378190;USD;2018;Q4;2018-12-31;2019-02-08;1458000000;1471000000;1100000000;2262000000;2592000000;7859000000;8482000000;7123000000;39265000000;54870000000;62729000000;8251000000;5840000000;16737000000;12532000000;20279000000;37016000000;31961000000;-20185000000;24491000000;25713000000;62729000000
ALXN;65359;USD;2017;Q4;2017-12-31;2018-02-08;224600000;225600000;1474100000;726500000;460400000;2953900000;1325400000;;9304000000;10629400000;13583300000;710200000;167400000;952500000;3063600000;3737700000;4690200000;8290300000;-1604900000;2242100000;8893100000;13583300000
ALXN;65359;USD;2016;Q4;2016-12-31;2017-02-16;222851000;229371000;1293400000;649600000;374700000;2578200000;1035600000;;9639500000;10675100000;13253300000;572100000;167000000;822900000;3121500000;3736600000;4559500000;7957000000;-1141300000;1817600000;8693800000;13253300000
ALXN;65359;USD;2015;Q4;2015-12-31;2016-02-08;225901000;230924000;1385000000;533000000;290000000;2416000000;697000000;;9984000000;10681000000;13097000000;460000000;166000000;709000000;3405000000;4129000000;4838000000;7727000000;-711000000;1181000000;8259000000;13097000000
ALXN;65359;USD;2014;Q4;2014-12-31;2015-02-06;198683000;201851000;1961566000;432888000;176441000;2796029000;392248000;;1013685000;1405933000;4201962000;439248000;48000000;606740000;116599000;293204000;899944000;2592187000;-382964000;1036010000;3302018000;4201962000
ALXN;65359;USD;2013;Q4;2013-12-31;2014-02-10;196448000;200781000;1514851000;421752000;102602000;2186857000;201109000;;929730000;1130839000;3317696000;423940000;48000000;582429000;97230000;353188000;935617000;2106203000;-80365000;379098000;2382079000;3317696000
ALXN;65359;USD;2012;Q4;2012-12-31;2013-02-19;194234000;201251000;989501000;295598000;94521000;1495600000;165629000;;952331000;1117960000;2613560000;271275000;48000000;360089000;101000000;282621000;642710000;1852241000;-14229000;126203000;1970850000;2613560000
ALXN;65359;USD;2011;Q4;2011-12-31;2012-02-17;184488000;193510000;540865000;244288000;81386000;941270000;165852000;;287629000;453481000;1394751000;199653000;0;227785000;0;32474000;260259000;1261608000;-2676000;-128619000;1134492000;1394751000
ALXN;65359;USD;2010;Q4;2010-12-31;2011-02-17;180172000;188924000;361605000;168732000;62165000;646556000;162240000;;203241000;365481000;1012037000;123056000;715000;138515000;4462000;13786000;152301000;1173486000;-2676000;-303934000;859736000;1012037000
ALXN;65359;USD;2009;Q4;2009-12-31;2010-07-30;175824000;183180000;176220000;113731000;40885000;373456000;164691000;;248254000;412945000;786401000;78445000;422000;85262000;10421000;12783000;98045000;1093938000;-2676000;-400964000;688356000;786401000
ALXN;65359;USD;2018;Q4;2018-12-31;2019-02-06;223200000;227100000;1563800000;922300000;472500000;3385000000;1471500000;;9075400000;10546900000;13931900000;698200000;93800000;1174000000;2862700000;3592600000;4766600000;8539100000;-1689900000;2325800000;9165300000;13931900000
AJG;66898;USD;2017;Q4;2017-12-31;2018-02-12;181100000;;681200000;;;7269400000;412200000;;7228100000;7640300000;14909700000;5933800000;290000000;6730200000;2691900000;3879800000;10610000000;3569200000;;1221800000;4299700000;14909700000
AJG;66898;USD;2016;Q4;2016-12-31;2017-02-13;178400000;;545500000;;;4416100000;377600000;;6695900000;7073500000;11489600000;3837200000;578000000;4611700000;2144600000;3222100000;7833800000;3443800000;;916400000;3655800000;11489600000
AJG;66898;USD;2015;Q4;2015-12-31;2016-02-10;176600000;;480400000;;;4213700000;249000000;;6447800000;6696800000;10910500000;3751100000;245000000;4187100000;2071700000;3035200000;7222300000;3386300000;;774500000;3688200000;10910500000
AJG;66898;USD;2014;Q4;2014-12-31;2015-02-13;162900000;;314400000;;;3811200000;195400000;;6003400000;6198800000;10010000000;3313100000;140000000;3642700000;2125000000;3062200000;6704900000;2814000000;;676000000;3305100000;10010000000
AJG;66898;USD;2013;Q4;2013-12-31;2014-02-07;132400000;;298100000;;;2875600000;160400000;;3824500000;3984900000;6860500000;2609800000;630500000;3284800000;825000000;1490200000;4775000000;1491700000;;596400000;2085500000;6860500000
AJG;66898;USD;2012;Q4;2012-12-31;2013-02-08;124800000;;302100000;;;2429500000;105400000;;2817400000;2922800000;5352300000;2197000000;129000000;2362900000;725000000;1330800000;3693700000;1181000000;;510400000;1658600000;5352300000
AJG;66898;USD;2011;Q4;2011-12-31;2012-02-14;113900000;;291200000;;;2199400000;91300000;;2192800000;2284100000;4483500000;1995700000;10000000;2073600000;675000000;1166300000;3239900000;807900000;;482900000;1243600000;4483500000
AJG;66898;USD;2010;Q4;2010-12-31;2011-02-07;106600000;;249800000;;;1726000000;75800000;;1794200000;1870000000;3596000000;1537300000;0;1577300000;550000000;912000000;2489300000;616200000;;488300000;1106700000;3596000000
AJG;66898;USD;2009;Q4;2009-12-31;2010-07-30;;;205900000;;;1540000000;80700000;;1629600000;1710300000;3250300000;1422700000;0;1474400000;550000000;883000000;2357400000;451600000;;450300000;892900000;3250300000
AJG;66898;USD;2018;Q4;2018-12-31;2019-02-08;183600000;;607200000;;;8118700000;436900000;;7778400000;8215300000;16334000000;6795300000;365000000;7693600000;3091400000;4070700000;11764300000;3725900000;;1558600000;4569700000;16334000000
NSC;378195;USD;2016;Q4;2016-12-31;2017-02-06;291000000;293800000;956000000;945000000;257000000;2291000000;29751000000;2777000000;73000000;32601000000;34892000000;1460000000;650000000;2339000000;9562000000;20144000000;22483000000;2471000000;;10425000000;12409000000;34892000000
NSC;378195;USD;2015;Q4;2015-12-31;2016-02-08;297800000;300000000;1101000000;946000000;271000000;2512000000;28992000000;2572000000;63000000;31627000000;34139000000;1294000000;700000000;2231000000;9393000000;19720000000;21951000000;2442000000;;10191000000;12188000000;34139000000
NSC;378195;USD;2014;Q4;2014-12-31;2015-02-11;;;973000000;1055000000;236000000;2778000000;27694000000;2679000000;49000000;30422000000;33200000000;1450000000;102000000;1780000000;8883000000;19012000000;20792000000;2458000000;;10348000000;12408000000;33200000000
NSC;378195;USD;2013;Q4;2013-12-31;2014-02-14;;;1561000000;1024000000;223000000;3075000000;26645000000;2439000000;324000000;29408000000;32483000000;1490000000;545000000;2305000000;8903000000;18889000000;21194000000;2331000000;;9339000000;11289000000;32483000000
NSC;378195;USD;2012;Q4;2012-12-31;2013-02-15;;;668000000;1109000000;216000000;2242000000;25736000000;2300000000;64000000;28100000000;30342000000;1568000000;250000000;2081000000;8432000000;18501000000;20582000000;2226000000;;8643000000;9760000000;30342000000
NSC;378195;USD;2011;Q4;2011-12-31;2012-02-15;;;301000000;1022000000;209000000;1751000000;24469000000;2234000000;84000000;26787000000;28538000000;1299000000;150000000;1701000000;7390000000;16926000000;18627000000;2244000000;;8693000000;9911000000;28538000000
NSC;378195;USD;2010;Q4;2010-12-31;2011-02-17;360500000;365600000;1110000000;807000000;169000000;2471000000;23231000000;2193000000;304000000;25728000000;28199000000;1380000000;458000000;2082000000;6567000000;15448000000;17530000000;2250000000;;9224000000;10669000000;28199000000
NSC;378195;USD;2009;Q4;2009-12-31;2010-02-17;368000000;373300000;1086000000;766000000;164000000;2246000000;22643000000;2164000000;316000000;25123000000;27369000000;1083000000;474000000;1789000000;6679000000;15227000000;17016000000;2179000000;;9027000000;10353000000;27369000000
NSC;378195;USD;2008;Q4;2008-12-31;2009-08-03;;;618000000;870000000;194000000;1999000000;22247000000;1779000000;272000000;24298000000;26297000000;1401000000;484000000;2105000000;6183000000;14585000000;16690000000;2048000000;;8501000000;9607000000;26297000000
NSC;378195;USD;2017;Q4;2017-12-31;2018-02-05;285200000;287700000;690000000;955000000;222000000;2149000000;30330000000;2981000000;251000000;33562000000;35711000000;1612000000;700000000;2545000000;9136000000;16807000000;19352000000;2539000000;;14176000000;16359000000;35711000000
NSC;378195;USD;2018;Q4;2018-12-31;2019-02-08;270500000;273000000;358000000;1009000000;207000000;1862000000;31091000000;3109000000;177000000;34377000000;36239000000;1760000000;585000000;2591000000;10560000000;18286000000;20877000000;2485000000;;13440000000;15362000000;36239000000
AOSL;175314;USD;2016;Q4;2016-06-30;2016-08-26;22609000;22609000;87774000;26594000;68848000;187930000;116084000;;14491000;130575000;318505000;67664000;819000;69480000;;6986000;76466000;191501000;-50199000;100071000;242039000;318505000
AOSL;175314;USD;2015;Q4;2015-06-30;2015-08-27;26307000;25689000;106085000;38781000;64175000;213688000;119579000;;14637000;134216000;347904000;64680000;941000;66337000;;4928000;71265000;181095000;-8593000;103232000;276639000;347904000
AOSL;175314;USD;2014;Q4;2014-06-30;2014-08-29;26211000;24970000;117788000;36535000;66560000;227779000;123254000;;13315000;136569000;364348000;58069000;14882000;73616000;1005000;7697000;81313000;174137000;-2889000;110754000;283035000;364348000
AOSL;175314;USD;2013;Q4;2013-06-30;2013-08-30;25595000;23940000;92406000;38298000;68339000;205855000;138111000;;12355000;150466000;356321000;47781000;5088000;53491000;13766000;21379000;74870000;168403000;-2054000;114145000;281451000;356321000
AOSL;175314;USD;2012;Q4;2012-06-30;2012-08-31;24939000;25859000;82166000;38850000;65778000;193781000;158543000;;13833000;172376000;366157000;59021000;4532000;63919000;17514000;22845000;86764000;160652000;-2104000;119873000;279393000;366157000
AOSL;175314;USD;2011;Q4;2011-06-30;2011-11-08;24516000;25952000;86708000;42503000;65251000;201345000;127839000;;18254000;146093000;347438000;82178000;306000;82979000;130000;4209000;87188000;153053000;-693000;106956000;260250000;347438000
AOSL;175314;USD;2017;Q4;2017-06-30;2017-09-05;23917000;24963000;115708000;28410000;76254000;225476000;139387000;;33545000;172932000;398408000;93268000;828000;94910000;866000;4949000;99859000;206391000;-49836000;113909000;298549000;398408000
AOSL;175314;USD;2018;Q4;2018-06-30;2018-08-23;23863000;24628000;131535000;33755000;90182000;285212000;331656000;;50181000;381837000;667049000;144713000;8302000;154680000;83577000;86207000;240887000;220305000;-64790000;122639000;426162000;667049000
AOSL;175314;USD;2019;Q4;2019-06-30;2019-08-23;24437000;26227000;121893000;24296000;111643000;295298000;409737000;;34359000;444096000;739394000;140000000;37964000;177964000;102761000;118141000;296105000;234472000;-66240000;125485000;443289000;739394000
KMB;384594;USD;2016;Q4;2016-12-31;2017-02-08;357700000;359500000;923000000;2176000000;1679000000;5115000000;7169000000;257000000;2061000000;9487000000;14602000000;4713000000;1133000000;5846000000;6439000000;8639000000;14485000000;;;;117000000;14602000000
KMB;384594;USD;2015;Q4;2015-12-31;2016-02-11;361800000;364400000;619000000;2281000000;1909000000;5426000000;7104000000;247000000;2065000000;9416000000;14842000000;4680000000;1669000000;6349000000;6106000000;8453000000;14802000000;1082000000;-2972000000;4994000000;40000000;14842000000
KMB;384594;USD;2014;Q4;2014-12-31;2015-02-18;369900000;373200000;789000000;2223000000;1892000000;5559000000;7359000000;257000000;2351000000;9967000000;15526000000;4900000000;1326000000;6226000000;5630000000;8301000000;14527000000;1168000000;-5597000000;8470000000;999000000;15526000000
KMB;384594;USD;2013;Q4;2013-12-31;2014-02-14;331543600;335043700;1054000000;2545000000;2233000000;6550000000;7948000000;382000000;4039000000;12369000000;18919000000;4967000000;375000000;5342000000;5386000000;8437000000;13779000000;1130000000;-3746000000;9714000000;5140000000;18919000000
KMB;384594;USD;2012;Q4;2012-12-31;2013-02-22;339904100;342917100;1106000000;2642000000;2348000000;6589000000;8095000000;355000000;4834000000;13284000000;19873000000;4976000000;1115000000;6091000000;5070000000;8495000000;14586000000;1017000000;-2796000000;8823000000;5287000000;19873000000
KMB;384594;USD;2011;Q4;2011-12-31;2012-02-29;410837700;414383900;764000000;2602000000;2356000000;6283000000;8049000000;338000000;4703000000;13090000000;19373000000;4691000000;706000000;5397000000;5426000000;8447000000;13844000000;976000000;-2105000000;8244000000;5529000000;19373000000
KMB;384594;USD;2010;Q4;2010-12-31;2011-02-23;425961200;427734300;876000000;2472000000;2373000000;6328000000;8356000000;374000000;4806000000;13536000000;19864000000;4488000000;344000000;4832000000;5120000000;8830000000;13662000000;1023000000;-4726000000;11086000000;6202000000;19864000000
KMB;384594;USD;2009;Q4;2009-12-31;2010-02-24;435243900;436912700;798000000;2566000000;2033000000;5864000000;8033000000;355000000;4957000000;13345000000;19209000000;4313000000;610000000;4923000000;4792000000;8596000000;13519000000;997000000;-4087000000;10329000000;5690000000;19209000000
KMB;384594;USD;2008;Q4;2008-12-31;2009-08-07;;;364000000;2492000000;2493000000;5813000000;7667000000;324000000;4285000000;12276000000;18089000000;3669000000;1083000000;4752000000;4882000000;9076000000;13828000000;1084000000;-4285000000;9465000000;4261000000;18089000000
KMB;384594;USD;2017;Q4;2017-12-31;2018-02-08;351300000;353500000;616000000;2315000000;1790000000;5211000000;7436000000;233000000;2271000000;9940000000;15151000000;4905000000;953000000;5858000000;6472000000;8411000000;14269000000;1249000000;-4431000000;6730000000;882000000;15151000000
KMB;384594;USD;2018;Q4;2018-12-31;2019-02-07;345600000;346700000;539000000;2164000000;1813000000;5041000000;7159000000;224000000;2094000000;9477000000;14518000000;5328000000;1208000000;6536000000;6247000000;8028000000;14564000000;1021000000;-3956000000;5947000000;-46000000;14518000000
CLF;754906;USD;2017;Q4;2017-12-31;2018-02-14;296236000;305036000;978300000;106700000;138400000;1544600000;1033800000;;375000000;1408800000;2953400000;210000000;44200000;452200000;2304200000;2945300000;3397500000;3971600000;-169600000;-4207300000;-444100000;2953400000
CLF;754906;USD;2016;Q4;2016-12-31;2017-02-09;230500000;237500000;323400000;128700000;178400000;824600000;984400000;;114900000;1099300000;1923900000;299500000;8700000;391100000;2175100000;2863300000;3254400000;3376800000;-245500000;-4574300000;-1330500000;1923900000
CLF;754906;USD;2015;Q4;2015-12-31;2016-02-24;153183000;129272000;285200000;40200000;329600000;982700000;1059000000;;93800000;1152800000;2135500000;297500000;;581700000;2699400000;3365400000;3947100000;2318700000;-265000000;-4748400000;-1811600000;2135500000
CLF;754906;USD;2014;Q4;2014-12-31;2015-02-25;153157000;151750000;271300000;122700000;260100000;1425300000;1070500000;;651400000;1721900000;3147200000;408500000;;954500000;2826500000;3927000000;4881500000;2329600000;-285700000;-3960700000;-1734300000;3147200000
CLF;754906;USD;2013;Q4;2013-12-31;2014-02-14;153037000;192324000;335500000;270000000;391400000;1485900000;11153400000;;482600000;11636000000;13121900000;855500000;69900000;1085500000;3022600000;5152100000;6237600000;2349300000;-305500000;3407300000;6884300000;13121900000
CLF;754906;USD;2012;Q4;2012-12-31;2013-02-12;142402000;140986000;195200000;329000000;436500000;1650000000;11207300000;;717600000;11924900000;13574900000;1092300000;94100000;1381500000;3960700000;6432500000;7814000000;1793200000;-322600000;3217700000;5760900000;13574900000
CLF;754906;USD;2011;Q4;2011-12-31;2012-02-16;142247000;143085000;519300000;287900000;456900000;1911200000;10404100000;;2226400000;12630500000;14541700000;1014900000;74800000;1502100000;3608700000;5999900000;7502000000;1789300000;-336000000;4424300000;7039700000;14541700000
CLF;754906;USD;2010;Q4;2010-12-31;2011-02-17;135366000;136251000;1566700000;359100000;269200000;2583700000;3979200000;;1215300000;5194500000;7778200000;675400000;;1028700000;1713100000;2910800000;3939500000;913600000;-37700000;2924100000;3838700000;7778200000
CLF;754906;USD;2009;Q4;2009-12-31;2010-02-18;130857000;131700000;502700000;103500000;272500000;1161200000;2592600000;88100000;797400000;3478100000;4639300000;375900000;;570400000;525000000;1531900000;2102300000;712200000;-19900000;1973100000;2537000000;4639300000
CLF;754906;USD;2018;Q4;2018-12-31;2019-02-08;296038000;307656000;823200000;226700000;87900000;1479600000;1286000000;;764000000;2050000000;3529600000;334700000;43500000;468200000;2092900000;2637200000;3105400000;3954400000;-186100000;-3060200000;424200000;3529600000
UTX;261978;USD;2017;Q4;2017-12-31;2018-02-09;789500000;798800000;8985000000;12595000000;9881000000;32858000000;10186000000;;53876000000;64062000000;96920000000;21895000000;2496000000;24391000000;24989000000;40977000000;65368000000;17574000000;-35596000000;55242000000;31552000000;96920000000
UTX;261978;USD;2016;Q4;2016-12-31;2017-02-09;800100000;808300000;7157000000;11481000000;8704000000;28550000000;9158000000;;51998000000;61156000000;89706000000;19702000000;2204000000;21906000000;21697000000;38335000000;60241000000;17285000000;-34150000000;52873000000;29465000000;89706000000
UTX;261978;USD;2015;Q4;2015-12-31;2016-02-11;846800000;854200000;7075000000;10653000000;8135000000;26706000000;8732000000;;52046000000;60778000000;87484000000;21513000000;1105000000;22618000000;19320000000;35900000000;58518000000;16033000000;-30907000000;49956000000;28966000000;87484000000
UTX;261978;USD;2014;Q4;2014-12-31;2015-02-05;894500000;904500000;5229000000;10448000000;7642000000;31483000000;8592000000;;51131000000;59723000000;91206000000;18777000000;1917000000;23475000000;17784000000;35027000000;58502000000;15300000000;-21922000000;44611000000;32704000000;91206000000
UTX;261978;USD;2013;Q4;2013-12-31;2014-02-06;900800000;917000000;4619000000;11458000000;10330000000;29442000000;8866000000;;52286000000;61152000000;90594000000;22300000000;500000000;22800000000;19741000000;34464000000;57264000000;14764000000;-20431000000;40539000000;33330000000;90594000000
UTX;261978;USD;2012;Q4;2012-12-31;2013-02-07;900200000;910500000;4819000000;11099000000;9537000000;29610000000;8518000000;;51281000000;59799000000;89409000000;21741000000;1624000000;23786000000;21597000000;38316000000;62102000000;13976000000;-19251000000;36776000000;27307000000;89409000000
UTX;261978;USD;2011;Q4;2011-12-31;2012-02-09;888800000;900600000;5960000000;9546000000;7797000000;25758000000;6201000000;;29493000000;35694000000;61452000000;17857000000;759000000;18616000000;9501000000;19658000000;38274000000;13445000000;-19410000000;33487000000;23178000000;61452000000
UTX;261978;USD;2010;Q4;2010-12-31;2011-02-10;902000000;916600000;4083000000;8925000000;7766000000;23510000000;6280000000;;28703000000;34983000000;58493000000;17453000000;279000000;17732000000;10010000000;18112000000;35844000000;12597000000;-17468000000;30191000000;22649000000;58493000000
UTX;261978;USD;2009;Q4;2009-12-31;2010-10-25;914000000;932000000;4449000000;8469000000;7509000000;23194000000;6364000000;;26204000000;32568000000;55762000000;16426000000;1487000000;17913000000;8257000000;16461000000;34374000000;11746000000;-15408000000;27396000000;21388000000;55762000000
UTX;261978;USD;2008;Q4;2008-12-31;2009-02-11;923000000;932000000;4327000000;9480000000;8340000000;24467000000;6348000000;;26022000000;32370000000;56837000000;17663000000;2139000000;19802000000;9337000000;20109000000;39911000000;11179000000;-14316000000;25159000000;16926000000;56837000000
UTX;261978;USD;2018;Q4;2018-12-31;2019-02-07;829900000;838600000;6152000000;14271000000;10083000000;35503000000;12297000000;;86411000000;98708000000;134211000000;21303000000;4345000000;31368000000;41192000000;62124000000;93492000000;22514000000;-32482000000;57823000000;40719000000;134211000000
REGN;378206;USD;2016;Q4;2016-12-31;2017-02-09;105120000;118543000;1038684000;1343368000;399356000;3180188000;2083421000;864260000;845597000;3793278000;6973466000;879096000;129557000;1241495000;351569000;1282726000;2524221000;3030103000;-316240000;1748222000;4449245000;6973466000
REGN;378206;USD;2015;Q4;2015-12-31;2016-02-11;103783000;115198000;1045223000;1152489000;238578000;2915095000;1594120000;632162000;467755000;2694037000;5609132000;644112000;0;811162000;362919000;1143133000;1954295000;3099634000;-306069000;852700000;3654837000;5609132000
REGN;378206;USD;2014;Q4;2014-12-31;2015-02-12;102552000;111046000;900480000;739379000;128861000;2084759000;974309000;460154000;318450000;1752913000;3837672000;483489000;;654660000;457711000;632761000;1287421000;2450886000;-169530000;216644000;2550251000;3837672000
REGN;378206;USD;2013;Q4;2013-12-31;2014-02-13;98864000;108018000;693984000;787071000;70354000;1796934000;526983000;389891000;237205000;1154079000;2951013000;250896000;;298835000;504573000;700102000;998937000;2045956000;0;-92692000;1952076000;2951013000
REGN;378206;USD;2012;Q4;2012-12-31;2013-02-15;95693000;127797000;308095000;593207000;28638000;1206012000;379940000;271230000;223308000;874478000;2080490000;111345000;1374000;163550000;455954000;671555000;835105000;1763605000;;-517054000;1245385000;2080490000
REGN;378206;USD;2011;Q4;2011-12-31;2012-02-21;91796000;91796000;526942000;28254000;;665777000;367955000;275887000;13964000;657806000;1323583000;95625000;1006000;148271000;434527000;689580000;837851000;1754917000;;-1267323000;485732000;1323583000
REGN;378206;USD;2010;Q4;2010-12-31;2011-02-17;;;249368000;2314000;;357622000;347450000;370053000;14307000;731810000;1089432000;53658000;675000;109056000;159355000;452561000;561617000;1575869000;;-1045563000;527815000;1089432000
REGN;378206;USD;2009;Q4;2009-12-31;2010-07-28;;;341330000;2865000;;425508000;259676000;47080000;8938000;315694000;741202000;49031000;0;93575000;109022000;250865000;344440000;1336813000;;-941095000;396764000;741204000
REGN;378206;USD;2017;Q4;2017-12-31;2018-02-08;107040000;115545000;1409580000;1538642000;726138000;4335030000;2358605000;1486494000;584157000;4429256000;8764286000;815078000;0;1135483000;703453000;1484725000;2620208000;3512945000;-316240000;2946733000;6144078000;8764286000
REGN;378206;USD;2018;Q4;2018-12-31;2019-02-07;108119000;114729000;2809900000;1723700000;1151200000;6447600000;2575800000;1755000000;956100000;5286900000;11734500000;218200000;;1442800000;708500000;1534400000;2977200000;3911700000;-396400000;5254300000;8757300000;11734500000
PYPL;109664;USD;2018;Q4;2018-12-31;2019-02-07;1176000000;1194000000;9109000000;20375000000;;32963000000;1724000000;971000000;7674000000;10369000000;43332000000;23906000000;;25904000000;;2042000000;27946000000;14939000000;-5511000000;5880000000;15386000000;43332000000
PYPL;109664;USD;2017;Q4;2017-12-31;2018-02-07;1205000000;1230000000;5695000000;24923000000;;32645000000;1528000000;1961000000;4640000000;8129000000;40774000000;21863000000;;22863000000;;1917000000;24780000000;14314000000;-2001000000;3823000000;15994000000;40774000000
PYPL;109664;USD;2016;Q4;2016-12-31;2016-10-25;1207000000;1218000000;4975000000;14577000000;;25733000000;1482000000;1539000000;4349000000;7370000000;33103000000;16878000000;;16878000000;;1513000000;18391000000;13579000000;-995000000;2069000000;14712000000;33103000000
PYPL;109664;USD;2015;Q4;2015-12-31;2016-02-11;1231000000;1241000000;3411000000;12398000000;;20648000000;1344000000;2348000000;4541000000;8233000000;28881000000;13617000000;;13617000000;;1505000000;15122000000;13100000000;0;668000000;13759000000;28881000000
PYPL;109664;USD;2014;Q4;2014-12-31;2015-07-29;1218000000;1230000000;2230000000;10677000000;;17565000000;922000000;31000000;3399000000;4352000000;21917000000;12190000000;;13283000000;;386000000;13669000000;0;;0;8248000000;21917000000
CNNX;208611;USD;2015;Q4;2015-12-31;2016-02-18;;;217000;;18916000;57588000;866309000;;528000;866837000;924425000;47783000;;47783000;73500000;73500000;121283000;313110000;;;803142000;924425000
CNNX;208611;USD;2014;Q4;2014-12-31;2015-02-26;;;3252000;;0;63445000;622746000;;613000;623359000;686804000;72741000;;72741000;31300000;31300000;104041000;293555000;;;582763000;686804000
CNNX;208611;USD;2013;Q4;2013-12-31;2014-10-30;;;5976000;;;21148000;388116000;;0;388116000;409264000;41190000;;41190000;368074000;368074000;409264000;;;;;409264000
CNNX;208611;USD;2017;Q4;2017-12-31;2018-02-07;;;3194000;8251000;;26718000;899278000;;593000;899871000;926589000;25978000;;25978000;149500000;149500000;175478000;393755000;;;751111000;926589000
CNNX;208611;USD;2016;Q4;2016-12-31;2017-02-16;;;6421000;0;;31036000;878560000;;8961000;887521000;918557000;26296000;;26296000;167000000;167000000;193296000;350055000;;;725261000;918557000
CNNX;208611;USD;2018;Q4;2018-12-31;2019-02-07;;;3966000;7028000;;30450000;891775000;;3203000;894978000;925428000;48899000;;48899000;477215000;477215000;526114000;331443000;;;399314000;925428000
NBIX;447972;USD;2016;Q4;2016-12-31;2017-02-14;86877000;86877000;307350000;;;310442000;6271000;43490000;4883000;54644000;365086000;26182000;3996000;30414000;;19795000;50209000;1371519000;;-1056324000;314877000;365086000
NBIX;447972;USD;2015;Q4;2015-12-31;2016-02-11;86261000;86261000;379191000;;;384074000;3432000;82488000;4791000;90711000;474785000;21595000;3692000;25715000;;24616000;50331000;1340665000;;-915234000;424454000;474785000
NBIX;447972;USD;2014;Q4;2014-12-31;2015-02-09;76221000;76221000;193809000;;;198203000;2507000;37492000;4831000;44830000;243033000;11754000;3443000;15664000;;18670000;34334000;1035281000;;-826305000;208699000;243033000
NBIX;447972;USD;2013;Q4;2013-12-31;2014-02-11;67358000;67358000;145739000;;;148462000;1771000;0;4443000;6214000;154676000;8056000;3227000;11699000;;22567000;34266000;886168000;;-765763000;120410000;154676000
NBIX;447972;USD;2012;Q4;2012-12-31;2013-02-08;66416000;71724000;173013000;14089000;;189264000;1900000;480000;4335000;6715000;195979000;9005000;6052000;15646000;;25961000;41607000;874047000;;-719673000;154372000;195979000
NBIX;447972;USD;2011;Q4;2011-12-31;2012-02-09;55264000;56462000;129103000;1903000;;132476000;1586000;;4306000;5892000;138368000;9562000;37284000;47110000;;31177000;78287000;784866000;;-724698000;60081000;138368000
NBIX;447972;USD;2010;Q4;2010-12-31;2011-07-29;54890000;54890000;126865000;4470000;;133051000;1532000;3739000;6102000;11373000;144424000;9413000;39979000;52777000;;72302000;125079000;781662000;;-762269000;19345000;144424000
NBIX;447972;USD;2017;Q4;2017-12-31;2018-02-13;88685000;88685000;515929000;31127000;;554919000;10811000;247361000;4500000;262672000;817591000;53520000;731000;54313000;369618000;391140000;445453000;1572854000;;-1198866000;372138000;817591000
NBIX;447972;USD;2018;Q4;2018-12-31;2019-02-08;90759000;105120000;650913000;56240000;10864000;737777000;33869000;216028000;5477000;255374000;993151000;86377000;;86377000;388496000;426009000;512386000;1660452000;;-1177755000;480765000;993151000
TYME;809189;USD;2017;Q4;2018-03-31;2018-06-13;93761299;93761299;28975822;;;29708377;3239;;1306225;1309464;31017841;4065780;480094;4545874;;0;4545874;79303548;;-52831581;26471967;31017841
TYME;809189;USD;2016;Q4;2017-03-31;2017-06-12;85003708;85003708;10482977;;;10711339;7535;;;7535;10718874;3327068;;3327068;;0;3327068;41253894;;-33862088;7391806;10718874
TYME;809189;USD;2018;Q4;2019-03-31;2019-06-12;103532717;103532717;14302328;;;16139115;10363;;1367173;1377536;17516651;5615796;597339;6213135;1635634;1635634;7848769;95482578;;-85814696;9667882;17516651
SGEN;487011;USD;2016;Q4;2016-12-31;2017-02-21;141883000;141883000;588986000;61928000;68124000;734648000;62870000;29988000;10890000;103748000;838396000;120669000;;148516000;;55793000;204309000;1701190000;;-1067040000;634087000;838396000
SGEN;487011;USD;2015;Q4;2015-12-31;2016-02-19;139693000;139693000;649651000;52930000;56963000;771059000;49598000;63060000;11378000;124036000;895095000;88031000;;134266000;;74918000;209184000;1613523000;;-926929000;685911000;895095000
SGEN;487011;USD;2014;Q4;2014-12-31;2015-02-27;123936000;123936000;313413000;39248000;43451000;407986000;46129000;0;4850000;50979000;458965000;77681000;;125893000;;122238000;248131000;1017306000;;-806443000;210834000;458965000
SGEN;487011;USD;2013;Q4;2013-12-31;2014-02-28;122538000;122538000;374267000;29508000;27073000;437256000;40787000;;5855000;46642000;483898000;59348000;;99198000;;154515000;253713000;960498000;;-730302000;230185000;483898000
SGEN;487011;USD;2012;Q4;2012-12-31;2013-02-27;119333000;119333000;364258000;33443000;37747000;440860000;24752000;;5810000;30562000;471422000;56130000;;100577000;;144697000;245274000;893893000;;-667782000;226148000;471422000
SGEN;487011;USD;2011;Q4;2011-12-31;2012-02-29;115156000;115156000;330696000;54955000;9469000;399581000;19652000;;5983000;25635000;425216000;53048000;;91140000;;115227000;206367000;832829000;;-614000000;218849000;425216000
SGEN;487011;USD;2010;Q4;2010-12-31;2011-05-06;;;281809000;19279000;0;304116000;12311000;13031000;478000;25820000;329936000;25783000;;54821000;;113597000;168418000;624861000;;-461970000;161518000;329936000
SGEN;487011;USD;2017;Q4;2017-12-31;2018-02-15;144079000;139368000;413171000;84774000;59978000;577061000;103756000;0;197132000;300888000;877949000;132672000;;167129000;;33251000;200380000;1806303000;;-1192570000;677569000;877949000
SGEN;487011;USD;2018;Q4;2018-12-31;2019-02-07;160886000;155885000;410672000;146281000;53239000;653595000;103820000;49194000;696720000;849734000;1503329000;191472000;;225072000;;4314000;229386000;2598571000;;-1324588000;1273943000;1503329000
CMG;80874;USD;2016;Q4;2016-12-31;2017-02-07;28897000;30676000;417716000;40451000;15019000;522374000;1303558000;125055000;75116000;1503729000;2026103000;281793000;;281793000;;341817000;623610000;1239233000;-2049389000;2220811000;1402493000;2026103000
CMG;80874;USD;2015;Q4;2015-12-31;2016-02-05;31025000;31310000;663204000;38283000;15043000;814647000;1217220000;622939000;70260000;1910419000;2725066000;279942000;;279942000;;317150000;597092000;1172986000;-1234612000;2197873000;2127974000;2725066000
CMG;80874;USD;2014;Q4;2014-12-31;2015-02-04;31022000;31541000;758057000;34839000;15332000;859511000;1106984000;496106000;64716000;1667806000;2527317000;245710000;;245710000;;269238000;514948000;1039286000;-748759000;1722271000;2012369000;2527317000
CMG;80874;USD;2013;Q4;2013-12-31;2014-02-05;31018000;31423000;578174000;24016000;13044000;666307000;963238000;313863000;65872000;1342973000;2009280000;199228000;;199228000;;271764000;470992000;920192000;-660421000;1276897000;1538288000;2009280000
CMG;80874;USD;2012;Q4;2012-12-31;2013-02-08;31303000;31489000;472859000;16800000;11096000;546607000;866703000;190868000;64489000;1122060000;1668667000;186852000;;186852000;;235889000;422741000;816961000;-521518000;949459000;1245926000;1668667000
CMG;80874;USD;2011;Q4;2011-12-31;2012-02-10;31288000;31790000;456248000;8389000;8913000;501192000;751951000;128241000;43924000;924116000;1425308000;157320000;133000;157453000;3529000;223629000;381082000;676996000;-304426000;671459000;1044226000;1425308000
CMG;80874;USD;2010;Q4;2010-12-31;2011-02-17;31049000;31695000;349604000;5658000;7098000;406221000;676881000;;38503000;715384000;1121605000;122933000;121000;123054000;3661000;187678000;310732000;594671000;-240918000;456514000;810873000;1121605000
CMG;80874;USD;2009;Q4;2009-12-31;2010-07-27;31583000;31904000;269566000;4763000;5614000;297454000;636411000;;27640000;664051000;961505000;102057000;96000;102153000;3782000;155891000;258044000;540215000;-114316000;277533000;703461000;961505000
CMG;80874;USD;2017;Q4;2017-12-31;2018-02-08;28150000;28155000;508951000;40453000;19860000;629535000;1338366000;;77791000;1416157000;2045692000;323893000;;323893000;;357354000;681247000;1305449000;-2334409000;2397064000;1364445000;2045692000
CMG;80874;USD;2018;Q4;2018-12-31;2019-02-08;27760000;27946000;676798000;62312000;21555000;814794000;1379254000;;71470000;1450724000;2265518000;379516000;;449990000;;374189000;824179000;1374514000;-2500556000;2573617000;1441339000;2265518000
FLEX;116586;USD;2016;Q4;2017-03-31;2016-05-20;546871000;550828000;1830675000;2192704000;3396462000;8387776000;2317026000;;1888561000;4205587000;12593363000;4829153000;61534000;6504627000;2890609000;3410460000;9915087000;6733539000;-388215000;-3572648000;2678276000;12593363000
FLEX;116586;USD;2015;Q4;2016-03-31;2015-05-21;569774000;581852000;1607570000;2044757000;3491656000;8315126000;2257633000;;1812222000;4069855000;12384981000;4601839000;65166000;6572205000;2709389000;3207246000;9779451000;6987214000;-388215000;-3892212000;2605530000;12384981000
FLEX;116586;USD;2014;Q4;2015-03-31;2014-05-20;598369000;611720000;1593728000;2697985000;3599008000;9400326000;2288656000;;811168000;3099824000;12500150000;5102668000;32575000;7656687000;2070020000;2641784000;10298471000;7614515000;-388215000;-4937094000;2201679000;12500150000
FLEX;116586;USD;2013;Q4;2014-03-31;2013-05-28;650940000;664302000;1587087000;2111996000;2722500000;7771401000;2174588000;;645566000;2820154000;10591555000;4056980000;416654000;6172785000;1650973000;2172012000;8344797000;8015142000;-388215000;-5302688000;2246758000;10591555000
FLEX;116586;USD;2012;Q4;2013-03-31;2012-05-29;685694000;699462000;1518329000;2593829000;3300791000;8534550000;2076442000;;422812000;2499254000;11033804000;4640210000;39340000;6288185000;2149333000;2461640000;8749825000;8292370000;-388215000;-5579739000;2283979000;11033804000
FLEX;116586;USD;2011;Q4;2012-03-31;2011-05-23;759874000;775885000;1748471000;2571912000;3517026000;9054199000;2084031000;;494922000;2578953000;11633152000;5379878000;21179000;6828931000;2199195000;2509525000;9338456000;8865556000;-523110000;-6068504000;2294696000;11633152000
FLEX;116586;USD;2010;Q4;2011-03-31;2010-05-24;812803000;831469000;1927556000;2438950000;2875819000;7990001000;2118576000;;533975000;2652551000;10642552000;4795292000;266551000;6347211000;1990258000;2310774000;8657985000;8924769000;-260074000;-6664723000;1984567000;10642552000
FLEX;116586;USD;2009;Q4;2010-03-31;2009-08-04;809695000;803810000;1821886000;2316939000;2996785000;7935006000;2333781000;;1048153000;3381934000;11316940000;4385657000;208403000;6408771000;2733680000;3047001000;9455772000;8862008000;-260074000;-6683317000;1861168000;11316940000
FLEX;116586;USD;2017;Q4;2018-03-31;2018-06-14;514779000;524992000;1472424000;2517695000;3799829000;9170414000;2239506000;;2305935000;4545441000;13715855000;5505635000;43011000;7268064000;2897631000;3429218000;10697282000;6636747000;-388215000;-3144114000;3018573000;13715855000
FLEX;116586;USD;2018;Q4;2019-03-31;2019-05-21;520317000;525492000;1696625000;2612961000;3722854000;9103432000;2336213000;;2059722000;4395935000;13499367000;5538827000;632611000;7597513000;2421904000;2929494000;10527007000;6523750000;-388215000;-3012012000;2972360000;13499367000
ARW;445806;USD;2016;Q4;2016-12-31;2017-02-07;89607000;90714000;534320000;6746687000;2855645000;10316721000;756299000;88401000;3044945000;3889645000;14206366000;6595395000;93827000;6689222000;2696334000;3051524000;9740746000;1237538000;-1637476000;5197230000;4465620000;14206366000
ARW;445806;USD;2015;Q4;2015-12-31;2016-02-05;92572000;93607000;273090000;6161418000;2466490000;9186471000;700178000;73376000;3061905000;3835459000;13021930000;6012128000;44024000;6056152000;2380575000;2770967000;8827119000;1232738000;-1480069000;4674480000;4194811000;13021930000
ARW;445806;USD;2014;Q4;2014-12-31;2015-02-05;96672000;97961000;400355000;6043850000;2335257000;9032607000;636299000;69124000;2697271000;3402694000;12435301000;5824567000;13454000;5838021000;2067898000;2438369000;8276390000;1211506000;-1169673000;4176754000;4158911000;12435301000
ARW;445806;USD;2013;Q4;2013-12-31;2014-02-05;100372000;101279000;390602000;5769759000;2167287000;8585770000;632389000;67229000;2775495000;3475113000;12060883000;5278068000;23878000;5301946000;2226132000;2574109000;7876055000;1196499000;-920528000;3678709000;4184828000;12060883000
ARW;445806;USD;2012;Q4;2012-12-31;2013-02-07;106224000;108306000;409684000;4923898000;2052720000;7715301000;599641000;65603000;2405142000;3070386000;10785687000;4545854000;364357000;4910211000;1587478000;1888114000;6798325000;1211663000;-652867000;3279289000;3987362000;10785687000
ARW;445806;USD;2011;Q4;2011-12-31;2012-02-01;112073000;113891000;396887000;4482117000;1963910000;7024591000;556229000;60579000;2187680000;2804488000;9829079000;3925084000;33843000;3958927000;1927823000;2194892000;6153819000;1201657000;-434959000;2772957000;3675260000;9829079000
ARW;445806;USD;2010;Q4;2010-12-31;2011-02-02;115579000;117582000;926321000;4102870000;1908953000;7085834000;505540000;59455000;1949709000;2514704000;9600538000;4282033000;61210000;4343243000;1761203000;2006100000;6349343000;1188798000;-318494000;2174147000;3251195000;9600538000
ARW;445806;USD;2009;Q4;2009-12-31;2010-07-28;119965000;121242000;1137007000;3136141000;1397668000;5839628000;460706000;53010000;1409022000;1922738000;7762366000;3209151000;123095000;3332246000;1276138000;1512823000;4845069000;1181991000;-179152000;1694517000;2917297000;7762366000
ARW;445806;USD;2017;Q4;2017-12-31;2018-02-06;88133000;89146000;730083000;8171092000;3302518000;12417759000;838475000;88347000;3118228000;4045050000;16462809000;7599763000;356806000;7956569000;2933045000;3506016000;11462585000;1239591000;-1762239000;5599192000;5000224000;16462809000
ARW;445806;USD;2018;Q4;2018-12-31;2019-02-07;86545000;87481000;509327000;8945463000;3878678000;13608300000;824700000;83693000;3267752000;4176145000;17784445000;8544171000;246257000;8790428000;3239115000;3617651000;12408079000;1261358000;-1972254000;6335335000;5376366000;17784445000
HXL;103406;USD;2017;Q4;2017-12-31;2018-02-07;90200000;91300000;60100000;248700000;314000000;656700000;1866300000;;257900000;2124200000;2780900000;257800000;4300000;262100000;805600000;1023700000;1285800000;775400000;-731400000;1496100000;1495100000;2780900000
HXL;103406;USD;2016;Q4;2016-12-31;2017-02-09;92000000;93300000;35200000;245600000;291000000;607000000;1625600000;;168000000;1793600000;2400600000;267600000;4300000;271900000;684400000;883800000;1155700000;739900000;-575300000;1254700000;1244900000;2400600000
HXL;103406;USD;2015;Q4;2015-12-31;2016-02-04;94600000;95400000;51800000;234000000;307200000;633800000;1425600000;;128000000;1553600000;2187400000;292600000;;292600000;576500000;715200000;1007800000;716900000;-457800000;1044400000;1179600000;2187400000
HXL;103406;USD;2014;Q4;2014-12-31;2015-02-05;95600000;97300000;70900000;233500000;290100000;681700000;1238200000;;116500000;1354700000;2036400000;309300000;1300000;310600000;415000000;575900000;886500000;679500000;-305400000;845500000;1149900000;2036400000
HXL;103406;USD;2013;Q4;2013-12-31;2014-02-05;99900000;102800000;65500000;232400000;265300000;656400000;1067400000;;112300000;1179700000;1836100000;265700000;3000000;268700000;292000000;407000000;675700000;643300000;-129700000;636100000;1160400000;1836100000
HXL;103406;USD;2012;Q4;2012-12-31;2013-02-08;100500000;102200000;32600000;229000000;232800000;575700000;914400000;;113000000;1027400000;1603100000;218700000;16600000;235300000;240000000;373700000;609000000;618000000;-40200000;448200000;994100000;1603100000
HXL;103406;USD;2011;Q4;2011-12-31;2012-02-07;99400000;100600000;49500000;199300000;215700000;524300000;722100000;;129700000;851800000;1376100000;234900000;12600000;247500000;238300000;326400000;573900000;590200000;-32100000;283900000;802200000;1376100000
HXL;103406;USD;2010;Q4;2010-12-31;2011-02-10;97900000;100900000;117200000;173900000;169900000;497700000;598300000;;162100000;760400000;1258100000;178300000;27600000;205900000;304600000;392800000;598700000;553300000;-27200000;148400000;659400000;1258100000
HXL;103406;USD;2009;Q4;2009-12-31;2010-07-26;96900000;98500000;110100000;158400000;157200000;461100000;602100000;;183400000;785500000;1246600000;168200000;33500000;201700000;358800000;469300000;671000000;536300000;-24700000;71000000;575600000;1246600000
HXL;103406;USD;2018;Q4;2018-12-31;2019-02-06;85800000;86800000;32700000;260900000;297800000;675800000;1876500000;;271800000;2148300000;2824100000;317300000;9400000;326700000;947400000;1175400000;1502100000;799400000;-1095900000;1726500000;1322000000;2824100000
AYR;825458;USD;2017;Q4;2017-12-31;2018-02-13;78287223;78570497;211922000;12815000;;792422000;6188469000;76982000;141210000;6406661000;7199083000;140221000;;197851000;4313606000;5093668000;5291519000;1528583000;;380331000;1907564000;7199083000
AYR;825458;USD;2016;Q4;2016-12-31;2017-02-14;77953306;78092211;455579000;6035000;;775705000;6247585000;72977000;148398000;6468960000;7244665000;127527000;;189752000;4506245000;5220599000;5410351000;1521976000;;315890000;1834314000;7244665000
AYR;825458;USD;2015;Q4;2015-12-31;2016-02-11;80260324;80260324;155904000;8566000;;528818000;5867062000;50377000;123707000;6041146000;6569964000;131058000;;263385000;4041156000;4527079000;4790464000;1551139000;;241574000;1779500000;6569964000
AYR;825458;USD;2014;Q4;2014-12-31;2015-02-19;80390033;80390033;169656000;3334000;;443525000;5579718000;46453000;105450000;5731621000;6175146000;140863000;;259079000;3744587000;4195732000;4454811000;1565990000;;192805000;1720335000;6175146000
AYR;825458;USD;2013;Q4;2013-12-31;2014-02-26;80342204;80342204;654613000;2825000;;1032384000;5044410000;21123000;153976000;5219509000;6251893000;111661000;;307888000;3737362000;4298598000;4606486000;1562914000;;158398000;1645407000;6251893000
AYR;825458;USD;2012;Q4;2012-12-31;2013-02-22;69098634;69098634;618217000;5625000;;962735000;4662661000;0;186764000;4849425000;5812160000;108593000;;330760000;3598676000;4065774000;4396534000;1361241000;;180675000;1415626000;5812160000
AYR;825458;USD;2011;Q4;2011-12-31;2012-02-29;71307458;70393787;295522000;3646000;;656620000;4387986000;;179853000;4567839000;5224459000;105432000;;403176000;2986516000;3416675000;3819851000;1400813000;;191476000;1404608000;5224459000
AYR;825458;USD;2010;Q4;2010-12-31;2011-08-04;;;239957000;1815000;;507824000;4065780000;;285455000;4351235000;4859059000;84434000;;382809000;2707958000;3133532000;3516341000;1486637000;;104301000;1342718000;4859059000
AYR;825458;USD;2018;Q4;2018-12-31;2019-02-12;75912148;76256166;152719000;15091000;;652124000;6935585000;69111000;214361000;7219057000;7871181000;153341000;;241113000;4761353000;5621387000;5862500000;1469533000;;539332000;2008681000;7871181000
CERN;259186;USD;2016;Q4;2016-12-31;2017-02-10;334999000;339869000;356449000;944943000;14740000;1619361000;1552524000;109374000;2348704000;4010602000;5629963000;507365000;26197000;845401000;537552000;856615000;1702016000;1234450000;-1290665000;4094327000;3927947000;5629963000
CERN;259186;USD;2015;Q4;2015-12-31;2016-02-17;341025000;348159000;513181000;1034084000;15788000;1827833000;1309214000;173073000;2251864000;3734151000;5561984000;457626000;41797000;777866000;563353000;913734000;1691600000;1079285000;-590390000;3457843000;3870384000;5561984000
CERN;259186;USD;2014;Q4;2014-12-31;2015-02-11;341923000;350194000;1420866000;672778000;23789000;2348786000;924260000;231147000;1026372000;2181779000;4530565000;357200000;67460000;634315000;62868000;330282000;964597000;936916000;-245333000;2918481000;3565968000;4530565000
CERN;259186;USD;2013;Q4;2013-12-31;2014-02-05;343689000;352365000;879381000;582926000;32299000;1761708000;792781000;554873000;989002000;2336656000;4098364000;376579000;54107000;640432000;111717000;290268000;930700000;816296000;-28251000;2393048000;3167664000;4098364000
CERN;259186;USD;2012;Q4;2012-12-31;2013-02-08;343580000;352515000;1036785000;577848000;23681000;1790506000;569708000;509467000;834787000;1913962000;3704468000;330878000;59582000;580112000;136557000;290706000;870818000;844211000;0;1994694000;2833650000;3704468000
CERN;259186;USD;2011;Q4;2011-12-31;2012-02-15;339970000;349882000;774781000;563209000;23296000;1502313000;488996000;359324000;649725000;1498045000;3000358000;245859000;39722000;438720000;86821000;250837000;689557000;725186000;;1597462000;2310801000;3000358000
CERN;259186;USD;2010;Q4;2010-12-31;2011-02-16;331972000;343568000;571012000;476905000;11036000;1146061000;498829000;264467000;513433000;1276729000;2422790000;171744000;24837000;305932000;67923000;211441000;517373000;618653000;;1290835000;1905417000;2422790000
CERN;259186;USD;2009;Q4;2009-12-31;2010-07-30;326704000;339200000;558836000;461411000;11242000;1146335000;509178000;0;493054000;1002232000;2148567000;195994000;25014000;358103000;95506000;209666000;567769000;558371000;-28002000;1053563000;1580798000;2148567000
CERN;259186;USD;2017;Q4;2017-12-31;2018-02-12;332470000;339128000;805767000;1042781000;15749000;2380227000;1603319000;196837000;2288928000;4089084000;6469311000;466673000;11585000;789595000;515130000;894368000;1683963000;1383963000;-1464099000;4938866000;4785348000;6469311000
CERN;259186;USD;2018;Q4;2018-12-31;2019-02-08;328393000;331255000;775411000;1183494000;25029000;2318804000;1743575000;300046000;2346211000;4389832000;6708636000;558587000;4914000;962690000;438802000;817557000;1780247000;1563184000;-2107768000;5576525000;4928389000;6708636000
RSG;101495;USD;2015;Q4;2015-12-31;2016-02-12;347038000;348436000;32400000;962900000;;1230300000;7552800000;;11752800000;19305600000;20535900000;1515400000;5500000;1834800000;7805500000;10924500000;12759300000;4681200000;-14900000;3138300000;7776600000;20535900000
RSG;101495;USD;2014;Q4;2014-12-31;2015-02-23;354448000;356138000;75200000;930400000;;1391000000;7165300000;;11537700000;18703000000;20094000000;1509300000;10400000;1826000000;7348800000;10520200000;12346200000;6881000000;-1901800000;2795000000;7747800000;20094000000
RSG;101495;USD;2013;Q4;2013-12-31;2014-02-13;360934000;362207000;213300000;890700000;;1421900000;7036800000;;11490500000;18527300000;19949200000;1399600000;15700000;1717100000;7297300000;10326000000;12043100000;6769000000;-1501200000;2632700000;7906100000;19949200000
RSG;101495;USD;2012;Q4;2012-12-31;2013-02-15;363245000;364288000;67600000;836600000;;1231300000;6910300000;;11475300000;18385600000;19616900000;1362400000;19400000;1695000000;7342000000;10216200000;11911200000;6593000000;-1287100000;2403200000;7705700000;19616900000
RSG;101495;USD;2011;Q4;2011-12-31;2012-02-17;370293000;371579000;66300000;825800000;;1265700000;6792300000;;11493500000;18285800000;19551500000;1572500000;34800000;1897500000;7190900000;9970600000;11868100000;6499600000;-961500000;2164700000;7683400000;19551500000
RSG;101495;USD;2010;Q4;2010-12-31;2011-02-18;384024000;386356000;88300000;828900000;;1246100000;6698500000;;11517300000;18215800000;19461900000;1502900000;878500000;2676500000;6169600000;8936500000;11613000000;6435100000;-500800000;1890300000;7848900000;19461900000
RSG;101495;USD;2009;Q4;2009-12-31;2010-02-24;381000000;383100000;48000000;865100000;;1264900000;6657700000;;11617700000;18275400000;19540300000;1674600000;543000000;2548700000;6721600000;9424500000;11973200000;6320100000;-457700000;1683100000;7567100000;19540300000
RSG;101495;USD;2008;Q4;2008-12-31;2009-08-07;239000000;240400000;68700000;945500000;;1325700000;6738200000;;11857500000;18595700000;19921400000;1701900000;504000000;2565800000;7433000000;10073100000;12638900000;6264000000;-456700000;1477200000;7282500000;19921400000
RSG;101495;USD;2016;Q4;2016-12-31;2016-10-28;340109000;341635000;67800000;994800000;;1284500000;7588600000;;11756500000;19345100000;20629600000;1493300000;5800000;1812000000;7927700000;11123900000;12935900000;4768000000;-414900000;3324000000;7693700000;20629600000
RSG;101495;USD;2017;Q4;2017-12-31;2018-02-09;333926000;335652000;83300000;1105900000;;1436800000;7777400000;;11932800000;19710200000;21147000000;1616000000;706700000;2634800000;7756100000;10551100000;13185900000;4843100000;-1059400000;4152500000;7961100000;21147000000
RSG;101495;USD;2018;Q4;2018-12-31;2019-02-08;324080000;325700000;70500000;1102700000;;1564400000;8020100000;;12032500000;20052600000;21617000000;1689200000;690700000;2718600000;7917600000;10968900000;13687500000;4928400000;-1782600000;4750500000;7929500000;21617000000
ST;749178;USD;2017;Q4;2017-12-31;2018-02-01;171312000;172606000;753089000;556541000;446129000;1848291000;750049000;;4043185000;4793234000;6641525000;613775000;15720000;629495000;3254549000;3666404000;4295899000;1665656000;-288478000;1031612000;2345626000;6641525000
ST;749178;USD;2016;Q4;2016-12-31;2017-02-02;170869000;171762000;351428000;500211000;389844000;1341485000;724046000;;4175445000;4899491000;6240976000;568653000;14643000;583296000;3258951000;3715673000;4298969000;1645738000;-306505000;636841000;1942007000;6240976000
ST;749178;USD;2015;Q4;2015-12-31;2016-02-02;170267000;171515000;342263000;467567000;358701000;1277923000;694155000;;4326832000;5020987000;6298910000;564736000;300439000;865175000;3300552000;3765159000;4630334000;1628313000;-324994000;391247000;1668576000;6298910000
ST;749178;USD;2014;Q4;2014-12-31;2015-02-03;169065000;171034000;211329000;444852000;356364000;1118764000;589484000;;3408361000;3997845000;5116609000;518097000;145979000;677506000;2695857000;3136211000;3813717000;1612679000;-365272000;67233000;1302892000;5116609000
ST;749178;USD;2013;Q4;2013-12-31;2014-02-06;175277000;177538000;317896000;291723000;183395000;855631000;344657000;;2298536000;2643193000;3498824000;306563000;8100000;318492000;1715866000;2038744000;2357236000;1598833000;-236346000;-187792000;1141588000;3498824000
ST;749178;USD;2012;Q4;2012-12-31;2013-02-08;177908000;181552000;413539000;258114000;176233000;894680000;323186000;;2430525000;2753711000;3648391000;261960000;12878000;278363000;1811777000;2147734000;2426097000;1589491000;-11423000;-316368000;1222294000;3648391000
ST;749178;USD;2011;Q4;2011-12-31;2012-02-10;176356577;194434351;92127000;261425000;197542000;593166000;331175000;;2532310000;2863485000;3456651000;262032000;13741000;279252000;1821969000;2132448000;2411700000;1559475000;-136000;-491164000;1044951000;3456651000
ST;749178;USD;2010;Q4;2010-12-31;2011-07-22;;;493662000;198245000;140949000;864428000;231693000;;2291876000;2523569000;3387997000;233713000;16779000;255100000;1872914000;2125116000;2380216000;1533013000;-136000;-497638000;1007781000;3387997000
ST;749178;USD;2018;Q4;2018-12-31;2019-02-06;164147000;165293000;729833000;581769000;492319000;1917155000;787178000;;4093354000;4880532000;6797687000;625383000;14561000;639944000;3250380000;3549309000;4189253000;1693393000;-399417000;1340636000;2608434000;6797687000
TAP;248956;USD;2017;Q4;2017-12-31;2018-02-14;215700000;216600000;418600000;728300000;591500000;2189700000;4673700000;;23383500000;28057200000;30246900000;2679600000;714800000;3399300000;10598700000;13412600000;16811900000;7351400000;-471400000;7206100000;13435000000;30246900000
TAP;248956;USD;2016;Q4;2016-12-31;2017-02-14;214900000;216200000;560900000;654400000;592700000;2169600000;4507400000;;22664500000;27171900000;29341500000;2467700000;684800000;3157500000;11387700000;14562300000;17719800000;7316600000;-471400000;6145300000;11621700000;29341500000
TAP;248956;USD;2015;Q4;2015-12-31;2016-02-11;184700000;186200000;430900000;407900000;179300000;1258800000;1590800000;2441000000;6985700000;11017500000;12276300000;1184400000;28700000;1217200000;2908700000;3996000000;5213200000;4713300000;-471400000;4496000000;7063100000;12276300000
TAP;248956;USD;2014;Q4;2014-12-31;2015-02-12;185400000;187900000;624600000;488900000;202200000;1577100000;1798000000;2388600000;8216400000;12403000000;13980100000;1305000000;849000000;2324900000;2321300000;3769100000;6094000000;4642900000;-321100000;4439900000;7886100000;13980100000
TAP;248956;USD;2013;Q4;2013-12-31;2014-02-14;183900000;185200000;442300000;572800000;205300000;1537700000;1970100000;2506500000;9565800000;14042400000;15580100000;1429600000;586900000;2161400000;3213000000;4788600000;6950000000;4571900000;-321100000;4199500000;8630100000;15580100000
TAP;248956;USD;2012;Q4;2012-12-31;2013-02-22;181100000;181900000;624000000;608300000;213900000;1748000000;1995900000;2431800000;10036500000;14464200000;16212200000;1186900000;1245600000;2598700000;3422500000;5621900000;8220600000;4459800000;-321100000;3900500000;7991600000;16212200000
TAP;248956;USD;2011;Q4;2011-12-31;2012-02-27;180600000;181900000;1078900000;529900000;207200000;2118000000;1430100000;2487900000;6387800000;10305800000;12423800000;915300000;46900000;1277200000;1914900000;3456400000;4733600000;4409000000;-321100000;3689700000;7690200000;12423800000
TAP;248956;USD;2010;Q4;2010-12-31;2011-02-22;186400000;187200000;1217600000;503800000;195000000;2220900000;1388700000;2574100000;6513900000;10476700000;12697600000;1032400000;1100000;1333900000;1959600000;3521100000;4855000000;4386200000;0;3241500000;7842600000;12697600000
TAP;248956;USD;2009;Q4;2009-12-31;2010-02-19;185000000;187100000;734200000;513800000;181300000;1707900000;1347400000;2613600000;6352200000;10313200000;12021100000;938400000;300300000;1580900000;1412700000;3347400000;4928300000;4324000000;;2734900000;7092800000;12021100000
TAP;248956;USD;2008;Q4;2008-12-31;2009-08-04;183500000;185500000;216200000;432900000;192100000;1107100000;1301900000;2418700000;5558900000;9279500000;10386600000;843600000;100000;986100000;1752000000;3361100000;4347200000;4241900000;;2184900000;6039400000;10386600000
TAP;248956;USD;2018;Q4;2018-12-31;2019-02-12;216200000;216700000;1057900000;736000000;591800000;2766300000;4608300000;;22735200000;27343500000;30109800000;2706400000;1594500000;4300900000;8893800000;12073100000;16374000000;7435900000;-471400000;7692900000;13735800000;30109800000
VNO;378237;USD;2018;Q4;2018-12-31;2019-02-11;190350000;192584000;570916000;73322000;;790227000;13057708000;470956000;2861903000;16390567000;17180794000;8598774000;;9078310000;2114516000;2211039000;11289349000;7733457000;;-4167184000;5891445000;17180794000
VNO;378237;USD;2017;Q4;2017-12-31;2018-02-12;145063230;148250836;1817655000;58700000;;1973512000;11871012000;537556000;3015854000;15424422000;17397934000;8552933000;;9248257000;1592348000;2157039000;11405296000;7500235000;;-4183253000;5992638000;17397934000
VNO;378237;USD;2016;Q4;2016-12-31;2016-10-31;233814029;237628937;1501027000;61069000;;1657128000;11606306000;665836000;6885577000;19157719000;20814847000;8510382000;;10463300000;1333422000;1454605000;11917905000;7160874000;;-1419382000;8896942000;20814847000
VNO;378237;USD;2015;Q4;2015-12-31;2015-11-02;233228928;234707143;1835707000;98062000;;2041568000;14671870000;725758000;3704097000;19101725000;21143293000;9957668000;;10743222000;1577297000;1694772000;12437994000;7140500000;;-1766780000;8705299000;21143293000
VNO;378237;USD;2014;Q4;2014-12-31;2014-11-03;232287571;233905567;1198477000;109998000;;1484679000;13660725000;720296000;5292280000;19673301000;21157980000;8635588000;;10871040000;1342494000;1459778000;12330818000;6880518000;;-1505385000;8827162000;21157980000
VNO;378237;USD;2013;Q4;2013-12-31;2013-11-04;158637259;159264783;583290000;115862000;;961592000;14122229000;859627000;4153776000;19135632000;20097224000;8754269000;;9734340000;1646725000;1764520000;11498860000;7151309000;;-1734839000;8598364000;20097224000
VNO;378237;USD;2012;Q4;2012-12-31;2012-11-01;158078042;150820341;960319000;195718000;;1339293000;15165949000;1224333000;4335474000;20725756000;22065049000;9083968000;;10568240000;2528008000;2648513000;13216753000;7202878000;;-1573275000;8848296000;22065049000
VNO;378237;USD;2011;Q4;2011-12-31;2011-11-03;252296900;246512242;606553000;171798000;;876419000;13809383000;1221919000;4538766000;19570068000;20446487000;8496392000;;9664864000;2003727000;2112499000;11777363000;7134631000;;-1401704000;8669124000;20446487000
VNO;378237;USD;2010;Q4;2010-12-31;2010-11-02;250589660;253391774;690789000;157146000;;1048757000;14672655000;1112951000;3683108000;19468714000;20517471000;8693580000;;9619924000;2634341000;2739168000;12359092000;6940045000;;-1480876000;8158379000;20517471000
VNO;378237;USD;2009;Q4;2009-12-31;2009-08-21;246271670;252056328;575479000;157325000;;1026754000;15132901000;583938000;3441879000;19158718000;20185472000;8667096000;;9693651000;2493849000;2590787000;12284438000;6968225000;;-1577591000;7901034000;20185472000
VNO;378237;USD;2008;Q4;2008-12-31;2009-08-21;;;1526853000;201566000;;2104307000;15652276000;1099957000;2561508000;19313741000;21418048000;9277247000;;10259295000;3676283000;3766123000;14025418000;6032171000;;-1047340000;7392630000;21418048000
DHX;653310;USD;2017;Q4;2017-12-31;2018-02-12;48062000;48014000;12068000;38769000;;58540000;16147000;;221031000;237178000;295718000;23325000;;106971000;41450000;56106000;163077000;376368000;-276173000;59776000;132641000;295718000
DHX;653310;USD;2016;Q4;2016-12-31;2017-02-09;47499000;45818000;22987000;43148000;;70178000;16610000;;223307000;239917000;310095000;23687000;;108302000;84760000;97910000;206212000;367067000;-274986000;44078000;103883000;310095000
DHX;653310;USD;2015;Q4;2015-12-31;2016-02-10;50360000;46121000;34050000;46380000;;88683000;15255000;;264997000;280252000;368935000;27889000;;113539000;99436000;116783000;230322000;353015000;-243410000;49476000;138613000;368935000
DHX;653310;USD;2014;Q4;2014-12-31;2015-02-10;51843000;53968000;26777000;49048000;;84562000;16066000;;323328000;339394000;423956000;26919000;2500000;119746000;108000000;126412000;246158000;333759000;-202499000;60444000;177798000;423956000
DHX;653310;USD;2013;Q4;2013-12-31;2014-02-14;53924000;56392000;39351000;37760000;;84648000;18612000;;317381000;335993000;420641000;27868000;2500000;113636000;116500000;139193000;252829000;309821000;-168727000;32832000;167812000;420641000
DHX;653310;USD;2012;Q4;2012-12-31;2013-02-04;58103000;61898000;42214000;29030000;;75937000;11158000;;267135000;278293000;354230000;20369000;0;94699000;46000000;68893000;163592000;295457000;-112111000;16586000;190638000;354230000
DHX;653310;USD;2011;Q4;2011-12-31;2012-02-03;65237000;69446000;60220000;20684000;;83603000;8726000;;234049000;242775000;326378000;17528000;4000000;83972000;11000000;33190000;117162000;285847000;-43078000;-21501000;209216000;326378000
DHX;653310;USD;2010;Q4;2010-12-31;2011-07-26;63352000;69486000;45196000;16921000;;68486000;5674000;;244562000;250236000;318722000;14536000;4000000;77904000;37000000;62591000;140495000;256906000;-11043000;-55601000;178227000;318722000
DHX;653310;USD;2018;Q4;2018-12-31;2019-02-08;48320000;50334000;6472000;22850000;;38855000;15890000;;203640000;219530000;258385000;26198000;;80921000;17288000;32109000;113030000;383999000;-278843000;71435000;145355000;258385000
FRT;378144;USD;2016;Q4;2016-12-31;2017-02-13;71621000;71776000;23368000;116749000;;140117000;5029839000;29904000;223419000;5283162000;5423279000;552347000;2447711000;3000058000;71590000;203692000;3203750000;2719047000;;;2219529000;5423279000
FRT;378144;USD;2015;Q4;2015-12-31;2016-02-09;69283000;69467000;21046000;110402000;;131448000;4490365000;41618000;233128000;4765111000;4896559000;554831000;2213635000;2768466000;71620000;208846000;2977312000;2382563000;;;1919247000;4896559000
FRT;378144;USD;2014;Q4;2014-12-31;2015-02-10;68004000;68186000;47951000;93291000;;141242000;4141948000;50988000;212692000;4405628000;4546870000;496824000;2047511000;2544335000;71647000;190926000;2735261000;2281910000;;;1811609000;4546870000
FRT;378144;USD;2013;Q4;2013-12-31;2014-02-11;65979000;66127000;88927000;84838000;;173765000;3798992000;55155000;191382000;4045529000;4219294000;509477000;1949369000;2458846000;71671000;184726000;2643572000;2063375000;;;1575722000;4219294000
FRT;378144;USD;2012;Q4;2012-12-31;2013-02-12;64399000;64557000;36988000;73861000;;110849000;3555379000;55648000;176689000;3787716000;3898565000;468189000;1837334000;2305523000;71693000;188029000;2493552000;1876173000;;;1405013000;3898565000
FRT;378144;USD;2011;Q4;2011-12-31;2012-02-16;63249000;63402000;67806000;75921000;;143727000;3298856000;55967000;167660000;3522483000;3666210000;444048000;1752158000;2196206000;63093000;144075000;2340281000;1765576000;;;1325929000;3666210000
FRT;378144;USD;2010;Q4;2010-12-31;2011-02-15;61254000;61405000;15797000;68997000;;84794000;2860738000;44813000;169208000;3074759000;3159553000;242056000;1609328000;1851384000;59940000;127039000;1978423000;1612321000;;;1181130000;3159553000
FRT;378144;USD;2009;Q4;2009-12-31;2010-08-04;;;135389000;72191000;;207580000;2821147000;48336000;145246000;3014729000;3222309000;411606000;1469828000;1881434000;62275000;131812000;2013246000;1653789000;;;1209063000;3222309000
FRT;378144;USD;2017;Q4;2017-12-31;2018-02-13;72514000;72597000;15188000;209877000;;225065000;5758517000;30429000;261744000;6050690000;6275755000;592528000;2892945000;3485473000;71556000;257611000;3743084000;2856054000;;;2532671000;6275755000
FRT;378144;USD;2018;Q4;2018-12-31;2019-02-13;73801000;73807000;64087000;142237000;;206324000;5760329000;30429000;292562000;6083320000;6289644000;535156000;2878658000;3413814000;71519000;272292000;3686106000;3005187000;;;2603538000;6289644000
WCG;745218;USD;2017;Q4;2017-12-31;2018-02-16;44521775;45138497;4668100000;;;5819200000;319500000;766200000;1459700000;2545400000;8364600000;2296900000;;4443200000;1182400000;1504700000;5947900000;591900000;;1827500000;2416700000;8364600000
WCG;745218;USD;2016;Q4;2016-12-31;2017-02-13;44293110;44795204;4085600000;;;5119600000;274500000;57300000;701400000;1033200000;6152800000;1365300000;;3055800000;997600000;1096900000;4152700000;547300000;;1453800000;2000100000;6152800000
WCG;745218;USD;2015;Q4;2015-12-31;2016-02-12;44109557;44477504;2611400000;;;4229600000;244800000;131800000;539600000;916200000;5145800000;605600000;299500000;2441100000;899600000;976400000;3417500000;518800000;;1211700000;1728300000;5145800000
WCG;745218;USD;2014;Q4;2014-12-31;2015-02-17;43902193;44477130;1486300000;;;3526300000;187100000;257300000;524300000;968700000;4495000000;416700000;0;1935700000;900000000;963400000;2899100000;503400000;;1093100000;1595900000;4495000000
WCG;745218;USD;2013;Q4;2013-12-31;2014-02-14;43731434;44084914;1797200000;;;2692700000;147400000;80400000;530200000;758000000;3450700000;247500000;;1237100000;600000000;695700000;1932800000;489800000;;1029400000;1517900000;3450700000
WCG;745218;USD;2012;Q4;2012-12-31;2013-02-13;43236388;44223998;1320800000;;;2100700000;131500000;96700000;346600000;574800000;2675500000;328100000;15000000;1113400000;120000000;239000000;1352400000;469800000;;854100000;1323100000;2675500000
WCG;745218;USD;2011;Q4;2011-12-31;2012-02-15;43008340;43556155;1523667000;;;2119894000;98238000;83019000;186960000;368217000;2488111000;317512000;11250000;1123140000;135000000;248125000;1371265000;449249000;;669358000;1116846000;2488111000
WCG;745218;USD;2010;Q4;2010-12-31;2011-02-16;42518325;42518325;1468336000;;;1815171000;76825000;62931000;292366000;432122000;2247293000;321305000;0;1185701000;0;229546000;1415247000;429243000;;405112000;832046000;2247293000
WCG;745218;USD;2009;Q4;2009-12-31;2010-08-09;;;1220853000;;;1717465000;61785000;51710000;287487000;400982000;2118447000;359363000;;1180070000;;57477000;1237547000;425507000;;458512000;880900000;2118447000
WCG;745218;USD;2018;Q4;2018-12-31;2019-02-12;49992092;50555296;4484000000;;;6832400000;428200000;813200000;3690900000;4932300000;11764700000;2118200000;;5015600000;2126400000;2509100000;7524700000;1981600000;;2267300000;4240000000;11764700000
NNN;448043;USD;2014;Q4;2014-12-31;2014-11-04;125562433;129096332;10604000;14088000;38074000;79740000;4685001000;;150810000;4835811000;4915551000;1721105000;26182000;1832459000;;0;1832459000;2713000000;;-196827000;3083092000;4915551000
ILMN;86933;USD;2016;Q4;2016-12-31;2017-02-14;146803000;148013000;1559000000;381000000;300000000;2318000000;713000000;;1250000000;1963000000;4281000000;480000000;2000000;705000000;1056000000;1262000000;1967000000;2735000000;-2022000000;1485000000;2314000000;4281000000
ILMN;86933;USD;2015;Q4;2015-12-31;2016-03-02;145964000;148952000;1386220000;385529000;270777000;2096823000;342694000;;1248230000;1590924000;3687747000;526070000;74929000;610494000;1015649000;1196154000;1806648000;2499360000;-1673608000;1022765000;1881099000;3687747000
ILMN;86933;USD;2014;Q4;2014-12-31;2015-02-18;142341000;148656000;1338371000;289458000;191144000;1889603000;265264000;;1184773000;1450037000;3339640000;417902000;304256000;722158000;986780000;1154684000;1876842000;2174745000;-1272073000;561206000;1462798000;3339640000
ILMN;86933;USD;2013;Q4;2013-12-31;2014-02-18;126709000;155998000;1165603000;238946000;154099000;1617535000;202666000;;1198805000;1401471000;3019006000;292775000;29288000;322063000;839305000;1163459000;1485522000;2564458000;-1240345000;207855000;1533484000;3019006000
ILMN;86933;USD;2012;Q4;2012-12-31;2013-02-15;123210000;135395000;1350204000;214975000;158718000;1787048000;166167000;;612870000;779037000;2566085000;267604000;36967000;304571000;805406000;942933000;1247504000;2421534000;-1187623000;82547000;1318581000;2566085000
ILMN;86933;USD;2011;Q4;2011-12-31;2012-02-24;121544000;124888000;1189568000;173886000;128781000;1544619000;143483000;;507738000;651221000;2195840000;226921000;0;226921000;807369000;893704000;1120625000;2251568000;-1109763000;-68707000;1075215000;2195840000
ILMN;86933;USD;2010;Q4;2010-12-31;2011-02-28;125877000;151169000;894289000;165598000;142211000;1258398000;129874000;;450841000;580715000;1839113000;222908000;311609000;534517000;0;106921000;641438000;1892804000;-541559000;-155335000;1197675000;1839113000
ILMN;86933;USD;2009;Q4;2009-12-31;2010-08-04;122794000;136070000;693527000;157751000;92776000;981590000;117188000;;331159000;448347000;1429937000;151034000;290202000;441236000;;124453000;565689000;1639187000;-497543000;-280226000;864248000;1429937000
ILMN;86933;USD;2017;Q4;2017-12-31;2018-02-13;146000000;150000000;2145000000;411000000;333000000;2980000000;931000000;;1346000000;2277000000;5257000000;592000000;10000000;746000000;1182000000;1542000000;2288000000;2835000000;-2341000000;2256000000;2969000000;5257000000
ILMN;86933;USD;2018;Q4;2018-12-31;2019-02-12;147000000;151000000;3512000000;514000000;386000000;4490000000;1075000000;;1394000000;2469000000;6959000000;697000000;1107000000;1804000000;890000000;1249000000;3053000000;3292000000;-2616000000;3083000000;3906000000;6959000000
IR;378166;USD;2015;Q4;2015-12-31;2016-02-12;262900000;265000000;736800000;2150600000;1410700000;4609400000;1575100000;;10533100000;12108200000;16717600000;3144200000;504200000;3648400000;3713600000;7190000000;10838400000;492300000;-452600000;6897900000;5879200000;16717600000
IR;378166;USD;2014;Q4;2014-12-31;2015-02-13;265400000;269100000;1705200000;2119000000;1358900000;5707900000;1477000000;;10113600000;11590600000;17298500000;3183400000;482700000;3666100000;3741700000;7587000000;11253100000;363400000;-202500000;6540800000;6045400000;17298500000
IR;378166;USD;2013;Q4;2013-12-31;2014-02-14;288400000;294000000;1937200000;2071500000;1166100000;5716700000;1468400000;;10473000000;11941400000;17658100000;3040900000;367700000;3408600000;3153500000;7118200000;10526800000;441900000;-800000;6794500000;7131300000;17658100000
IR;378166;USD;2012;Q4;2012-12-31;2013-02-14;68642800;67022400;708400000;1870100000;1144000000;5993900000;1426100000;;11062100000;12488200000;18482100000;2831200000;962900000;4325900000;2266500000;6926900000;11252800000;1310100000;;6358700000;7229300000;18482100000
IR;378166;USD;2011;Q4;2011-12-31;2012-02-21;56464800;77405600;1160700000;2135600000;1278300000;5279200000;1639400000;;11925500000;13564900000;18844100000;3362300000;763300000;4125600000;2879300000;7706100000;11831700000;1930100000;;5547800000;7012400000;18844100000
IR;378166;USD;2010;Q4;2010-12-31;2011-02-22;410155200;431314000;1014300000;2224200000;1288500000;6287400000;1669000000;;12034500000;13703500000;19990900000;3348100000;761600000;4285900000;2922300000;7645900000;11931800000;2899900000;;5389400000;8059100000;19990900000
IR;378166;USD;2009;Q4;2009-12-31;2010-02-26;403269200;424553200;876700000;2094200000;1176100000;4869500000;1888800000;;13232700000;15121500000;19991000000;3075900000;1191700000;4297600000;2904900000;8517700000;12815300000;2668200000;;4837900000;7175700000;19991000000
IR;378166;USD;2008;Q4;2008-12-31;2009-08-06;401516400;403519600;550200000;2512100000;1615100000;5399700000;1968500000;;13556300000;15524800000;20924500000;3161000000;2350400000;5511400000;2773700000;8651000000;14162400000;2564800000;;4547400000;6762100000;20924500000
IR;378166;USD;2016;Q4;2016-12-31;2017-02-13;259000000;262100000;1714700000;2223000000;1385800000;5579300000;1511000000;;10307100000;11818100000;17397400000;3229500000;360800000;3590300000;3709400000;7088800000;10679100000;618200000;-702700000;8018800000;6718300000;17397400000
IR;378166;USD;2017;Q4;2017-12-31;2018-02-12;250500000;253400000;1549400000;2477400000;1555400000;6119100000;1551300000;;10502900000;12054200000;18173300000;3721000000;1107000000;4828000000;2957000000;6138400000;10966400000;735300000;-1719400000;8903200000;7206900000;18173300000
IR;378166;USD;2018;Q4;2018-12-31;2019-02-12;244500000;247800000;903400000;2679200000;1677800000;5732000000;1730800000;;10452100000;12182900000;17914900000;3965100000;350600000;4315700000;3740700000;6534400000;10850100000;266400000;-1719400000;9439800000;7064800000;17914900000
SAVE;170150;USD;2017;Q4;2017-12-31;2018-02-13;68796000;68897000;901786000;49323000;;1282110000;2492155000;;371535000;2863690000;4145800000;22822000;115430000;664333000;1387498000;1718893000;2383226000;360160000;-65854000;1469732000;1762574000;4145800000
SAVE;170150;USD;2016;Q4;2016-12-31;2017-02-13;69307000;69534000;801055000;41136000;;977547000;1790910000;;385172000;2176082000;3153629000;15193000;84338000;545742000;897359000;1222703000;1768445000;551011000;-218692000;1054210000;1385184000;3153629000
SAVE;170150;USD;2015;Q4;2015-12-31;2016-02-17;71522000;71649000;803632000;28266000;;1026340000;1131054000;;373151000;1504205000;2530545000;17043000;49637000;466240000;596693000;838995000;1305235000;544284000;-116182000;798754000;1225310000;2530545000
SAVE;170150;USD;2014;Q4;2014-12-31;2015-02-18;72777000;73325000;632784000;22685000;;721498000;468256000;;402999000;871255000;1592753000;13402000;10431000;365624000;135232000;224054000;589678000;526180000;-3921000;481534000;1003075000;1592753000
SAVE;170150;USD;2013;Q4;2013-12-31;2014-02-20;72661000;73197000;530631000;23246000;;649075000;193282000;;338408000;531690000;1180765000;23104000;0;335993000;0;75655000;411648000;515338000;-2291000;256070000;769117000;1180765000
SAVE;170150;USD;2012;Q4;2012-12-31;2013-02-25;72446000;72623000;416816000;22740000;;547357000;125095000;;247432000;372527000;919884000;24166000;;276894000;;60455000;337349000;504534000;-1151000;79152000;582535000;919884000
SAVE;170150;USD;2011;Q4;2011-12-31;2012-02-23;72444000;72673000;343328000;15425000;;442708000;114660000;;188445000;303105000;745813000;15928000;;227064000;;52043000;279107000;496143000;-129000;-29308000;466706000;745813000
SAVE;170150;USD;2010;Q4;2010-12-31;2011-07-28;;;82714000;9471000;;251219000;63517000;;161021000;224538000;475757000;13360000;3240000;214429000;11966000;286688000;501117000;679000;0;-105756000;-25360000;475757000
SAVE;170150;USD;2018;Q4;2018-12-31;2019-02-13;68269000;68689000;1107522000;47660000;;1345466000;3352787000;;467204000;3819991000;5165457000;39320000;163557000;834535000;2024774000;2402418000;3236953000;371232000;-67016000;1625481000;1928504000;5165457000
GLPI;447206;USD;2018;Q4;2018-12-31;2019-02-13;214121000;215001000;25783000;13000000;;373434000;8105551000;;98308000;8203859000;8577293000;95079000;;457928000;5853497000;5853758000;6311686000;3954645000;;-1689038000;2265607000;8577293000
CNA;446249;USD;2018;Q4;2018-12-31;2019-02-13;271500000;272700000;41922000000;;;51545000000;324000000;391000000;4892000000;5607000000;57152000000;;0;39072000000;2680000000;6863000000;45935000000;2875000000;-57000000;9277000000;11217000000;57152000000
CNA;446249;USD;2017;Q4;2017-12-31;2018-02-14;271400000;272700000;43973000000;;;53778000000;326000000;411000000;2052000000;2789000000;56567000000;;150000000;37586000000;2708000000;6737000000;44323000000;2858000000;-60000000;9414000000;12244000000;56567000000
CNA;446249;USD;2016;Q4;2016-12-31;2016-10-31;270300000;271400000;42693000000;;;52316000000;310000000;405000000;2202000000;2917000000;55233000000;;0;36792000000;2710000000;6472000000;43264000000;2856000000;-73000000;9359000000;11969000000;55233000000
CNA;446249;USD;2015;Q4;2015-12-31;2015-11-03;270100000;270600000;41816000000;;;51617000000;343000000;404000000;2681000000;3428000000;55045000000;;350000000;37408000000;2210000000;5881000000;43289000000;2836000000;-78000000;9313000000;11756000000;55045000000
CNA;446249;USD;2014;Q4;2014-12-31;2014-11-04;270000000;270700000;42886000000;;;53082000000;295000000;405000000;1784000000;2484000000;55566000000;;0;36594000000;2559000000;6177000000;42771000000;2834000000;-84000000;9645000000;12795000000;55566000000
CNA;446249;USD;2013;Q4;2013-12-31;2013-04-30;269900000;270600000;43020000000;;;54298000000;304000000;443000000;2149000000;2896000000;57194000000;;549000000;38698000000;2011000000;5822000000;44520000000;2828000000;-91000000;9495000000;12674000000;57194000000
CNA;446249;USD;2012;Q4;2012-12-31;2012-10-30;269500000;269900000;44870000000;;;55832000000;326000000;434000000;1930000000;2690000000;58522000000;;13000000;39884000000;2557000000;6303000000;46187000000;2829000000;-99000000;8774000000;12335000000;58522000000
CNA;446249;USD;2011;Q4;2011-12-31;2011-11-01;269400000;269700000;41957000000;;;52063000000;309000000;436000000;2302000000;3047000000;55110000000;;83000000;37588000000;2593000000;6012000000;43600000000;2824000000;-102000000;8308000000;11510000000;55110000000
CNA;446249;USD;2010;Q4;2010-12-31;2011-08-02;269100000;269800000;40309000000;;;51368000000;333000000;425000000;3205000000;3963000000;55331000000;;400000000;38120000000;2311000000;5661000000;43781000000;2883000000;-105000000;7876000000;11550000000;55331000000
PTEN;345674;USD;2016;Q4;2016-12-31;2017-02-13;146672000;146672000;35152000;148091000;20191000;246882000;3408963000;;116446000;3525409000;3772291000;264815000;;264815000;598437000;1258752000;1523567000;1044611000;-911094000;2116341000;2248724000;3772291000
PTEN;345674;USD;2015;Q4;2015-12-31;2016-02-10;145719000;144957000;113346000;219672000;14716000;421415000;3920708000;;187361000;4108069000;4529484000;244382000;63267000;307649000;787900000;1660704000;1968353000;1013715000;-907045000;2458554000;2561131000;4529484000
PTEN;345674;USD;2014;Q4;2014-12-31;2015-02-12;144952000;143385000;43012000;663404000;32251000;872017000;4131071000;;390923000;4521994000;5394011000;555904000;12500000;568404000;973000000;1919797000;2488201000;986567000;-899035000;2811815000;2905810000;5394011000
PTEN;345674;USD;2013;Q4;2013-12-31;2014-02-14;142686000;142623000;249509000;451517000;21248000;775698000;3635541000;;275888000;3911429000;4687127000;344277000;10000000;354277000;682500000;1576853000;1931130000;915370000;-880888000;2707439000;2755997000;4687127000
PTEN;345674;USD;2012;Q4;2012-12-31;2013-02-13;146836000;147218000;110723000;465517000;26889000;647032000;3615383000;;294496000;3909879000;4556911000;353613000;6250000;359863000;692500000;1556391000;1916254000;865399000;-795051000;2548542000;2640657000;4556911000
PTEN;345674;USD;2011;Q4;2011-12-31;2012-02-10;156189000;156862000;23946000;518109000;31306000;622225000;3167266000;;432410000;3599676000;4221901000;408712000;10000000;418712000;492500000;1286558000;1705270000;842564000;-624759000;2279367000;2516631000;4221901000
PTEN;345674;USD;2010;Q4;2010-12-31;2011-02-14;153047000;153002000;27612000;337167000;17215000;530595000;2620900000;;271536000;2892436000;3423031000;309715000;6250000;315965000;392500000;919459000;1235424000;798456000;-620445000;1987999000;2187607000;3423031000
PTEN;345674;USD;2009;Q4;2009-12-31;2010-02-19;152358000;152264000;49877000;164498000;6941000;423084000;2110402000;;128666000;2239068000;2662152000;192450000;0;192450000;0;388002000;580452000;783443000;-618592000;1901853000;2081700000;2662152000
PTEN;345674;USD;2008;Q4;2008-12-31;2009-08-04;152665000;151787000;81223000;414531000;41999000;605446000;1937112000;;170259000;2107371000;2712817000;302613000;;302613000;0;283262000;585875000;767313000;-616969000;1970824000;2126942000;2712817000
PTEN;345674;USD;2017;Q4;2017-12-31;2018-02-20;220647000;226387000;42828000;580354000;69167000;746855000;4254730000;;757271000;5012001000;5758856000;546250000;;546250000;866783000;1230113000;1776363000;2788485000;-918711000;2105897000;3982493000;5758856000
PTEN;345674;USD;2018;Q4;2018-12-31;2019-02-13;215637000;215637000;245029000;558817000;65579000;950197000;4002549000;;517120000;4519669000;5469866000;526316000;;526316000;1119205000;1438127000;1964443000;2829827000;-1080448000;1753557000;3505423000;5469866000
HLT;740329;USD;2015;Q4;2015-12-31;2016-02-26;-126408000;-125331800;609000000;876000000;442000000;2585000000;9119000000;;13918000000;23037000000;25622000000;2239000000;204000000;2443000000;10249000000;17228000000;19671000000;10161000000;;-3392000000;5951000000;25622000000
HLT;740329;USD;2014;Q4;2014-12-31;2015-02-18;-127971500;-124946100;566000000;844000000;404000000;2499000000;7483000000;;16143000000;23626000000;26125000000;2120000000;137000000;2257000000;11555000000;19154000000;21411000000;10038000000;;-4658000000;4714000000;26125000000
HLT;740329;USD;2013;Q4;2013-12-31;2014-05-09;452701700;452701700;594000000;731000000;396000000;2383000000;9058000000;;15121000000;24179000000;26562000000;2090000000;52000000;2142000000;12671000000;20144000000;22286000000;9958000000;;-5331000000;4276000000;26562000000
AMGN;65735;USD;2016;Q4;2016-12-31;2017-02-14;741000000;747000000;38085000000;3165000000;2745000000;46010000000;4961000000;;26655000000;31616000000;77626000000;6801000000;4403000000;11204000000;30193000000;36547000000;47751000000;30784000000;;-438000000;29875000000;77626000000
AMGN;65735;USD;2015;Q4;2015-12-31;2016-02-16;754000000;762000000;31382000000;2995000000;2435000000;38515000000;4907000000;;28027000000;32934000000;71449000000;6417000000;2247000000;8664000000;29182000000;34702000000;43366000000;30649000000;;-2086000000;28083000000;71449000000
AMGN;65735;USD;2014;Q4;2014-12-31;2015-02-19;759000000;773000000;27026000000;2546000000;2647000000;34713000000;5223000000;;29073000000;34296000000;69009000000;6508000000;500000000;7008000000;30215000000;36223000000;43231000000;30410000000;;-4624000000;25778000000;69009000000
AMGN;65735;USD;2013;Q4;2013-12-31;2014-02-24;755000000;766000000;19401000000;2697000000;3019000000;27367000000;5349000000;;33409000000;38758000000;66125000000;5442000000;2505000000;7947000000;29623000000;36082000000;44029000000;29891000000;;-7634000000;22096000000;66125000000
AMGN;65735;USD;2012;Q4;2012-12-31;2013-02-27;762000000;780000000;24061000000;2518000000;2744000000;31209000000;5326000000;;17763000000;23089000000;54298000000;5696000000;2495000000;8191000000;24034000000;27047000000;35238000000;29337000000;;-10423000000;19060000000;54298000000
AMGN;65735;USD;2011;Q4;2011-12-31;2012-02-29;853000000;858000000;20641000000;2896000000;2484000000;27593000000;5420000000;;15858000000;21278000000;48871000000;5670000000;84000000;5754000000;21344000000;24088000000;29842000000;27777000000;;-8919000000;19029000000;48871000000
AMGN;65735;USD;2010;Q4;2010-12-31;2011-02-25;941000000;946000000;17422000000;2335000000;2022000000;23129000000;5522000000;;14835000000;20357000000;43486000000;4082000000;2488000000;6570000000;10874000000;12972000000;19542000000;27299000000;;-3508000000;23944000000;43486000000
AMGN;65735;USD;2009;Q4;2009-12-31;2010-03-01;1003000000;1008000000;13442000000;2109000000;2220000000;18932000000;5738000000;;14959000000;20697000000;39629000000;3873000000;0;3873000000;10601000000;13089000000;16962000000;26944000000;;-4322000000;22667000000;39629000000
AMGN;65735;USD;2008;Q4;2008-12-31;2009-08-10;1055000000;1063000000;9552000000;2073000000;2075000000;15221000000;5879000000;;15327000000;21206000000;36427000000;3886000000;1000000000;4886000000;8352000000;10656000000;15542000000;26441000000;;-5673000000;20885000000;36427000000
AMGN;65735;USD;2017;Q4;2017-12-31;2018-02-13;725000000;728000000;41678000000;3237000000;2834000000;49476000000;4989000000;;25489000000;30478000000;79954000000;7868000000;1152000000;9020000000;34190000000;45693000000;54713000000;30992000000;;-5072000000;25241000000;79954000000
AMGN;65735;USD;2018;Q4;2018-12-31;2019-02-13;636000000;640000000;29304000000;3580000000;2940000000;37618000000;4958000000;;23840000000;28798000000;66416000000;9069000000;4419000000;13488000000;29510000000;40428000000;53916000000;31246000000;;-17977000000;12500000000;66416000000
HAL;378158;USD;2016;Q4;2016-12-31;2017-02-07;864000000;862000000;4009000000;3922000000;2275000000;11677000000;8532000000;;6791000000;15323000000;27000000000;2308000000;170000000;4023000000;12214000000;13529000000;17552000000;2875000000;-7153000000;14141000000;9448000000;27000000000
HAL;378158;USD;2015;Q4;2015-12-31;2016-02-05;855000000;853000000;10077000000;5317000000;2993000000;20070000000;12117000000;;4755000000;16872000000;36942000000;2881000000;659000000;5337000000;14687000000;16110000000;21447000000;2951000000;-7650000000;20524000000;15495000000;36942000000
HAL;378158;USD;2014;Q4;2014-12-31;2015-02-24;849000000;849000000;2291000000;7564000000;3571000000;14647000000;12475000000;;5043000000;17518000000;32165000000;3847000000;14000000;5866000000;7765000000;10001000000;15867000000;2988000000;-8131000000;21809000000;16298000000;32165000000
HAL;378158;USD;2013;Q4;2013-12-31;2014-02-07;846000000;855000000;2356000000;6181000000;3305000000;13316000000;11322000000;;4585000000;15907000000;29223000000;3394000000;;5026000000;7816000000;10582000000;15608000000;3095000000;-8049000000;18842000000;13615000000;29223000000
HAL;378158;USD;2012;Q4;2012-12-31;2013-02-11;929000000;930000000;2484000000;5787000000;3186000000;12735000000;10257000000;;4418000000;14675000000;27410000000;2971000000;;4752000000;4820000000;6868000000;11620000000;3168000000;-4276000000;17182000000;15790000000;27410000000
HAL;378158;USD;2011;Q4;2011-12-31;2012-02-16;922000000;923000000;2698000000;5084000000;2570000000;11256000000;8492000000;;3929000000;12421000000;23677000000;2688000000;;4121000000;4820000000;6340000000;10461000000;3138000000;-4547000000;14880000000;13216000000;23677000000
HAL;378158;USD;2010;Q4;2010-12-31;2011-02-17;911000000;915000000;2051000000;3924000000;1940000000;8629000000;6842000000;;2826000000;9668000000;18297000000;1855000000;;2757000000;3824000000;5153000000;7910000000;3013000000;-4771000000;12371000000;10387000000;18297000000
HAL;378158;USD;2009;Q4;2009-12-31;2010-02-17;903000000;905000000;3394000000;2964000000;1598000000;8428000000;5759000000;;2351000000;8110000000;16538000000;1301000000;750000000;2889000000;3824000000;4892000000;7781000000;3080000000;-5002000000;10863000000;8757000000;16538000000
HAL;378158;USD;2008;Q4;2008-12-31;2009-07-30;895000000;897000000;1124000000;3795000000;1828000000;7165000000;4782000000;;2438000000;7220000000;14385000000;1541000000;26000000;2781000000;2586000000;3860000000;6641000000;3150000000;-5251000000;10041000000;7744000000;14385000000
HAL;378158;USD;2017;Q4;2017-12-31;2018-02-09;872000000;869000000;2337000000;5036000000;2396000000;10777000000;8521000000;;5787000000;14308000000;25085000000;3300000000;512000000;4862000000;10430000000;11874000000;16736000000;2880000000;-6757000000;12668000000;8349000000;25085000000
HAL;378158;USD;2018;Q4;2018-12-31;2019-02-13;871000000;872000000;2008000000;5234000000;3028000000;11151000000;8961000000;;5870000000;14831000000;25982000000;3732000000;36000000;4802000000;10421000000;11636000000;16438000000;2882000000;-6744000000;13739000000;9544000000;25982000000
IVAC;639373;USD;2017;Q4;2017-12-31;2018-02-14;21795000;22711000;35639000;20474000;33792000;92429000;12478000;6849000;3267000;22594000;115023000;18455000;;29481000;;2879000;32360000;177543000;-28489000;-66881000;82663000;115023000
IVAC;639373;USD;2016;Q4;2016-12-31;2017-02-15;20933000;20933000;44645000;17447000;24876000;88736000;11237000;3593000;4758000;19588000;108324000;26554000;;31976000;;3082000;35058000;171335000;-28489000;-69901000;73266000;108324000
IVAC;639373;USD;2015;Q4;2015-12-31;2016-02-17;21009000;20727000;36954000;12310000;18760000;69736000;11921000;9673000;6351000;27945000;97681000;15648000;;19273000;;2411000;21684000;166534000;-28489000;-62460000;75997000;97681000
IVAC;639373;USD;2014;Q4;2014-12-31;2015-02-17;23242000;23242000;51080000;12087000;19212000;84106000;12826000;17542000;5801000;36169000;120275000;16894000;;19445000;;2200000;21645000;161294000;-9989000;-53294000;98630000;120275000
IVAC;639373;USD;2013;Q4;2013-12-31;2014-02-20;23949000;23949000;69096000;15037000;22762000;108132000;12945000;12318000;14881000;40144000;148276000;12308000;;16990000;;1715000;18705000;156383000;-1688000;-25849000;129571000;148276000
IVAC;639373;USD;2012;Q4;2012-12-31;2013-02-22;23464000;23464000;64852000;19822000;26193000;112987000;13426000;27317000;18773000;59516000;172503000;17162000;;20636000;;9232000;29868000;152019000;;-10153000;142635000;172503000
IVAC;639373;USD;2011;Q4;2011-12-31;2012-02-21;23083000;23083000;82145000;18561000;18070000;128092000;14449000;32677000;50603000;97729000;225821000;18949000;;23989000;;9922000;33911000;146330000;;45166000;191910000;225821000
IVAC;639373;USD;2010;Q4;2010-12-31;2011-08-02;22496000;23115000;114514000;25911000;20671000;170850000;13918000;22866000;44137000;80921000;251771000;28031000;;32898000;;11630000;44528000;139847000;;67141000;207243000;251771000
IVAC;639373;USD;2018;Q4;2018-12-31;2019-02-13;22789000;24329000;34791000;27717000;30597000;95633000;11198000;4372000;10867000;26437000;122070000;15694000;;30008000;;2438000;32446000;183227000;-29047000;-64934000;89624000;122070000
F;249937;USD;2017;Q4;2017-12-31;2018-02-08;3975000000;4001000000;38927000000;62809000000;11176000000;116801000000;63562000000;56182000000;21951000000;141695000000;258496000000;23282000000;51621000000;94600000000;102666000000;128192000000;222792000000;21884000000;-1253000000;21906000000;35704000000;258496000000
F;249937;USD;2016;Q4;2016-12-31;2016-10-27;3975000000;4003000000;38827000000;57368000000;8898000000;108461000000;60901000000;49924000000;18665000000;129490000000;237951000000;21296000000;49669000000;90281000000;93301000000;118387000000;208668000000;21671000000;-1122000000;15634000000;29283000000;237951000000
F;249937;USD;2015;Q4;2015-12-31;2015-10-27;3970000000;4001000000;35176000000;56179000000;8319000000;102587000000;57256000000;45554000000;19528000000;122338000000;224925000000;20272000000;42975000000;82336000000;89879000000;113838000000;196174000000;21462000000;-977000000;14414000000;28751000000;224925000000
F;249937;USD;2014;Q4;2014-12-31;2014-10-31;3901000000;3640000000;31150000000;11708000000;7870000000;50728000000;53343000000;81111000000;23433000000;157887000000;208615000000;20035000000;;64067000000;119171000000;119741000000;183808000000;21129000000;-848000000;9422000000;24807000000;208615000000
F;249937;USD;2013;Q4;2013-12-31;2013-10-31;3942000000;4096000000;36568000000;9828000000;7708000000;54104000000;47600000000;77481000000;22994000000;148075000000;202179000000;134219000000;;175105000000;;598000000;175703000000;21462000000;-506000000;23386000000;26476000000;202179000000
F;249937;USD;2012;Q4;2012-12-31;2012-11-02;3828000000;4019000000;35943000000;10878000000;7362000000;54183000000;40245000000;70991000000;23987000000;135223000000;189406000000;124366000000;;172625000000;;470000000;173095000000;21016000000;-292000000;18077000000;16311000000;189406000000
F;249937;USD;2011;Q4;2011-12-31;2011-11-04;3802000000;4045000000;35766000000;8565000000;5901000000;50232000000;35209000000;69976000000;22931000000;128116000000;178348000000;117212000000;;162581000000;;696000000;163277000000;20943000000;-166000000;12985000000;15071000000;178348000000
F;249937;USD;2010;Q4;2010-12-31;2010-11-08;3572000000;3359000000;35570000000;8381000000;5917000000;49868000000;34854000000;70070000000;9895000000;114819000000;164687000000;120350000000;;164194000000;;1135000000;165329000000;20841000000;-163000000;-7038000000;-642000000;164687000000
F;249937;USD;2009;Q4;2009-12-31;2009-11-06;3310000000;3672000000;42281000000;7194000000;5041000000;54516000000;39907000000;75892000000;21725000000;137524000000;192040000000;145936000000;;197401000000;;2421000000;199822000000;16820000000;-177000000;-13599000000;-7782000000;192040000000
F;249937;USD;2008;Q4;2008-12-31;2009-08-05;;;39460000000;5674000000;6988000000;52122000000;49393000000;93484000000;23299000000;166176000000;218298000000;165722000000;;230790000000;;2035000000;232825000000;10898000000;-181000000;-16316000000;-14528000000;218297000000
F;249937;USD;2018;Q4;2018-12-31;2019-02-21;3969000000;3996000000;33951000000;65548000000;11220000000;114649000000;65297000000;55544000000;21050000000;141891000000;256540000000;21520000000;53493000000;95569000000;100720000000;124905000000;220474000000;22047000000;-1417000000;22668000000;36066000000;256540000000
VRTX;344083;USD;2017;Q4;2017-12-31;2018-02-15;251619000;262297000;2088666000;281343000;111830000;2648963000;789437000;;107614000;897051000;3546014000;517955000;22531000;807260000;20496000;696448000;1503708000;7159874000;;-5119723000;2042306000;3546014000
VRTX;344083;USD;2016;Q4;2016-12-31;2016-10-31;245507000;245507000;1434557000;200364000;77604000;1831540000;698362000;20276000;346609000;1065247000;2896787000;376700000;19426000;492537000;34976000;1066059000;1558596000;6509245000;;-5373836000;1338191000;2896787000
VRTX;344083;USD;2015;Q4;2015-12-31;2015-10-30;243029000;243029000;1042462000;173838000;57207000;1407153000;697715000;0;393719000;1091434000;2498587000;380762000;86841000;506167000;266786000;898792000;1404959000;6199927000;;-5261784000;1093628000;2498587000
VRTX;344083;USD;2014;Q4;2014-12-31;2014-11-06;238396000;238396000;1387106000;75964000;30848000;1546511000;715812000;;72356000;788168000;2334679000;280870000;32012000;368254000;319862000;870242000;1238496000;5779539000;;-4705450000;1096183000;2334679000
VRTX;344083;USD;2013;Q4;2013-12-31;2013-11-07;231645000;231645000;1465076000;85517000;14147000;1588576000;696911000;;33554000;730465000;2319041000;320404000;16893000;397829000;48754000;564807000;962636000;5323606000;;-3966895000;1356405000;2319041000
VRTX;344083;USD;2012;Q4;2012-12-31;2012-11-06;214655000;216673000;1321215000;143250000;30464000;1589585000;433609000;;736094000;1169703000;2759288000;366176000;14422000;432624000;415170000;1092282000;1524906000;4521597000;;-3521867000;1234382000;2759288000
VRTX;344083;USD;2011;Q4;2011-12-31;2011-11-03;206820000;209137000;968922000;183135000;112430000;1331254000;133176000;;739850000;873026000;2204280000;317829000;12075000;392348000;400000000;846420000;1238768000;4202731000;;-3414835000;965512000;2204280000
VRTX;344083;USD;2010;Q4;2010-12-31;2010-10-28;201389000;201389000;1031411000;12529000;;1057039000;72333000;;596074000;668407000;1725446000;173727000;136991000;474783000;400000000;746690000;1221473000;3949449000;;-3444409000;503973000;1725446000
VRTX;344083;USD;2009;Q4;2009-12-31;2010-05-03;185878000;185878000;1284913000;9601000;;1307026000;62279000;;586183000;648462000;1955488000;156313000;32071000;284883000;121765000;574259000;859142000;3786769000;;-2689783000;1096346000;1955488000
VRTX;344083;USD;2018;Q4;2018-12-31;2019-02-13;254897000;259842000;3168242000;409688000;124360000;3843109000;812005000;;1590784000;2402789000;6245898000;715482000;9817000;1120292000;19658000;690403000;1810695000;7424022000;;-2989478000;4435203000;6245898000
TRT;288723;USD;2018;Q4;2018-06-30;2018-09-25;7127447;7614228;7192000;8007000;2930000;19049000;13081000;;4344000;17425000;36474000;7161000;250000;9821000;1961000;3152000;12973000;14272000;;5525000;23501000;36474000
TRT;288723;USD;2017;Q4;2017-06-30;2017-09-20;10571964;10989792;5559000;9009000;1756000;17037000;12507000;;3954000;16461000;33498000;6505000;228000;9549000;2083000;2422000;11971000;14127000;;4341000;21527000;33498000
TRT;288723;USD;2016;Q4;2016-06-30;2016-05-12;3463;3514;4102000;8826000;1460000;15340000;12623000;;4256000;16879000;32219000;5793000;235000;8861000;2228000;2487000;11348000;14070000;;3025000;20871000;32219000
TRT;288723;USD;2015;Q4;2015-06-30;2015-05-13;3513;3561;3812000;7875000;1141000;13559000;14062000;;4416000;18478000;32037000;6150000;197000;8271000;2673000;3044000;11315000;13969000;;2246000;20722000;32037000
TRT;288723;USD;2014;Q4;2014-06-30;2014-05-14;3632;3707;3040000;8625000;1106000;13287000;15306000;0;5997000;21303000;34590000;6422000;81000;10718000;2798000;3039000;13757000;13854000;;1725000;20833000;34590000
TRT;288723;USD;2013;Q4;2013-06-30;2013-05-14;3322;3322;2897000;8728000;2463000;16578000;14744000;791000;3931000;19466000;36044000;7655000;105000;12394000;2841000;3044000;15438000;13287000;;1668000;20606000;36044000
TRT;288723;USD;2012;Q4;2012-06-30;2012-05-14;3356;3356;1822000;11311000;2324000;18056000;15008000;765000;4221000;19994000;38050000;8314000;175000;12860000;3594000;4634000;17494000;12962000;;2687000;20556000;38050000
TRT;288723;USD;2011;Q4;2011-06-30;2011-11-14;3328;2946;3310000;6812000;2430000;14429000;16189000;764000;4974000;21927000;36356000;5545000;148000;7173000;3039000;4206000;11379000;12758000;;5791000;24977000;36356000
TRT;288723;USD;2019;Q4;2019-06-30;2019-09-23;14681046;15036802;9007000;7113000;2427000;19740000;12941000;;3846000;16787000;36527000;7175000;283000;8133000;2734000;3533000;11666000;14729000;;7070000;24861000;36527000
APH;65820;USD;2017;Q4;2017-12-31;2018-02-21;305400000;317800000;1753700000;1598600000;1106900000;4656000000;816800000;;4531100000;5347900000;10003900000;1239500000;1100000;1579400000;3541500000;4381100000;5960500000;1249300000;;2941500000;4043400000;10003900000
APH;65820;USD;2016;Q4;2016-12-31;2016-11-03;308500000;315500000;1173200000;1349300000;928900000;3591200000;711400000;;4196100000;4907500000;8498700000;984400000;375200000;1635200000;2635500000;3140400000;4775600000;1021200000;;3122700000;3723100000;8498700000
APH;65820;USD;2015;Q4;2015-12-31;2016-02-19;308646358;315213404;1760400000;1104600000;851800000;3850000000;609500000;;2998900000;3608400000;7458400000;818400000;300000;1008400000;2813200000;3171600000;4180000000;783600000;;2804400000;3278400000;7458400000
APH;65820;USD;2014;Q4;2014-12-31;2015-02-20;309829424;317027013;1329600000;1123700000;865600000;3452200000;590700000;;2943000000;3533700000;6985900000;857800000;1600000;1045600000;2654600000;3002400000;4048000000;659700000;;2453500000;2937900000;6985900000
APH;65820;USD;2013;Q4;2013-12-31;2014-02-21;316582582;323117568;1192200000;1001000000;792600000;3157600000;532400000;;2478000000;3010400000;6168000000;751200000;701400000;1609900000;1431400000;1678000000;3287900000;490100000;;2424400000;2880100000;6168000000
APH;65820;USD;2012;Q4;2012-12-31;2013-02-22;320730828;325563140;942503000;910711000;733718000;2706915000;417436000;;2091112000;2508548000;5215463000;680008000;100293000;888514000;1606204000;1884767000;2773281000;336843000;;2210120000;2442182000;5215463000
APH;65820;USD;2011;Q4;2011-12-31;2012-02-24;328491646;332047790;648934000;767181000;649862000;2181237000;380501000;;1883487000;2263988000;4445225000;548992000;298000;642415000;1376831000;1618024000;2260439000;189329000;;2102497000;2184786000;4445225000
APH;65820;USD;2010;Q4;2010-12-31;2011-02-28;349085704;355237512;624229000;718545000;549169000;1992130000;366996000;;1656731000;2023727000;4015857000;525457000;352000;654990000;799640000;1018152000;1673142000;145031000;;2260581000;2342715000;4015857000
APH;65820;USD;2009;Q4;2009-12-31;2010-02-23;345000050;350180478;422383000;449591000;461750000;1420395000;332875000;;1465914000;1798789000;3219184000;413537000;399000;503159000;753050000;953207000;1456366000;71542000;;1774625000;1762818000;3219184000
APH;65820;USD;2008;Q4;2008-12-31;2009-08-06;347567700;351043564;214987000;515999000;512507000;1335864000;344515000;;1313780000;1658295000;2994159000;431440000;439000;634832000;786020000;990758000;1625590000;22917000;;1467099000;1368569000;2994159000
APH;65820;USD;2018;Q4;2018-12-31;2019-02-13;299800000;309700000;1291700000;1791800000;1233800000;4571600000;875800000;;4597500000;5473300000;10044900000;1319900000;764300000;2451300000;2806400000;3529400000;5980700000;1433500000;-55000000;3028700000;4064200000;10044900000
LIVE;655099;USD;2017;Q4;2017-09-30;2018-01-19;2737602;4570785;3972539;10636925;34501801;55547156;22817860;;50229579;73047439;128594595;17562480;48877536;66440016;26570271;28570271;95010287;63159266;-999242;-28575716;33584308;128594595
LIVE;655099;USD;2016;Q4;2016-09-30;2016-12-29;2820761;3342360;770895;7602764;11053085;25218762;14014501;;14234137;28248638;53467400;11799426;2011880;13811306;13460282;15460282;29271588;59571290;-300027;-35075579;24195812;53467400
LIVE;655099;USD;2015;Q4;2015-09-30;2016-01-13;2624255;2624255;2727818;8243992;13335598;25829435;12481901;;2353020;14834921;40664356;9573745;1443036;11016781;14568190;21380015;32396796;52967853;0;-46665003;8267560;40664356
LIVE;655099;USD;2014;Q4;2014-09-30;2014-12-29;2483559;2483559;8114682;854583;4277145;13830057;153114;;4306275;4459389;18289446;3328917;920360;4332857;638969;889969;5222826;45052707;;-31996953;13066620;18289446
LIVE;655099;USD;2013;Q4;2013-09-30;2014-01-10;1820856;1820856;761458;174901;0;1003485;71162;44639;2873964;2989765;3993250;823517;0;823517;0;0;823517;30492514;;-27333647;3169733;3993250
LIVE;655099;USD;2012;Q4;2012-09-30;2013-01-15;-304753;-304753;1305785;439848;;1798247;50526;374570;2033378;2458474;4256721;1427467;;1427467;;;1427467;24403103;;-21584715;2829254;4256721
LIVE;655099;USD;2011;Q4;2011-09-30;2011-12-29;339337;339337;244470;654856;;1012649;171201;371438;1253341;1795980;2808629;1025503;1036992;2062495;;0;2062495;20813780;-70923;-20007589;746134;2808629
LIVE;655099;USD;2010;Q4;2010-09-30;2011-08-15;316343;316343;3227374;948439;;4496227;397382;330234;1988246;2715862;7212089;1234628;60327;1294955;38283;38283;1333238;20442331;-70923;-14503423;5878851;7212089
LIVE;655099;USD;2018;Q4;2018-09-30;2018-12-27;1946728;3670919;1991622;13839422;46527039;65914802;27991060;;47866534;75857594;141772396;23159260;13958355;37509564;59384685;64814243;102323807;63656423;-1550011;-22654165;39448589;141772396
GOOD;106972;USD;2017;Q4;2017-12-31;2018-02-14;27957629;27957629;6683000;;;18126000;744436000;;165892000;910328000;928454000;7339000;;16296000;542627000;561928000;578224000;534819000;;;350230000;928454000
GOOD;106972;USD;2016;Q4;2016-12-31;2017-02-15;24037118;24037118;4658000;;;17250000;690088000;;144404000;834492000;851742000;5891000;;15674000;509395000;525448000;541122000;463462000;;;310620000;851742000
GOOD;106972;USD;2015;Q4;2015-12-31;2016-02-17;22189818;22189818;5152000;5900000;;16334000;668134000;;142716000;810850000;827184000;6388000;;16550000;525332000;538663000;555213000;418920000;;;271971000;827184000
GOOD;106972;USD;2014;Q4;2014-12-31;2015-02-18;18980421;18633241;8599000;5600000;;17746000;630432000;;139616000;770048000;787794000;8285000;;16813000;502599000;514809000;531622000;369769000;;;256172000;787794000
GOOD;106972;USD;2013;Q4;2013-12-31;2014-02-18;14849504;14849504;8546000;;;13597000;561112000;;115816000;676928000;690525000;2359000;;11978000;447002000;456901000;468879000;298767000;;;221646000;690525000
GOOD;106972;USD;2012;Q4;2012-12-31;2013-02-19;10977163;10915945;5546000;;;8481000;468023000;;88275000;556298000;564779000;4715000;;10595000;384185000;393319000;403914000;215481000;;;160865000;564779000
GOOD;106972;USD;2011;Q4;2011-12-31;2012-02-28;10971128;11023499;3329000;;;5802000;388737000;;58608000;447345000;453147000;1956000;;6643000;304050000;311190000;317833000;211564000;;;135314000;453147000
GOOD;106972;USD;2010;Q4;2010-12-31;2011-08-02;8637212;8721612;7062000;;;9350000;357358000;;43901000;401259000;410609000;2683000;;7300000;286595000;291934000;299234000;174270000;;;111375000;410609000
GOOD;106972;USD;2018;Q4;2018-12-31;2019-02-13;29110509;29110509;6591000;;;13233000;768392000;;157150000;925542000;938775000;2704000;;12519000;566059000;586239000;598758000;560007000;;;340017000;938775000
IRBT;675457;USD;2018;Q4;2018-12-31;2019-02-14;27672000;28794000;161978000;162166000;164633000;514437000;57026000;;195498000;252524000;766961000;208001000;;213757000;;17882000;231639000;173049000;;367021000;535322000;766961000
IRBT;675457;USD;2017;Q4;2017-12-31;2018-02-16;27885000;29023000;165860000;142829000;106932000;434726000;44579000;;212217000;256796000;691522000;189963000;;197724000;;23471000;221195000;190346000;;277989000;470327000;691522000
IRBT;675457;USD;2016;Q4;2016-12-31;2017-02-17;27191000;28080000;254453000;73048000;50578000;383670000;27532000;;96710000;124242000;507912000;108150000;;112636000;;6320000;118956000;162157000;;226950000;388956000;507912000
IRBT;675457;USD;2015;Q4;2015-12-31;2016-02-19;29108000;29813000;213039000;104679000;61678000;389349000;26850000;;105544000;132394000;521743000;77609000;;80874000;;23458000;104332000;232636000;;185011000;417411000;521743000
IRBT;675457;USD;2014;Q4;2014-12-31;2015-02-13;29623000;30495000;222123000;71056000;47857000;374859000;31297000;;87057000;118354000;493213000;78957000;;82806000;;19971000;102777000;249706000;;140881000;390436000;493213000
IRBT;675457;USD;2013;Q4;2013-12-31;2014-02-18;28901000;30050000;187358000;39348000;46107000;300661000;23661000;;92015000;115676000;416337000;56224000;;61309000;;24339000;85648000;227464000;;103078000;330689000;416337000
IRBT;675457;USD;2012;Q4;2012-12-31;2013-02-15;27784000;28418000;139200000;29413000;36965000;234893000;24953000;;94467000;119420000;354313000;56157000;;62414000;;16082000;78496000;200181000;;75437000;275817000;354313000
IRBT;675457;USD;2011;Q4;2011-12-31;2012-02-21;27190000;28360000;184119000;43338000;31089000;284180000;29029000;;19004000;48033000;332213000;65594000;;67121000;;22134000;89255000;184667000;;58140000;242958000;332213000
IRBT;675457;USD;2010;Q4;2010-12-31;2011-08-05;25697000;26915000;122311000;34056000;27160000;206593000;25620000;;22118000;47738000;254331000;54479000;;58013000;;21411000;79424000;156878000;;17949000;174907000;254331000
WSCO;659717;USD;2017;Q4;2017-09-30;2017-12-29;26922007;26922007;4560;10000;;14560;;;578;578;15138;113961;;113961;;0;113961;1324978;;-1423801;-98823;15138
WSCO;659717;USD;2016;Q4;2016-09-30;2016-12-12;26922007;26922007;422;0;;422;;;0;0;422;103479;;103479;;0;103479;1324978;;-1428035;-103057;422
WSCO;659717;USD;2015;Q4;2015-09-30;2015-12-23;26885195;26885195;857;;;857;;;;;857;66395;;66395;;;66395;1324978;;-1390516;-65538;857
WSCO;659717;USD;2014;Q4;2014-09-30;2014-12-24;26822007;26822007;1332;;;1332;;;;;1332;16412;;129212;;0;129212;1212178;;-1340058;-127880;1332
WSCO;659717;USD;2013;Q4;2013-09-30;2014-01-13;26561984;26561984;1833;;;1833;;;;;1833;48367;;72367;;0;72367;1173678;;-1244212;-70534;1833
WSCO;659717;USD;2012;Q4;2012-09-30;2012-12-31;1563553;1563553;4125;;;4125;;;;;4125;100607;427192;527799;;0;527799;603002;;-1126676;-523674;4125
WSCO;659717;USD;2011;Q4;2011-09-30;2011-12-23;;;1622;9154;;48276;;;;;48276;63415;308192;371607;;;371607;585502;;-908833;-323331;48276
WSCO;659717;USD;2010;Q4;2010-09-30;2011-07-21;;;19816;2000;;21816;;;;;21816;337737;0;337737;;;337737;150201;;-466122;-315921;21816
WSCO;659717;USD;2018;Q4;2018-09-30;2018-12-28;26922003;26922003;4812;2500;;7312;;;578;578;7890;125987;;125987;;0;125987;1324978;;-1443075;-118097;7890
WSCO;659717;USD;2019;Q4;2019-09-30;2019-11-01;26922010;26922010;8375;0;;8375;;;578;578;8953;103736;;103736;;0;103736;1324978;;-1419761;-94783;8953
PPC;423305;USD;2017;Q4;2017-12-31;2018-02-16;248754000;248997000;581510000;565478000;1255070000;2516288000;2095147000;;1637217000;3732364000;6248652000;1368141000;47775000;1452523000;2635617000;2940468000;4392991000;1935111000;-231758000;173943000;1855661000;6248652000
PPC;423305;USD;2016;Q4;2016-12-31;2017-02-09;250855000;251493000;292544000;445553000;975608000;1809885000;1833985000;;1378072000;3212057000;5021942000;1169445000;15712000;1185157000;1396124000;1750653000;2935810000;3407620000;-217117000;-782785000;2086132000;5021942000
PPC;423305;USD;2015;Q4;2015-12-31;2016-02-12;255150000;255375000;439638000;348994000;801357000;1746224000;1352529000;;219690000;1572219000;3318443000;818148000;28812000;846960000;985509000;1209673000;2056633000;1678271000;-99233000;-261252000;1261810000;3318443000
PPC;423305;USD;2014;Q4;2014-12-31;2015-02-12;258997000;259342000;576143000;378890000;790305000;1857734000;1182795000;;51189000;1233984000;3091718000;719295000;262000;719557000;3980000;175360000;894917000;1664944000;0;591492000;2196801000;3091718000
PPC;423305;USD;2013;Q4;2013-12-31;2014-02-21;258829000;259467000;605108000;376678000;808832000;1928982000;1151811000;;91609000;1243420000;3172402000;657649000;410234000;1083398000;501999000;596402000;1679800000;1655709000;;-120156000;1492602000;3172402000
PPC;423305;USD;2012;Q4;2012-12-31;2013-02-15;259390000;259555000;68180000;384930000;950296000;1542728000;1189921000;;181220000;1371141000;2913869000;609809000;15886000;730177000;1148870000;1274695000;2004872000;1644593000;;-669711000;908997000;2913869000
PPC;423305;USD;2011;Q4;2011-12-31;2012-02-17;224996000;224996000;41766000;349222000;879094000;1464193000;1241752000;497000;173103000;1415352000;2879545000;622314000;15611000;717173000;1408001000;1603942000;2321115000;1445627000;;-843945000;558430000;2879545000
PPC;423305;USD;2010;Q4;2010-12-31;2011-07-29;257138000;257138000;107631000;321300000;1029254000;1710465000;1358136000;11595000;138702000;1508433000;3218898000;641746000;58144000;738635000;1281160000;1401667000;2140302000;1444953000;;-348653000;1078596000;3218898000
PPC;423305;USD;2018;Q4;2018-12-31;2019-02-14;248980000;249371000;338386000;561549000;1159519000;2234657000;2161702000;;1534843000;3696545000;5931202000;1232490000;30405000;1296223000;2295190000;2615394000;3911617000;1947740000;-231994000;421888000;2019585000;5931202000
PII;104458;USD;2017;Q4;2017-12-31;2018-02-15;62995000;64895000;138345000;200144000;783961000;1253504000;747189000;;1088900000;1836089000;3089593000;442310000;47746000;1130311000;865266000;1015906000;2146217000;734525000;;242763000;943376000;3089593000
PII;104458;USD;2016;Q4;2016-12-31;2017-02-16;63581000;64326000;127325000;174832000;746534000;1190989000;727596000;;1181012000;1908608000;3099597000;393422000;3847000;959751000;1138063000;1264078000;2223829000;650793000;;300084000;875768000;3099597000
PII;104458;USD;2015;Q4;2015-12-31;2016-02-19;65415000;66593000;155349000;150778000;710001000;1152922000;650678000;;582059000;1232737000;2385659000;429677000;5059000;826783000;456417000;567754000;1394537000;596796000;;447173000;991122000;2385659000
PII;104458;USD;2014;Q4;2014-12-31;2015-02-20;66546000;68542000;137600000;204876000;565685000;1096555000;555428000;;422952000;978380000;2074935000;474907000;2528000;850810000;223620000;349330000;1200140000;486668000;;401840000;874795000;2074935000
PII;104458;USD;2013;Q4;2013-12-31;2014-02-21;67301000;69481000;92248000;186213000;417948000;865698000;455167000;;364623000;819790000;1685488000;347898000;3281000;748070000;284342000;393392000;1141462000;361272000;;155572000;544026000;1685488000
PII;104458;USD;2012;Q4;2012-12-31;2013-02-28;69113000;71151000;417015000;119769000;344996000;1017841000;253369000;;217317000;470686000;1488527000;260742000;2887000;631029000;104292000;166968000;797997000;269201000;;409091000;690530000;1488527000
PII;104458;USD;2011;Q4;2011-12-31;2012-02-27;68883000;71061000;325336000;115302000;298042000;875037000;213778000;;139209000;352987000;1228024000;223894000;2653000;586333000;104600000;141635000;727968000;166202000;;321831000;500056000;1228024000
PII;104458;USD;2010;Q4;2010-12-31;2011-03-01;68141000;70311000;393927000;89294000;235927000;808145000;184011000;;69491000;253502000;1061647000;195540000;100000000;584210000;100000000;106446000;690656000;79924000;;285169000;370991000;1061647000
PII;104458;USD;2009;Q4;2009-12-31;2010-08-05;65050000;67006000;140240000;90405000;179315000;491500000;194416000;10536000;67201000;272153000;763653000;154588000;;343074000;200000000;216038000;559112000;10318000;;191399000;204541000;763653000
PII;104458;USD;2018;Q4;2018-12-31;2019-02-14;61370000;62145000;161164000;197082000;969511000;1485703000;843122000;;1796090000;2639212000;4124915000;475842000;66543000;1197374000;1896027000;2053689000;3251063000;808595000;;121393000;873852000;4124915000
ZTS;378251;USD;2016;Q4;2016-12-31;2017-02-16;493960000;496713000;727000000;913000000;1502000000;3390000000;1381000000;;2878000000;4259000000;7649000000;1076000000;0;1117000000;4468000000;5033000000;6150000000;1029000000;-421000000;1477000000;1499000000;7649000000
ZTS;378251;USD;2015;Q4;2015-12-31;2016-02-24;498355000;502976000;1154000000;937000000;1467000000;3830000000;1307000000;;2776000000;4083000000;7913000000;1313000000;405000000;1781000000;4463000000;5041000000;6822000000;1017000000;-203000000;876000000;1091000000;7913000000
ZTS;378251;USD;2014;Q4;2014-12-31;2015-02-27;501561000;503269000;882000000;980000000;1289000000;3465000000;1318000000;;1805000000;3123000000;6588000000;1071000000;7000000;1086000000;3624000000;4165000000;5251000000;963000000;0;709000000;1337000000;6588000000
ZTS;378251;USD;2013;Q4;2013-12-31;2014-03-26;500008000;500586000;610000000;1138000000;1293000000;3357000000;1295000000;;1906000000;3201000000;6558000000;1381000000;15000000;1415000000;3642000000;4181000000;5596000000;883000000;;276000000;962000000;6558000000
ZTS;378251;USD;2012;Q4;2012-12-31;2013-05-15;500000000;500000000;317000000;900000000;1345000000;2864000000;1241000000;;2157000000;3398000000;6262000000;543000000;73000000;1123000000;509000000;1098000000;2221000000;0;;0;4041000000;6262000000
ZTS;378251;USD;2017;Q4;2017-12-31;2018-02-15;487372000;490944000;1564000000;998000000;1427000000;4217000000;1435000000;;2934000000;4369000000;8586000000;1050000000;;1094000000;4953000000;5706000000;6800000000;1018000000;-852000000;2109000000;1786000000;8586000000
ZTS;378251;USD;2018;Q4;2018-12-31;2019-02-14;480552000;484492000;1701000000;1036000000;1391000000;4399000000;1658000000;;4720000000;6378000000;10777000000;1180000000;9000000;1223000000;6443000000;7369000000;8592000000;1031000000;-1487000000;3270000000;2185000000;10777000000
OI;406666;USD;2016;Q4;2016-12-31;2017-02-10;162199000;163483000;492000000;580000000;983000000;2254000000;2880000000;;4001000000;6881000000;9135000000;1576000000;195000000;2060000000;5133000000;6712000000;8772000000;3082000000;-560000000;-96000000;363000000;9135000000
OI;406666;USD;2015;Q4;2015-12-31;2016-02-16;160808000;161734000;399000000;562000000;1007000000;2334000000;2961000000;;4126000000;7087000000;9421000000;1619000000;228000000;2122000000;5345000000;7020000000;9142000000;3066000000;-573000000;-305000000;279000000;9421000000
OI;406666;USD;2014;Q4;2014-12-31;2015-02-11;164416000;165627000;512000000;550000000;1035000000;2371000000;2445000000;;3027000000;5472000000;7843000000;1552000000;488000000;2328000000;2957000000;4744000000;7072000000;3068000000;-480000000;-440000000;771000000;7843000000
OI;406666;USD;2013;Q4;2013-12-31;2014-02-13;164716000;166099000;383000000;943000000;1117000000;2550000000;2632000000;;3237000000;5869000000;8419000000;1613000000;322000000;2254000000;3245000000;4562000000;6816000000;3042000000;-454000000;-11000000;1603000000;8419000000
OI;406666;USD;2012;Q4;2012-12-31;2013-02-13;-493182104;-497237928;431000000;968000000;1139000000;2648000000;2769000000;;3181000000;5950000000;8598000000;1516000000;319000000;2162000000;3454000000;5381000000;7543000000;3007000000;-425000000;-195000000;1055000000;8598000000
OI;406666;USD;2011;Q4;2011-12-31;2012-02-09;163964000;156684000;400000000;1158000000;1061000000;2743000000;2877000000;;3355000000;6232000000;8975000000;1525000000;406000000;2245000000;3627000000;5689000000;7934000000;2993000000;-405000000;-379000000;1041000000;8975000000
OI;406666;USD;2010;Q4;2010-12-31;2011-02-10;163123000;165591000;640000000;1075000000;946000000;2738000000;3107000000;;3909000000;7016000000;9754000000;1395000000;354000000;2079000000;3924000000;5649000000;7728000000;3042000000;-412000000;82000000;2026000000;9754000000
OI;406666;USD;2009;Q4;2009-12-31;2010-02-10;168027000;171655000;756000000;983000000;889000000;2797000000;2711000000;;3219000000;5930000000;8727000000;1329000000;350000000;2034000000;3258000000;4957000000;6991000000;2944000000;-217000000;129000000;1736000000;8727000000
OI;406666;USD;2008;Q4;2008-12-31;2009-08-07;165542000;167259000;404500000;988800000;999500000;2444700000;2645600000;;2886200000;5531800000;7976500000;1434500000;393800000;2003300000;2940300000;4679800000;6683100000;2915100000;-221500000;-32400000;1293400000;7976500000
OI;406666;USD;2017;Q4;2017-12-31;2018-02-14;162978000;165273000;492000000;663000000;1036000000;2420000000;3131000000;;4205000000;7336000000;9756000000;1737000000;162000000;2280000000;5121000000;6549000000;8829000000;3101000000;-551000000;84000000;927000000;9756000000
OI;406666;USD;2018;Q4;2018-12-31;2019-02-14;157691000;159419000;512000000;549000000;1018000000;2357000000;3085000000;;4257000000;7342000000;9699000000;1730000000;160000000;2207000000;5181000000;6592000000;8799000000;3126000000;-705000000;333000000;900000000;9699000000
FORD;257294;USD;2016;Q4;2016-09-30;2016-08-12;8606936;8741075;4760620;4864423;2572980;12339444;43030;;12843;55873;12395317;649877;;4169553;;51486;4221039;17870868;;-9674805;8174278;12395317
FORD;257294;USD;2015;Q4;2015-09-30;2015-08-11;8074632;8065543;4042124;5454129;2866464;12658729;78733;;40962;119695;12778424;1161888;;5329909;;115202;5445111;17636465;;-10281367;7333313;12778424
FORD;257294;USD;2014;Q4;2014-09-30;2014-08-19;8195517;8185077;7528362;6124871;2374837;16429619;98990;;40962;139952;16569571;1218541;;6434309;;115202;6549511;18838969;-1260057;-8371806;10020060;16569571
FORD;257294;USD;2013;Q4;2013-09-30;2013-08-12;8112637;8098251;7697742;4382406;2050710;14860393;129987;;40493;170480;15030873;4628968;;4762191;;157708;4919899;18053518;-1260057;-7378700;10110974;15030873
XPO;364942;USD;2016;Q4;2016-12-31;2017-02-28;110871906;136400000;373400000;2313300000;;3073600000;2537400000;;6087400000;8624800000;11698400000;2438400000;136500000;2731600000;4731500000;5929200000;8660800000;3245000000;;-392900000;3037600000;11698400000
XPO;364942;USD;2015;Q4;2015-12-31;2016-02-29;109298037;109500000;289800000;2266400000;;2957200000;2852200000;;6833800000;9686000000;12643200000;2355500000;135300000;2694400000;5272600000;6888000000;9582400000;3212400000;;-465000000;3060800000;12643200000
XPO;364942;USD;2014;Q4;2014-12-31;2015-02-23;66172375;66000000;644100000;543800000;;1223900000;221900000;;1303600000;1525500000;2749400000;372600000;1800000;381100000;580300000;713200000;1094300000;1832000000;;-219100000;1655100000;2749400000
XPO;364942;USD;2013;Q4;2013-12-31;2014-02-26;30766517;30766000;21500000;134200000;;170000000;56600000;;553600000;610200000;780200000;92600000;2000000;99300000;181700000;225000000;324300000;525000000;-100000;-111700000;455900000;780200000
XPO;364942;USD;2012;Q4;2012-12-31;2013-03-12;17975981;17998664;252293000;61245000;;320934000;13090000;;79184000;92274000;413208000;46747000;491000;49027000;108956000;119122000;168149000;262659000;-107000;-60287000;245059000;413208000
XPO;364942;USD;2011;Q4;2011-12-31;2012-03-01;8306389;7630000;74007000;22425000;;99141000;2979000;;25521000;28500000;127641000;13588000;1675000;16071000;454000;3210000;19281000;102621000;-107000;-36948000;108360000;127641000
XPO;364942;USD;2010;Q4;2010-12-31;2011-08-15;8125215;8559632;561000;24272000;;27565000;2960000;;26147000;29107000;56672000;12798000;1680000;15251000;4832000;7408000;22659000;27241000;-107000;6879000;34013000;56672000
XPO;364942;USD;2017;Q4;2017-12-31;2018-02-12;118900000;132300000;396900000;2725300000;;3587900000;2663700000;;6350000000;9013700000;12601600000;2776500000;103700000;2997100000;4417500000;5594500000;8591600000;3590100000;;-42600000;4010000000;12601600000
XPO;364942;USD;2018;Q4;2018-12-31;2019-02-14;125900000;135900000;502000000;2596000000;;3688000000;2605000000;;5977000000;8582000000;12270000000;2738000000;367000000;3313000000;3902000000;4987000000;8300000000;3311000000;;377000000;3970000000;12270000000
LPX;849042;USD;2017;Q4;2017-12-31;2018-02-13;144400000;147000000;928000000;142500000;259100000;1359600000;1008500000;;80400000;1088900000;2448500000;241600000;25100000;270100000;350800000;573900000;844000000;624000000;-177500000;1280100000;1604500000;2448500000
LPX;849042;USD;2016;Q4;2016-12-31;2017-02-15;143600000;145400000;659300000;108300000;234600000;1008300000;954600000;;68300000;1022900000;2031200000;222800000;2600000;228800000;374400000;606700000;835500000;631600000;-189000000;890300000;1195700000;2031200000
EQT;378136;USD;2018;Q4;2018-12-31;2019-02-14;-406522879;-406750667;3487000;1241843000;;1969664000;17392507000;1013002000;346171000;18751680000;20721344000;1059873000;704390000;2355001000;4792991000;7408114000;9763115000;7828554000;-49194000;3184275000;10958229000;20721344000
EQT;378136;USD;2017;Q4;2017-12-31;2018-02-15;423900609;422767180;26311000;664685000;;1163055000;19730008000;0;8629541000;28359549000;29522604000;726433000;12406000;1232237000;5984923000;9875754000;11107991000;9388903000;-63602000;3996775000;18414613000;29522604000
EQT;378136;USD;2016;Q4;2016-12-31;2017-02-09;315089588;314217013;1103540000;341628000;;1828219000;13162216000;184562000;297925000;13644703000;15472922000;309978000;0;804640000;3289459000;5549035000;6353675000;3440185000;-91019000;2509073000;9119247000;15472922000
EQT;378136;USD;2015;Q4;2015-12-31;2016-02-11;284211455;281555153;1601232000;176957000;;2251019000;11472021000;77025000;176107000;11725153000;13976172000;291550000;;795819000;2793343000;5152311000;5948130000;2153280000;-104079000;2982212000;8028042000;13976172000
EQT;378136;USD;2014;Q4;2014-12-31;2015-02-12;285433060;279945941;1077429000;306085000;;1904323000;10076814000;;54216000;10131030000;12035353000;444077000;165874000;833342000;2793479000;4828948000;5662290000;1895632000;-429440000;2917129000;6373063000;12035353000
EQT;378136;USD;2013;Q4;2013-12-31;2014-02-20;285868429;281323691;845641000;235781000;19656000;1255425000;8333762000;128983000;73883000;8536628000;9792053000;330329000;11162000;523410000;2490354000;4404515000;4927925000;1869843000;-447738000;2567980000;4864128000;9792053000
EQT;378136;USD;2012;Q4;2012-12-31;2013-02-21;275175252;277884827;182055000;190258000;45165000;852844000;7059412000;130368000;807238000;7997018000;8849862000;276802000;23204000;570464000;2502969000;4390596000;4961060000;1770545000;-461774000;2195502000;3888802000;8849862000
EQT;378136;USD;2011;Q4;2011-12-31;2012-02-16;274469844;276325214;831251000;153321000;123960000;1690134000;6806309000;136972000;139304000;7082585000;8772719000;256757000;219315000;804910000;2527627000;4373979000;5178889000;1734994000;-473215000;2143910000;3593830000;8772719000
EQT;378136;USD;2010;Q4;2010-12-31;2011-02-24;270112480;271609635;0;156709000;137853000;827940000;5910091000;220233000;140174000;6270498000;7098438000;212134000;59650000;596984000;1943200000;3422758000;4019742000;1723898000;-479072000;1795766000;3078696000;7098438000
EQT;378136;USD;2009;Q4;2009-12-31;2010-02-18;240384309;241712460;0;155574000;182957000;695166000;4914731000;218022000;129338000;5262091000;5957257000;248987000;5000000;612674000;1949200000;3193553000;3806227000;952237000;-482125000;1695358000;2151030000;5957257000
EQT;378136;USD;2008;Q4;2008-12-31;2009-07-29;239300479;239838720;0;209008000;288182000;927182000;4097519000;195121000;109840000;4402480000;5329662000;356732000;324217000;1042608000;1249200000;2236961000;3279569000;948497000;-483464000;1653797000;2050093000;5329662000
AAN;441241;USD;2016;Q4;2016-12-31;2017-02-24;71413000;72357000;308561000;180581000;999381000;1488523000;211271000;20519000;895423000;1127213000;2615736000;297766000;;573882000;497829000;560256000;1134138000;299888000;-352742000;1534983000;1481598000;2615736000
AAN;441241;USD;2015;Q4;2015-12-31;2016-02-29;72597000;73276000;14942000;199234000;1138938000;1532288000;225836000;22226000;918138000;1166200000;2698488000;348410000;;655891000;606746000;675979000;1331870000;285488000;-321473000;1403120000;1366618000;2698488000
AAN;441241;USD;2014;Q4;2014-12-31;2015-03-02;72483000;72750000;3549000;107383000;1087032000;1328415000;219417000;21311000;887701000;1128429000;2456844000;297621000;;566172000;606082000;667151000;1233323000;272666000;-323288000;1274233000;1223521000;2456844000
AAN;441241;USD;2013;Q4;2013-12-31;2014-02-24;75226000;75721000;231091000;68684000;869725000;1191541000;231293000;112391000;291951000;635635000;1827176000;272310000;;499268000;142704000;187945000;687213000;243558000;-305750000;1202219000;1139963000;1827176000
AAN;441241;USD;2012;Q4;2012-12-31;2013-02-22;75554000;76375000;129534000;74157000;964067000;1178862000;230598000;85861000;317608000;634067000;1812929000;225532000;;489253000;141528000;187550000;676803000;265738000;-216575000;1087032000;1136126000;1812929000
AAN;441241;USD;2011;Q4;2011-12-31;2012-02-29;75496000;77021000;176257000;87471000;862276000;1135889000;226619000;98132000;271259000;596010000;1731899000;270023000;;556985000;153789000;198360000;755345000;257687000;-200106000;918699000;976554000;1731899000
AAN;441241;USD;2010;Q4;2010-12-31;2011-02-25;80828000;82256000;72022000;69662000;814484000;968017000;204912000;;329143000;534055000;1502072000;213139000;;440652000;41790000;82003000;522655000;247128000;-77641000;809084000;979417000;1502072000
AAN;441241;USD;2009;Q4;2009-12-31;2010-08-04;;;109685000;66095000;682402000;870615000;215183000;;235658000;450841000;1321456000;177284000;;340954000;55044000;93242000;434196000;242047000;-49375000;694689000;887260000;1321456000
AAN;441241;USD;2017;Q4;2017-12-31;2018-03-01;70598000;72306000;51037000;185999000;1152135000;1489194000;207687000;20385000;974998000;1203070000;2692264000;304810000;;527402000;368798000;436858000;964260000;315419000;-407713000;1819524000;1728004000;2692264000
AAN;441241;USD;2018;Q4;2018-12-31;2019-02-14;67943000;69394000;15278000;174312000;1318470000;1537208000;229492000;0;1059992000;1289484000;2826692000;293153000;;560653000;424752000;505331000;1065984000;324298000;-567847000;2005344000;1760708000;2826692000
CGNX;710555;USD;2017;Q4;2017-12-31;2018-02-15;173990000;181268000;404543000;119388000;67923000;629991000;78048000;423441000;156273000;657762000;1287753000;103215000;;112635000;;79445000;192080000;461685000;;668587000;1095673000;1287753000
CGNX;710555;USD;2016;Q4;2016-12-31;2017-02-16;171684000;175190000;420835000;55438000;26984000;526344000;53992000;324335000;133933000;512260000;1038604000;57562000;;65773000;;10232000;76005000;375191000;;643836000;962599000;1038604000
CGNX;710555;USD;2015;Q4;2015-12-31;2016-02-10;169836000;172508000;348443000;42846000;37334000;444494000;53285000;273088000;116889000;443262000;887756000;42117000;;53688000;;8401000;62089000;311178000;;566613000;825667000;887756000
CGNX;710555;USD;2014;Q4;2014-12-31;2015-02-12;173616000;177786000;146150000;40053000;29223000;271911000;45963000;400845000;103015000;549823000;821734000;53885000;;80674000;;4623000;85297000;251890000;;523946000;736437000;821734000
CGNX;710555;USD;2013;Q4;2013-12-31;2014-02-13;173758000;178542000;225466000;53015000;25694000;332051000;37136000;229655000;110857000;377648000;709699000;45081000;;61022000;;4765000;65787000;211614000;;462131000;643912000;709699000
CGNX;710555;USD;2012;Q4;2012-12-31;2013-02-11;171996000;174960000;150265000;42387000;26182000;239597000;34820000;238255000;114933000;388008000;627605000;37414000;;50104000;;5216000;55320000;165334000;;436466000;572285000;627605000
CGNX;710555;USD;2011;Q4;2011-12-31;2012-02-09;168520000;171904000;182534000;48206000;28098000;285346000;31744000;174906000;119885000;326535000;611881000;40647000;;54105000;;4796000;58901000;135752000;;434581000;552980000;611881000
CGNX;710555;USD;2010;Q4;2010-12-31;2011-02-10;162468000;167180000;181026000;45901000;22717000;279005000;29596000;102055000;122448000;254099000;533104000;44270000;;54432000;;5361000;59793000;102702000;;379826000;473311000;533104000
CGNX;710555;USD;2009;Q4;2009-12-31;2010-08-02;158648000;158648000;175394000;30964000;16832000;249354000;28576000;26633000;135306000;190515000;439869000;23772000;;38680000;;6741000;45421000;69350000;;328459000;394448000;439869000
CGNX;710555;USD;2018;Q4;2018-12-31;2019-02-14;171493000;175589000;535560000;119172000;83282000;780326000;91396000;262039000;155906000;509341000;1289667000;81512000;;91357000;;63047000;154404000;529550000;;646214000;1135263000;1289667000
CGA;532888;USD;2018;Q4;2018-06-30;2018-10-19;3268630;3239835;150805639;174460937;53784814;407426651;30894683;;44664627;75559310;482985961;67750245;4726300;83066274;7371899;7371899;90438173;160323276;;235822726;392547787;482985960
CGA;532888;USD;2017;Q4;2017-06-30;2017-10-19;3209833;3209833;123031537;139596455;78006276;370954462;34191332;;50535836;84727168;455681630;31657673;7678111;49718115;8435461;8435461;58153576;157916504;;244738993;397528054;455681630
CGA;532888;USD;2016;Q4;2016-06-30;2016-10-07;3080441;3080441;102896486;116573490;87436315;333305345;37569739;;45631554;83201293;416506638;25746374;4665500;39350537;6671769;6671769;46022306;154835441;;221345279;370484332;416506638
CGA;532888;USD;2015;Q4;2015-06-30;2015-09-17;2956535;2956535;92982564;68528598;101302947;304184346;44634194;;80764078;125398272;429582618;11829649;23605540;56633144;;0;56633144;148426977;;198814259;372949474;429582618
CGA;532888;USD;2014;Q4;2014-06-30;2014-09-15;2665200;2665200;26890321;88781608;75486898;228212666;48061611;;116835933;164897544;393110210;9608776;24002720;61070418;;0;61070418;137177970;;172021331;332039792;393110210
CGA;532888;USD;2013;Q4;2013-06-30;2013-09-12;2336530;2336530;75031489;85323442;34511167;227164937;50660989;;70902416;121563405;348728342;33038276;16099100;51875050;;0;51875050;126114757;;148925125;296853292;348728342
CGA;532888;USD;2012;Q4;2012-06-30;2012-09-24;2250320;2250320;71978630;62001158;28602684;175089323;80065161;;32876569;112941730;288031053;28847386;13931280;45774399;;0;45774399;117333323;;109142824;242256654;288031053
CGA;532888;USD;2011;Q4;2011-06-30;2011-11-21;2159187;2045854;65606413;17517625;23732404;118881464;70873480;;33616043;104489523;223370987;16268921;4099550;31497746;;0;31497746;108682049;;72287436;191873241;223370987
CGA;532888;USD;2019;Q4;2019-06-30;2019-10-15;3725480;3725480;72259804;145190160;162013889;414954040;26669938;;39376422;66046360;481000400;63112680;11157307;84444713;;;84444713;169254321;;247122574;396555684;481000397
TNET;797860;USD;2018;Q4;2018-12-31;2019-02-14;69395371;69725179;282000000;11000000;;1646000000;79000000;135000000;575000000;789000000;2435000000;416000000;22000000;1425000000;391000000;635000000;2060000000;641000000;;-266000000;375000000;2435000000
TNET;797860;USD;2017;Q4;2017-12-31;2018-02-27;69671759;72373943;336000000;21000000;;1991000000;70000000;0;532000000;602000000;2593000000;413000000;40000000;1757000000;383000000;630000000;2387000000;583000000;;-377000000;206000000;2593000000
TNET;797860;USD;2016;Q4;2016-12-31;2017-02-28;68561945;71859596;184000000;;;1535000000;59000000;;501000000;560000000;2095000000;54000000;37000000;1379000000;422000000;681000000;2060000000;535000000;;-500000000;35000000;2095000000
TNET;797860;USD;2015;Q4;2015-12-31;2016-04-01;70171714;76256679;166178000;;;1568164000;37844000;;486441000;524285000;2092449000;41867000;32970000;1455736000;460965000;628632000;2084368000;494397000;;-485595000;8081000;2092449000
TNET;797860;USD;2014;Q4;2014-12-31;2015-03-30;69678332;73257049;134341000;;;1824338000;32298000;;483944000;516242000;2340580000;41452000;20738000;1703048000;524412000;663291000;2366339000;442682000;;-468127000;-25759000;2340580000
TNET;797860;USD;2013;Q4;2013-12-31;2014-05-08;14908218;20343455;94356000;;;898546000;25690000;;510502000;536192000;1434738000;33579000;6669000;816950000;812208000;888150000;1705100000;74160000;;-467209000;-270362000;1434738000
DNOW;558120;USD;2016;Q4;2016-12-31;2017-02-15;108664724;108664724;106000000;354000000;483000000;959000000;143000000;;501000000;644000000;1603000000;346000000;;347000000;65000000;73000000;420000000;2003000000;;-678000000;1183000000;1603000000
DNOW;558120;USD;2015;Q4;2015-12-31;2016-02-23;107695888;107695888;90000000;485000000;693000000;1292000000;165000000;;375000000;540000000;1832000000;305000000;;307000000;108000000;122000000;429000000;1981000000;;-444000000;1403000000;1832000000
DNOW;558120;USD;2014;Q4;2014-12-31;2015-02-25;107235372;107224576;195000000;851000000;949000000;2047000000;124000000;;425000000;549000000;2596000000;615000000;;620000000;;10000000;630000000;1953000000;;58000000;1966000000;2596000000
DNOW;558120;USD;2013;Q4;2013-12-31;2014-05-14;107212124;108875472;101000000;661000000;850000000;1662000000;102000000;;419000000;521000000;2183000000;363000000;;363000000;;1820000000;2183000000;;;;0;2183000000
DNOW;558120;USD;2017;Q4;2017-12-31;2018-02-14;107988089;107988089;98000000;423000000;590000000;1129000000;119000000;;501000000;620000000;1749000000;393000000;;394000000;162000000;170000000;564000000;2020000000;;-730000000;1185000000;1749000000
DNOW;558120;USD;2018;Q4;2018-12-31;2019-02-14;108429410;108855322;116000000;482000000;602000000;1219000000;106000000;;470000000;576000000;1795000000;439000000;;441000000;132000000;140000000;581000000;2035000000;;-678000000;1214000000;1795000000
FRD;543788;USD;2016;Q4;2017-03-31;2016-06-29;7009444;7009444;1461695;8939051;34918550;45432836;15173164;;2657297;17830461;63263297;2314590;;2356590;;550282;2906872;37051074;-5475964;28781315;60356425;63263297
FRD;543788;USD;2015;Q4;2016-03-31;2016-06-29;6799444;6799444;2796762;4822386;41939128;49701656;15968239;;1220502;17188741;66890397;2822250;;2865750;;785600;3651350;36978834;-5475964;31736177;63239047;66890397
FRD;543788;USD;2014;Q4;2015-03-31;2015-06-11;6799444;6799444;2225924;6896186;40850666;50117355;15517311;;1323358;16840669;66958024;2600111;;2651111;;1089888;3740999;36978834;-5475964;31714155;63217025;66958024
FRD;543788;USD;2013;Q4;2014-03-31;2014-06-11;6799444;6799444;15081024;9347289;35288559;59846668;11362731;;1075000;12437731;72284399;7718189;;7770689;;1203054;8973743;36978834;-5475964;31807786;63310656;72284399
FRD;543788;USD;2012;Q4;2013-03-31;2013-06-13;6799444;6799444;15923294;9037548;39219168;64283557;11278572;;1013000;12291572;76575129;12259582;;12312082;;1305428;13617510;36978834;-5475964;31454749;62957619;76575129
FRD;543788;USD;2011;Q4;2012-03-31;2012-06-19;6799444;6799444;11881548;16284377;36753680;65007891;12611502;;951000;13562502;78570393;13800888;;13853388;;1299737;15153125;36978834;-5475964;31914398;63417268;78570393
FRD;543788;USD;2010;Q4;2011-03-31;2011-08-12;6799444;6799444;7210290;12594954;34679270;54562344;14131787;;890000;15021787;69584131;9417375;;9467375;;1314242;10781617;36978834;-5475964;27299644;58802514;69584131
FRD;543788;USD;2017;Q4;2018-03-31;2018-06-28;7009444;7009444;4052582;17458289;38039332;59979304;14166001;;217900;14383901;74363205;10985635;;11030635;;278254;11308889;37340034;-5475964;31190246;63054316;74363205
FRD;543788;USD;2018;Q4;2019-03-31;2019-07-01;7012732;7012732;11667161;13183411;49062086;74456207;11909958;;235817;12145775;86601982;12314652;;12364902;;1755503;14120405;37527632;-5525964;40479909;72481577;86601982
INCY;671924;USD;2017;Q4;2017-12-31;2018-02-15;211123000;205309000;1169645000;266299000;6482000;1504854000;259763000;134356000;403609000;797728000;2302582000;341155000;7393000;375396000;16608000;296557000;671953000;3627644000;;-1990005000;1630629000;2302582000
INCY;671924;USD;2016;Q4;2016-12-31;2017-02-14;188597000;196595000;808546000;148758000;4106000;994178000;167679000;31987000;444753000;644419000;1638597000;253962000;;273501000;651481000;945629000;1219130000;2097118000;;-1674765000;419467000;1638597000
INCY;671924;USD;2015;Q4;2015-12-31;2016-02-12;186271000;209258000;707783000;114450000;1783000;842375000;86006000;35248000;43811000;165065000;1007440000;155495000;;168007000;619893000;668278000;836285000;1950951000;;-1778987000;171155000;1007440000
INCY;671924;USD;2014;Q4;2014-12-31;2015-02-17;169925000;149471000;600263000;57933000;358000;679573000;81790000;;35114000;116904000;796477000;122995000;85186000;221061000;589981000;657044000;878105000;1702075000;;-1785518000;-81628000;796477000
INCY;671924;USD;2013;Q4;2013-12-31;2014-02-21;161916000;161916000;509004000;35374000;406000;555799000;26848000;;46921000;73769000;629568000;95152000;;108042000;661567000;714634000;822676000;1541936000;;-1737037000;-193108000;629568000
INCY;671924;USD;2012;Q4;2012-12-31;2013-02-21;131710000;122965000;228418000;70951000;278000;309514000;6348000;;14557000;20905000;330419000;69995000;;136074000;331076000;369302000;505376000;1477055000;;-1653890000;-174957000;330419000
INCY;671924;USD;2011;Q4;2011-12-31;2012-02-22;126391000;126391000;277594000;6415000;;310778000;6431000;;11753000;18184000;328962000;66311000;;135614000;316153000;420425000;556039000;1380851000;;-1609570000;-227077000;328962000
INCY;671924;USD;2010;Q4;2010-12-31;2011-05-03;122966000;116305000;424168000;5701000;;455454000;4804000;;29323000;34127000;489581000;46600000;;113573000;293432000;464652000;578225000;1332400000;;-1423030000;-88644000;489581000
INCY;671924;USD;2018;Q4;2018-12-31;2019-02-14;213014000;219792000;1438323000;307598000;6967000;1832254000;319751000;99199000;394558000;813508000;2645762000;393433000;;425277000;17434000;294518000;719795000;3813891000;;-1877759000;1925967000;2645762000
PAYC;746934;USD;2018;Q4;2018-12-31;2019-02-14;57488135;58325366;45718000;3414000;797000;1064622000;176962000;;280342000;457304000;1521926000;39469000;1775000;1028682000;32614000;158491000;1187173000;204287000;-265124000;395590000;334753000;1521926000
PAYC;746934;USD;2017;Q4;2017-12-31;2018-02-14;58147297;58944152;46077000;1576000;979000;1176265000;147705000;;226168000;373873000;1550138000;33496000;888000;1140152000;34414000;128739000;1268891000;162410000;-139688000;258525000;281247000;1550138000
PAYC;746934;USD;2016;Q4;2016-12-31;2017-02-21;57656617;59905846;60158000;1339000;675000;925583000;96848000;;56182000;153030000;1078613000;26304000;1113000;898894000;28711000;63192000;962086000;96037000;-49958000;70448000;116527000;1078613000
PAYC;746934;USD;2015;Q4;2015-12-31;2016-02-22;57142024;58379226;50714000;2354000;1093000;761138000;58858000;;56659000;115517000;876655000;17532000;886000;727534000;24856000;50807000;778341000;71706000;;26608000;98314000;876655000
PAYC;746934;USD;2014;Q4;2014-12-31;2015-02-26;52074208;55795654;25144000;2794000;195000;691948000;47919000;;57630000;105549000;797497000;9745000;855000;678772000;26123000;44587000;723359000;68475000;;5663000;74138000;797497000
PAYC;746934;USD;2013;Q4;2013-12-31;2014-06-12;45720122;50624263;13362000;1705000;578000;477748000;38671000;;59059000;97730000;575478000;12479000;9545000;482983000;11545000;87412000;570395000;34435000;;-29349000;5083000;575478000
DISH;741324;USD;2017;Q4;2017-12-31;2018-02-21;466413000;583760000;1980673000;653948000;321008000;3285023000;2183661000;113460000;24191622000;26488743000;29773766000;3050406000;1068524000;4828004000;15134441000;17624466000;22452470000;3301152000;;3635380000;7321296000;29773766000
DISH;741324;USD;2016;Q4;2016-12-31;2017-02-22;465123000;512820000;5360119000;777908000;422349000;8280387000;2654271000;33248000;16946386000;19633905000;27914292000;2876947000;941903000;4592832000;15541736000;18390503000;22983335000;3076077000;;1536691000;4930957000;27914292000
DISH;741324;USD;2015;Q4;2015-12-31;2016-02-18;1850591791;1857394617;1611069000;864028000;390328000;3543243000;2924180000;327250000;16092037000;19343467000;22886710000;2759281000;1534000000;5162940000;12221925000;14691740000;19854680000;2785181000;-1569459000;1471084000;3032030000;22886710000
DISH;741324;USD;2014;Q4;2014-12-31;2015-02-23;921758246;927276798;9236241000;951493000;493754000;12552067000;3773539000;327250000;5392685000;9493474000;22045541000;2539685000;681467000;4112525000;13746059000;15879384000;19991909000;2683969000;-1569459000;723992000;2053632000;22045541000
DISH;741324;USD;2013;Q4;2013-12-31;2014-02-21;-1364246824;-1370522336;9739404000;957518000;512707000;12313446000;4097711000;151273000;3794000000;8042984000;20356430000;2623899000;1034893000;4551649000;12596793000;14807776000;19359425000;2593368000;-1569459000;-220701000;997005000;20356430000
DISH;741324;USD;2012;Q4;2012-12-31;2013-02-20;452433000;457597000;7205379000;860715000;465584000;9059153000;4366629000;119051000;3834775000;8320455000;17379608000;2312759000;537285000;3924467000;11350399000;13383513000;17307980000;2445716000;-1569459000;-1028193000;71628000;17379608000
DISH;741324;USD;2011;Q4;2011-12-31;2012-02-23;446664000;443582000;2040853000;794817000;707151000;3747823000;4514891000;1409746000;1797771000;7722408000;11470231000;2286896000;35645000;3220511000;7458134000;8668723000;11889234000;2279036000;-1569459000;-1211990000;-419003000;11470231000
DISH;741324;USD;2010;Q4;2010-12-31;2011-02-24;443080000;443658000;2940377000;786053000;487575000;4573393000;3232348000;224517000;1601895000;5058760000;9632153000;2045616000;1030895000;4499301000;5484041000;6266295000;10765596000;2176792000;-1569459000;-1834619000;-1133443000;9632153000
DISH;741324;USD;2009;Q4;2009-12-31;2010-03-01;447047000;451499000;2139336000;779871000;295950000;3475952000;3042262000;170224000;1606905000;4819391000;8295343000;2051319000;26518000;3287281000;6470046000;7099750000;10387031000;2125184000;-1462380000;-2760589000;-2091688000;8295343000
DISH;741324;USD;2008;Q4;2008-12-31;2009-08-10;447190000;457784000;559132000;820709000;426671000;2097984000;2663289000;158296000;1540478000;4362063000;6460047000;2083599000;38333000;2980003000;4969423000;5429150000;8409153000;2095482000;-1443786000;-2492804000;-1949106000;6460047000
DISH;741324;USD;2018;Q4;2018-12-31;2019-02-13;467763000;526175000;2068817000;639855000;290733000;3289205000;1928180000;118992000;25250635000;27297807000;30587012000;2778827000;1341993000;4776132000;13810784000;16756623000;21532755000;3383772000;;5212790000;9054257000;30587012000
AEPI;210001;USD;2015;Q4;2015-10-31;2016-01-14;5102810;5127709;20167000;104930000;101264000;233255000;193993000;;12957000;206950000;440205000;109129000;2475000;111604000;210951000;238953000;350557000;115075000;-189810000;165395000;89648000;440205000
AEPI;210001;USD;2014;Q4;2014-10-31;2015-01-14;5073622;5067555;867000;119355000;86420000;216206000;216509000;;14231000;230740000;446946000;110374000;2636000;113010000;253695000;274239000;387249000;113090000;-189810000;136558000;59697000;446946000
AEPI;210001;USD;2013;Q4;2013-10-31;2014-01-14;5601603;5593408;13319000;112605000;97091000;234704000;220314000;;16545000;236859000;471563000;112723000;3335000;116058000;238931000;270092000;386150000;112639000;-169826000;142064000;85413000;471563000
AEPI;210001;USD;2012;Q4;2012-10-31;2013-01-22;5527779;5597180;2807000;109895000;95128000;213426000;195986000;;22031000;218017000;431443000;114453000;2604000;117057000;214728000;240657000;357714000;111660000;-169826000;131316000;73729000;431443000
AEPI;210001;USD;2011;Q4;2011-10-31;2012-01-17;5485866;5523798;6445000;109061000;103092000;228866000;169580000;;17223000;186803000;415669000;110254000;1392000;111646000;237123000;254037000;365683000;109630000;-169826000;108164000;49986000;415669000
AEPI;210001;USD;2010;Q4;2010-10-31;2011-09-09;;;1049000;86625000;72978000;167438000;169343000;;14015000;183358000;350796000;96450000;441000;96891000;185259000;197275000;294166000;109158000;-150424000;95776000;56630000;350796000
AEPI;210001;USD;2016;Q4;2016-10-31;2017-01-17;5113819;5150258;3676000;99510000;92685000;201860000;179666000;;11105000;190771000;392631000;112476000;2400000;114876000;133125000;164463000;279339000;115594000;-189810000;189085000;113292000;392631000
AGIO;737501;USD;2017;Q4;2017-12-31;2018-02-14;48864815;48864815;423936000;;;445261000;24431000;143814000;891000;169136000;614397000;56798000;;94941000;;143953000;238894000;1174953000;;-798061000;375503000;614397000
AGIO;737501;USD;2016;Q4;2016-12-31;2017-02-16;42136980;42136980;541314000;3428000;;559892000;25337000;32250000;1615000;59202000;619094000;49108000;;88433000;;172070000;260503000;842055000;;-483151000;358591000;619094000
AGIO;737501;USD;2015;Q4;2015-12-31;2016-02-26;37665783;37665783;317002000;3374000;;337329000;23220000;58905000;611000;82736000;420065000;30744000;;52888000;;22059000;74947000;630116000;;-284680000;345118000;420065000
AGIO;737501;USD;2014;Q4;2014-12-31;2015-02-24;35175985;33078378;342065000;2334000;;359546000;6386000;125382000;590000;132358000;491904000;25087000;;61089000;;6449000;67538000;591371000;;-166948000;424366000;491904000
AGIO;737501;USD;2013;Q4;2013-12-31;2014-03-18;31536027;31536027;166769000;;;169747000;3758000;27125000;575000;31458000;201205000;11726000;;36930000;;32793000;69723000;244912000;;-113444000;131482000;201205000
AGIO;737501;USD;2012;Q4;2012-12-31;2013-09-05;3561760;3561760;127976000;;;130144000;3565000;;3299000;6864000;137008000;9891000;;35113000;;57997000;93110000;2015000;;-74037000;43898000;137008000
AGIO;737501;USD;2018;Q4;2018-12-31;2019-02-14;58223425;58223425;585302000;;869000;613780000;24320000;220119000;238000;244677000;858457000;60027000;;93503000;;77417000;170920000;1794341000;;-1104633000;687537000;858457000
PPL;26853;USD;2018;Q4;2018-12-31;2019-02-14;720506000;727661000;621000000;663000000;303000000;2432000000;34458000000;;6506000000;40964000000;43396000000;1673000000;1960000000;4563000000;20069000000;27176000000;31739000000;11028000000;;4593000000;11657000000;43396000000
PPL;26853;USD;2017;Q4;2017-12-31;2018-02-22;689674000;691155000;485000000;681000000;320000000;2294000000;33092000000;;6093000000;39185000000;41479000000;1584000000;1428000000;4023000000;19847000000;26695000000;30718000000;10312000000;;3871000000;10761000000;41479000000
PPL;26853;USD;2016;Q4;2016-12-31;2016-11-01;679668000;681890000;341000000;666000000;356000000;2067000000;30074000000;;6174000000;36248000000;38315000000;1450000000;1441000000;3837000000;17808000000;24579000000;28416000000;9848000000;;3829000000;9899000000;38315000000
PPL;26853;USD;2015;Q4;2015-12-31;2016-02-19;673104000;676624000;836000000;673000000;357000000;2646000000;30382000000;;6273000000;36655000000;39301000000;1455000000;1401000000;3876000000;18563000000;25506000000;29382000000;9694000000;;2953000000;9919000000;39301000000
PPL;26853;USD;2014;Q4;2014-12-31;2015-02-23;619216799;618826696;1519000000;737000000;381000000;6026000000;28169000000;;14411000000;42580000000;48606000000;1805000000;1836000000;7439000000;17054000000;27539000000;34978000000;9440000000;;6462000000;13628000000;48606000000
PPL;26853;USD;2013;Q4;2013-12-31;2014-02-24;499492576;519947421;1102000000;923000000;702000000;5153000000;33087000000;907000000;7112000000;41106000000;46259000000;1979000000;1016000000;4912000000;20592000000;28881000000;33793000000;8322000000;;5709000000;12466000000;46259000000
PPL;26853;USD;2012;Q4;2012-12-31;2013-02-28;624460699;626770228;901000000;745000000;673000000;5068000000;30032000000;759000000;7775000000;38566000000;43634000000;1877000000;1403000000;5625000000;18725000000;27511000000;33136000000;6942000000;;5478000000;10498000000;43634000000
PPL;26853;USD;2011;Q4;2011-12-31;2012-02-28;620807971;622091043;1218000000;732000000;654000000;6426000000;27266000000;718000000;8238000000;36222000000;42648000000;1709000000;578000000;5255000000;17993000000;26297000000;31552000000;6819000000;;4797000000;11096000000;42648000000
PPL;26853;USD;2010;Q4;2010-12-31;2011-02-28;518827946;519083486;1088000000;652000000;643000000;6188000000;20823000000;693000000;5133000000;26649000000;32837000000;1502000000;1196000000;5214000000;12161000000;19145000000;24359000000;4607000000;;4082000000;8478000000;32837000000
PPL;26853;USD;2009;Q4;2009-12-31;2010-02-26;404732289;405099494;801000000;409000000;357000000;4752000000;13174000000;613000000;3626000000;17413000000;22165000000;958000000;639000000;4182000000;7143000000;12168000000;16350000000;2284000000;;3749000000;5815000000;22165000000
PPL;26853;USD;2008;Q4;2008-12-31;2009-08-25;401909531;402263852;1250000000;456000000;337000000;4383000000;12375000000;522000000;4125000000;17022000000;21405000000;1104000000;1375000000;4324000000;7142000000;11685000000;16009000000;2200000000;;3862000000;5396000000;21405000000
APC;67564;USD;2017;Q4;2017-12-31;2018-02-15;536000000;536000000;4553000000;1222000000;;6762000000;27451000000;;7873000000;35324000000;42086000000;2160000000;142000000;3906000000;15547000000;24390000000;28296000000;12057000000;-2132000000;1109000000;13790000000;42086000000
APC;67564;USD;2016;Q4;2016-12-31;2017-02-17;552000000;552000000;3184000000;1007000000;;5266000000;32168000000;;8130000000;40298000000;45564000000;1920000000;42000000;3328000000;15281000000;26739000000;30067000000;11932000000;-1033000000;1704000000;15497000000;45564000000
APC;67564;USD;2015;Q4;2015-12-31;2016-02-17;509000000;508000000;939000000;652000000;;3981000000;33751000000;;8599000000;42350000000;46331000000;3839000000;32000000;4180000000;15636000000;26694000000;30874000000;9317000000;-995000000;4880000000;15457000000;46331000000
APC;67564;USD;2014;Q4;2014-12-31;2015-02-20;509000000;505000000;7369000000;1118000000;;10499000000;41589000000;;8879000000;50468000000;60967000000;4767000000;0;10234000000;15092000000;28415000000;38649000000;9057000000;-940000000;12125000000;22318000000;60967000000
APC;67564;USD;2013;Q4;2013-12-31;2014-02-28;502000000;508000000;3698000000;1481000000;;7108000000;40929000000;;7744000000;48673000000;55781000000;4794000000;500000000;6553000000;13065000000;25578000000;32131000000;8681000000;-895000000;14356000000;23650000000;55781000000
APC;67564;USD;2012;Q4;2012-12-31;2013-02-19;501000000;505000000;2471000000;1473000000;;6795000000;38398000000;;7396000000;45794000000;52589000000;3696000000;0;3994000000;13269000000;26713000000;30707000000;8281000000;-841000000;13829000000;21882000000;52589000000
APC;67564;USD;2011;Q4;2011-12-31;2012-02-21;499000000;495000000;2697000000;1269000000;;6931000000;37501000000;;7347000000;44848000000;51779000000;4729000000;170000000;4899000000;15060000000;27897000000;32796000000;7902000000;-804000000;11619000000;18983000000;51779000000
APC;67564;USD;2010;Q4;2010-12-31;2011-02-23;496000000;501000000;3680000000;1032000000;;6675000000;37957000000;;6927000000;44884000000;51559000000;3823000000;291000000;4114000000;12722000000;26006000000;30120000000;7547000000;-763000000;14449000000;21439000000;51559000000
APC;67564;USD;2009;Q4;2009-12-31;2010-02-23;492000000;490000000;3531000000;1019000000;;6083000000;37204000000;;6836000000;44040000000;50123000000;3824000000;;3824000000;11149000000;25884000000;29708000000;7293000000;-721000000;13868000000;20415000000;50123000000
APC;67564;USD;2008;Q4;2008-12-31;2009-08-04;459000000;460000000;2360000000;791000000;;5095000000;37047000000;;6781000000;43828000000;48923000000;4064000000;1472000000;5536000000;9128000000;24231000000;29767000000;5743000000;-686000000;14179000000;19156000000;48923000000
APC;67564;USD;2018;Q4;2018-12-31;2019-02-14;495000000;492000000;1295000000;1491000000;;3795000000;28615000000;;7966000000;36581000000;40376000000;2164000000;947000000;4658000000;15470000000;24775000000;29433000000;12450000000;-4864000000;1245000000;10943000000;40376000000
TROW;378221;USD;2016;Q4;2016-12-31;2017-02-07;242800000;247500000;1204900000;455100000;;3340500000;615100000;1257500000;1011900000;2884500000;6225000000;312700000;;312700000;;216500000;529200000;703500000;;4293600000;5695800000;6225000000
TROW;378221;USD;2015;Q4;2015-12-31;2016-02-05;249300000;254700000;1172300000;446000000;;1676000000;607100000;1961200000;862600000;3430900000;5106900000;276000000;;276000000;;68900000;344900000;704700000;;3970700000;4762000000;5106900000
TROW;378221;USD;2014;Q4;2014-12-31;2015-02-05;257600000;264900000;3390100000;442800000;;3832900000;586400000;408300000;816800000;1811500000;5644400000;249200000;;249200000;;;249200000;808700000;;4450100000;5395200000;5644400000
TROW;378221;USD;2013;Q4;2013-12-31;2014-02-04;259400000;267600000;3009900000;398800000;;3408700000;572900000;313600000;737900000;1624400000;5033100000;215000000;;215000000;;;215000000;947000000;;3682800000;4818100000;5033100000
TROW;378221;USD;2012;Q4;2012-12-31;2013-02-05;254100000;262100000;2155200000;353900000;;2509100000;561000000;304700000;828000000;1693700000;4202800000;202000000;;202000000;;154700000;356700000;682400000;;3031800000;3846100000;4202800000
TROW;378221;USD;2011;Q4;2011-12-31;2012-02-03;252000000;258000000;1860800000;304500000;;2165300000;567400000;206300000;831300000;1605000000;3770300000;176100000;;176100000;;173500000;349600000;552700000;;2765200000;3420700000;3770300000
TROW;378221;USD;2010;Q4;2010-12-31;2011-02-08;256900000;266700000;1745700000;307900000;;2053600000;560300000;209700000;818400000;1588400000;3642000000;185100000;;185100000;;160400000;345500000;558000000;;2599400000;3296500000;3642000000
TROW;378221;USD;2009;Q4;2009-12-31;2010-02-05;256900000;264900000;1603400000;246200000;;1849600000;512800000;45700000;802200000;1360700000;3210300000;166800000;;166800000;;161300000;328100000;540200000;;2240100000;2882200000;3210300000
TROW;378221;USD;2008;Q4;2008-12-31;2009-10-23;;;1298600000;177300000;;1475900000;440100000;41900000;861500000;1343500000;2819400000;172800000;;172800000;;157800000;330600000;415100000;;2086800000;2488800000;2819400000
TROW;378221;USD;2017;Q4;2017-12-31;2018-02-16;242600000;247500000;1902700000;565300000;;4516400000;652000000;1477300000;889700000;3019000000;7535400000;393000000;;393000000;;325200000;718200000;895100000;;4932900000;6817200000;7535400000
TROW;378221;USD;2018;Q4;2018-12-31;2019-02-13;239500000;242900000;1425200000;549600000;;3655200000;661300000;2453400000;919400000;4034100000;7689300000;406000000;;406000000;;418700000;824700000;702200000;;5464100000;6864600000;7689300000
CDR;664567;USD;2017;Q4;2017-12-31;2018-02-12;87525000;87525000;3702000;17193000;;24412000;1192656000;;35350000;1228006000;1252418000;24519000;127969000;207488000;414819000;414819000;622307000;880541000;-18463000;;630111000;1252418000
CDR;664567;USD;2016;Q4;2016-12-31;2017-02-23;81679000;81679000;2882000;14894000;;20656000;1183359000;;29506000;1212865000;1233521000;23463000;138243000;233706000;417818000;417818000;651524000;834645000;-18129000;;581997000;1233521000
CDR;664567;USD;2015;Q4;2015-12-31;2016-02-19;81619000;81619000;2083000;17912000;;39989000;1249195000;;29196000;1278391000;1318380000;23831000;298089000;399920000;320918000;320918000;720838000;831082000;-17284000;;597542000;1318380000
CDR;664567;USD;2014;Q4;2014-12-31;2015-02-20;75546000;75546000;3499000;18405000;;46271000;1208962000;;31546000;1240508000;1286779000;22364000;393388000;487752000;223776000;223776000;711528000;795927000;-18803000;;575253000;1286781000
CDR;664567;USD;2013;Q4;2013-12-31;2014-02-25;68475000;68475000;3973000;18492000;;104285000;1199346000;;28295000;1227641000;1331926000;22666000;516292000;696562000;76868000;99716000;796278000;752329000;-20191000;;535648000;1331926000
CDR;664567;USD;2012;Q4;2012-12-31;2013-03-07;68263000;68263000;7522000;17846000;;156793000;1183867000;;29243000;1213110000;1369903000;28179000;589168000;778345000;30502000;69808000;848153000;752503000;-21702000;;521750000;1369903000
CDR;664567;USD;2011;Q4;2011-12-31;2012-03-06;66789000;66789000;12070000;25660000;;264116000;1167275000;;80772000;1248047000;1512163000;32404000;586743000;791870000;35017000;159905000;951775000;723050000;-10528000;;560388000;1512163000
CDR;664567;USD;2010;Q4;2010-12-31;2011-08-08;;;14166000;7048000;;389318000;1132313000;;100856000;1233169000;1622487000;29026000;;719719000;40253000;197244000;916963000;716539000;-10367000;;705524000;1622487000
CDR;664567;USD;2018;Q4;2018-12-31;2019-02-14;88997000;88016000;1977000;21977000;;35546000;1146713000;;40642000;1187355000;1222901000;26142000;47315000;173457000;490728000;490728000;664185000;880991000;-16572000;;558716000;1222901000
TRU;700411;USD;2017;Q4;2017-12-31;2018-02-13;182800000;190800000;115800000;326700000;;588700000;198600000;;4331200000;4529800000;5118500000;131300000;119300000;458400000;2345300000;2835500000;3293900000;1865400000;-138800000;137400000;1824600000;5118500000
TRU;700411;USD;2016;Q4;2016-12-31;2017-02-15;182800000;185200000;182200000;277900000;;550000000;197500000;;4033700000;4231200000;4781200000;114200000;50400000;373300000;2325200000;2934900000;3308200000;1846700000;-5300000;-303800000;1473000000;4781200000
TRU;700411;USD;2015;Q4;2015-12-31;2016-02-19;182700000;188700000;133200000;228300000;;426800000;183000000;;3833000000;4016000000;4442800000;105400000;43900000;296000000;2160700000;2776900000;3072900000;1852100000;-4600000;-424300000;1369900000;4442800000
TRU;700411;USD;2014;Q4;2014-12-31;2015-05-07;184600000;183800000;77900000;200400000;;401000000;181400000;;4083400000;4264800000;4665800000;106500000;74000000;329900000;2865900000;3564800000;3894700000;1139100000;-4300000;-430200000;771100000;4665800000
TRU;700411;USD;2013;Q4;2013-12-31;2014-02-27;;;111200000;165000000;;349700000;150400000;;3992200000;4142600000;4492300000;100300000;13800000;247600000;2853100000;3512600000;3760200000;1122900000;-4100000;-417700000;732100000;4492300000
TRU;700411;USD;2018;Q4;2018-12-31;2019-02-14;185300000;191500000;187400000;456800000;;841500000;220300000;;5978000000;6198300000;7039800000;169900000;71700000;548500000;3976400000;4509100000;5057600000;1949200000;-139900000;363100000;1982200000;7039800000
WM;378239;USD;2015;Q4;2015-12-31;2016-02-18;447200000;454400000;39000000;1549000000;92000000;2345000000;10665000000;;7357000000;18022000000;20367000000;1785000000;253000000;2510000000;8676000000;12490000000;15000000000;4833000000;-6300000000;6939000000;5367000000;20367000000
WM;378239;USD;2014;Q4;2014-12-31;2015-02-17;458500000;463900000;1307000000;1587000000;106000000;3526000000;10657000000;;7114000000;17771000000;21297000000;1920000000;1090000000;3485000000;8345000000;11923000000;15408000000;4591000000;-5636000000;6888000000;5889000000;21297000000
WM;378239;USD;2013;Q4;2013-12-31;2014-02-18;467900000;472100000;235000000;1699000000;178000000;2499000000;12344000000;;7760000000;20104000000;22603000000;1813000000;726000000;3014000000;9500000000;13587000000;16601000000;4602000000;-5338000000;6289000000;6002000000;22603000000
WM;378239;USD;2012;Q4;2012-12-31;2013-02-14;464800000;465300000;194000000;1737000000;174000000;2423000000;12651000000;;8023000000;20674000000;23097000000;1828000000;743000000;3036000000;9173000000;13386000000;16422000000;4555000000;-5273000000;6879000000;6675000000;23097000000
WM;378239;USD;2011;Q4;2011-12-31;2012-02-16;460600000;462300000;258000000;1631000000;153000000;2379000000;12242000000;;7948000000;20190000000;22569000000;1967000000;631000000;3068000000;9125000000;13111000000;16179000000;4567000000;-5390000000;6721000000;6390000000;22569000000
WM;378239;USD;2010;Q4;2010-12-31;2010-10-28;475800000;473900000;539000000;1510000000;130000000;2482000000;11868000000;;7126000000;18994000000;21476000000;1792000000;233000000;2485000000;8674000000;12400000000;14885000000;4534000000;-4904000000;6400000000;6591000000;21476000000
WM;378239;USD;2009;Q4;2009-12-31;2010-02-16;488500000;492100000;1140000000;1408000000;110000000;3010000000;11541000000;;6603000000;18144000000;21154000000;1695000000;749000000;2901000000;8124000000;11662000000;14563000000;4549000000;-4525000000;6053000000;6591000000;21154000000
WM;378239;USD;2008;Q4;2008-12-31;2009-10-29;;;480000000;1463000000;110000000;2335000000;11402000000;;6490000000;17892000000;20227000000;1750000000;835000000;3036000000;7491000000;11006000000;14042000000;4564000000;-4381000000;5631000000;6185000000;20227000000
WM;378239;USD;2016;Q4;2016-12-31;2017-02-16;441000000;445000000;32000000;1700000000;90000000;2376000000;10950000000;;7533000000;18483000000;20859000000;1884000000;417000000;2794000000;8893000000;12745000000;15539000000;4856000000;-6867000000;7388000000;5320000000;20859000000
WM;378239;USD;2017;Q4;2017-12-31;2018-02-15;434200000;438300000;22000000;1805000000;96000000;2624000000;11559000000;;7646000000;19205000000;21829000000;2020000000;739000000;3262000000;8752000000;12525000000;15787000000;4939000000;-7516000000;8588000000;6042000000;21829000000
WM;378239;USD;2018;Q4;2018-12-31;2019-02-14;425300000;429900000;61000000;1931000000;102000000;2645000000;11942000000;;8063000000;20005000000;22650000000;2154000000;432000000;3108000000;9594000000;13266000000;16374000000;4999000000;-8434000000;9797000000;6276000000;22650000000
UAL;219075;USD;2017;Q4;2017-12-31;2018-02-22;290400000;291500000;3798000000;1340000000;924000000;7133000000;26208000000;852000000;8153000000;35213000000;42346000000;4362000000;1693000000;12763000000;12699000000;20849000000;33612000000;6101000000;-769000000;4549000000;8734000000;42346000000
UAL;219075;USD;2016;Q4;2016-12-31;2017-02-23;314800000;315400000;4428000000;1176000000;873000000;7309000000;23318000000;579000000;8934000000;32831000000;40140000000;4446000000;965000000;12286000000;10740000000;19195000000;31481000000;6572000000;-511000000;3427000000;8659000000;40140000000
UAL;219075;USD;2015;Q4;2015-12-31;2016-02-18;367400000;367600000;5196000000;1128000000;738000000;7828000000;21580000000;;11453000000;33033000000;40861000000;4219000000;1359000000;12414000000;10400000000;19481000000;31895000000;7950000000;-1610000000;3457000000;8966000000;40861000000
UAL;219075;USD;2014;Q4;2014-12-31;2015-02-20;373400000;401800000;4384000000;1146000000;666000000;7547000000;19467000000;;9581000000;29048000000;36595000000;3700000000;1423000000;12508000000;10524000000;21691000000;34199000000;7725000000;-367000000;-3883000000;2396000000;36595000000
UAL;219075;USD;2013;Q4;2013-12-31;2014-02-20;362000000;443000000;5121000000;1503000000;667000000;8702000000;18047000000;;10063000000;28110000000;36812000000;3783000000;1485000000;12107000000;10924000000;21721000000;33828000000;7429000000;-38000000;-5015000000;2984000000;36812000000
UAL;219075;USD;2012;Q4;2012-12-31;2013-02-25;332000000;269000000;6543000000;1338000000;695000000;10049000000;17292000000;;10287000000;27579000000;37628000000;4075000000;1934000000;12818000000;11232000000;24329000000;37147000000;7148000000;-35000000;-5586000000;481000000;37628000000
UAL;219075;USD;2011;Q4;2011-12-31;2012-02-22;329000000;344000000;7762000000;1358000000;615000000;10997000000;16419000000;;10572000000;26991000000;37988000000;3507000000;1311000000;11394000000;11424000000;24788000000;36182000000;7117000000;-31000000;-4863000000;1806000000;37988000000
UAL;219075;USD;2010;Q4;2010-12-31;2011-02-22;408000000;511000000;8680000000;1613000000;466000000;12045000000;16945000000;818000000;9790000000;27553000000;39598000000;3275000000;2663000000;12645000000;12470000000;25226000000;37871000000;7074000000;-31000000;-5703000000;1727000000;39598000000
UAL;219075;USD;2009;Q4;2009-12-31;2010-07-20;;;3042000000;743000000;472000000;5105000000;9840000000;983000000;2756000000;13579000000;18684000000;1504000000;971000000;6473000000;7572000000;15022000000;21495000000;3138000000;-28000000;-5956000000;-2811000000;18684000000
UAL;219075;USD;2018;Q4;2018-12-31;2019-02-28;271000000;272700000;3950000000;1346000000;985000000;7194000000;28329000000;966000000;8303000000;37598000000;44792000000;4547000000;1379000000;13212000000;13349000000;21585000000;34797000000;6123000000;-1993000000;6668000000;9995000000;44792000000
CL;255327;USD;2016;Q4;2016-12-31;2017-02-23;887700000;893100000;1315000000;1411000000;1171000000;4338000000;3840000000;;3945000000;7785000000;12123000000;1565000000;13000000;3305000000;6520000000;8801000000;12106000000;3157000000;-19135000000;19922000000;17000000;12123000000
CL;255327;USD;2015;Q4;2015-12-31;2016-02-18;896400000;903200000;970000000;1427000000;1180000000;4384000000;3796000000;;3755000000;7551000000;11935000000;1387000000;302000000;3534000000;6246000000;8445000000;11979000000;2904000000;-18102000000;18861000000;-44000000;11935000000
CL;255327;USD;2014;Q4;2014-12-31;2015-02-19;911000000;919900000;1089000000;1552000000;1382000000;4863000000;4080000000;;4516000000;8596000000;13459000000;1525000000;504000000;3946000000;5644000000;8128000000;12074000000;2702000000;-16862000000;18832000000;1385000000;13459000000
CL;255327;USD;2013;Q4;2013-12-31;2014-02-20;925400000;935400000;962000000;1636000000;1425000000;4931000000;4083000000;;4971000000;9054000000;13985000000;1582000000;908000000;4579000000;4749000000;6870000000;11449000000;2470000000;-15633000000;17952000000;2536000000;13985000000
CL;255327;USD;2012;Q4;2012-12-31;2013-02-21;943800000;951900000;884000000;1668000000;1365000000;4556000000;3842000000;;4996000000;8838000000;13394000000;1544000000;304000000;3736000000;4926000000;7268000000;11004000000;2284000000;-14386000000;16953000000;2390000000;13394000000
CL;255327;USD;2011;Q4;2011-12-31;2012-02-23;967600000;975600000;878000000;1675000000;1327000000;4402000000;3668000000;;4654000000;8322000000;12724000000;1636000000;380000000;3716000000;4430000000;6467000000;10183000000;2069000000;-12808000000;15649000000;2541000000;12724000000
CL;255327;USD;2010;Q4;2010-12-31;2011-02-24;962800000;1000800000;490000000;1610000000;1222000000;3730000000;3693000000;;3749000000;7442000000;11172000000;1437000000;609000000;3728000000;2815000000;4627000000;8355000000;1865000000;-11305000000;14329000000;2817000000;11172000000
CL;255327;USD;2009;Q4;2009-12-31;2010-02-25;994800000;1046800000;600000000;1626000000;1209000000;3810000000;3516000000;;3808000000;7324000000;11134000000;1559000000;361000000;3599000000;2821000000;4278000000;7877000000;2497000000;-10478000000;13157000000;3257000000;11134000000
CL;255327;USD;2008;Q4;2008-12-31;2009-07-30;;;555000000;1592000000;1197000000;3710000000;3119000000;;3150000000;6269000000;9979000000;1333000000;198000000;2952000000;3585000000;4983000000;7935000000;2343000000;-9697000000;11760000000;2044000000;9979000000
CL;255327;USD;2017;Q4;2017-12-31;2018-02-15;878000000;883100000;1535000000;1480000000;1221000000;4639000000;4072000000;;3965000000;8037000000;12676000000;1566000000;11000000;3408000000;6566000000;9025000000;12433000000;3450000000;-20181000000;20531000000;243000000;12676000000
CL;255327;USD;2018;Q4;2018-12-31;2019-02-21;866500000;867000000;726000000;1400000000;1250000000;3793000000;3881000000;;4487000000;8368000000;12161000000;1633000000;12000000;3341000000;6354000000;8623000000;11964000000;3670000000;-21196000000;21615000000;197000000;12161000000
QRVO;35151;USD;2018;Q4;2019-03-31;2019-05-17;121987000;127834000;711035000;378172000;511793000;1684841000;1366513000;97786000;2658884000;4123183000;5808024000;393823000;80000;435614000;920935000;1012731000;1448345000;4687455000;;-321152000;4359679000;5808024000
QRVO;35151;USD;2017;Q4;2018-03-31;2018-05-21;126532000;123011000;926037000;345957000;472292000;1843805000;1374112000;63765000;3099837000;4537714000;6381519000;380375000;;441279000;983290000;1164676000;1605955000;5237085000;;-458769000;4775564000;6381519000
QRVO;35151;USD;2016;Q4;2017-03-31;2017-05-23;126545000;121762000;545463000;357948000;430454000;1461605000;1391932000;35494000;3633292000;5060718000;6522323000;386830000;;418828000;989154000;1206773000;1625601000;5357394000;;-456366000;4896722000;6522323000
QRVO;35151;USD;2015;Q4;2016-03-31;2016-05-31;133030000;123161000;612689000;316356000;427551000;1509210000;1046888000;26050000;4014671000;5087609000;6596819000;343253000;;373801000;988130000;1223346000;1597147000;5442613000;;-439808000;4999672000;6596819000
QRVO;35151;USD;2014;Q4;2015-03-31;2015-05-27;145410000;150597000;544644000;353830000;346900000;1500105000;883371000;4083000;4504820000;5392274000;6892379000;314339000;;325310000;0;393909000;719219000;6584247000;;-410963000;6173160000;6892379000
QRVO;35151;USD;2013;Q4;2014-03-31;2014-09-12;70685000;72412000;243965000;137417000;125703000;537418000;195996000;3841000;183057000;382894000;920312000;131607000;87263000;219973000;;23988000;243961000;1284402000;;-607266000;676351000;920312000
